diacritic_word	diacritic_pos	diacritic_freq	no_diacritic_word	no_diacritic_pos	no_diacritic_freq	total_freq	cnt
abellà	4	104	abella	4	3700	3804	0
adrià	4	17567	adria	4	313	17880	1
agàtocles	4	60	agatocles	4	6	66	2
aidí	4	17	aidi	2	10	27	3
ainès	4	3	aines	4	60	63	4
ainés	4	9	aines	4	60	69	5
aiòder	4	10	aioder	0	0	10	6
alabès	4	600	alabes	2	3	603	7
alabó	4	0	alabo	2	8	8	8
albanès	4	737	albanes	4	17	754	9
albertí	4	1969	alberti	4	724	2693	10
alberí	4	3	alberi	4	11	14	11
albà	4	1448	alba	4	19597	21045	12
albí	4	498	albi	4	1235	1733	13
alcàsser	4	1132	alcasser	0	42	1174	14
alegrí	4	43	alegri	2	123	166	15
alfés	4	674	alfes	4	49	723	16
alió	4	534	alio	2	18	552	17
almúnia	4	139	almunia	4	685	824	18
altejó	4	5	altejo	2	0	5	19
altés	4	481	altes	0	26986	27467	20
alujà	4	0	aluja	4	167	167	21
alès	4	64	ales	4	9673	9737	22
alés	4	34	ales	4	9673	9707	23
alí	4	1094	ali	2	3719	4813	24
amargó	4	5	amargo	2	165	170	25
amarí	4	0	amari	2	97	97	26
ambrosià	4	38	ambrosia	4	138	176	27
ambròsia	4	6	ambrosia	4	138	144	28
amigó	4	2439	amigo	2	704	3143	29
amín	4	10	amin	2	496	506	30
amó	4	19	amo	2	9917	9936	31
amós	4	162	amos	4	6017	6179	32
andaní	4	15	andani	2	7	22	33
andorrà	4	7091	andorra	4	66929	74020	34
anglès	4	95652	angles	4	5902	101554	35
angèlic	4	76	angelic	2	27	103	36
angèlica	4	299	angelica	2	263	562	37
ansó	4	98	anso	2	10	108	38
antoní	4	251	antoni	4	75384	75635	39
apení	4	1	apeni	2	0	1	40
apià	4	97	apia	4	120	217	41
apol·ló	4	32	apol·lo	4	1621	1653	42
argentó	4	18	argento	2	153	171	43
arijà	4	0	arija	4	50	50	44
aristòbul	4	43	aristobul	4	2	45	45
armadà	4	4	armada	4	7288	7292	46
arnó	4	354	arno	4	300	654	47
arpí	4	54	arpi	2	11	65	48
arrià	4	143	arria	2	30	173	49
arró	4	56	arro	4	354	410	50
artigó	4	0	artigo	2	13	13	51
artà	4	3011	arta	4	104	3115	52
aràntzazu	4	5	arantzazu	4	76	81	53
arçà	4	0	arça	4	15	15	54
arís	4	52	aris	0	369	421	55
ascós	4	0	ascos	4	9	9	56
aspró	4	1	aspro	2	15	16	57
audí	4	112	audi	4	1784	1896	58
ausà	4	2	ausa	4	334	336	59
avencó	4	95	avenco	2	1	96	60
avilés	4	930	aviles	2	44	974	61
avià	4	1171	avia	2	1283	2454	62
aín	4	182	ain	4	559	741	63
badés	4	12	bades	4	310	322	64
badó	4	122	bado	2	47	169	65
bagà	4	1827	baga	4	640	2467	66
baixés	4	442	baixes	0	24159	24601	67
baiés	4	16	baies	4	839	855	68
baió	4	12	baio	2	18	30	69
balbí	4	13	balbi	2	44	57	70
baldé	4	51	balde	2	59	110	71
baldí	4	3	baldi	2	104	107	72
baldó	4	192	baldo	2	131	323	73
ballarà	4	347	ballara	2	10	357	74
balàfia	4	968	balafia	2	91	1059	75
barberà	4	12297	barbera	4	323	12620	76
barbí	4	1	barbi	2	30	31	77
barcelonès	4	8088	barcelones	4	232	8320	78
barravés	4	92	barraves	2	2	94	79
barà	4	339	bara	4	244	583	80
barés	4	25	bares	0	113	138	81
bascó	4	2	basco	2	81	83	82
bascós	4	18	bascos	0	4026	4044	83
basilís	4	0	basilis	4	7	7	84
bastià	4	32	bastia	2	225	257	85
begudà	4	140	beguda	4	10563	10703	86
bellveí	4	127	bellvei	4	459	586	87
belló	4	106	bello	4	825	931	88
belém	4	195	belem	2	100	295	89
benés	4	31	benes	4	303	334	90
bernabéu	4	1272	bernabeu	4	777	2049	91
besòs	4	6945	besos	4	607	7552	92
blandí	4	5	blandi	2	9	14	93
bodí	4	90	bodi	4	137	227	94
boixó	4	18	boixo	2	9	27	95
boió	4	0	boio	2	1	1	96
bolló	4	79	bollo	2	77	156	97
bolòs	4	458	bolos	4	740	1198	98
borgonyà	4	354	borgonya	4	2095	2449	99
bornís	4	0	bornis	2	32	32	100
borrassà	4	548	borrassa	4	79	627	101
borén	4	75	boren	2	23	98	102
borés	4	88	bores	4	100	188	103
boscà	4	465	bosca	2	86	551	104
bossòst	4	493	bossost	4	75	568	105
boí	4	2620	boi	4	12353	14973	106
brió	4	71	brio	4	96	167	107
brocà	4	122	broca	4	422	544	108
brotó	4	2	broto	2	289	291	109
brullà	4	33	brulla	4	5	38	110
budó	4	307	budo	4	80	387	111
burguès	4	195	burgues	4	59	254	112
burjó	4	3	burjo	2	0	3	113
buscó	4	3	busco	2	3039	3042	114
bàrbara	4	4664	barbara	2	3218	7882	115
bàrbares	4	321	barbares	2	18	339	116
bàscara	4	521	bascara	2	7	528	117
béja	4	22	beja	4	99	121	118
bítem	4	184	bitem	2	50	234	119
bòrdes	4	166	bordes	4	1537	1703	120
bòria	4	128	boria	2	37	165	121
bóquer	4	60	boquer	4	40	100	122
cabeçó	4	48	cabeço	2	69	117	123
cabrerès	4	372	cabreres	4	36	408	124
cabó	4	325	cabo	2	1387	1712	125
cadí	4	4404	cadi	4	296	4700	126
cairó	4	148	cairo	2	538	686	127
callís	4	404	callis	2	136	540	128
calló	4	3	callo	2	288	291	129
calmé	4	1	calme	2	48	49	130
calmó	4	1	calmo	2	35	36	131
calví	4	173	calvi	4	151	324	132
campanyà	4	144	campanya	4	129344	129488	133
campà	4	143	campa	0	554	697	134
campí	4	28	campi	2	777	805	135
campís	4	0	campis	2	21	21	136
camús	4	140	camus	4	1458	1598	137
canadà	4	14957	canada	4	1632	16589	138
cantí	4	104	canti	2	612	716	139
cantó	4	10591	canto	2	1898	12489	140
canà	4	251	cana	4	507	758	141
caparà	4	15	capara	2	3	18	142
capellà	4	6243	capella	4	26656	32899	143
capó	4	1736	capo	2	813	2549	144
cardó	4	703	cardo	2	357	1060	145
cardós	4	1197	cardos	4	34	1231	146
carrascó	4	1	carrasco	4	3518	3519	147
carròs	4	241	carros	4	4128	4369	148
carrós	4	24	carros	4	4128	4152	149
cassà	4	4761	cassa	4	487	5248	150
castellà	4	73461	castella	4	12711	86172	151
castilló	4	73	castillo	4	5124	5197	152
casòs	4	3	casos	4	135617	135620	153
casó	4	26	caso	2	1401	1427	154
casós	4	40	casos	4	135617	135657	155
causà	4	815	causa	4	134023	134838	156
censà	4	40	censa	2	32	72	157
cervià	4	1514	cervia	4	34	1548	158
ceró	4	9	cero	4	1336	1345	159
cirà	4	4	cira	4	94	98	160
cisó	4	39	ciso	2	14	53	161
ció	4	799	cio	2	432	1231	162
clarà	4	1717	clara	4	68619	70336	163
clarís	4	65	claris	4	1448	1513	164
claudí	4	6	claudi	4	2624	2630	165
codí	4	4	codi	4	65467	65471	166
coixós	4	0	coixos	0	240	240	167
colón	4	1952	colon	4	1278	3230	168
colúmbia	4	1058	columbia	4	2293	3351	169
comí	4	637	comi	2	89	726	170
comín	4	2818	comin	2	231	3049	171
coralí	4	113	corali	2	3	116	172
corberà	4	80	corbera	4	3841	3921	173
corbí	4	155	corbi	2	41	196	174
corcó	4	450	corco	2	16	466	175
cornellà	4	13314	cornella	4	572	13886	176
corró	4	2167	corro	2	913	3080	177
coró	4	2	coro	4	1271	1273	178
costejà	4	22	costeja	2	45	67	179
costerà	4	0	costera	4	2385	2385	180
crespí	4	3081	crespi	2	264	3345	181
crispí	4	95	crispi	2	56	151	182
cuixà	4	516	cuixa	4	1729	2245	183
cuscó	4	359	cusco	4	446	805	184
custòdia	4	7279	custodia	2	1302	8581	185
càceres	4	928	caceres	4	473	1401	186
càndia	4	182	candia	2	69	251	187
càndida	4	441	candida	2	162	603	188
càndides	4	108	candides	2	13	121	189
càndies	4	1	candies	2	15	16	190
cànoes	4	11	canoes	4	453	464	191
cària	4	95	caria	2	67	162	192
càstor	4	490	castor	4	2125	2615	193
càstors	4	1	castors	4	628	629	194
cóll	4	52	coll	4	55326	55378	195
cós	4	773	cos	4	133887	134660	196
dagà	4	2	daga	4	394	396	197
darién	4	100	darien	2	66	166	198
daurí	4	0	dauri	2	108	108	199
deià	4	889	deia	2	63646	64535	200
demètria	4	9	demetria	2	11	20	201
demètries	4	6	demetries	2	1	7	202
diamantí	4	12	diamanti	2	12	24	203
dinarés	4	44	dinares	2	10	54	204
domní	4	0	domni	4	7	7	205
donís	4	147	donis	2	1270	1417	206
dragó	4	762	drago	2	140	902	207
duró	4	292	duro	2	1440	1732	208
dària	4	40	daria	4	329	369	209
dèlia	4	131	delia	2	341	472	210
déu	4	113160	deu	4	124639	237799	211
eixalà	4	9	eixala	2	3	12	212
eleàtzar	4	0	eleatzar	4	1	1	213
elià	4	24	elia	4	634	658	214
eloí	4	10	eloi	4	4274	4284	215
elí	4	74	eli	4	1822	1896	216
eriçó	4	834	eriço	2	20	854	217
ermità	4	1372	ermita	4	22995	24367	218
escaró	4	32	escaro	2	1	33	219
escolà	4	1095	escola	4	330805	331900	220
escós	4	38	escos	4	2	40	221
espadà	4	527	espada	2	730	1257	222
espanyó	4	1	espanyo	2	38	39	223
espigó	4	674	espigo	2	10	684	224
espirà	4	75	espira	4	225	300	225
espígol	4	1385	espigol	2	67	1452	226
espòrades	4	12	esporades	4	1	13	227
esquerrà	4	959	esquerra	4	119309	120268	228
esquèrda	4	0	esquerda	4	2640	2640	229
esquís	4	3319	esquis	2	440	3759	230
estaís	4	20	estais	4	48	68	231
estellés	4	4249	estelles	4	404	4653	232
evelí	4	28	eveli	4	22	50	233
fadó	4	61	fado	2	505	566	234
falcó	4	2450	falco	2	317	2767	235
favà	4	157	fava	4	995	1152	236
feixó	4	2	feixo	2	2	4	237
fermí	4	1268	fermi	2	422	1690	238
ferrà	4	790	ferra	2	73	863	239
ferrís	4	75	ferris	2	653	728	240
ferró	4	14	ferro	4	27400	27414	241
filó	4	537	filo	2	719	1256	242
fintà	4	1	finta	4	148	149	243
fitó	4	379	fito	2	741	1120	244
florià	4	61	floria	2	680	741	245
fluixà	4	247	fluixa	0	1663	1910	246
fondó	4	113	fondo	4	3439	3552	247
forès	4	649	fores	2	350	999	248
fotí	4	24	foti	2	383	407	249
francí	4	62	franci	4	80	142	250
franquès	4	393	franques	0	336	729	251
fullà	4	71	fulla	4	9617	9688	252
fòssa	4	8	fossa	4	3344	3352	253
gabí	4	18	gabi	2	805	823	254
gaietà	4	796	gaieta	4	24	820	255
gaiolà	4	10	gaiola	4	1	11	256
gaià	4	3669	gaia	4	1306	4975	257
gal·lès	4	1180	gal·les	4	3902	5082	258
gargallà	4	23	gargalla	4	4	27	259
gaspé	4	15	gaspe	2	5	20	260
gastí	4	1	gasti	2	385	386	261
gastó	4	292	gasto	2	641	933	262
gasà	4	2	gasa	4	489	491	263
gasó	4	59	gaso	2	8	67	264
gaudí	4	15777	gaudi	4	6159	21936	265
gavarró	4	193	gavarro	4	6	199	266
gavarrós	4	22	gavarros	4	1	23	267
generés	4	219	generes	2	380	599	268
generó	4	83	genero	2	160	243	269
genís	4	4088	genis	4	1944	6032	270
germània	4	317	germania	4	551	868	271
gestí	4	82	gesti	2	71	153	272
girés	4	205	gires	4	2666	2871	273
giró	4	1267	giro	4	1854	3121	274
glòria	4	15213	gloria	2	2665	17878	275
glòries	4	3091	glories	2	116	3207	276
godés	4	5	godes	4	310	315	277
gosé	4	107	gose	2	48	155	278
gracià	4	234	gracia	2	2880	3114	279
grifé	4	27	grife	2	5	32	280
grisó	4	13	griso	4	205	218	281
grogués	4	19	grogues	0	4312	4331	282
gràcia	4	51162	gracia	2	2880	54042	283
gràcies	4	267295	gracies	2	7044	274339	284
gréixer	4	106	greixer	4	14	120	285
grífol	4	60	grifol	2	53	113	286
grífols	4	329	grifols	4	258	587	287
guardí	4	13	guardi	2	728	741	288
guifré	4	2034	guifre	4	108	2142	289
guillé	4	3	guille	2	775	778	290
guilló	4	53	guillo	2	10	63	291
guinyó	4	0	guinyo	2	9	9	292
guinó	4	301	guino	4	55	356	293
guitó	4	54	guito	2	6	60	294
guixà	4	288	guixa	4	284	572	295
gurí	4	51	guri	4	322	373	296
gussí	4	0	gussi	4	44	44	297
gustà	4	78	gusta	2	579	657	298
guàlter	4	0	gualter	4	115	115	299
gàtova	4	206	gatova	4	34	240	300
gèrs	4	3	gers	4	209	212	301
gòrgona	4	15	gorgona	4	59	74	302
gòrgones	4	18	gorgones	4	44	62	303
helí	4	0	heli	4	1243	1243	304
herbés	4	28	herbes	4	11827	11855	305
herédia	4	10	heredia	4	1204	1214	306
humilià	4	18	humilia	2	237	255	307
huíla	4	12	huila	4	28	40	308
isolí	4	0	isoli	2	3	3	309
jalón	4	106	jalon	2	8	114	310
jofré	4	241	jofre	4	1719	1960	311
juià	4	223	juia	4	7	230	312
justí	4	193	justi	2	29	222	313
justó	4	0	justo	2	1155	1155	314
jóc	4	77	joc	4	167704	167781	315
khàrkiv	4	212	kharkiv	4	38	250	316
lladró	4	137	lladro	2	3	140	317
llançà	4	4065	llança	4	8180	12245	318
llaurí	4	139	llauri	2	143	282	319
llauró	4	67	llauro	2	17	84	320
lleixà	4	498	lleixa	4	539	1037	321
lletjós	4	35	lletjos	0	525	560	322
llinyà	4	3	llinya	4	15	18	323
lliterà	4	34	llitera	4	1629	1663	324
lliçà	4	2266	lliça	4	331	2597	325
llordà	4	147	llorda	0	28	175	326
llorençà	4	68	llorença	4	70	138	327
llorà	4	208	llora	4	81	289	328
llossà	4	1	llossa	4	37	38	329
llucí	4	0	lluci	4	100	100	330
lluçà	4	683	lluça	4	34	717	331
lídia	4	3343	lidia	2	1223	4566	332
lídies	4	3	lidies	2	1	4	333
macària	4	7	macaria	2	3	10	334
maià	4	441	maia	4	1731	2172	335
maldà	4	1685	malda	2	559	2244	336
mallén	4	83	mallen	2	19	102	337
maltés	4	87	maltes	4	337	424	338
mamés	4	447	mames	4	738	1185	339
manassès	4	31	manasses	2	44	75	340
manassés	4	0	manasses	2	44	44	341
mandrès	4	0	mandres	0	62	62	342
manyà	4	422	manya	4	198	620	343
marcià	4	569	marcia	2	210	779	344
marcó	4	332	marco	2	8608	8940	345
marguí	4	14	margui	2	22	36	346
marià	4	4756	maria	4	150351	155107	347
marquès	4	7844	marques	4	37997	45841	348
marqués	4	2698	marques	4	37997	40695	349
marró	4	6566	marro	2	426	6992	350
marxandó	4	9	marxando	0	2	11	351
marès	4	1382	mares	4	41301	42683	352
mascaró	4	1841	mascaro	2	37	1878	353
masdéu	4	414	masdeu	4	903	1317	354
mató	4	1712	mato	2	796	2508	355
maurí	4	257	mauri	2	2408	2665	356
maó	4	12601	mao	4	1440	14041	357
merlès	4	501	merles	4	280	781	358
merlí	4	1387	merli	4	108	1495	359
mesopotàmia	4	1310	mesopotamia	4	38	1348	360
micó	4	826	mico	4	2060	2886	361
millà	4	530	milla	4	2246	2776	362
milà	4	10372	mila	4	787	11159	363
miró	4	18534	miro	2	7235	25769	364
mitjà	4	106194	mitja	0	62239	168433	365
moianès	4	2991	moianes	4	41	3032	366
mollà	4	2010	molla	4	2047	4057	367
molès	4	3	moles	4	2127	2130	368
molí	4	16906	moli	2	724	17630	369
mont-ròs	4	0	mont-ros	4	71	71	370
montalbà	4	77	montalba	4	20	97	371
monòver	4	525	monover	0	70	595	372
morellà	4	155	morella	4	5716	5871	373
moró	4	186	moro	2	9521	9707	374
mundó	4	1030	mundo	4	8806	9836	375
muntanyà	4	129	muntanya	4	87266	87395	376
muntó	4	256	munto	2	138	394	377
mànega	4	3011	manega	2	256	3267	378
màrcia	4	123	marcia	2	210	333	379
màurar	4	0	maurar	2	5	5	380
mèdia	4	1104	media	2	7659	8763	381
míriam	4	2507	miriam	4	1802	4309	382
míriams	4	1	miriams	4	2	3	383
móra	4	7169	mora	4	9407	16576	384
múnia	4	138	munia	2	59	197	385
múnter	4	16	munter	4	42	58	386
natjà	4	4	natja	4	93	97	387
neró	4	797	nero	4	446	1243	388
nevà	4	108	neva	4	961	1069	389
nicòstrat	4	6	nicostrat	4	2	8	390
nogueró	4	22	noguero	4	152	174	391
nogués	4	1074	nogues	4	29	1103	392
norís	4	75	noris	4	39	114	393
nàquera	4	628	naquera	4	17	645	394
nét	4	4267	net	0	18867	23134	395
obís	4	0	obis	4	58	58	396
odí	4	29	odi	4	14462	14491	397
olivó	4	24	olivo	2	131	155	398
olià	4	38	olia	2	30	68	399
olió	4	2	olio	2	22	24	400
oncés	4	2	onces	4	30	32	401
ondí	4	1	ondi	2	3	4	402
orbí	4	0	orbi	2	107	107	403
orellà	4	33	orella	4	8141	8174	404
orà	4	474	ora	4	1048	1522	405
orís	4	596	oris	2	58	654	406
oró	4	601	oro	2	2210	2811	407
orós	4	19	oros	4	348	367	408
pacífic	4	8526	pacific	2	997	9523	409
pagà	4	1099	paga	4	17394	18493	410
pairà	4	2	paira	2	4	6	411
paisà	4	1140	paisa	4	32	1172	412
pallarès	4	1902	pallares	2	161	2063	413
pallejà	4	1490	palleja	2	36	1526	414
pallí	4	245	palli	2	34	279	415
pal·ladí	4	3	pal·ladi	4	190	193	416
paredó	4	16	paredo	2	0	16	417
parlavà	4	232	parlava	2	16475	16707	418
parés	4	2433	pares	2	120631	123064	419
parís	4	46511	paris	4	6838	53349	420
pascó	4	43	pasco	4	55	98	421
pedró	4	1000	pedro	4	28325	29325	422
peixó	4	23	peixo	2	122	145	423
pelló	4	58	pello	2	58	116	424
penedès	4	34588	penedes	4	392	34980	425
pení	4	92	peni	2	98	190	426
pequín	4	3251	pequin	2	139	3390	427
peraltó	4	2	peralto	2	0	2	428
perpètua	4	7902	perpetua	2	1170	9072	429
perpètues	4	201	perpetues	2	17	218	430
perutxó	4	0	perutxo	4	24	24	431
petrús	4	2	petrus	4	495	497	432
petén	4	92	peten	2	162	254	433
picassó	4	29	picasso	4	8962	8991	434
picó	4	1733	pico	2	1622	3355	435
pinós	4	1681	pinos	4	247	1928	436
pisà	4	101	pisa	4	2707	2808	437
pià	4	94	pia	4	5684	5778	438
planès	4	116	planes	4	12576	12692	439
polpís	4	52	polpis	2	22	74	440
pontí	4	12	ponti	2	192	204	441
ponçà	4	1	ponça	4	436	437	442
porcària	4	0	porcaria	2	1	1	443
portè	4	100	porte	2	1743	1843	444
premià	4	9613	premia	2	2967	12580	445
privàs	4	3	privas	4	6	9	446
progrés	4	26191	progres	0	685	26876	447
pràxedis	4	6	praxedis	4	26	32	448
pròsper	4	1624	prosper	2	205	1829	449
pròspera	4	1662	prospera	2	663	2325	450
pugès	4	136	puges	4	807	943	451
pujò	4	1	pujo	2	1635	1636	452
pujó	4	24	pujo	2	1635	1659	453
pujós	4	14	pujos	4	23	37	454
pullès	4	10	pulles	4	29	39	455
pàrtia	4	186	partia	2	1365	1551	456
pàtrocle	4	119	patrocle	4	46	165	457
pécs	4	68	pecs	0	72	140	458
píram	4	57	piram	2	2	59	459
pòlit	4	74	polit	4	2133	2207	460
querolà	4	1	querola	4	17	18	461
queró	4	0	quero	2	179	179	462
quintà	4	266	quinta	0	2070	2336	463
quintí	4	1086	quinti	2	72	1158	464
rabadà	4	168	rabada	4	19	187	465
rabó	4	0	rabo	4	123	123	466
rabós	4	323	rabos	4	15	338	467
rafí	4	23	rafi	4	140	163	468
rallé	4	10	ralle	2	4	14	469
ralló	4	13	rallo	2	163	176	470
redovà	4	15	redova	4	1	16	471
regí	4	121	regi	0	203	324	472
remolí	4	842	remoli	2	11	853	473
rifà	4	449	rifa	4	1273	1722	474
rifé	4	185	rife	2	11	196	475
rià	4	103	ria	4	1377	1480	476
rodès	4	61	rodes	4	19919	19980	477
rodés	4	1078	rodes	4	19919	20997	478
rodó	4	6733	rodo	2	227	6960	479
romanyà	4	626	romanya	4	184	810	480
romà	4	19653	roma	4	32097	51750	481
romània	4	112	romania	4	10819	10931	482
rotllà	4	66	rotlla	2	2	68	483
rovelló	4	657	rovello	2	9	666	484
rubió	4	3440	rubio	4	4205	7645	485
rufà	4	24	rufa	4	105	129	486
rupià	4	220	rupia	4	169	389	487
rués	4	1	rues	4	521	522	488
ràfels	4	35	rafels	4	16	51	489
règul	4	41	regul	2	7	48	490
règula	4	7	regula	2	13687	13694	491
rúbies	4	379	rubies	4	138	517	492
sabà	4	75	saba	4	1811	1886	493
sacarés	4	2	sacares	2	2	4	494
sagristà	4	557	sagrista	4	9	566	495
salamí	4	9	salami	4	132	141	496
salarí	4	0	salari	4	10962	10962	497
saldó	4	13	saldo	2	3199	3212	498
salvà	4	1773	salva	0	5896	7669	499
salví	4	5	salvi	4	1423	1428	500
salvó	4	74	salvo	2	520	594	501
salé	4	65	sale	4	3002	3067	502
salí	4	481	sali	2	185	666	503
samsó	4	967	samso	4	20	987	504
samària	4	54	samaria	4	229	283	505
sansà	4	4	sansa	4	840	844	506
santamaría	4	2504	santamaria	4	1825	4329	507
sapés	4	16	sapes	4	5	21	508
saturní	4	50	saturni	0	12	62	509
saurí	4	569	sauri	0	72	641	510
savellà	4	15	savella	4	27	42	511
sebastòpol	4	124	sebastopol	4	89	213	512
secundí	4	19	secundi	2	343	362	513
sedó	4	716	sedo	2	23	739	514
seguí	4	4778	segui	2	700	5478	515
segòvia	4	903	segovia	2	829	1732	516
sentís	4	1722	sentis	2	1524	3246	517
senès	4	7	senes	4	54	61	518
serralló	4	7	serrallo	4	1680	1687	519
serrà	4	457	serra	4	56766	57223	520
servià	4	201	servia	2	5610	5811	521
servós	4	3	servos	4	76	79	522
sigués	4	215	sigues	2	3296	3511	523
silvà	4	62	silva	4	2842	2904	524
silví	4	7	silvi	4	59	66	525
solà	4	6500	sola	0	45804	52304	526
soló	4	140	solo	2	4954	5094	527
sorà	4	54	sora	4	473	527	528
suró	4	18	suro	2	5171	5189	529
surós	4	44	suros	4	262	306	530
sèrvia	4	22	servia	2	5610	5632	531
sònia	4	4119	sonia	4	2404	6523	532
talló	4	310	tallo	2	277	587	533
taló	4	3479	talo	2	66	3545	534
tanyà	4	16	tanya	2	137	153	535
tardà	4	4289	tarda	4	113880	118169	536
tarés	4	30	tares	4	214	244	537
tarí	4	24	tari	2	32	56	538
taulí	4	1526	tauli	2	43	1569	539
tauló	4	314	taulo	2	3	317	540
taís	4	9	tais	4	73	82	541
taús	4	214	taus	4	86	300	542
teià	4	1744	teia	4	427	2171	543
termenès	4	4	termenes	2	2	6	544
termòpiles	4	130	termopiles	4	19	149	545
tesà	4	26	tesa	0	438	464	546
teulís	4	43	teulis	2	0	43	547
thaís	4	21	thais	4	207	228	548
tintín	4	2225	tintin	2	587	2812	549
titó	4	94	tito	2	2866	2960	550
tió	4	5731	tio	4	4428	10159	551
tolosà	4	161	tolosa	4	4734	4895	552
tolós	4	53	tolos	4	24	77	553
tomé	4	956	tome	2	180	1136	554
tonyà	4	26	tonya	4	126	152	555
torcó	4	3	torco	2	1	4	556
torrellà	4	3	torrella	4	784	787	557
torró	4	4604	torro	2	65	4669	558
tortellà	4	753	tortella	4	148	901	559
torà	4	1908	tora	4	200	2108	560
torí	4	2294	tori	4	363	2657	561
torís	4	121	toris	4	34	155	562
trillà	4	18	trilla	4	744	762	563
trilló	4	0	trillo	4	354	354	564
trulló	4	0	trullo	2	30	30	565
trémol	4	7	tremol	2	16	23	566
tucà	4	53	tuca	4	189	242	567
tudó	4	394	tudo	2	80	474	568
turbó	4	41	turbo	4	1010	1051	569
turà	4	39	tura	4	2466	2505	570
turó	4	17764	turo	4	400	18164	571
tuvà	4	20	tuva	0	94	114	572
tuéjar	4	62	tuejar	2	21	83	573
tànger	4	1196	tanger	4	68	1264	574
tàpia	4	871	tapia	2	424	1295	575
tàpies	4	3776	tapies	2	88	3864	576
tíber	4	242	tiber	0	29	271	577
ullà	4	375	ulla	4	179	554	578
ursicí	4	7	ursici	4	1	8	579
usès	4	28	uses	2	383	411	580
valentinès	4	18	valentines	4	67	85	581
ventalló	4	717	ventallo	2	6	723	582
ventolrà	4	29	ventolra	4	1	30	583
vergonyà	4	1	vergonya	4	16522	16523	584
victorí	4	74	victori	4	176	250	585
vidrà	4	870	vidra	2	24	894	586
viladà	4	0	vilada	4	586	586	587
vilamanyà	4	30	vilamanya	4	28	58	588
vinçà	4	122	vinça	4	12	134	589
virolès	4	15	viroles	2	3	18	590
virà	4	47	vira	4	278	325	591
visà	4	1	visa	4	2138	2139	592
visé	4	9	vise	2	38	47	593
vitalí	4	0	vitali	4	189	189	594
vitré	4	24	vitre	4	4	28	595
vivià	4	0	vivia	2	14779	14779	596
vià	4	41	via	4	125425	125466	597
voló	4	205	volo	2	168	373	598
wílson	4	0	wilson	4	3401	3401	599
xaló	4	694	xalo	2	41	735	600
xapí	4	1	xapi	2	19	20	601
xifró	4	11	xifro	2	4	15	602
xèrica	4	124	xerica	2	1	125	603
zoè	4	113	zoe	4	609	722	604
zoé	4	68	zoe	4	609	677	605
abaixarà	2	109	abaixara	2	6	115	606
abaixà	2	72	abaixa	2	698	770	607
abaixàrem	2	2	abaixarem	2	71	73	608
abaixàreu	2	0	abaixareu	2	1	1	609
abaixés	2	36	abaixes	2	43	79	610
abaixí	2	0	abaixi	2	121	121	611
abalancés	2	2	abalances	2	1	3	612
abalancí	2	0	abalanci	2	2	2	613
abalançà	2	3	abalança	2	29	32	614
abalançàreu	2	1	abalançareu	2	0	1	615
abalisarà	2	2	abalisara	2	0	2	616
abalisà	2	0	abalisa	2	3	3	617
abalisí	2	0	abalisi	2	1	1	618
abaltirà	2	0	abaltira	2	1	1	619
abancalà	2	0	abancala	2	1	1	620
abanderarà	2	4	abanderara	2	0	4	621
abanderà	2	11	abandera	2	115	126	622
abanderés	2	1	abanderes	2	0	1	623
abanderí	2	0	abanderi	2	16	16	624
abandonarà	2	674	abandonara	2	69	743	625
abandonà	2	2366	abandona	2	4833	7199	626
abandonàrem	2	16	abandonarem	2	312	328	627
abandonàreu	2	2	abandonareu	2	24	26	628
abandonés	2	749	abandones	2	180	929	629
abandoní	2	2	abandoni	2	1467	1469	630
abaratirà	2	61	abaratira	2	1	62	631
abaratírem	2	0	abaratirem	2	1	1	632
abarrocà	2	2	abarroca	2	2	4	633
abarrotà	2	2	abarrota	2	8	10	634
abarrotàrem	2	1	abarrotarem	2	0	1	635
abarrotàreu	2	0	abarrotareu	2	1	1	636
abarrotés	2	0	abarrotes	2	1	1	637
abarrotí	2	0	abarroti	2	3	3	638
abassegarà	2	2	abassegara	2	0	2	639
abassegués	2	1	abassegues	2	0	1	640
abasseguí	2	0	abassegui	2	2	2	641
abassegà	2	0	abassega	2	18	18	642
abastarà	2	338	abastara	2	5	343	643
abastirà	2	65	abastira	2	2	67	644
abastà	2	78	abasta	2	6886	6964	645
abastàrem	2	0	abastarem	2	10	10	646
abastàreu	2	0	abastareu	2	1	1	647
abastés	2	95	abastes	2	8	103	648
abastí	2	9	abasti	2	691	700	649
abastírem	2	1	abastirem	2	6	7	650
abastís	2	8	abastis	2	2	10	651
abatollés	2	0	abatolles	2	1	1	652
abatré	2	3	abatre	2	1072	1075	653
abatés	2	10	abates	2	2	12	654
abatí	2	2	abati	2	20	22	655
abdicarà	2	11	abdicara	2	0	11	656
abdicà	2	117	abdica	2	111	228	657
abdicàrem	2	0	abdicarem	2	6	6	658
abdiqués	2	42	abdiques	2	3	45	659
abdiquí	2	0	abdiqui	2	19	19	660
abellirà	2	3	abellira	2	6	9	661
abessonarà	2	1	abessonara	2	0	1	662
abeurarà	2	1	abeurara	2	0	1	663
abeurà	2	3	abeura	2	37	40	664
abeuràrem	2	0	abeurarem	2	2	2	665
abeurés	2	1	abeures	2	0	1	666
abillà	2	5	abilla	2	21	26	667
abillí	2	0	abilli	2	1	1	668
abismà	2	1	abisma	2	9	10	669
abismés	2	0	abismes	2	393	393	670
abismí	2	0	abismi	2	1	1	671
abissà	2	0	abissa	2	2	2	672
abissàrem	2	1	abissarem	2	0	1	673
abjurarà	2	1	abjurara	2	0	1	674
abjurà	2	6	abjura	2	14	20	675
abjurés	2	5	abjures	2	1	6	676
ablamà	2	0	ablama	2	3	3	677
ablanirà	2	1	ablanira	2	0	1	678
abocarà	2	183	abocara	2	3	186	679
abocà	2	158	aboca	2	3462	3620	680
abocàrem	2	2	abocarem	2	284	286	681
abocàreu	2	0	abocareu	2	12	12	682
aboià	2	0	aboia	2	1	1	683
aboiés	2	0	aboies	2	1	1	684
abolirà	2	36	abolira	2	7	43	685
abolírem	2	0	abolirem	2	5	5	686
abolíreu	2	0	abolireu	2	3	3	687
abominà	2	6	abomina	2	70	76	688
abominés	2	1	abomines	2	1	2	689
abominí	2	0	abomini	2	2	2	690
abonançà	2	0	abonança	2	3	3	691
abonarà	2	978	abonara	2	13	991	692
abonyegarà	2	1	abonyegara	2	0	1	693
abonyegués	2	0	abonyegues	2	6	6	694
abonyeguí	2	0	abonyegui	2	1	1	695
abonyegà	2	0	abonyega	2	7	7	696
abonà	2	15	abona	2	804	819	697
abonàrem	2	0	abonarem	2	46	46	698
abonàreu	2	0	abonareu	2	8	8	699
abonés	2	44	abones	2	16	60	700
aboní	2	0	aboni	2	231	231	701
abonírem	2	0	abonirem	2	1	1	702
abonís	2	0	abonis	2	22	22	703
aboqués	2	42	aboques	2	65	107	704
aboquí	2	0	aboqui	2	195	195	705
abordarà	2	2041	abordara	2	8	2049	706
abordà	2	113	aborda	2	6600	6713	707
abordàrem	2	12	abordarem	2	609	621	708
abordàreu	2	1	abordareu	2	3	4	709
abordés	2	154	abordes	2	16	170	710
abordí	2	0	abordi	2	1053	1053	711
aborronarà	2	1	aborronara	2	0	1	712
aborronà	2	0	aborrona	2	14	14	713
abossà	2	0	abossa	2	1	1	714
aboí	2	0	aboi	2	1	1	715
abracés	2	76	abraces	2	66	142	716
abrací	2	0	abraci	2	180	180	717
abrandà	2	5	abranda	2	16	21	718
abrandàrem	2	0	abrandarem	2	1	1	719
abrandí	2	0	abrandi	2	7	7	720
abraonarà	2	4	abraonara	2	0	4	721
abraonà	2	12	abraona	2	78	90	722
abraonàrem	2	0	abraonarem	2	1	1	723
abraonés	2	2	abraones	2	3	5	724
abraoní	2	0	abraoni	2	7	7	725
abrasarà	2	2	abrasara	2	0	2	726
abrasà	2	1	abrasa	2	22	23	727
abrasés	2	0	abrases	2	3	3	728
abrasí	2	0	abrasi	2	2	2	729
abraçarà	2	97	abraçara	2	11	108	730
abraçà	2	169	abraça	2	2919	3088	731
abraçàrem	2	6	abraçarem	2	25	31	732
abraçàreu	2	2	abraçareu	2	2	4	733
abreugés	2	1	abreuges	2	0	1	734
abreugí	2	0	abreugi	2	5	5	735
abreujarà	2	5	abreujara	2	0	5	736
abreujà	2	1	abreuja	2	89	90	737
abreujàrem	2	0	abreujarem	2	1	1	738
abrevià	2	0	abrevia	2	26	26	739
abreviàrem	2	0	abreviarem	2	1	1	740
abreviés	2	1	abrevies	2	0	1	741
abrigallà	2	0	abrigalla	2	4	4	742
abrigallàreu	2	0	abrigallareu	2	1	1	743
abrigallí	2	0	abrigalli	2	2	2	744
abrigarà	2	10	abrigara	2	2	12	745
abrigués	2	11	abrigues	2	11	22	746
abriguí	2	0	abrigui	2	43	43	747
abrigà	2	5	abriga	2	198	203	748
abrigàrem	2	0	abrigarem	2	5	5	749
abrilegés	2	1	abrileges	2	0	1	750
abrilejà	2	0	abrileja	2	12	12	751
abrillantà	2	0	abrillanta	2	25	25	752
abrillantàrem	2	0	abrillantarem	2	1	1	753
abrinà	2	0	abrina	2	1	1	754
abrinés	2	0	abrines	4	239	239	755
abriní	2	0	abrini	2	10	10	756
abrivà	2	2	abriva	2	1	3	757
abrivàrem	2	1	abrivarem	2	0	1	758
abrogà	2	3	abroga	2	3	6	759
abrusarà	2	3	abrusara	2	0	3	760
abrusà	2	0	abrusa	2	20	20	761
abrusí	2	0	abrusi	2	3	3	762
absentarà	2	13	absentara	2	2	15	763
absentà	2	8	absenta	4	420	428	764
absentàrem	2	0	absentarem	2	1	1	765
absentàreu	2	0	absentareu	2	1	1	766
absentés	2	9	absentes	4	56	65	767
absentí	2	0	absenti	2	18	18	768
absoldré	2	1	absoldre	2	475	476	769
absolgués	2	16	absolgues	2	0	16	770
absolguí	2	0	absolgui	2	22	22	771
absolutitzà	2	1	absolutitza	2	8	9	772
absolutitzàrem	2	0	absolutitzarem	2	1	1	773
absorbirà	2	147	absorbira	2	1	148	774
absorbírem	2	0	absorbirem	2	7	7	775
absorbíreu	2	0	absorbireu	2	3	3	776
abstenguí	2	0	abstengui	2	2	2	777
abstindré	2	169	abstindre	2	113	282	778
abstingués	2	84	abstingues	2	3	87	779
abstinguí	2	0	abstingui	2	251	251	780
abstragués	2	3	abstragues	2	0	3	781
abstrauré	2	1	abstraure	2	91	92	782
abundarà	2	7	abundara	2	3	10	783
abundà	2	2	abunda	2	822	824	784
abundàrem	2	0	abundarem	2	2	2	785
abundés	2	0	abundes	2	2	2	786
abundí	2	1	abundi	4	47	48	787
aburgesà	2	0	aburgesa	2	2	2	788
aburgesàrem	2	0	aburgesarem	2	1	1	789
aburgesés	2	1	aburgeses	2	0	1	790
abusarà	2	12	abusara	2	0	12	791
abusà	2	9	abusa	2	664	673	792
abusàrem	2	0	abusarem	2	7	7	793
abusàreu	2	0	abusareu	2	2	2	794
abusés	2	23	abuses	2	31	54	795
abusí	2	0	abusi	2	166	166	796
acabalà	2	0	acabala	2	4	4	797
acabarà	2	15702	acabara	2	409	16111	798
acabdillà	2	1	acabdilla	2	0	1	799
acabussà	2	0	acabussa	2	1	1	800
acabà	2	6085	acaba	2	88851	94936	801
acabàrem	2	167	acabarem	2	4287	4454	802
acabàreu	2	3	acabareu	2	373	376	803
acabés	2	3687	acabes	2	4418	8105	804
acabí	2	19	acabi	2	15008	15027	805
acací	2	0	acaci	4	19	19	806
academitzà	2	2	academitza	2	1	3	807
academitzí	2	0	academitzi	2	1	1	808
acalorà	2	0	acalora	2	2	2	809
acaloràreu	2	1	acalorareu	2	0	1	810
acalorés	2	0	acalores	2	1	1	811
acalorí	2	0	acalori	2	1	1	812
acalà	2	2	acala	2	6	8	813
acalí	2	0	acali	2	4	4	814
acalín	2	0	acalin	2	1	1	815
acamparà	2	9	acampara	2	0	9	816
acampà	2	29	acampa	2	56	85	817
acampàrem	2	2	acamparem	2	41	43	818
acampàreu	2	0	acampareu	2	2	2	819
acampés	2	5	acampes	2	6	11	820
acampí	2	0	acampi	2	9	9	821
acanalà	2	0	acanala	2	6	6	822
acanalí	2	0	acanali	2	1	1	823
acantonà	2	2	acantona	2	4	6	824
acantoní	2	0	acantoni	2	1	1	825
acanà	2	0	acana	2	13	13	826
acanés	2	1	acanes	2	0	1	827
acaní	2	0	acani	2	1	1	828
acapararà	2	27	acaparara	2	2	29	829
acaparà	2	20	acapara	2	460	480	830
acaparés	2	9	acapares	2	4	13	831
acaparí	2	0	acapari	2	48	48	832
acaptà	2	0	acapta	2	20	20	833
acaptés	2	0	acaptes	2	24	24	834
acaramullà	2	0	acaramulla	2	8	8	835
acaramullí	2	0	acaramulli	2	1	1	836
acararà	2	5	acarara	2	0	5	837
acariciarà	2	6	acariciara	2	2	8	838
acaricià	2	20	acaricia	2	361	381	839
acariciàrem	2	0	acariciarem	2	8	8	840
acariciàreu	2	0	acariciareu	2	7	7	841
acariciés	2	14	acaricies	2	35	49	842
acaricií	2	1	acaricii	2	3	4	843
acarnissarà	2	3	acarnissara	2	2	5	844
acarnissà	2	20	acarnissa	2	169	189	845
acarnissés	2	4	acarnisses	2	3	7	846
acarnissí	2	0	acarnissi	2	8	8	847
acaronarà	2	10	acaronara	2	1	11	848
acaronà	2	24	acarona	2	472	496	849
acaronàrem	2	2	acaronarem	2	6	8	850
acaronàreu	2	1	acaronareu	2	0	1	851
acaronés	2	17	acarones	2	41	58	852
acaroní	2	1	acaroni	2	45	46	853
acarrerí	2	0	acarreri	2	1	1	854
acartonà	2	1	acartona	2	0	1	855
acartonés	2	0	acartones	2	1	1	856
acarà	2	6	acara	2	113	119	857
acaràrem	2	1	acararem	2	3	4	858
acarés	2	1	acares	2	2	3	859
acarí	2	1	acari	4	24	25	860
acatalanà	2	0	acatalana	2	4	4	861
acatalanés	2	0	acatalanes	2	1	1	862
acatarà	2	103	acatara	2	3	106	863
acatxarà	2	0	acatxara	2	1	1	864
acatxà	2	2	acatxa	2	6	8	865
acatxí	2	0	acatxi	2	1	1	866
acatà	2	9	acata	2	270	279	867
acatàrem	2	0	acatarem	2	43	43	868
acatàreu	2	0	acatareu	2	2	2	869
acatés	2	17	acates	2	8	25	870
acatí	2	0	acati	2	132	132	871
acaçà	2	0	acaça	2	19	19	872
accedirà	2	561	accedira	2	29	590	873
accedírem	2	7	accedirem	2	224	231	874
accedíreu	2	0	accedireu	2	341	341	875
accelerarà	2	319	accelerara	2	6	325	876
accelerà	2	179	accelera	2	1941	2120	877
acceleràrem	2	0	accelerarem	2	21	21	878
accelerés	2	69	acceleres	2	27	96	879
accelerí	2	0	acceleri	2	470	470	880
accentuarà	2	137	accentuara	2	0	137	881
accentuà	2	205	accentua	2	1615	1820	882
accentuàrem	2	1	accentuarem	2	4	5	883
accentuàreu	2	0	accentuareu	2	1	1	884
accentués	2	17	accentues	2	3	20	885
acceptarà	2	1958	acceptara	2	58	2016	886
acceptà	2	1248	accepta	2	18257	19505	887
acceptàrem	2	40	acceptarem	2	723	763	888
acceptàreu	2	5	acceptareu	2	33	38	889
acceptés	2	1048	acceptes	2	2817	3865	890
acceptí	2	1	accepti	2	3079	3080	891
accidentà	2	5	accidenta	2	21	26	892
accidentàrem	2	0	accidentarem	2	1	1	893
accidentés	2	0	accidentes	2	120	120	894
accidentí	2	0	accidenti	2	9	9	895
accionarà	2	7	accionara	2	0	7	896
accionà	2	3	acciona	2	939	942	897
accionàrem	2	0	accionarem	2	2	2	898
accionària	4	4	accionaria	2	4	8	899
accionàries	4	1	accionaries	2	1	2	900
accionés	2	7	acciones	2	372	379	901
accioní	2	0	accioni	2	33	33	902
acendrés	2	0	acendres	2	1	1	903
acerà	2	0	acera	2	206	206	904
acerés	2	1	aceres	2	130	131	905
acerí	2	0	aceri	2	1	1	906
aceró	4	6	acero	2	344	350	907
acetilè	4	173	acetile	2	0	173	908
acetilé	4	1	acetile	2	0	1	909
acidificarà	2	2	acidificara	2	1	3	910
acidificà	2	0	acidifica	2	28	28	911
acidifiquí	2	0	acidifiqui	2	6	6	912
acidulà	2	0	acidula	2	2	2	913
acidà	2	0	acida	2	30	30	914
acidés	2	5	acides	2	18	23	915
acidí	2	2	acidi	2	0	2	916
acilà	2	0	acila	2	2	2	917
acilí	2	0	acili	2	9	9	918
acimà	2	0	acima	2	17	17	919
acivadà	2	0	acivada	2	2	2	920
acivadés	2	0	acivades	2	1	1	921
aclamarà	2	1	aclamara	2	0	1	922
aclamà	2	17	aclama	2	76	93	923
aclamàrem	2	0	aclamarem	2	3	3	924
aclamàreu	2	0	aclamareu	2	1	1	925
aclamés	2	1	aclames	2	1	2	926
aclamí	2	0	aclami	2	5	5	927
aclapararà	2	13	aclaparara	2	0	13	928
aclaparà	2	4	aclapara	2	340	344	929
aclaparí	2	0	aclapari	2	21	21	930
aclarirà	2	319	aclarira	2	28	347	931
aclarírem	2	3	aclarirem	2	128	131	932
aclaríreu	2	0	aclarireu	2	5	5	933
aclimatarà	2	1	aclimatara	2	0	1	934
aclimatà	2	7	aclimata	2	12	19	935
aclimatàrem	2	0	aclimatarem	2	1	1	936
aclimatés	2	1	aclimates	2	1	2	937
aclimatí	2	0	aclimati	2	2	2	938
aclivellarà	2	1	aclivellara	2	0	1	939
aclivellà	2	0	aclivella	2	1	1	940
aclofarà	2	1	aclofara	2	0	1	941
aclofà	2	3	aclofa	2	7	10	942
aclofí	2	0	aclofi	2	1	1	943
acloqués	2	0	acloques	2	1	1	944
aclucà	2	9	acluca	2	66	75	945
aclucàreu	2	0	aclucareu	2	1	1	946
acluqués	2	4	acluques	2	14	18	947
acluquí	2	0	acluqui	2	7	7	948
acoblarà	2	13	acoblara	2	0	13	949
acoblà	2	8	acobla	2	235	243	950
acoblàrem	2	0	acoblarem	2	3	3	951
acoblés	2	5	acobles	2	5	10	952
acoblí	2	0	acobli	2	18	18	953
acollirà	2	16876	acollira	2	56	16932	954
acollonarà	2	1	acollonara	2	0	1	955
acollonirà	2	1	acollonira	2	0	1	956
acollonà	2	0	acollona	2	41	41	957
acollonés	2	1	acollones	2	2	3	958
acolloní	2	1	acolloni	2	2	3	959
acollonírem	2	0	acollonirem	2	1	1	960
acollonís	2	1	acollonis	2	5	6	961
acollà	2	0	acolla	2	5	5	962
acollí	2	711	acolli	2	22	733	963
acollírem	2	2	acollirem	2	187	189	964
acollíreu	2	7	acollireu	2	5	12	965
acollís	2	211	acollis	2	12	223	966
acolorirà	2	12	acolorira	2	0	12	967
acolorà	2	0	acolora	2	2	2	968
acolorí	2	4	acolori	2	2	6	969
acolorírem	2	0	acolorirem	2	5	5	970
acolorís	2	1	acoloris	2	1	2	971
acoltellà	2	0	acoltella	2	2	2	972
acoltellí	2	1	acoltelli	2	2	3	973
acomboiarà	2	3	acomboiara	2	1	4	974
acomboià	2	3	acomboia	2	24	27	975
acomiadarà	2	363	acomiadara	2	5	368	976
acomiadà	2	142	acomiada	2	1939	2081	977
acomiadàrem	2	48	acomiadarem	2	252	300	978
acomiadàreu	2	0	acomiadareu	2	5	5	979
acomiadés	2	62	acomiades	2	39	101	980
acomiadí	2	2	acomiadi	2	68	70	981
acomodarà	2	17	acomodara	2	0	17	982
acomodà	2	15	acomoda	2	240	255	983
acomodàrem	2	0	acomodarem	2	13	13	984
acomodés	2	6	acomodes	2	16	22	985
acomodí	2	0	acomodi	2	53	53	986
acompanyarà	2	4907	acompanyara	2	84	4991	987
acompanyà	2	912	acompanya	2	18297	19209	988
acompanyàrem	2	25	acompanyarem	2	698	723	989
acompanyàreu	2	8	acompanyareu	2	46	54	990
acompanyés	2	493	acompanyes	2	386	879	991
acompanyí	2	5	acompanyi	2	2088	2093	992
acomparà	2	0	acompara	2	1	1	993
acomplexà	2	0	acomplexa	2	16	16	994
acomplexés	2	1	acomplexes	2	0	1	995
acomplexí	2	0	acomplexi	2	11	11	996
acomplirà	2	88	acomplira	2	7	95	997
acomplírem	2	0	acomplirem	2	11	11	998
acomplíreu	2	0	acomplireu	2	3	3	999
acondicià	2	1	acondicia	2	1	2	1000
aconductà	2	1	aconducta	2	1	2	1001
aconductés	2	0	aconductes	2	1	1	1002
aconhortà	2	0	aconhorta	2	3	3	1003
aconhortí	2	0	aconhorti	2	1	1	1004
aconseguirà	2	4993	aconseguira	2	143	5136	1005
aconseguírem	2	149	aconseguirem	2	5246	5395	1006
aconseguíreu	2	8	aconseguireu	2	437	445	1007
aconsellarà	2	280	aconsellara	2	6	286	1008
aconsellà	2	202	aconsella	2	4304	4506	1009
aconsellàrem	2	1	aconsellarem	2	201	202	1010
aconsellàreu	2	0	aconsellareu	2	1	1	1011
aconsellés	2	55	aconselles	2	47	102	1012
aconsellí	2	1	aconselli	2	247	248	1013
aconsolà	2	0	aconsola	2	14	14	1014
aconsolí	2	0	aconsoli	2	1	1	1015
acontentarà	2	33	acontentara	2	0	33	1016
acontentà	2	16	acontenta	2	216	232	1017
acontentàrem	2	1	acontentarem	2	22	23	1018
acontentàreu	2	0	acontentareu	2	1	1	1019
acontentés	2	12	acontentes	2	6	18	1020
acontentí	2	0	acontenti	2	53	53	1021
acopà	2	0	acopa	2	7	7	1022
acopí	2	0	acopi	2	61	61	1023
acoquinarà	2	2	acoquinara	2	0	2	1024
acoquinà	2	1	acoquina	2	18	19	1025
acoquiní	2	0	acoquini	2	5	5	1026
acorarà	2	1	acorara	2	0	1	1027
acordarà	2	355	acordara	2	21	376	1028
acordillàrem	2	1	acordillarem	2	0	1	1029
acordonarà	2	2	acordonara	2	0	2	1030
acordonà	2	1	acordona	2	12	13	1031
acordonés	2	1	acordones	2	0	1	1032
acordoní	2	0	acordoni	2	1	1	1033
acordà	2	1119	acorda	2	3173	4292	1034
acordàrem	2	53	acordarem	2	76	129	1035
acordàreu	2	0	acordareu	2	2	2	1036
acordés	2	188	acordes	2	70	258	1037
acordí	2	0	acordi	2	947	947	1038
acorralà	2	3	acorrala	2	40	43	1039
acorralés	2	1	acorrales	2	3	4	1040
acorralí	2	0	acorrali	2	2	2	1041
acorruà	2	1	acorrua	2	2	3	1042
acorà	2	0	acora	2	6	6	1043
acorés	2	0	acores	2	5	5	1044
acostalà	2	0	acostala	2	1	1	1045
acostarà	2	849	acostara	2	34	883	1046
acostumarà	2	48	acostumara	2	3	51	1047
acostumà	2	26	acostuma	2	12184	12210	1048
acostumàrem	2	6	acostumarem	2	41	47	1049
acostumàreu	2	0	acostumareu	2	7	7	1050
acostumés	2	25	acostumes	2	427	452	1051
acostumí	2	0	acostumi	2	196	196	1052
acostà	2	574	acosta	2	13831	14405	1053
acostàrem	2	16	acostarem	2	434	450	1054
acostàreu	2	1	acostareu	2	18	19	1055
acostés	2	271	acostes	2	312	583	1056
acostí	2	2	acosti	2	1106	1108	1057
acotarà	2	22	acotara	2	0	22	1058
acotxarà	2	2	acotxara	2	0	2	1059
acotxà	2	1	acotxa	2	37	38	1060
acotxés	2	0	acotxes	2	1	1	1061
acotxí	2	0	acotxi	2	4	4	1062
acotà	2	12	acota	2	170	182	1063
acotàrem	2	0	acotarem	2	17	17	1064
acotàreu	2	0	acotareu	2	1	1	1065
acotés	2	6	acotes	2	9	15	1066
acotí	2	0	acoti	2	23	23	1067
acovardirà	2	5	acovardira	2	0	5	1068
acovardírem	2	0	acovardirem	2	2	2	1069
acovilarà	2	0	acovilara	2	1	1	1070
acovilà	2	0	acovila	2	1	1	1071
acreditarà	2	381	acreditara	2	6	387	1072
acredità	2	30	acredita	2	3543	3573	1073
acreditàrem	2	0	acreditarem	2	5	5	1074
acreditàreu	2	0	acreditareu	2	3	3	1075
acredités	2	71	acredites	2	19	90	1076
acredití	2	0	acrediti	2	2721	2721	1077
acreixérem	2	0	acreixerem	2	1	1	1078
acreixés	2	1	acreixes	2	1	2	1079
acreixí	2	0	acreixi	2	10	10	1080
acretà	2	0	acreta	2	6	6	1081
activarà	2	795	activara	2	15	810	1082
activà	2	46	activa	0	46088	46134	1083
activàrem	2	1	activarem	2	102	103	1084
activàreu	2	0	activareu	2	18	18	1085
activés	2	98	actives	0	11914	12012	1086
activí	2	0	activi	2	717	717	1087
actualitzarà	2	740	actualitzara	2	4	744	1088
actualitzà	2	29	actualitza	2	4570	4599	1089
actualitzàrem	2	0	actualitzarem	2	239	239	1090
actualitzàreu	2	0	actualitzareu	2	6	6	1091
actualitzés	2	49	actualitzes	2	76	125	1092
actualitzí	2	1	actualitzi	2	471	472	1093
actuarà	2	6269	actuara	2	76	6345	1094
actuà	2	1170	actua	2	18467	19637	1095
actuàrem	2	31	actuarem	2	540	571	1096
actuàreu	2	0	actuareu	2	9	9	1097
actuària	4	6	actuaria	2	470	476	1098
actuàries	4	2	actuaries	2	7	9	1099
actués	2	609	actues	2	190	799	1100
acubà	2	1	acuba	2	2	3	1101
acubés	2	0	acubes	2	2	2	1102
acudirà	2	617	acudira	2	42	659	1103
acudí	2	385	acudi	2	13	398	1104
acudírem	2	18	acudirem	2	131	149	1105
acudíreu	2	2	acudireu	2	6	8	1106
acudís	2	244	acudis	2	7	251	1107
acuindàrem	2	0	acuindarem	2	1	1	1108
acuità	2	1	acuita	2	17	18	1109
acuití	2	0	acuiti	2	1	1	1110
aculturà	2	0	acultura	2	2	2	1111
aculturés	2	0	acultures	2	1	1	1112
aculturí	2	1	aculturi	2	0	1	1113
aculà	2	0	acula	2	1	1	1114
aculí	2	0	aculi	2	6	6	1115
acumularà	2	169	acumulara	2	4	173	1116
acumulà	2	75	acumula	2	5523	5598	1117
acumulàrem	2	1	acumularem	2	22	23	1118
acumulàreu	2	0	acumulareu	2	2	2	1119
acumulés	2	56	acumules	2	87	143	1120
acumulí	2	0	acumuli	2	338	338	1121
acunçà	2	0	acunça	2	5	5	1122
acurtarà	2	3	acurtara	2	1	4	1123
acurtà	2	8	acurta	2	47	55	1124
acurtàrem	2	0	acurtarem	2	2	2	1125
acurtés	2	1	acurtes	2	0	1	1126
acurtí	2	0	acurti	2	1	1	1127
acurçà	2	3	acurça	2	10	13	1128
acusarà	2	136	acusara	2	6	142	1129
acusà	2	473	acusa	2	6313	6786	1130
acusàrem	2	0	acusarem	2	20	20	1131
acusàreu	2	0	acusareu	2	4	4	1132
acusés	2	138	acuses	2	69	207	1133
acusí	2	1	acusi	2	362	363	1134
acídul	0	5	acidul	2	1	6	1135
acídula	0	1	acidula	2	2	3	1136
acídules	0	1	acidules	2	0	1	1137
adaptarà	2	764	adaptara	2	24	788	1138
adaptà	2	194	adapta	2	7485	7679	1139
adaptàrem	2	2	adaptarem	2	251	253	1140
adaptàreu	2	0	adaptareu	2	3	3	1141
adaptés	2	212	adaptes	2	118	330	1142
adaptí	2	2	adapti	2	3579	3581	1143
adargués	2	0	adargues	4	1	1	1144
adargà	2	1	adarga	4	28	29	1145
addicionarà	2	3	addicionara	2	0	3	1146
addicionà	2	2	addiciona	2	109	111	1147
addicionàrem	2	0	addicionarem	2	2	2	1148
addicionés	2	0	addiciones	2	2	2	1149
addicioní	2	0	addicioni	2	1	1	1150
adduírem	2	0	adduirem	2	2	2	1151
adelerà	2	0	adelera	2	1	1	1152
adelità	2	1	adelita	4	48	49	1153
adelitàrem	2	1	adelitarem	2	0	1	1154
adelités	2	1	adelites	4	0	1	1155
adelití	2	0	adeliti	2	1	1	1156
adequarà	2	338	adequara	2	4	342	1157
adequà	2	12	adequa	2	1180	1192	1158
adequàrem	2	0	adequarem	2	36	36	1159
adeqüés	2	47	adeqües	2	4	51	1160
adeqüí	2	3	adeqüi	2	676	679	1161
adesà	2	0	adesa	2	1	1	1162
adherirà	2	127	adherira	2	4	131	1163
adherírem	2	3	adherirem	2	19	22	1164
adheríreu	2	1	adherireu	2	0	1	1165
adigués	2	19	adigues	2	0	19	1166
adiguí	2	0	adigui	2	97	97	1167
adià	2	5	adia	2	231	236	1168
adiés	2	2	adies	2	5	7	1169
adií	2	0	adii	2	5	5	1170
adjectivarà	2	2	adjectivara	2	0	2	1171
adjectivà	2	2	adjectiva	0	83	85	1172
adjectivàrem	2	0	adjectivarem	2	2	2	1173
adjectivés	2	1	adjectives	0	47	48	1174
adjectiví	2	0	adjectivi	2	4	4	1175
adjudicarà	2	394	adjudicara	2	13	407	1176
adjudicà	2	222	adjudica	2	1129	1351	1177
adjudicàrem	2	1	adjudicarem	2	10	11	1178
adjudicàreu	2	1	adjudicareu	2	0	1	1179
adjudiqués	2	72	adjudiques	2	12	84	1180
adjudiquí	2	0	adjudiqui	2	143	143	1181
adjuntarà	2	328	adjuntara	2	3	331	1182
adjuntà	2	11	adjunta	0	5345	5356	1183
adjuntàrem	2	3	adjuntarem	2	62	65	1184
adjuntàreu	2	0	adjuntareu	2	2	2	1185
adjuntés	2	12	adjuntes	0	363	375	1186
adjuntí	2	0	adjunti	2	174	174	1187
adjurà	2	1	adjura	2	1	2	1188
admetré	2	39	admetre	2	10412	10451	1189
admetés	2	153	admetes	2	2	155	1190
admetí	2	1	admeti	2	588	589	1191
administrarà	2	172	administrara	2	1	173	1192
administrà	2	69	administra	2	1762	1831	1193
administràrem	2	1	administrarem	2	20	21	1194
administrés	2	46	administres	2	36	82	1195
administrí	2	0	administri	2	161	161	1196
admirarà	2	13	admirara	2	4	17	1197
admirà	2	59	admira	2	950	1009	1198
admiràrem	2	7	admirarem	2	99	106	1199
admiràreu	2	0	admirareu	2	9	9	1200
admirés	2	20	admires	2	126	146	1201
admirí	2	0	admiri	2	55	55	1202
adobarà	2	4	adobara	2	1	5	1203
adobà	2	4	adoba	2	132	136	1204
adobàrem	2	1	adobarem	2	6	7	1205
adobàreu	2	1	adobareu	2	2	3	1206
adobés	2	2	adobes	2	27	29	1207
adobí	2	0	adobi	2	12	12	1208
adoctrinarà	2	2	adoctrinara	2	1	3	1209
adoctrinà	2	2	adoctrina	2	166	168	1210
adoctrinàreu	2	1	adoctrinareu	2	0	1	1211
adoctrinés	2	4	adoctrines	2	2	6	1212
adoctriní	2	0	adoctrini	2	15	15	1213
adollà	2	0	adolla	2	2	2	1214
adonarà	2	559	adonara	2	32	591	1215
adondà	2	0	adonda	2	1	1	1216
adonà	2	748	adona	2	5443	6191	1217
adonàrem	2	69	adonarem	2	845	914	1218
adonàreu	2	3	adonareu	2	397	400	1219
adonés	2	447	adones	2	3592	4039	1220
adoní	2	16	adoni	4	1016	1032	1221
adoptarà	2	1778	adoptara	2	24	1802	1222
adoptà	2	1262	adopta	2	5274	6536	1223
adoptàrem	2	6	adoptarem	2	257	263	1224
adoptàreu	2	0	adoptareu	2	4	4	1225
adoptés	2	662	adoptes	2	58	720	1226
adoptí	2	0	adopti	2	3224	3224	1227
adorarà	2	8	adorara	2	0	8	1228
adormirà	2	34	adormira	2	3	37	1229
adormiscà	2	0	adormisca	2	1	1	1230
adormissà	2	0	adormissa	2	3	3	1231
adormissàreu	2	1	adormissareu	2	0	1	1232
adormí	2	55	adormi	2	193	248	1233
adormírem	2	0	adormirem	2	16	16	1234
adormíreu	2	0	adormireu	2	3	3	1235
adormís	2	75	adormis	2	60	135	1236
adornarà	2	21	adornara	2	1	22	1237
adornà	2	10	adorna	2	275	285	1238
adornàrem	2	0	adornarem	2	18	18	1239
adornàreu	2	2	adornareu	2	0	2	1240
adornés	2	2	adornes	2	9	11	1241
adorní	2	0	adorni	2	18	18	1242
adorà	2	7	adora	2	535	542	1243
adoràrem	2	0	adorarem	2	15	15	1244
adoràreu	2	0	adorareu	2	8	8	1245
adorés	2	14	adores	2	53	67	1246
adorí	2	1	adori	2	18	19	1247
adossarà	2	3	adossara	2	0	3	1248
adossà	2	26	adossa	2	165	191	1249
adotzenà	2	0	adotzena	2	1	1	1250
adquirirà	2	641	adquirira	2	27	668	1251
adquirírem	2	9	adquirirem	2	62	71	1252
adquiríreu	2	2	adquirireu	2	10	12	1253
adrecés	2	69	adreces	4	18679	18748	1254
adrecí	2	0	adreci	2	340	340	1255
adreçarà	2	325	adreçara	2	4	329	1256
adreçà	2	313	adreça	4	54309	54622	1257
adreçàrem	2	6	adreçarem	2	99	105	1258
adreçàreu	2	0	adreçareu	2	1	1	1259
adscrigués	2	1	adscrigues	2	0	1	1260
adscriguí	2	0	adscrigui	2	32	32	1261
adscriuré	2	0	adscriure	2	452	452	1262
adulterarà	2	1	adulterara	2	0	1	1263
adulterà	2	1	adultera	2	44	45	1264
adulterés	2	1	adulteres	2	5	6	1265
adulterí	2	5	adulteri	2	823	828	1266
adulà	2	0	adula	4	10	10	1267
adulària	4	1	adularia	2	1	2	1268
adulí	2	0	aduli	2	1	1	1269
adunà	2	0	aduna	2	33	33	1270
adunés	2	0	adunes	2	1	1	1271
aduní	2	0	aduni	2	1	1	1272
advertirà	2	289	advertira	2	13	302	1273
advertírem	2	10	advertirem	2	25	35	1274
advertíreu	2	1	advertireu	2	2	3	1275
adverà	2	2	advera	2	17	19	1276
advindré	2	0	advindre	2	1	1	1277
advinguí	2	0	advingui	2	1	1	1278
advocarà	2	29	advocara	2	2	31	1279
advocà	2	53	advoca	2	1507	1560	1280
advocàrem	2	0	advocarem	2	18	18	1281
advoqués	2	12	advoques	2	3	15	1282
advoquí	2	0	advoqui	2	69	69	1283
adès	2	47	ades	4	92	139	1284
adés	6	939	ades	4	92	1031	1285
adéu	7	6826	adeu	7	984	7810	1286
adéu-siau	7	107	adeu-siau	7	20	127	1287
adéus	4	344	adeus	4	75	419	1288
adúlter	0	66	adulter	2	0	66	1289
adúltera	0	189	adultera	2	44	233	1290
adúlteres	0	55	adulteres	2	5	60	1291
aerotransportí	2	0	aerotransporti	2	2	2	1292
afaitarà	2	3	afaitara	2	2	5	1293
afaità	2	3	afaita	2	89	92	1294
afaitàrem	2	0	afaitarem	2	1	1	1295
afaitàreu	2	0	afaitareu	2	1	1	1296
afaités	2	8	afaites	2	9	17	1297
afaití	2	0	afaiti	2	8	8	1298
afaiçonà	2	7	afaiçona	2	35	42	1299
afaiçonés	2	1	afaiçones	2	2	3	1300
afaiçoní	2	0	afaiçoni	2	1	1	1301
afalagarà	2	4	afalagara	2	0	4	1302
afalagués	2	3	afalagues	2	8	11	1303
afalaguí	2	0	afalagui	2	5	5	1304
afalagà	2	5	afalaga	2	142	147	1305
afalconà	2	0	afalcona	2	1	1	1306
afal·lerà	2	0	afal·lera	2	1	1	1307
afamà	2	1	afama	2	75	76	1308
afanyarà	2	19	afanyara	2	2	21	1309
afanyà	2	71	afanya	2	775	846	1310
afanyàrem	2	1	afanyarem	2	11	12	1311
afanyàreu	2	0	afanyareu	2	1	1	1312
afanyés	2	29	afanyes	2	19	48	1313
afanyí	2	0	afanyi	2	81	81	1314
afanà	2	0	afana	2	6	6	1315
afanàrem	2	0	afanarem	2	1	1	1316
afanàreu	2	1	afanareu	2	0	1	1317
afanés	2	0	afanes	2	3	3	1318
afaní	2	0	afani	2	1	1	1319
afartarà	2	2	afartara	2	0	2	1320
afartà	2	1	afarta	2	28	29	1321
afartàrem	2	0	afartarem	2	3	3	1322
afartàreu	2	1	afartareu	2	5	6	1323
afartés	2	0	afartes	2	5	5	1324
afartí	2	0	afarti	2	25	25	1325
afavorirà	2	1224	afavorira	2	18	1242	1326
afavorírem	2	1	afavorirem	2	142	143	1327
afavoríreu	2	0	afavorireu	2	7	7	1328
afeblirà	2	108	afeblira	2	0	108	1329
afeblírem	2	0	afeblirem	2	12	12	1330
afeccionarà	2	1	afeccionara	2	0	1	1331
afeccionà	2	14	afecciona	2	11	25	1332
afeccionés	2	1	afecciones	2	7	8	1333
afeccioní	2	0	afeccioni	2	5	5	1334
afectarà	2	4992	afectara	2	38	5030	1335
afectà	2	725	afecta	2	35284	36009	1336
afectàrem	2	0	afectarem	2	1	1	1337
afectés	2	399	afectes	2	1798	2197	1338
afectí	2	0	afecti	2	3123	3123	1339
afegirà	2	1793	afegira	2	35	1828	1340
afegírem	2	18	afegirem	2	2987	3005	1341
afegíreu	2	2	afegireu	2	103	105	1342
afeixugués	2	4	afeixugues	2	0	4	1343
afeixuguí	2	0	afeixugui	2	1	1	1344
afeixugà	2	2	afeixuga	2	21	23	1345
afeixugàrem	2	1	afeixugarem	2	0	1	1346
afeixés	2	0	afeixes	2	2	2	1347
afeixí	2	0	afeixi	2	6	6	1348
afemellà	2	0	afemella	2	1	1	1349
afemà	2	0	afema	2	3	3	1350
afermançà	2	1	afermança	2	0	1	1351
afermarà	2	22	afermara	2	0	22	1352
afermà	2	57	aferma	2	276	333	1353
afermàrem	2	0	afermarem	2	1	1	1354
afermés	2	8	afermes	2	0	8	1355
afermí	2	0	afermi	2	26	26	1356
aferrarà	2	25	aferrara	2	1	26	1357
aferrissarà	2	1	aferrissara	2	0	1	1358
aferrissà	2	1	aferrissa	2	8	9	1359
aferrissí	2	0	aferrissi	2	1	1	1360
aferrussà	2	1	aferrussa	2	0	1	1361
aferrà	2	49	aferra	2	763	812	1362
aferràrem	2	1	aferrarem	2	11	12	1363
aferràreu	2	1	aferrareu	2	0	1	1364
aferrés	2	8	aferres	2	46	54	1365
aferrí	2	1	aferri	2	88	89	1366
aferrís	2	0	aferris	2	13	13	1367
afetgegà	2	0	afetgega	2	6	6	1368
afganès	0	740	afganes	4	26	766	1369
afganés	0	15	afganes	4	26	41	1370
afiancí	2	0	afianci	2	3	3	1371
afiançarà	2	3	afiançara	2	0	3	1372
afiançà	2	7	afiança	2	60	67	1373
aficionarà	2	3	aficionara	2	1	4	1374
aficionà	2	15	aficiona	2	39	54	1375
aficionàrem	2	0	aficionarem	2	1	1	1376
aficionés	2	9	aficiones	2	89	98	1377
aficioní	2	0	aficioni	2	13	13	1378
afigurà	2	1	afigura	2	29	30	1379
afigurés	2	0	afigures	2	6	6	1380
afigurí	2	2	afiguri	2	0	2	1381
afilerà	2	0	afilera	2	2	2	1382
afilerés	2	0	afileres	2	1	1	1383
afiliarà	2	19	afiliara	2	0	19	1384
afilià	2	858	afilia	2	154	1012	1385
afiliàrem	2	0	afiliarem	2	2	2	1386
afiliés	2	10	afilies	2	9	19	1387
afillà	2	2	afilla	2	7	9	1388
afillàrem	2	0	afillarem	2	1	1	1389
afilà	2	2	afila	2	35	37	1390
afilàrem	2	0	afilarem	2	1	1	1391
afilés	2	1	afiles	2	2	3	1392
afinarà	2	12	afinara	2	1	13	1393
afincà	2	5	afinca	2	3	8	1394
afincàrem	2	1	afincarem	2	0	1	1395
afinqués	2	1	afinques	2	0	1	1396
afinà	2	9	afina	2	340	349	1397
afinàrem	2	1	afinarem	2	11	12	1398
afinàreu	2	0	afinareu	2	3	3	1399
afinés	2	10	afines	2	74	84	1400
afiní	2	0	afini	2	29	29	1401
afirmarà	2	104	afirmara	2	21	125	1402
afirmà	2	1726	afirma	2	32284	34010	1403
afirmàrem	2	4	afirmarem	2	18	22	1404
afirmàreu	2	2	afirmareu	2	0	2	1405
afirmés	2	197	afirmes	2	136	333	1406
afirmí	2	2	afirmi	2	393	395	1407
afitorà	2	0	afitora	2	1	1	1408
afità	2	0	afita	2	3	3	1409
afití	2	0	afiti	2	2	2	1410
afixarà	2	1	afixara	2	0	1	1411
afixà	2	0	afixa	0	6	6	1412
afixés	2	0	afixes	0	4	4	1413
afixí	2	0	afixi	2	5	5	1414
aflacà	2	0	aflaca	2	2	2	1415
aflamarà	2	1	aflamara	2	0	1	1416
aflamà	2	0	aflama	2	3	3	1417
afligirà	2	2	afligira	2	0	2	1418
aflorarà	2	19	aflorara	2	3	22	1419
aflorà	2	20	aflora	2	653	673	1420
afloràrem	2	1	aflorarem	2	1	2	1421
aflorés	2	22	aflores	2	1	23	1422
aflorí	2	1	aflori	2	114	115	1423
afluixarà	2	59	afluixara	2	1	60	1424
afluixà	2	16	afluixa	2	496	512	1425
afluixàrem	2	0	afluixarem	2	20	20	1426
afluixés	2	19	afluixes	2	27	46	1427
afluixí	2	1	afluixi	2	112	113	1428
afogués	2	1	afogues	2	1	2	1429
afoguí	2	0	afogui	2	1	1	1430
afogà	2	0	afoga	2	10	10	1431
afonarà	2	4	afonara	2	2	6	1432
afonà	2	6	afona	2	65	71	1433
afonés	2	1	afones	2	3	4	1434
afoní	2	0	afoni	2	1	1	1435
aforarà	2	1	aforara	2	0	1	1436
aforestà	2	0	aforesta	2	3	3	1437
aforestàrem	2	1	aforestarem	2	0	1	1438
aforà	2	0	afora	2	141	141	1439
aforés	2	2	afores	2	6464	6466	1440
aforí	2	0	afori	2	1	1	1441
afrancesà	2	1	afrancesa	2	4	5	1442
africà	2	5635	africa	2	1580	7215	1443
afriqués	2	0	afriques	2	2	2	1444
afrontarà	2	713	afrontara	2	6	719	1445
afrontà	2	80	afronta	2	4796	4876	1446
afrontàrem	2	3	afrontarem	2	158	161	1447
afrontàreu	2	0	afrontareu	2	4	4	1448
afrontés	2	45	afrontes	2	97	142	1449
afrontí	2	0	afronti	2	360	360	1450
afuarà	2	0	afuara	2	1	1	1451
afusellarà	2	3	afusellara	2	0	3	1452
afusellà	2	29	afusella	2	55	84	1453
afusellàrem	2	0	afusellarem	2	2	2	1454
afusellés	2	21	afuselles	2	0	21	1455
afusellí	2	0	afuselli	2	4	4	1456
afusés	2	1	afuses	2	0	1	1457
afuà	2	1	afua	2	22	23	1458
afués	2	1	afues	2	0	1	1459
agabellà	2	0	agabella	2	3	3	1460
agafarà	2	1169	agafara	2	63	1232	1461
agafà	2	1018	agafa	2	14282	15300	1462
agafàrem	2	110	agafarem	2	3118	3228	1463
agafàreu	2	1	agafareu	2	295	296	1464
agafés	2	686	agafes	2	1553	2239	1465
agafí	2	16	agafi	2	3208	3224	1466
agarberà	2	0	agarbera	2	2	2	1467
agarberàreu	2	1	agarberareu	2	0	1	1468
agarbí	2	0	agarbi	2	1	1	1469
agarrarà	2	6	agarrara	2	4	10	1470
agarrotà	2	0	agarrota	2	6	6	1471
agarrà	2	15	agarra	2	92	107	1472
agarràrem	2	2	agarrarem	2	23	25	1473
agarrés	2	2	agarres	2	29	31	1474
agarrí	2	1	agarri	2	67	68	1475
agegantà	2	0	ageganta	2	8	8	1476
agemolírem	2	0	agemolirem	2	1	1	1477
agencià	2	3	agencia	2	2272	2275	1478
agenciés	2	0	agencies	2	319	319	1479
agencés	2	0	agences	2	4	4	1480
agencí	2	0	agenci	2	1	1	1481
agenollarà	2	7	agenollara	2	1	8	1482
agenollà	2	60	agenolla	2	176	236	1483
agenollàrem	2	3	agenollarem	2	2	5	1484
agenollés	2	8	agenolles	2	13	21	1485
agenollí	2	0	agenolli	2	24	24	1486
agençarà	2	1	agençara	2	0	1	1487
agençà	2	3	agença	2	4	7	1488
agermanarà	2	23	agermanara	2	0	23	1489
agermanà	2	9	agermana	2	483	492	1490
agermanàrem	2	1	agermanarem	2	6	7	1491
agermanés	2	6	agermanes	2	1	7	1492
agermaní	2	0	agermani	2	12	12	1493
agilitarà	2	54	agilitara	2	2	56	1494
agilitzarà	2	99	agilitzara	2	7	106	1495
agilitzà	2	4	agilitza	2	347	351	1496
agilitzàrem	2	0	agilitzarem	2	12	12	1497
agilitzàreu	2	0	agilitzareu	2	1	1	1498
agilitzés	2	12	agilitzes	2	0	12	1499
agilitzí	2	0	agilitzi	2	104	104	1500
agilità	2	1	agilita	2	102	103	1501
agilitàrem	2	0	agilitarem	2	2	2	1502
agilités	2	5	agilites	2	0	5	1503
agilití	2	0	agiliti	2	74	74	1504
agitarà	2	17	agitara	2	0	17	1505
agità	2	24	agita	2	426	450	1506
agitàrem	2	1	agitarem	2	7	8	1507
agités	2	5	agites	2	8	13	1508
agití	2	0	agiti	2	27	27	1509
aglanàrem	2	1	aglanarem	2	0	1	1510
aglevà	2	0	agleva	2	4	4	1511
aglomerarà	2	1	aglomerara	2	0	1	1512
aglomerà	2	1	aglomera	2	36	37	1513
aglomerés	2	1	aglomeres	2	0	1	1514
aglomerí	2	0	aglomeri	2	2	2	1515
aglutinarà	2	202	aglutinara	2	6	208	1516
aglutinà	2	56	aglutina	2	2673	2729	1517
aglutinàrem	2	0	aglutinarem	2	1	1	1518
aglutinés	2	91	aglutines	2	8	99	1519
aglutiní	2	0	aglutini	2	338	338	1520
agomboià	2	0	agomboia	2	4	4	1521
agombolarà	2	0	agombolara	2	1	1	1522
agombolà	2	6	agombola	2	73	79	1523
agombolés	2	1	agomboles	2	0	1	1524
agombolí	2	0	agomboli	2	5	5	1525
agonitzarà	2	3	agonitzara	2	0	3	1526
agonitzà	2	2	agonitza	2	226	228	1527
agonitzés	2	1	agonitzes	2	1	2	1528
agonitzí	2	0	agonitzi	2	12	12	1529
agostarà	2	1	agostara	2	0	1	1530
agostejà	2	0	agosteja	2	1	1	1531
agostà	2	0	agosta	2	20	20	1532
agostí	2	5	agosti	2	9	14	1533
agotzonà	2	0	agotzona	2	3	3	1534
agracià	2	1	agracia	2	2	3	1535
agraciés	2	0	agracies	2	2	2	1536
agradarà	2	4295	agradara	2	115	4410	1537
agradà	2	350	agrada	2	101440	101790	1538
agradàrem	2	1	agradarem	2	9	10	1539
agradàreu	2	0	agradareu	2	1	1	1540
agradés	2	845	agrades	2	424	1269	1541
agradí	2	1	agradi	2	13039	13040	1542
agranarà	2	3	agranara	2	1	4	1543
agranà	2	2	agrana	2	29	31	1544
agranés	2	0	agranes	2	1	1	1545
agraní	2	0	agrani	2	1	1	1546
agraírem	2	15	agrairem	2	1285	1300	1547
agraíreu	2	2	agraireu	2	60	62	1548
agredirà	2	5	agredira	2	2	7	1549
agregarà	2	16	agregara	2	1	17	1550
agregués	2	6	agregues	2	5	11	1551
agreguí	2	0	agregui	2	22	22	1552
agregà	2	69	agrega	2	622	691	1553
agregàrem	2	1	agregarem	2	15	16	1554
agregàreu	2	0	agregareu	2	1	1	1555
agregí	2	0	agregi	2	3	3	1556
agrejarà	2	0	agrejara	2	1	1	1557
agrejà	2	0	agreja	2	7	7	1558
agremiarà	2	1	agremiara	2	0	1	1559
agremià	2	0	agremia	2	1	1	1560
agremiés	2	1	agremies	2	0	1	1561
agresà	0	5	agresa	4	1	6	1562
agreugés	2	17	agreuges	2	3	20	1563
agreugí	2	0	agreugi	2	168	168	1564
agreujarà	2	312	agreujara	2	1	313	1565
agreujà	2	163	agreuja	2	1722	1885	1566
agreujàrem	2	0	agreujarem	2	6	6	1567
agrimàrem	2	0	agrimarem	2	1	1	1568
agrimí	2	0	agrimi	2	8	8	1569
agrirà	2	1	agrira	2	0	1	1570
agrisà	2	1	agrisa	2	3	4	1571
agrumollà	2	0	agrumolla	2	4	4	1572
agrumollí	2	0	agrumolli	2	5	5	1573
agrumí	2	0	agrumi	2	1	1	1574
agrunsí	2	0	agrunsi	2	1	1	1575
agruparà	2	188	agrupara	2	7	195	1576
agrupà	2	80	agrupa	2	6456	6536	1577
agrupàrem	2	4	agruparem	2	53	57	1578
agrupàreu	2	0	agrupareu	2	1	1	1579
agrupés	2	64	agrupes	2	10	74	1580
agrupí	2	0	agrupi	2	193	193	1581
agrírem	2	0	agrirem	2	1	1	1582
aguaitarà	2	1	aguaitara	2	1	2	1583
aguaità	2	1	aguaita	2	185	186	1584
aguaités	2	0	aguaites	2	1	1	1585
aguaití	2	1	aguaiti	2	5	6	1586
aguaitó	4	0	aguaito	2	9	9	1587
aguantarà	2	381	aguantara	2	15	396	1588
aguantà	2	81	aguanta	2	3841	3922	1589
aguantàrem	2	4	aguantarem	2	105	109	1590
aguantàreu	2	1	aguantareu	2	4	5	1591
aguantés	2	149	aguantes	2	175	324	1592
aguantí	2	2	aguanti	2	662	664	1593
aguardà	2	0	aguarda	2	50	50	1594
aguardés	2	0	aguardes	2	1	1	1595
aguardí	2	0	aguardi	2	1	1	1596
aguditzarà	2	60	aguditzara	2	0	60	1597
aguditzà	2	27	aguditza	2	408	435	1598
aguditzés	2	1	aguditzes	2	1	2	1599
aguditzí	2	0	aguditzi	2	22	22	1600
agullonarà	2	2	agullonara	2	0	2	1601
agullonà	2	0	agullona	2	14	14	1602
agusarà	2	1	agusara	2	0	1	1603
agusà	2	0	agusa	2	4	4	1604
agusés	2	0	aguses	2	2	2	1605
agusí	2	4	agusi	2	6	10	1606
agència	4	59831	agencia	2	2272	62103	1607
agències	4	12928	agencies	2	319	13247	1608
agènesi	4	18	agenesi	4	0	18	1609
agènesis	4	0	agenesis	4	1	1	1610
aidà	2	9	aida	4	1899	1908	1611
aidàreu	2	1	aidareu	2	0	1	1612
aidés	2	0	aides	4	24	24	1613
aiguabarrejà	2	0	aiguabarreja	2	2	2	1614
aiguabatré	2	0	aiguabatre	2	3	3	1615
aigualegí	2	0	aigualegi	2	1	1	1616
aigualirà	2	3	aigualira	2	0	3	1617
aigualíreu	2	0	aigualireu	2	1	1	1618
aiguavivà	0	0	aiguaviva	4	943	943	1619
airegés	2	7	aireges	2	2	9	1620
airegí	2	0	airegi	2	23	23	1621
airejarà	2	4	airejara	2	0	4	1622
airejà	2	2	aireja	2	68	70	1623
airejàrem	2	0	airejarem	2	5	5	1624
aixadà	2	0	aixada	4	549	549	1625
aixadés	2	0	aixades	4	135	135	1626
aixadó	4	2	aixado	2	0	2	1627
aixafarà	2	32	aixafara	2	1	33	1628
aixafà	2	22	aixafa	2	286	308	1629
aixafàrem	2	0	aixafarem	2	44	44	1630
aixafàreu	2	0	aixafareu	2	3	3	1631
aixafés	2	26	aixafes	2	19	45	1632
aixafí	2	0	aixafi	2	59	59	1633
aixafín	2	0	aixafin	2	36	36	1634
aixamfranà	2	0	aixamfrana	2	1	1	1635
aixaragallàrem	2	1	aixaragallarem	2	0	1	1636
aixarà	2	3	aixara	2	2	5	1637
aixecarà	2	678	aixecara	2	5	683	1638
aixecà	2	956	aixeca	2	7834	8790	1639
aixecàrem	2	18	aixecarem	2	179	197	1640
aixecàreu	2	1	aixecareu	2	15	16	1641
aixequés	2	575	aixeques	2	394	969	1642
aixequí	2	3	aixequi	2	991	994	1643
aixoplugarà	2	19	aixoplugara	2	1	20	1644
aixoplugués	2	5	aixoplugues	2	2	7	1645
aixopluguí	2	0	aixoplugui	2	24	24	1646
aixoplugà	2	9	aixopluga	2	333	342	1647
aixoplugàrem	2	1	aixoplugarem	2	2	3	1648
aixà	2	148	aixa	4	908	1056	1649
aixés	2	0	aixes	4	21	21	1650
així	2	836911	aixi	2	6532	843443	1651
això	5	1144894	aixo	2	5670	1150564	1652
ajagués	2	3	ajagues	2	0	3	1653
ajauré	2	2	ajaure	2	18	20	1654
ajaçà	2	1	ajaça	2	7	8	1655
ajocà	2	3	ajoca	2	12	15	1656
ajoquí	2	0	ajoqui	2	2	2	1657
ajornalés	2	0	ajornales	2	1	1	1658
ajornarà	2	105	ajornara	2	11	116	1659
ajornà	2	41	ajorna	2	670	711	1660
ajornàrem	2	1	ajornarem	2	19	20	1661
ajornés	2	102	ajornes	2	4	106	1662
ajorní	2	0	ajorni	2	275	275	1663
ajovés	2	0	ajoves	2	1	1	1664
ajudarà	2	14358	ajudara	2	164	14522	1665
ajudà	2	1107	ajuda	4	140773	141880	1666
ajudàrem	2	18	ajudarem	2	1999	2017	1667
ajudàreu	2	3	ajudareu	2	206	209	1668
ajudés	2	1098	ajudes	4	35683	36781	1669
ajudí	2	3	ajudi	2	7529	7532	1670
ajuntarà	2	105	ajuntara	2	4	109	1671
ajuntà	2	97	ajunta	2	1115	1212	1672
ajuntàrem	2	16	ajuntarem	2	146	162	1673
ajuntàreu	2	0	ajuntareu	2	2	2	1674
ajuntés	2	32	ajuntes	2	95	127	1675
ajuntí	2	0	ajunti	2	86	86	1676
ajupirà	2	4	ajupira	2	0	4	1677
ajupí	2	38	ajupi	2	7	45	1678
ajupírem	2	0	ajupirem	2	1	1	1679
ajupís	2	4	ajupis	2	5	9	1680
ajustarà	2	441	ajustara	2	12	453	1681
ajusticià	2	5	ajusticia	2	6	11	1682
ajusticií	2	0	ajusticii	2	1	1	1683
ajustà	2	27	ajusta	2	5390	5417	1684
ajustàrem	2	0	ajustarem	2	71	71	1685
ajustàreu	2	0	ajustareu	2	4	4	1686
ajustés	2	108	ajustes	2	63	171	1687
ajustí	2	2	ajusti	2	1828	1830	1688
alabarà	2	4	alabara	2	0	4	1689
alabatré	2	0	alabatre	2	1012	1012	1690
alabà	2	7	alaba	2	117	124	1691
alabàreu	2	1	alabareu	2	1	2	1692
alabés	2	21	alabes	2	3	24	1693
alabí	2	1	alabi	2	7	8	1694
alambinà	2	0	alambina	2	1	1	1695
alambinàrem	2	0	alambinarem	2	1	1	1696
alardó	4	1	alardo	4	61	62	1697
alarmarà	2	2	alarmara	2	3	5	1698
alarmà	2	27	alarma	4	7553	7580	1699
alarmàrem	2	1	alarmarem	2	3	4	1700
alarmàreu	2	1	alarmareu	2	0	1	1701
alarmés	2	6	alarmes	4	2950	2956	1702
alarmí	2	0	alarmi	2	17	17	1703
alarà	2	0	alara	2	18	18	1704
albanés	0	18	albanes	4	17	35	1705
albardanejà	2	0	albardaneja	2	1	1	1706
albardà	2	24	albarda	4	187	211	1707
albardés	2	0	albardes	4	30	30	1708
albardí	2	8	albardi	2	1	9	1709
albardó	4	1	albardo	2	0	1	1710
albaterà	0	0	albatera	4	176	176	1711
albeldà	0	1	albelda	4	312	313	1712
albergarà	2	515	albergara	2	7	522	1713
albergués	2	30	albergues	4	26	56	1714
alberguí	2	0	albergui	2	37	37	1715
albergà	2	77	alberga	4	2940	3017	1716
albergàrem	2	0	albergarem	2	2	2	1717
albesà	0	0	albesa	4	784	784	1718
albirarà	2	6	albirara	2	3	9	1719
albirà	2	57	albira	2	1184	1241	1720
albiràrem	2	7	albirarem	2	44	51	1721
albiràreu	2	0	albirareu	2	3	3	1722
albirés	2	5	albires	2	20	25	1723
albirí	2	0	albiri	2	49	49	1724
alcalinitzarà	2	2	alcalinitzara	2	0	2	1725
alcalinitzà	2	0	alcalinitza	2	15	15	1726
alcalinitzàrem	2	0	alcalinitzarem	2	1	1	1727
alcalinitzàreu	2	0	alcalinitzareu	2	1	1	1728
alcancés	2	0	alcances	2	16	16	1729
alcançarà	2	7	alcançara	2	3	10	1730
alcançà	2	12	alcança	2	80	92	1731
alcançàrem	2	0	alcançarem	2	1	1	1732
alcavotegés	2	1	alcavoteges	2	0	1	1733
alcoholitzà	2	0	alcoholitza	2	2	2	1734
alcoholitzés	2	0	alcoholitzes	2	1	1	1735
alcoholés	2	2	alcoholes	2	8	10	1736
alcoholí	2	0	alcoholi	2	1	1	1737
alcolejà	0	2	alcoleja	4	259	261	1738
alcorà	4	1374	alcora	4	1081	2455	1739
alcàssers	4	28	alcassers	0	3	31	1740
alcés	2	80	alces	4	309	389	1741
alcí	2	5	alci	2	186	191	1742
aldeà	4	58	aldea	4	3386	3444	1743
aldrín	4	5	aldrin	4	126	131	1744
aleatoritzà	2	0	aleatoritza	2	13	13	1745
alegrarà	2	168	alegrara	2	2	170	1746
alegrà	2	62	alegra	2	4576	4638	1747
alegràrem	2	3	alegrarem	2	36	39	1748
alegràreu	2	1	alegrareu	2	11	12	1749
alegrés	2	25	alegres	2	2545	2570	1750
alegés	2	0	aleges	2	1	1	1751
alegí	2	0	alegi	2	2	2	1752
alejarà	2	0	alejara	2	1	1	1753
alejà	2	0	aleja	2	16	16	1754
alejàreu	2	0	alejareu	2	1	1	1755
alenarà	2	3	alenara	2	0	3	1756
alendà	2	1	alenda	2	22	23	1757
alentirà	2	52	alentira	2	1	53	1758
alentírem	2	0	alentirem	2	2	2	1759
alenà	2	26	alena	4	178	204	1760
alenàrem	2	1	alenarem	2	0	1	1761
alenés	2	4	alenes	4	8	12	1762
alení	2	0	aleni	2	10	10	1763
alertarà	2	47	alertara	2	3	50	1764
alertà	2	77	alerta	4	18424	18501	1765
alertàrem	2	3	alertarem	2	5	8	1766
alertés	2	66	alertes	4	2105	2171	1767
alertí	2	0	alerti	2	48	48	1768
aletegés	2	0	aleteges	2	1	1	1769
aletejà	2	0	aleteja	2	18	18	1770
alfabetitzarà	2	1	alfabetitzara	2	0	1	1771
alfabetitzà	2	1	alfabetitza	2	6	7	1772
alfabetitzí	2	0	alfabetitzi	2	1	1	1773
alfarrassà	2	3	alfarrassa	2	3	6	1774
alfarrassés	2	0	alfarrasses	2	2	2	1775
alfarrassí	2	3	alfarrassi	2	0	3	1776
alforrà	2	0	alforra	2	1	1	1777
alforrés	2	0	alforres	2	2	2	1778
algalià	2	0	algalia	2	14	14	1779
algalií	2	1	algalii	2	0	1	1780
algerí	0	21	algeri	4	82	103	1781
algàlia	4	6	algalia	2	14	20	1782
aliarà	2	22	aliara	2	0	22	1783
alicatà	2	0	alicata	2	1	1	1784
alicatés	2	0	alicates	2	155	155	1785
alienarà	2	2	alienara	2	0	2	1786
alienà	2	21	aliena	2	4109	4130	1787
alienés	2	2	alienes	2	4377	4379	1788
aliení	2	0	alieni	2	37	37	1789
alimentarà	2	165	alimentara	2	5	170	1790
alimentà	2	60	alimenta	2	5194	5254	1791
alimentàrem	2	0	alimentarem	2	47	47	1792
alimentàreu	2	0	alimentareu	2	4	4	1793
alimentària	0	19750	alimentaria	2	1612	21362	1794
alimentàries	0	4499	alimentaries	2	217	4716	1795
alimentés	2	42	alimentes	2	95	137	1796
alimentí	2	0	alimenti	2	273	273	1797
alinearà	2	65	alineara	2	4	69	1798
alineà	2	72	alinea	2	872	944	1799
alineàrem	2	0	alinearem	2	5	5	1800
alineés	2	8	alinees	2	1	9	1801
alineí	2	0	alinei	2	11	11	1802
alià	2	159	alia	2	537	696	1803
aliàrem	2	0	aliarem	2	5	5	1804
aliè	0	4377	alie	2	18	4395	1805
alièn	2	0	alien	2	1175	1175	1806
alié	0	297	alie	2	18	315	1807
aliés	2	19	alies	2	225	244	1808
alií	2	7	alii	2	81	88	1809
aljubà	2	0	aljuba	4	2	2	1810
aljubés	2	0	aljubes	4	1	1	1811
allararà	2	1	allarara	2	0	1	1812
allargarà	2	3322	allargara	2	16	3338	1813
allargassarà	2	3	allargassara	2	0	3	1814
allargassà	2	5	allargassa	2	87	92	1815
allargassés	2	1	allargasses	2	2	3	1816
allargassí	2	0	allargassi	2	5	5	1817
allargués	2	174	allargues	2	79	253	1818
allarguí	2	1	allargui	2	660	661	1819
allargà	2	366	allarga	2	3472	3838	1820
allargàrem	2	1	allargarem	2	83	84	1821
allargàreu	2	0	allargareu	2	5	5	1822
allargàssem	2	0	allargassem	2	1	1	1823
allegés	2	0	alleges	2	1	1	1824
allejà	2	0	alleja	2	1	1	1825
allerà	2	1	allera	4	7	8	1826
allerés	2	0	alleres	4	1	1	1827
alletà	2	25	alleta	2	90	115	1828
alletàrem	2	3	alletarem	2	1	4	1829
alletàreu	2	1	alletareu	2	0	1	1830
alletés	2	2	alletes	2	9	11	1831
alletí	2	0	alleti	2	6	6	1832
alleugerarà	2	1	alleugerara	2	0	1	1833
alleugerirà	2	30	alleugerira	2	0	30	1834
alleugerà	2	17	alleugera	2	91	108	1835
alleugeràrem	2	0	alleugerarem	2	1	1	1836
alleugerés	2	1	alleugeres	2	2	3	1837
alleugerí	2	12	alleugeri	2	13	25	1838
alleugerírem	2	0	alleugerirem	2	12	12	1839
alleugerís	2	12	alleugeris	2	2	14	1840
alleugés	2	16	alleuges	2	3	19	1841
alleugí	2	0	alleugi	2	65	65	1842
alleujarà	2	66	alleujara	2	2	68	1843
alleujà	2	14	alleuja	2	720	734	1844
alleujàrem	2	0	alleujarem	2	6	6	1845
allevarà	2	1	allevara	2	0	1	1846
allevà	2	0	alleva	2	4	4	1847
alleví	2	0	allevi	2	1	1	1848
alliberarà	2	391	alliberara	2	9	400	1849
alliberà	2	289	allibera	2	3373	3662	1850
alliberàrem	2	1	alliberarem	2	91	92	1851
alliberàreu	2	0	alliberareu	2	13	13	1852
alliberés	2	202	alliberes	2	91	293	1853
alliberí	2	1	alliberi	2	718	719	1854
alligà	2	0	alliga	2	1	1	1855
allisarà	2	2	allisara	2	0	2	1856
allistarà	2	7	allistara	2	1	8	1857
allistà	2	202	allista	2	122	324	1858
allistés	2	7	allistes	2	0	7	1859
allistí	2	0	allisti	2	7	7	1860
allisà	2	7	allisa	2	135	142	1861
allisàrem	2	0	allisarem	2	10	10	1862
allisés	2	0	allises	2	5	5	1863
allisí	2	0	allisi	2	3	3	1864
allisó	4	0	alliso	2	7	7	1865
allità	2	2	allita	2	7	9	1866
allitàrem	2	1	allitarem	2	0	1	1867
allités	2	2	allites	2	1	3	1868
allití	2	0	alliti	2	1	1	1869
alliçonarà	2	4	alliçonara	2	0	4	1870
alliçonà	2	7	alliçona	2	141	148	1871
alliçonés	2	1	alliçones	2	5	6	1872
alliçoní	2	0	alliçoni	2	11	11	1873
allongarà	2	1	allongara	2	0	1	1874
allongà	2	0	allonga	2	4	4	1875
alloquí	2	0	alloqui	2	1	1	1876
allotgés	2	19	allotges	2	62	81	1877
allotgí	2	0	allotgi	2	65	65	1878
allotjarà	2	228	allotjara	2	0	228	1879
allotjà	2	130	allotja	2	2022	2152	1880
allotjàrem	2	11	allotjarem	2	293	304	1881
allotjàreu	2	1	allotjareu	2	54	55	1882
allunarà	2	3	allunara	2	0	3	1883
allunyarà	2	203	allunyara	2	9	212	1884
allunyà	2	259	allunya	2	4684	4943	1885
allunyàrem	2	1	allunyarem	2	48	49	1886
allunyàreu	2	0	allunyareu	2	7	7	1887
allunyés	2	146	allunyes	2	139	285	1888
allunyí	2	0	allunyi	2	616	616	1889
allunà	2	4	alluna	2	7	11	1890
alluní	2	0	alluni	2	2	2	1891
allèn	6	66	allen	4	3654	3720	1892
allén	6	2	allen	4	3654	3656	1893
almesquí	2	2	almesqui	2	0	2	1894
almoinà	2	0	almoina	4	1418	1418	1895
almoinés	2	0	almoines	4	1067	1067	1896
almívar	4	1241	almivar	2	25	1266	1897
almón	6	15	almon	6	12	27	1898
alquenà	2	0	alquena	4	14	14	1899
alquenàrem	2	1	alquenarem	2	0	1	1900
alquenés	2	0	alquenes	4	2	2	1901
alquerià	0	0	alqueria	4	3005	3005	1902
alquilà	2	0	alquila	2	29	29	1903
alquilàrem	2	2	alquilarem	2	0	2	1904
alquilés	2	0	alquiles	2	1	1	1905
alterarà	2	233	alterara	2	5	238	1906
alternarà	2	143	alternara	2	1	144	1907
alternà	2	107	alterna	0	1878	1985	1908
alternàrem	2	0	alternarem	2	32	32	1909
alternàreu	2	1	alternareu	2	6	7	1910
alternària	4	2	alternaria	2	26	28	1911
alternés	2	8	alternes	0	402	410	1912
alterní	2	0	alterni	2	24	24	1913
alterà	2	82	altera	4	2006	2088	1914
alteràrem	2	0	alterarem	2	7	7	1915
alteràreu	2	0	alterareu	2	2	2	1916
alterés	2	54	alteres	4	16	70	1917
alterí	2	0	alteri	2	473	473	1918
alteró	4	27	altero	2	23	50	1919
alteà	0	105	altea	4	2907	3012	1920
altifiquí	2	1	altifiqui	2	0	1	1921
altivà	2	0	altiva	0	311	311	1922
altivés	2	0	altives	0	75	75	1923
altiví	2	0	altivi	2	3	3	1924
alturà	0	0	altura	4	20746	20746	1925
alumenà	2	0	alumena	2	1	1	1926
alumenés	2	0	alumenes	2	14	14	1927
aluminià	2	0	aluminia	2	2	2	1928
aluminií	2	0	aluminii	2	1	1	1929
alumà	2	58	aluma	2	12	70	1930
alumèn	2	0	alumen	2	9	9	1931
alumés	2	0	alumes	2	193	193	1932
alumí	2	0	alumi	2	9	9	1933
alzinà	2	0	alzina	4	4111	4111	1934
alzinés	2	0	alzines	4	3619	3619	1935
al·legarà	2	30	al·legara	2	1	31	1936
al·legoritzarà	2	1	al·legoritzara	2	0	1	1937
al·legués	2	15	al·legues	2	3	18	1938
al·leguí	2	0	al·legui	2	137	137	1939
al·legà	2	58	al·lega	2	1081	1139	1940
al·legàrem	2	0	al·legarem	2	8	8	1941
al·literarà	2	1	al·literara	2	0	1	1942
al·literà	2	0	al·litera	2	1	1	1943
al·literés	2	2	al·literes	2	0	2	1944
al·literí	2	0	al·literi	2	1	1	1945
al·lucinarà	2	13	al·lucinara	2	1	14	1946
al·lucinà	2	0	al·lucina	2	104	104	1947
al·lucinàrem	2	1	al·lucinarem	2	3	4	1948
al·lucinàreu	2	0	al·lucinareu	2	39	39	1949
al·lucinés	2	2	al·lucines	2	19	21	1950
al·luciní	2	0	al·lucini	2	3	3	1951
al·ludirà	2	3	al·ludira	2	2	5	1952
al·ludírem	2	0	al·ludirem	2	5	5	1953
alà	2	213	ala	4	8651	8864	1954
alàlia	4	11	alalia	4	1	12	1955
alçarà	2	269	alçara	2	54	323	1956
alçurà	2	0	alçura	2	2	2	1957
alçà	2	527	alça	7	8780	9307	1958
alçàrem	2	19	alçarem	2	67	86	1959
alçàreu	2	0	alçareu	2	2	2	1960
alçària	4	1749	alçaria	2	174	1923	1961
alçàries	4	112	alçaries	2	19	131	1962
alè	4	4435	ale	4	1366	5801	1963
alèn	2	0	alen	2	85	85	1964
alé	4	286	ale	4	1366	1652	1965
alís	0	305	alis	2	89	394	1966
aló	4	24	alo	2	63	87	1967
amacés	2	1	amaces	2	1	2	1968
amací	2	0	amaci	2	1	1	1969
amagarà	2	145	amagara	2	14	159	1970
amagués	2	127	amagues	2	185	312	1971
amaguí	2	0	amagui	2	442	442	1972
amagà	2	228	amaga	2	14756	14984	1973
amagàrem	2	0	amagarem	2	59	59	1974
amagàreu	2	0	amagareu	2	2	2	1975
amainarà	2	16	amainara	2	2	18	1976
amainà	2	8	amaina	2	50	58	1977
amainés	2	7	amaines	2	2	9	1978
amainí	2	0	amaini	2	32	32	1979
amalgamarà	2	0	amalgamara	2	1	1	1980
amalgamà	2	0	amalgama	4	1364	1364	1981
amalgamàrem	2	0	amalgamarem	2	1	1	1982
amalgamés	2	0	amalgames	4	129	129	1983
amalgamí	2	0	amalgami	2	10	10	1984
amanerà	2	0	amanera	2	26	26	1985
amanerés	2	0	amaneres	2	1	1	1986
amanirà	2	10	amanira	2	0	10	1987
amansarà	2	1	amansara	2	0	1	1988
amansà	2	1	amansa	2	23	24	1989
amansí	2	7	amansi	2	0	7	1990
amansís	2	0	amansis	2	1	1	1991
amantà	2	0	amanta	2	2	2	1992
amantés	2	0	amantes	2	202	202	1993
amantí	2	0	amanti	2	20	20	1994
amanyagués	2	2	amanyagues	2	1	3	1995
amanyaguí	2	0	amanyagui	2	3	3	1996
amanyagà	2	1	amanyaga	2	47	48	1997
amanyogarà	2	1	amanyogara	2	0	1	1998
amanírem	2	0	amanirem	2	71	71	1999
amaníreu	2	0	amanireu	2	4	4	2000
amararà	2	10	amarara	2	0	10	2001
amargantejarà	2	1	amargantejara	2	0	1	2002
amargantejà	2	0	amarganteja	2	7	7	2003
amargarà	2	12	amargara	2	2	14	2004
amarguegí	2	0	amarguegi	2	4	4	2005
amarguejà	2	0	amargueja	2	15	15	2006
amargués	2	6	amargues	0	586	592	2007
amarguí	2	0	amargui	2	36	36	2008
amargà	2	5	amarga	0	1982	1987	2009
amargàrem	2	0	amargarem	2	3	3	2010
amarinà	2	0	amarina	4	1	1	2011
amarrarà	2	8	amarrara	2	0	8	2012
amarrà	2	3	amarra	4	78	81	2013
amarràrem	2	0	amarrarem	2	4	4	2014
amarrés	2	0	amarres	4	227	227	2015
amarrí	2	0	amarri	2	18	18	2016
amarrís	2	0	amarris	2	9	9	2017
amartellà	2	0	amartella	2	2	2	2018
amarà	2	23	amara	4	611	634	2019
amaràrem	2	0	amararem	2	2	2	2020
amaré	2	37	amare	2	38	75	2021
amarés	2	10	amares	2	8	18	2022
amarín	2	0	amarin	2	23	23	2023
amassarà	2	1	amassara	2	0	1	2024
amassà	2	7	amassa	2	227	234	2025
amassàrem	2	1	amassarem	2	49	50	2026
amassàreu	2	0	amassareu	2	2	2	2027
amassés	2	1	amasses	2	3	4	2028
amassí	2	0	amassi	2	14	14	2029
amaçà	2	0	amaça	2	1	1	2030
ambicionarà	2	0	ambicionara	2	1	1	2031
ambicionà	2	2	ambiciona	2	120	122	2032
ambicionàreu	2	1	ambicionareu	2	0	1	2033
ambicionés	2	2	ambiciones	2	26	28	2034
ambicioní	2	0	ambicioni	2	3	3	2035
ambientarà	2	59	ambientara	2	0	59	2036
ambientà	2	7	ambienta	2	361	368	2037
ambientàrem	2	0	ambientarem	2	5	5	2038
ambientés	2	8	ambientes	2	30	38	2039
ambientí	2	0	ambienti	2	64	64	2040
ambigú	4	35	ambigu	0	1158	1193	2041
ambigús	4	1	ambigus	0	423	424	2042
amblà	2	1	ambla	2	210	211	2043
amblés	2	0	ambles	2	52	52	2044
ambròsies	4	1	ambrosies	4	14	15	2045
ambulà	2	0	ambula	2	4	4	2046
ambulí	2	1	ambuli	2	0	1	2047
ambó	4	57	ambo	4	28	85	2048
amelà	2	0	amela	2	507	507	2049
amelés	2	0	ameles	2	7	7	2050
amelí	2	11	ameli	2	6	17	2051
amenacés	2	121	amenaces	4	14163	14284	2052
amenací	2	0	amenaci	2	247	247	2053
amenaçarà	2	55	amenaçara	2	5	60	2054
amenaçà	2	191	amenaça	4	25324	25515	2055
amenaçàrem	2	1	amenaçarem	2	4	5	2056
amenitzarà	2	412	amenitzara	2	1	413	2057
amenitzà	2	41	amenitza	2	180	221	2058
amenitzàrem	2	0	amenitzarem	2	22	22	2059
amenitzés	2	10	amenitzes	2	1	11	2060
amenitzí	2	0	amenitzi	2	10	10	2061
americanitzà	2	0	americanitza	2	2	2	2062
americanitzés	2	2	americanitzes	2	0	2	2063
amerà	2	3	amera	2	46	49	2064
ameràrem	2	0	amerarem	2	1	1	2065
amerés	2	0	ameres	2	1	1	2066
amerí	2	0	ameri	2	12	12	2067
amidarà	2	6	amidara	2	0	6	2068
amidà	2	11	amida	4	395	406	2069
amidés	2	2	amides	4	85	87	2070
amidí	2	0	amidi	2	5	5	2071
amigués	2	0	amigues	0	11988	11988	2072
amiguí	2	0	amigui	2	2	2	2073
amigà	2	0	amiga	0	17861	17861	2074
amistancés	2	2	amistances	4	1	3	2075
amistançà	2	5	amistança	4	21	26	2076
amistà	2	0	amista	2	9	9	2077
amistés	2	0	amistes	2	2	2	2078
amitjanà	2	0	amitjana	2	1	1	2079
amitjanés	2	0	amitjanes	2	1	1	2080
amnistiarà	2	3	amnistiara	2	0	3	2081
amnistià	2	3	amnistia	4	5144	5147	2082
amnistiàrem	2	1	amnistiarem	2	0	1	2083
amnistiàreu	2	1	amnistiareu	2	0	1	2084
amnistiés	2	2	amnisties	4	131	133	2085
amnistií	2	2	amnistii	2	0	2	2086
amoixarà	2	1	amoixara	2	0	1	2087
amoixirà	2	1	amoixira	2	0	1	2088
amoixà	2	1	amoixa	2	11	12	2089
amoixés	2	1	amoixes	2	0	1	2090
amoixí	2	0	amoixi	2	2	2	2091
amollarà	2	8	amollara	2	3	11	2092
amollà	2	41	amolla	2	162	203	2093
amollàrem	2	4	amollarem	2	8	12	2094
amollés	2	2	amolles	2	6	8	2095
amollí	2	1	amolli	2	18	19	2096
amollís	2	0	amollis	2	4	4	2097
amolà	2	0	amola	2	2	2	2098
amolés	2	0	amoles	2	1	1	2099
amolí	2	0	amoli	2	4	4	2100
amonedà	2	0	amoneda	2	3	3	2101
amonestarà	2	10	amonestara	2	0	10	2102
amonestà	2	10	amonesta	2	36	46	2103
amonestés	2	3	amonestes	2	2	5	2104
amonestí	2	0	amonesti	2	11	11	2105
amorosirà	2	3	amorosira	2	0	3	2106
amorosírem	2	0	amorosirem	2	1	1	2107
amorrallàreu	2	1	amorrallareu	2	0	1	2108
amorrà	2	3	amorra	2	84	87	2109
amorrés	2	1	amorres	2	2	3	2110
amorrí	2	1	amorri	2	3	4	2111
amortallà	2	12	amortalla	2	25	37	2112
amorterà	2	0	amortera	2	1	1	2113
amortirà	2	4	amortira	2	0	4	2114
amortitzarà	2	47	amortitzara	2	0	47	2115
amortitzà	2	0	amortitza	2	126	126	2116
amortitzàrem	2	0	amortitzarem	2	2	2	2117
amortitzàreu	2	0	amortitzareu	2	2	2	2118
amortitzés	2	0	amortitzes	2	11	11	2119
amortitzí	2	0	amortitzi	2	23	23	2120
amortà	2	0	amorta	2	1	1	2121
amortí	2	0	amorti	2	1	1	2122
amortís	2	1	amortis	2	0	1	2123
amorà	2	0	amora	2	9	9	2124
amorés	2	3	amores	2	459	462	2125
amorí	2	0	amori	2	15	15	2126
amotinà	2	8	amotina	2	17	25	2127
amotinés	2	2	amotines	2	0	2	2128
amotiní	2	0	amotini	2	1	1	2129
amotà	2	0	amota	2	1	1	2130
amoïnarà	2	3	amoïnara	2	0	3	2131
amoïnà	2	4	amoïna	2	441	445	2132
amoïnàrem	2	0	amoïnarem	2	2	2	2133
amoïnés	2	19	amoïnes	2	11	30	2134
amoïní	2	1	amoïni	2	83	84	2135
amplejà	2	0	ampleja	2	1	1	2136
ampliarà	2	2075	ampliara	2	29	2104	2137
amplificarà	2	28	amplificara	2	0	28	2138
amplificà	2	6	amplifica	2	424	430	2139
amplificàrem	2	0	amplificarem	2	2	2	2140
amplifiqués	2	6	amplifiques	2	1	7	2141
amplifiquí	2	0	amplifiqui	2	19	19	2142
amplià	2	732	amplia	2	13568	14300	2143
ampliàrem	2	2	ampliarem	2	438	440	2144
ampliàreu	2	0	ampliareu	2	7	7	2145
ampliés	2	245	amplies	2	625	870	2146
amplií	2	11	amplii	2	40	51	2147
amprarà	2	0	amprara	2	1	1	2148
amprà	2	0	ampra	2	10	10	2149
amprés	2	2	ampres	2	0	2	2150
amputarà	2	2	amputara	2	0	2	2151
amputà	2	4	amputa	2	31	35	2152
amputés	2	2	amputes	2	1	3	2153
amputí	2	0	amputi	2	3	3	2154
amullerarà	2	2	amullerara	2	0	2	2155
amullerà	2	4	amullera	2	3	7	2156
amullerí	2	0	amulleri	2	1	1	2157
amuntanyà	2	2	amuntanya	2	2	4	2158
amuntegarà	2	4	amuntegara	2	0	4	2159
amuntegués	2	2	amuntegues	2	6	8	2160
amunteguí	2	0	amuntegui	2	12	12	2161
amuntegà	2	5	amuntega	2	142	147	2162
amuntegàrem	2	0	amuntegarem	2	2	2	2163
amuntonarà	2	1	amuntonara	2	0	1	2164
amuntonà	2	0	amuntona	2	9	9	2165
amuradà	2	0	amurada	2	2	2	2166
amuradés	2	0	amurades	2	4	4	2167
amuradí	2	0	amuradi	2	1	1	2168
amurallà	2	0	amuralla	2	1	1	2169
amurà	2	0	amura	4	57	57	2170
amurés	2	0	amures	4	5	5	2171
amurí	2	0	amuri	2	1	1	2172
amussà	2	0	amussa	2	1	1	2173
amà	2	18	ama	4	998	1016	2174
amàrem	2	0	amarem	2	13	13	2175
amàreu	2	0	amareu	2	2	2	2176
amàssem	2	0	amassem	2	289	289	2177
amàsseu	2	0	amasseu	2	157	157	2178
amè	0	1542	ame	2	168	1710	2179
amé	0	103	ame	2	168	271	2180
amén	7	832	amen	2	264	1096	2181
amés	2	1081	ames	4	869	1950	2182
amí	2	31	ami	2	2751	2782	2183
anagramatitzí	2	1	anagramatitzi	2	0	1	2184
analitzarà	2	2221	analitzara	2	21	2242	2185
analitzà	2	180	analitza	2	14248	14428	2186
analitzàrem	2	20	analitzarem	2	1713	1733	2187
analitzàreu	2	0	analitzareu	2	10	10	2188
analitzés	2	122	analitzes	2	146	268	2189
analitzí	2	0	analitzi	2	734	734	2190
anastomosà	2	0	anastomosa	2	1	1	2191
anastomosí	2	0	anastomosi	2	39	39	2192
anatematitzà	2	0	anatematitza	2	3	3	2193
anatematitzí	2	0	anatematitzi	2	1	1	2194
anatomitzà	2	0	anatomitza	2	1	1	2195
ancorarà	2	5	ancorara	2	0	5	2196
ancorà	2	18	ancora	2	375	393	2197
ancoràrem	2	2	ancorarem	2	5	7	2198
ancoràreu	2	0	ancorareu	2	1	1	2199
ancorés	2	0	ancores	2	29	29	2200
ancorí	2	0	ancori	2	6	6	2201
andalusià	0	5	andalusia	4	9323	9328	2202
andanà	2	0	andana	4	2982	2982	2203
andanés	2	2	andanes	4	1684	1686	2204
andarejà	2	0	andareja	2	1	1	2205
andillà	0	0	andilla	4	156	156	2206
andoiàreu	2	0	andoiareu	2	2	2	2207
andà	4	5	anda	4	408	413	2208
anegarà	2	1	anegara	2	0	1	2209
anegà	2	3	anega	2	5	8	2210
anellarà	2	5	anellara	2	0	5	2211
anellà	2	0	anella	4	3543	3543	2212
anellàrem	2	21	anellarem	2	2	23	2213
anellés	2	0	anelles	4	1734	1734	2214
anellí	2	0	anelli	2	8	8	2215
anestesiarà	2	3	anestesiara	2	0	3	2216
anestesià	2	0	anestesia	2	184	184	2217
anestesiés	2	1	anestesies	2	3	4	2218
anestesií	2	0	anestesii	2	2	2	2219
anestèsia	4	1958	anestesia	2	184	2142	2220
anestèsies	4	19	anestesies	2	3	22	2221
angelicà	2	0	angelica	2	263	263	2222
angeliqués	2	0	angeliques	2	1	1	2223
angelitzarà	2	1	angelitzara	2	0	1	2224
angelitzà	2	0	angelitza	2	1	1	2225
angelitzés	2	0	angelitzes	2	1	1	2226
anglicitzí	2	0	anglicitzi	2	1	1	2227
anglés	0	4335	angles	4	5902	10237	2228
angoixarà	2	5	angoixara	2	0	5	2229
angoixà	2	2	angoixa	4	7132	7134	2230
angoixàrem	2	0	angoixarem	2	1	1	2231
angoixés	2	0	angoixes	4	1328	1328	2232
angoixí	2	0	angoixi	2	23	23	2233
anguilejà	2	1	anguileja	2	4	5	2234
anguillà	0	0	anguilla	4	263	263	2235
anguniejà	2	1	angunieja	2	23	24	2236
angunià	2	1	angunia	2	101	102	2237
anguniés	2	0	angunies	2	18	18	2238
angèliques	0	39	angeliques	2	1	40	2239
angúnia	4	657	angunia	2	101	758	2240
angúnies	4	200	angunies	2	18	218	2241
anhelarà	2	1	anhelara	2	2	3	2242
anhelà	2	1	anhela	2	492	493	2243
anhelàrem	2	0	anhelarem	2	2	2	2244
anhelés	2	1	anheles	2	42	43	2245
anhelí	2	2	anheli	2	20	22	2246
anihilarà	2	1	anihilara	2	0	1	2247
anihilà	2	11	anihila	2	32	43	2248
anihilàreu	2	0	anihilareu	2	1	1	2249
anihilés	2	2	anihiles	2	0	2	2250
animalitzarà	2	1	animalitzara	2	0	1	2251
animalitzà	2	0	animalitza	2	3	3	2252
animarà	2	583	animara	2	18	601	2253
animà	2	365	anima	2	9655	10020	2254
animàrem	2	9	animarem	2	113	122	2255
animàreu	2	1	animareu	2	27	28	2256
animés	2	204	animes	2	1439	1643	2257
animí	2	0	animi	2	949	949	2258
aniquilarà	2	9	aniquilara	2	0	9	2259
aniquilà	2	12	aniquila	2	102	114	2260
aniquilàrem	2	0	aniquilarem	2	2	2	2261
aniquilés	2	2	aniquiles	2	3	5	2262
aniquilí	2	0	aniquili	2	9	9	2263
anisà	2	1	anisa	2	10	11	2264
anisí	2	0	anisi	2	1	1	2265
anivellarà	2	20	anivellara	2	0	20	2266
anivellà	2	1	anivella	2	57	58	2267
anivellàrem	2	1	anivellarem	2	3	4	2268
anivellés	2	1	anivelles	2	3	4	2269
anivellí	2	0	anivelli	2	15	15	2270
annexarà	2	17	annexara	2	0	17	2271
annexionarà	2	12	annexionara	2	1	13	2272
annexionà	2	96	annexiona	2	50	146	2273
annexionés	2	19	annexiones	2	0	19	2274
annexioní	2	0	annexioni	2	4	4	2275
annexà	2	92	annexa	0	1990	2082	2276
annexàrem	2	0	annexarem	2	1	1	2277
annexés	2	7	annexes	0	1264	1271	2278
annexí	2	0	annexi	2	11	11	2279
anoditzà	2	0	anoditza	2	1	1	2280
anomenarà	2	559	anomenara	2	14	573	2281
anomenà	2	1512	anomena	2	21425	22937	2282
anomenàrem	2	15	anomenarem	2	528	543	2283
anomenàreu	2	3	anomenareu	2	5	8	2284
anomenés	2	167	anomenes	2	231	398	2285
anomení	2	5	anomeni	2	381	386	2286
anonimitzarà	2	3	anonimitzara	2	0	3	2287
anonimitzà	2	0	anonimitza	2	20	20	2288
anonimitzàrem	2	0	anonimitzarem	2	3	3	2289
anorrearà	2	7	anorreara	2	0	7	2290
anorreà	2	20	anorrea	2	51	71	2291
anorreàrem	2	0	anorrearem	2	2	2	2292
anorreés	2	2	anorrees	2	0	2	2293
anostrà	2	1	anostra	2	10	11	2294
anotarà	2	135	anotara	2	20	155	2295
anotà	2	121	anota	2	970	1091	2296
anotàrem	2	4	anotarem	2	70	74	2297
anotàreu	2	0	anotareu	2	9	9	2298
anotés	2	79	anotes	2	25	104	2299
anotí	2	1	anoti	2	95	96	2300
anquejà	2	0	anqueja	2	1	1	2301
anquilosà	2	0	anquilosa	2	6	6	2302
anquilosí	2	0	anquilosi	2	17	17	2303
ansarà	2	0	ansara	2	3	3	2304
ansiejà	2	0	ansieja	2	1	1	2305
ansià	2	2	ansia	2	115	117	2306
ansiés	2	0	ansies	2	73	73	2307
ansà	2	5	ansa	4	391	396	2308
ansés	2	0	anses	4	389	389	2309
ansí	2	5	ansi	4	238	243	2310
antecedirà	2	1	antecedira	2	0	1	2311
antellà	0	3	antella	4	417	420	2312
anteposarà	2	6	anteposara	2	0	6	2313
anteposà	2	2	anteposa	2	254	256	2314
anteposàrem	2	0	anteposarem	2	1	1	2315
anteposés	2	5	anteposes	2	0	5	2316
anteposí	2	0	anteposi	2	54	54	2317
anticiparà	2	22	anticipara	2	1	23	2318
anticipà	2	55	anticipa	2	856	911	2319
anticipàrem	2	0	anticiparem	2	7	7	2320
anticipés	2	20	anticipes	2	10	30	2321
anticipí	2	0	anticipi	2	79	79	2322
antologitzà	2	0	antologitza	2	1	1	2323
antropomorfitzà	2	0	antropomorfitza	2	4	4	2324
antrè	4	0	antre	4	181	181	2325
antré	4	0	antre	4	181	181	2326
antullà	2	0	antulla	2	108	108	2327
antullí	2	0	antulli	2	7	7	2328
antílop	4	202	antilop	4	5	207	2329
antílops	4	222	antilops	4	10	232	2330
anul·larà	2	231	anul·lara	2	16	247	2331
anul·là	2	130	anul·la	2	1894	2024	2332
anul·làrem	2	0	anul·larem	2	22	22	2333
anul·lés	2	159	anul·les	2	11	170	2334
anul·lí	2	0	anul·li	2	414	414	2335
anunciarà	2	1346	anunciara	2	102	1448	2336
anuncià	2	1605	anuncia	2	10843	12448	2337
anunciàrem	2	30	anunciarem	2	513	543	2338
anunciàreu	2	0	anunciareu	2	3	3	2339
anunciés	2	812	anuncies	2	65	877	2340
anuncií	2	7	anuncii	2	34	41	2341
anyellà	2	0	anyella	4	95	95	2342
anyellàrem	2	0	anyellarem	2	1	1	2343
anyellés	2	0	anyelles	4	3	3	2344
anàstasi	4	6	anastasi	4	618	624	2345
anàstasis	4	0	anastasis	4	3	3	2346
anés	2	6251	anes	4	154	6405	2347
aní	2	97	ani	4	327	424	2348
anòmia	4	42	anomia	4	61	103	2349
anòmies	4	4	anomies	4	0	4	2350
aombrarà	2	4	aombrara	2	0	4	2351
aombrà	2	1	aombra	2	25	26	2352
aombrés	2	3	aombres	2	1	4	2353
aombrí	2	0	aombri	2	4	4	2354
apadrinarà	2	61	apadrinara	2	0	61	2355
apadrinà	2	21	apadrina	2	409	430	2356
apadrinàrem	2	0	apadrinarem	2	9	9	2357
apadrinàreu	2	0	apadrinareu	2	3	3	2358
apadrinés	2	10	apadrines	2	14	24	2359
apadriní	2	0	apadrini	2	19	19	2360
apagarà	2	189	apagara	2	11	200	2361
apagués	2	77	apagues	2	75	152	2362
apaguí	2	1	apagui	2	352	353	2363
apagà	2	56	apaga	2	1458	1514	2364
apagàrem	2	0	apagarem	2	47	47	2365
apagàreu	2	0	apagareu	2	5	5	2366
apaivagarà	2	20	apaivagara	2	0	20	2367
apaivagués	2	9	apaivagues	2	0	9	2368
apaivaguí	2	0	apaivagui	2	21	21	2369
apaivagà	2	19	apaivaga	2	110	129	2370
apaivagàreu	2	0	apaivagareu	2	1	1	2371
apalancà	2	0	apalanca	2	12	12	2372
apalanqués	2	1	apalanques	2	2	3	2373
apalanquí	2	0	apalanqui	2	2	2	2374
apallerarà	2	0	apallerara	2	1	1	2375
apalleronàreu	2	1	apalleronareu	2	0	1	2376
apalleràreu	2	1	apallerareu	2	0	1	2377
apallissarà	2	6	apallissara	2	1	7	2378
apallissà	2	8	apallissa	2	73	81	2379
apallissàrem	2	0	apallissarem	2	1	1	2380
apallissés	2	4	apallisses	2	1	5	2381
apallissí	2	0	apallissi	2	4	4	2382
apallàrem	2	1	apallarem	2	0	1	2383
apamà	2	0	apama	2	40	40	2384
apamàrem	2	0	apamarem	2	1	1	2385
apamés	2	0	apames	2	2	2	2386
apamí	2	0	apami	2	2	2	2387
apanyarà	2	9	apanyara	2	1	10	2388
apanyà	2	3	apanya	2	62	65	2389
apanyàrem	2	1	apanyarem	2	16	17	2390
apanyàreu	2	0	apanyareu	2	5	5	2391
apanyés	2	0	apanyes	2	13	13	2392
apanyí	2	0	apanyi	2	11	11	2393
apanà	2	0	apana	2	4	4	2394
apanàrem	2	0	apanarem	2	1	1	2395
apanàreu	2	1	apanareu	2	0	1	2396
apanés	2	0	apanes	2	1	1	2397
apaní	2	0	apani	2	1	1	2398
aparaulà	2	0	aparaula	2	28	28	2399
aparaulés	2	1	aparaules	2	0	1	2400
aparaulí	2	0	aparauli	2	1	1	2401
aparcarà	2	30	aparcara	2	2	32	2402
aparcà	2	16	aparca	2	658	674	2403
aparcàrem	2	5	aparcarem	2	155	160	2404
aparcàreu	2	0	aparcareu	2	3	3	2405
aparedà	2	1	apareda	2	3	4	2406
aparedí	2	0	aparedi	2	2	2	2407
aparegués	2	850	aparegues	2	9	859	2408
apareguí	2	1	aparegui	2	3645	3646	2409
aparellarà	2	10	aparellara	2	0	10	2410
aparellà	2	7	aparella	2	161	168	2411
aparellàrem	2	1	aparellarem	2	0	1	2412
aparellés	2	10	aparelles	2	22	32	2413
aparellí	2	0	aparelli	2	8	8	2414
aparencés	2	0	aparences	4	1832	1832	2415
aparencí	2	0	aparenci	2	3	3	2416
aparentarà	2	3	aparentara	2	1	4	2417
aparentà	2	3	aparenta	2	416	419	2418
aparentàrem	2	0	aparentarem	2	1	1	2419
aparentés	2	5	aparentes	2	18	23	2420
aparentí	2	0	aparenti	2	29	29	2421
aparençarà	2	1	aparençara	2	1	2	2422
aparençà	2	0	aparença	4	11162	11162	2423
aparençàrem	2	1	aparençarem	2	0	1	2424
aparià	2	0	aparia	2	13	13	2425
apariàreu	2	1	apariareu	2	0	1	2426
apariés	2	1	aparies	2	1	2	2427
aparqués	2	28	aparques	2	75	103	2428
aparquí	2	2	aparqui	2	93	95	2429
aparroquianà	2	0	aparroquiana	2	1	1	2430
aparroquià	2	0	aparroquia	2	1	1	2431
apartarà	2	80	apartara	2	8	88	2432
apartà	2	145	aparta	2	1230	1375	2433
apartàrem	2	0	apartarem	2	29	29	2434
apartàreu	2	0	apartareu	2	2	2	2435
apartés	2	121	apartes	2	55	176	2436
apartí	2	3	aparti	2	297	300	2437
aparés	2	0	apares	2	1	1	2438
aparí	2	0	apari	2	4	4	2439
aparíeu	2	0	aparieu	2	1	1	2440
apassionarà	2	39	apassionara	2	2	41	2441
apassionà	2	26	apassiona	2	2775	2801	2442
apassionàreu	2	0	apassionareu	2	2	2	2443
apassionés	2	11	apassiones	2	5	16	2444
apassioní	2	0	apassioni	2	139	139	2445
apassà	2	1	apassa	2	1	2	2446
apedacés	2	0	apedaces	2	1	1	2447
apedací	2	0	apedaci	2	4	4	2448
apedaçarà	2	1	apedaçara	2	0	1	2449
apedaçà	2	0	apedaça	2	16	16	2450
apedaçàrem	2	0	apedaçarem	2	1	1	2451
apedregués	2	3	apedregues	2	4	7	2452
apedreguí	2	0	apedregui	2	3	3	2453
apedregà	2	2	apedrega	2	10	12	2454
apedregàrem	2	1	apedregarem	2	0	1	2455
apedregàreu	2	0	apedregareu	2	1	1	2456
apegarà	2	3	apegara	2	1	4	2457
apegués	2	2	apegues	2	4	6	2458
apeguí	2	0	apegui	2	5	5	2459
apegà	2	0	apega	2	58	58	2460
apegàrem	2	0	apegarem	2	1	1	2461
apeixirà	2	0	apeixira	2	1	1	2462
apeixà	2	0	apeixa	2	3	3	2463
apeixí	2	1	apeixi	2	0	1	2464
apelfàreu	2	0	apelfareu	2	1	1	2465
apellà	2	3	apella	2	14	17	2466
apellés	2	0	apelles	2	1	1	2467
apellí	2	0	apelli	2	1	1	2468
apel·larà	2	53	apel·lara	2	0	53	2469
apel·là	2	46	apel·la	4	1631	1677	2470
apel·làrem	2	2	apel·larem	2	25	27	2471
apel·lés	2	15	apel·les	4	988	1003	2472
apel·lí	2	2	apel·li	2	74	76	2473
apenà	2	0	apena	2	11	11	2474
apenés	2	0	apenes	2	505	505	2475
apercebré	2	0	apercebre	2	12	12	2476
apercebí	2	0	apercebi	2	1	1	2477
apergaminà	2	0	apergamina	2	1	1	2478
apesararà	2	1	apesarara	2	0	1	2479
apesarà	2	0	apesara	2	36	36	2480
apesarí	2	0	apesari	2	1	1	2481
apetirà	2	1	apetira	2	0	1	2482
apetità	2	0	apetita	2	13	13	2483
apetités	2	0	apetites	2	1	1	2484
apetíreu	2	0	apetireu	2	1	1	2485
apiadarà	2	21	apiadara	2	1	22	2486
apiadà	2	13	apiada	2	28	41	2487
apiadés	2	5	apiades	2	1	6	2488
apiadí	2	0	apiadi	2	29	29	2489
apianà	2	0	apiana	2	8	8	2490
apianés	2	0	apianes	2	1	1	2491
apilarà	2	1	apilara	2	0	1	2492
apilonà	2	0	apilona	2	8	8	2493
apilonàrem	2	0	apilonarem	2	1	1	2494
apilotà	2	3	apilota	2	5	8	2495
apilà	2	12	apila	2	124	136	2496
apilàrem	2	0	apilarem	2	3	3	2497
apilàreu	2	0	apilareu	2	1	1	2498
apilés	2	1	apiles	2	4	5	2499
apilí	2	0	apili	2	5	5	2500
apinyà	2	0	apinya	2	9	9	2501
apirrossarà	2	0	apirrossara	2	1	1	2502
apitxà	2	1	apitxa	2	4	5	2503
aplacarà	2	4	aplacara	2	0	4	2504
aplacà	2	4	aplaca	2	34	38	2505
aplacàrem	2	0	aplacarem	2	1	1	2506
aplacés	2	6	aplaces	2	1	7	2507
aplací	2	0	aplaci	2	5	5	2508
aplanarà	2	60	aplanara	2	0	60	2509
aplantillà	2	0	aplantilla	2	1	1	2510
aplanà	2	17	aplana	2	462	479	2511
aplanàrem	2	0	aplanarem	2	35	35	2512
aplanàreu	2	0	aplanareu	2	2	2	2513
aplançonés	2	0	aplançones	2	1	1	2514
aplanés	2	5	aplanes	2	4	9	2515
aplaní	2	1	aplani	2	51	52	2516
aplaqués	2	2	aplaques	2	1	3	2517
aplaquí	2	0	aplaqui	2	6	6	2518
aplatarà	2	1	aplatara	2	0	1	2519
aplatà	2	0	aplata	2	2	2	2520
aplatés	2	1	aplates	2	0	1	2521
aplaudirà	2	39	aplaudira	2	3	42	2522
aplaudírem	2	5	aplaudirem	2	29	34	2523
aplaudíreu	2	1	aplaudireu	2	0	1	2524
aplaçarà	2	6	aplaçara	2	1	7	2525
aplaçà	2	3	aplaça	2	62	65	2526
aplaçàrem	2	0	aplaçarem	2	2	2	2527
aplegarà	2	861	aplegara	2	23	884	2528
aplegués	2	69	aplegues	4	30	99	2529
apleguí	2	6	aplegui	2	238	244	2530
aplegà	2	494	aplega	4	7477	7971	2531
aplegàrem	2	43	aplegarem	2	105	148	2532
aplegàreu	2	0	aplegareu	2	3	3	2533
apletà	2	0	apleta	2	3	3	2534
apletàreu	2	1	apletareu	2	0	1	2535
aplicarà	2	5465	aplicara	2	66	5531	2536
aplicà	2	483	aplica	2	20536	21019	2537
aplicàrem	2	8	aplicarem	2	620	628	2538
aplicàreu	2	1	aplicareu	2	18	19	2539
apliqués	2	672	apliques	2	173	845	2540
apliquí	2	1	apliqui	2	3880	3881	2541
aplomà	2	0	aploma	2	3	3	2542
apocopà	2	0	apocopa	2	1	1	2543
apocopí	2	0	apocopi	2	1	1	2544
apocà	2	0	apoca	2	46	46	2545
apoderarà	2	42	apoderara	2	1	43	2546
apoderà	2	270	apodera	2	786	1056	2547
apoderàrem	2	0	apoderarem	2	7	7	2548
apoderés	2	51	apoderes	2	3	54	2549
apoderí	2	0	apoderi	2	176	176	2550
apollegà	2	0	apollega	2	1	1	2551
apologitzà	2	0	apologitza	2	2	2	2552
apoltronà	2	0	apoltrona	2	3	3	2553
apoltronés	2	0	apoltrones	2	2	2	2554
apoltroní	2	0	apoltroni	2	1	1	2555
apomarà	2	1	apomara	2	0	1	2556
apomellés	2	0	apomelles	2	1	1	2557
apomà	2	0	apoma	2	1	1	2558
aponí	2	0	aponi	2	2	2	2559
apoquinà	2	0	apoquina	2	1	1	2560
apoqués	2	1	apoques	2	4	5	2561
aporrinà	2	0	aporrina	2	1	1	2562
aporrinés	2	1	aporrines	2	0	1	2563
aportarà	2	4233	aportara	2	43	4276	2564
aportà	2	549	aporta	2	28510	29059	2565
aportàrem	2	12	aportarem	2	259	271	2566
aportàreu	2	0	aportareu	2	22	22	2567
aportés	2	320	aportes	2	241	561	2568
aportí	2	0	aporti	2	2809	2809	2569
aposentà	2	0	aposenta	2	10	10	2570
aposentàrem	2	0	aposentarem	2	1	1	2571
aposentí	2	0	aposenti	2	3	3	2572
apostarà	2	375	apostara	2	7	382	2573
apostatarà	2	1	apostatara	2	0	1	2574
apostatà	2	3	apostata	2	8	11	2575
apostatàrem	2	0	apostatarem	2	1	1	2576
apostatés	2	0	apostates	2	6	6	2577
apostatí	2	0	apostati	2	1	1	2578
apostemés	2	0	apostemes	4	1	1	2579
apostrofà	2	0	apostrofa	2	100	100	2580
apostrofàrem	2	0	apostrofarem	2	3	3	2581
apostrofés	2	0	apostrofes	2	1	1	2582
apostrofí	2	0	apostrofi	2	1	1	2583
apostà	2	119	aposta	4	40667	40786	2584
apostàrem	2	15	apostarem	2	178	193	2585
apostàreu	2	0	apostareu	2	1	1	2586
apostés	2	120	apostes	4	4878	4998	2587
apostí	2	1	aposti	2	923	924	2588
aposà	2	0	aposa	2	1	1	2589
aposí	2	0	aposi	2	2	2	2590
apotecària	4	13	apotecaria	4	72	85	2591
apotecàries	4	4	apotecaries	4	16	20	2592
apradà	2	0	aprada	2	2	2	2593
apradés	2	0	aprades	2	2	2	2594
apreciarà	2	131	apreciara	2	4	135	2595
aprecià	2	42	aprecia	2	3565	3607	2596
apreciàrem	2	1	apreciarem	2	109	110	2597
apreciàreu	2	1	apreciareu	2	53	54	2598
apreciés	2	39	aprecies	2	131	170	2599
aprecií	2	4	aprecii	2	27	31	2600
apregonà	2	0	apregona	2	6	6	2601
aprehendré	2	0	aprehendre	2	140	140	2602
aprehenguí	2	0	aprehengui	2	1	1	2603
aprendré	2	159	aprendre	2	86809	86968	2604
aprengués	2	243	aprengues	2	13	256	2605
aprenguí	2	9	aprengui	2	1603	1612	2606
apressarà	2	5	apressara	2	1	6	2607
apressà	2	41	apressa	2	180	221	2608
apressàrem	2	2	apressarem	2	0	2	2609
apressés	2	1	apresses	2	37	38	2610
apressí	2	0	apressi	2	16	16	2611
aprestarà	2	1	aprestara	2	0	1	2612
aprestà	2	0	apresta	2	22	22	2613
aprestés	2	3	aprestes	2	0	3	2614
aprestí	2	0	apresti	2	2	2	2615
apretarà	2	18	apretara	2	3	21	2616
apretà	2	15	apreta	2	678	693	2617
apretàrem	2	1	apretarem	2	24	25	2618
apretés	2	17	apretes	2	82	99	2619
apretí	2	0	apreti	2	86	86	2620
apreuà	2	0	apreua	2	1	1	2621
aprimarà	2	14	aprimara	2	0	14	2622
aprimà	2	5	aprima	2	193	198	2623
aprimàrem	2	0	aprimarem	2	6	6	2624
aprimés	2	5	aprimes	2	14	19	2625
aprimí	2	0	aprimi	2	23	23	2626
aprisià	2	1	aprisia	2	0	1	2627
aprisió	4	27	aprisio	2	5	32	2628
aprofitarà	2	1640	aprofitara	2	27	1667	2629
aprofità	2	909	aprofita	2	11316	12225	2630
aprofitàrem	2	137	aprofitarem	2	1828	1965	2631
aprofitàreu	2	3	aprofitareu	2	44	47	2632
aprofités	2	311	aprofites	2	274	585	2633
aprofití	2	5	aprofiti	2	2443	2448	2634
aprofitó	4	1	aprofito	2	5048	5049	2635
aprofundirà	2	555	aprofundira	2	4	559	2636
aprofundírem	2	3	aprofundirem	2	443	446	2637
aprofundíreu	2	0	aprofundireu	2	6	6	2638
aproparà	2	686	apropara	2	24	710	2639
apropiarà	2	19	apropiara	2	4	23	2640
apropinquà	2	0	apropinqua	2	1	1	2641
apropià	2	49	apropia	2	373	422	2642
apropiàrem	2	1	apropiarem	2	4	5	2643
apropiés	2	38	apropies	2	6	44	2644
apropií	2	3	apropii	2	8	11	2645
apropà	2	274	apropa	2	9189	9463	2646
apropàrem	2	11	aproparem	2	466	477	2647
apropàreu	2	0	apropareu	2	20	20	2648
apropés	2	174	apropes	2	222	396	2649
apropí	2	2	apropi	2	768	770	2650
aprovarà	2	2770	aprovara	2	120	2890	2651
aprovisionarà	2	3	aprovisionara	2	0	3	2652
aprovisionà	2	3	aprovisiona	2	26	29	2653
aprovisionàrem	2	1	aprovisionarem	2	0	1	2654
aprovisioní	2	0	aprovisioni	2	1	1	2655
aprovà	2	2175	aprova	2	18293	20468	2656
aprovàrem	2	42	aprovarem	2	521	563	2657
aprovàreu	2	2	aprovareu	2	6	8	2658
aprovés	2	1529	aproves	2	91	1620	2659
aproví	2	5	aprovi	2	4468	4473	2660
aproximarà	2	125	aproximara	2	4	129	2661
aproximà	2	43	aproxima	2	1973	2016	2662
aproximàrem	2	3	aproximarem	2	128	131	2663
aproximàreu	2	0	aproximareu	2	2	2	2664
aproximés	2	32	aproximes	2	19	51	2665
aproximí	2	1	aproximi	2	207	208	2666
aprísies	4	1	aprisies	2	0	1	2667
apugés	2	35	apuges	2	17	52	2668
apugí	2	0	apugi	2	69	69	2669
apujarà	2	144	apujara	2	0	144	2670
apujà	2	29	apuja	2	518	547	2671
apujàrem	2	3	apujarem	2	16	19	2672
apujàreu	2	0	apujareu	2	2	2	2673
apuntalarà	2	15	apuntalara	2	1	16	2674
apuntalà	2	4	apuntala	2	147	151	2675
apuntalàrem	2	0	apuntalarem	2	2	2	2676
apuntalés	2	7	apuntales	2	7	14	2677
apuntalí	2	0	apuntali	2	16	16	2678
apuntarà	2	180	apuntara	2	13	193	2679
apuntà	2	339	apunta	2	19748	20087	2680
apuntàrem	2	8	apuntarem	2	111	119	2681
apuntàreu	2	4	apuntareu	2	17	21	2682
apuntés	2	138	apuntes	2	1005	1143	2683
apuntí	2	0	apunti	2	664	664	2684
apunyalarà	2	6	apunyalara	2	1	7	2685
apunyalà	2	12	apunyala	2	103	115	2686
apunyalàrem	2	0	apunyalarem	2	3	3	2687
apunyalés	2	14	apunyales	2	5	19	2688
apunyalí	2	0	apunyali	2	1	1	2689
apurarà	2	3	apurara	2	1	4	2690
apurà	2	1	apura	2	68	69	2691
apuràrem	2	0	apurarem	2	2	2	2692
apurés	2	0	apures	2	82	82	2693
apurí	2	0	apuri	2	4	4	2694
apòcope	4	24	apocope	2	0	24	2695
apòcopes	4	2	apocopes	2	0	2	2696
apòria	4	0	aporia	4	86	86	2697
apòries	4	1	apories	4	32	33	2698
apòstata	0	149	apostata	2	8	157	2699
apòstates	0	59	apostates	2	6	65	2700
apòstrof	4	348	apostrof	2	15	363	2701
apòstrofe	4	13	apostrofe	2	3	16	2702
apòstrofes	4	2	apostrofes	2	1	3	2703
aquarterà	2	1	aquartera	2	3	4	2704
aquedarà	2	0	aquedara	2	1	1	2705
aquedà	2	1	aqueda	2	2	3	2706
aqueferà	2	1	aquefera	2	0	1	2707
aquietarà	2	1	aquietara	2	0	1	2708
aquietà	2	2	aquieta	2	22	24	2709
aquilotà	2	0	aquilota	2	1	1	2710
aquissarà	2	1	aquissara	2	0	1	2711
aquissà	2	0	aquissa	2	2	2	2712
aquissés	2	0	aquisses	2	1	1	2713
aquistà	2	0	aquista	2	10	10	2714
aquistés	2	0	aquistes	2	4	4	2715
aquós	0	292	aquos	4	12	304	2716
arabitzà	2	6	arabitza	2	0	6	2717
araucà	0	9	arauca	4	20	29	2718
arbitrarà	2	48	arbitrara	2	0	48	2719
arbitrà	2	26	arbitra	2	70	96	2720
arbitràrem	2	0	arbitrarem	2	1	1	2721
arbitrària	0	1816	arbitraria	2	112	1928	2722
arbitràries	0	1011	arbitraries	2	30	1041	2723
arbitrés	2	11	arbitres	2	236	247	2724
arbitrí	2	0	arbitri	2	337	337	2725
arborarà	2	0	arborara	2	1	1	2726
arborà	2	5	arbora	2	38	43	2727
arborés	2	0	arbores	2	10	10	2728
arborí	2	0	arbori	2	286	286	2729
arbrà	2	0	arbra	2	17	17	2730
arbrés	2	4	arbres	2	37447	37451	2731
arbrí	2	0	arbri	2	1	1	2732
arcarà	2	1	arcara	2	0	1	2733
arcà	2	142	arca	4	2450	2592	2734
areguí	2	0	aregui	2	3	3	2735
aregà	2	0	arega	0	2	2	2736
arengarà	2	2	arengara	2	0	2	2737
arengués	2	1	arengues	4	132	133	2738
arenguí	2	0	arengui	2	1	1	2739
arengà	2	15	arenga	4	221	236	2740
arenosòls	4	0	arenosols	4	1	1	2741
arenà	2	0	arena	4	7524	7524	2742
arenària	4	3	arenaria	2	49	52	2743
arenés	2	1	arenes	4	1524	1525	2744
arení	2	0	areni	2	9	9	2745
argeletà	0	0	argeleta	4	22	22	2746
argentà	2	0	argenta	4	65	65	2747
argentés	2	1	argentes	2	0	1	2748
argentí	2	6583	argenti	2	43	6626	2749
argilà	2	2	argila	4	3668	3670	2750
argilés	2	163	argiles	4	966	1129	2751
argilí	2	0	argili	2	3	3	2752
argollà	2	0	argolla	4	136	136	2753
argollés	2	0	argolles	4	109	109	2754
arguellés	2	0	arguelles	2	5	5	2755
argumentarà	2	47	argumentara	2	2	49	2756
argumentà	2	180	argumenta	2	4099	4279	2757
argumentàrem	2	3	argumentarem	2	10	13	2758
argumentàreu	2	0	argumentareu	2	1	1	2759
argumentés	2	21	argumentes	2	36	57	2760
argumentí	2	0	argumenti	2	108	108	2761
argüírem	2	2	argüirem	2	1	3	2762
arlès	0	21	arles	4	889	910	2763
arlés	0	37	arles	4	889	926	2764
armarà	2	17	armara	2	2	19	2765
armà	2	55	arma	4	11771	11826	2766
armàrem	2	2	armarem	2	4	6	2767
armèria	4	4	armeria	4	225	229	2768
armèries	4	0	armeries	4	57	57	2769
armés	2	21	armes	4	36687	36708	2770
armí	2	1	armi	2	59	60	2771
armó	4	14	armo	2	16	30	2772
arnià	2	0	arnia	2	4	4	2773
arnà	2	1	arna	4	274	275	2774
arnès	4	473	arnes	4	1592	2065	2775
arnés	2	476	arnes	4	1592	2068	2776
arní	2	0	arni	2	28	28	2777
aromatitzarà	2	10	aromatitzara	2	0	10	2778
aromatitzà	2	0	aromatitza	2	68	68	2779
aromatitzàrem	2	0	aromatitzarem	2	4	4	2780
aromatitzés	2	1	aromatitzes	2	0	1	2781
aromatitzí	2	0	aromatitzi	2	13	13	2782
aromà	2	2	aroma	4	7995	7997	2783
aromés	2	1	aromes	4	8456	8457	2784
aromí	2	17	aromi	2	6	23	2785
arpegí	2	0	arpegi	4	73	73	2786
arpejàrem	2	1	arpejarem	2	0	1	2787
arpellejàreu	2	0	arpellejareu	2	1	1	2788
arpellà	2	0	arpella	4	192	192	2789
arpellés	2	0	arpelles	4	52	52	2790
arpillerà	2	0	arpillera	4	189	189	2791
arpillerés	2	0	arpilleres	4	404	404	2792
arpà	2	0	arpa	4	2884	2884	2793
arpés	2	1	arpes	4	330	331	2794
arpó	4	134	arpo	2	2	136	2795
arquegés	2	1	arqueges	2	14	15	2796
arquegí	2	0	arquegi	2	1	1	2797
arquejarà	2	1	arquejara	2	0	1	2798
arquejà	2	1	arqueja	2	49	50	2799
arqués	2	258	arques	4	3513	3771	2800
arquí	2	0	arqui	2	10	10	2801
arrabassarà	2	15	arrabassara	2	1	16	2802
arrabassà	2	55	arrabassa	2	163	218	2803
arrabassàrem	2	0	arrabassarem	2	1	1	2804
arrabassés	2	16	arrabasses	2	0	16	2805
arrabassí	2	0	arrabassi	2	35	35	2806
arraconarà	2	8	arraconara	2	1	9	2807
arraconà	2	16	arracona	2	165	181	2808
arraconàrem	2	0	arraconarem	2	3	3	2809
arraconés	2	9	arracones	2	4	13	2810
arraconí	2	0	arraconi	2	18	18	2811
arramadà	2	0	arramada	2	1	1	2812
arramassà	2	0	arramassa	2	3	3	2813
arramassés	2	1	arramasses	2	0	1	2814
arramblarà	2	1	arramblara	2	0	1	2815
arramblà	2	1	arrambla	2	3	4	2816
arramblés	2	0	arrambles	2	3	3	2817
arramblí	2	0	arrambli	2	1	1	2818
arrambà	2	2	arramba	2	27	29	2819
arrambàrem	2	0	arrambarem	2	2	2	2820
arrambàreu	2	0	arrambareu	2	1	1	2821
arrambés	2	3	arrambes	2	0	3	2822
arrambí	2	0	arrambi	2	2	2	2823
arranarà	2	1	arranara	2	0	1	2824
arrancarà	2	605	arrancara	2	17	622	2825
arrancà	2	127	arranca	2	1957	2084	2826
arrancàrem	2	6	arrancarem	2	36	42	2827
arrancàreu	2	0	arrancareu	2	1	1	2828
arrangés	2	18	arranges	2	3	21	2829
arrangí	2	0	arrangi	2	16	16	2830
arranjarà	2	89	arranjara	2	0	89	2831
arranjà	2	50	arranja	2	151	201	2832
arranjàrem	2	0	arranjarem	2	10	10	2833
arranjàreu	2	0	arranjareu	2	1	1	2834
arranqués	2	39	arranques	2	20	59	2835
arranquí	2	0	arranqui	2	125	125	2836
arranà	2	0	arrana	2	9	9	2837
arranés	2	1	arranes	2	0	1	2838
arraparà	2	1	arrapara	2	0	1	2839
arrapà	2	8	arrapa	2	164	172	2840
arrapàrem	2	1	arraparem	2	2	3	2841
arrapés	2	3	arrapes	2	10	13	2842
arrapí	2	0	arrapi	2	10	10	2843
arrapís	2	0	arrapis	2	2	2	2844
arrasarà	2	41	arrasara	2	1	42	2845
arrastellà	2	1	arrastella	2	0	1	2846
arrastrarà	2	8	arrastrara	2	2	10	2847
arrastrà	2	8	arrastra	2	140	148	2848
arrastràrem	2	0	arrastrarem	2	6	6	2849
arrastrés	2	1	arrastres	2	19	20	2850
arrastrí	2	0	arrastri	2	13	13	2851
arrasà	2	80	arrasa	2	406	486	2852
arrasàrem	2	0	arrasarem	2	5	5	2853
arrasàreu	2	0	arrasareu	2	2	2	2854
arrasés	2	33	arrases	2	3	36	2855
arrasí	2	0	arrasi	2	32	32	2856
arraulirà	2	1	arraulira	2	0	1	2857
arraulírem	2	2	arraulirem	2	0	2	2858
arravatà	2	2	arravata	2	5	7	2859
arravatés	2	1	arravates	2	0	1	2860
arraïmarà	2	0	arraïmara	2	1	1	2861
arraïmà	2	0	arraïma	2	4	4	2862
arrebossarà	2	1	arrebossara	2	0	1	2863
arrebossà	2	4	arrebossa	2	57	61	2864
arrebossàrem	2	0	arrebossarem	2	46	46	2865
arrebossàreu	2	0	arrebossareu	2	2	2	2866
arrebossés	2	0	arrebosses	2	8	8	2867
arrebossí	2	0	arrebossi	2	2	2	2868
arrecerarà	2	1	arrecerara	2	0	1	2869
arrecerà	2	3	arrecera	2	62	65	2870
arrecerés	2	0	arreceres	2	1	1	2871
arrecerí	2	0	arreceri	2	4	4	2872
arredonirà	2	4	arredonira	2	0	4	2873
arredonírem	2	0	arredonirem	2	1	1	2874
arredossà	2	0	arredossa	2	2	2	2875
arreglarà	2	414	arreglara	2	10	424	2876
arreglà	2	29	arregla	2	1128	1157	2877
arreglàrem	2	2	arreglarem	2	219	221	2878
arreglàreu	2	0	arreglareu	2	4	4	2879
arreglés	2	93	arregles	2	64	157	2880
arreglí	2	0	arregli	2	398	398	2881
arregussarà	2	0	arregussara	2	1	1	2882
arregussà	2	0	arregussa	2	1	1	2883
arrelarà	2	35	arrelara	2	3	38	2884
arrelà	2	75	arrela	2	916	991	2885
arrelàrem	2	0	arrelarem	2	2	2	2886
arrelés	2	48	arreles	2	9	57	2887
arrelí	2	0	arreli	2	175	175	2888
arremangarà	2	2	arremangara	2	0	2	2889
arremangués	2	1	arremangues	2	7	8	2890
arremanguí	2	0	arremangui	2	23	23	2891
arremangà	2	4	arremanga	2	28	32	2892
arremangàrem	2	0	arremangarem	2	3	3	2893
arremetré	2	1	arremetre	2	144	145	2894
arremetés	2	1	arremetes	2	0	1	2895
arremetí	2	0	arremeti	2	5	5	2896
arremolinarà	2	1	arremolinara	2	0	1	2897
arremolinà	2	0	arremolina	2	27	27	2898
arrencarà	2	1666	arrencara	2	2	1668	2899
arrencà	2	165	arrenca	2	7097	7262	2900
arrencàrem	2	3	arrencarem	2	52	55	2901
arrendarà	2	16	arrendara	2	5	21	2902
arrendà	2	32	arrenda	2	57	89	2903
arrendàrem	2	0	arrendarem	2	2	2	2904
arrendés	2	2	arrendes	2	3	5	2905
arrendí	2	0	arrendi	2	4	4	2906
arrenglarà	2	3	arrenglara	2	0	3	2907
arrenglerarà	2	2	arrenglerara	2	0	2	2908
arrenglerà	2	39	arrenglera	2	50	89	2909
arrenglerés	2	2	arrengleres	2	2	4	2910
arrenglerí	2	0	arrengleri	2	11	11	2911
arrenglà	2	3	arrengla	2	2	5	2912
arrenglàrem	2	0	arrenglarem	2	1	1	2913
arrengués	2	0	arrengues	2	1	1	2914
arrenguí	2	0	arrengui	2	6	6	2915
arrengà	2	1	arrenga	2	1	2	2916
arrenqués	2	78	arrenques	2	46	124	2917
arrenquí	2	0	arrenqui	2	1104	1104	2918
arrepapà	2	1	arrepapa	2	6	7	2919
arrepengés	2	1	arrepenges	2	1	2	2920
arrepengí	2	0	arrepengi	2	1	1	2921
arrepenjarà	2	0	arrepenjara	2	1	1	2922
arrepenjà	2	3	arrepenja	2	25	28	2923
arreplegarà	2	141	arreplegara	2	16	157	2924
arreplegués	2	15	arreplegues	4	25	40	2925
arrepleguí	2	0	arreplegui	2	33	33	2926
arreplegà	2	135	arreplega	4	2127	2262	2927
arreplegàrem	2	10	arreplegarem	2	27	37	2928
arreplegàreu	2	1	arreplegareu	2	1	2	2929
arreplegó	4	0	arreplego	2	36	36	2930
arrestarà	2	5	arrestara	2	0	5	2931
arrestà	2	33	arresta	2	73	106	2932
arrestàrem	2	0	arrestarem	2	3	3	2933
arrestàreu	2	0	arrestareu	2	2	2	2934
arrestés	2	17	arrestes	2	5	22	2935
arrestí	2	0	arresti	2	20	20	2936
arreà	2	2	arrea	2	15	17	2937
arreés	2	1	arrees	2	4	5	2938
arreí	2	0	arrei	4	1	1	2939
arriarà	2	5	arriara	2	0	5	2940
arribarà	2	14503	arribara	2	474	14977	2941
arribà	2	8954	arriba	2	108095	117049	2942
arribàrem	2	565	arribarem	2	6590	7155	2943
arribàreu	2	6	arribareu	2	1345	1351	2944
arribés	2	4861	arribes	2	3366	8227	2945
arribí	2	25	arribi	2	18688	18713	2946
arrimarà	2	0	arrimara	2	3	3	2947
arrimà	2	7	arrima	2	113	120	2948
arrimàrem	2	3	arrimarem	2	1	4	2949
arrimés	2	0	arrimes	2	2	2	2950
arriscarà	2	56	arriscara	2	1	57	2951
arriscà	2	25	arrisca	2	856	881	2952
arriscàrem	2	1	arriscarem	2	27	28	2953
arriscàreu	2	0	arriscareu	2	1	1	2954
arrisqués	2	28	arrisques	2	118	146	2955
arrisquí	2	0	arrisqui	2	97	97	2956
arrissarà	2	2	arrissara	2	0	2	2957
arrissà	2	0	arrissa	2	34	34	2958
arrissí	2	0	arrissi	2	17	17	2959
arriàrem	2	0	arriarem	2	1	1	2960
arriés	2	2	arries	2	2	4	2961
arrií	2	0	arrii	2	1	1	2962
arrodolà	2	0	arrodola	2	1	1	2963
arrodonirà	2	77	arrodonira	2	0	77	2964
arrodonírem	2	1	arrodonirem	2	15	16	2965
arrogarà	2	1	arrogara	2	0	1	2966
arrogués	2	5	arrogues	2	0	5	2967
arroguí	2	0	arrogui	2	16	16	2968
arrogà	2	8	arroga	2	37	45	2969
arromangués	2	2	arromangues	2	1	3	2970
arromanguí	2	0	arromangui	2	6	6	2971
arromangà	2	6	arromanga	2	16	22	2972
arromangàrem	2	1	arromangarem	2	2	3	2973
arromançà	2	0	arromança	2	2	2	2974
arronsarà	2	14	arronsara	2	0	14	2975
arronsà	2	17	arronsa	2	607	624	2976
arronsàrem	2	0	arronsarem	2	13	13	2977
arronsàreu	2	0	arronsareu	2	1	1	2978
arronsés	2	4	arronses	2	81	85	2979
arronsí	2	0	arronsi	2	28	28	2980
arroparà	2	1	arropara	2	0	1	2981
arropà	2	0	arropa	2	14	14	2982
arrossegarà	2	229	arrossegara	2	5	234	2983
arrossegués	2	65	arrossegues	2	88	153	2984
arrosseguí	2	1	arrossegui	2	232	233	2985
arrossegà	2	108	arrossega	2	4220	4328	2986
arrossegàrem	2	2	arrossegarem	2	39	41	2987
arrossegó	4	0	arrossego	2	199	199	2988
arrossà	2	0	arrossa	2	3	3	2989
arrossés	2	0	arrosses	2	1	1	2990
arrosà	2	0	arrosa	2	6	6	2991
arrosés	2	1	arroses	2	0	1	2992
arrufarà	2	8	arrufara	2	0	8	2993
arrufà	2	11	arrufa	2	87	98	2994
arrufàrem	2	0	arrufarem	2	1	1	2995
arrufés	2	1	arrufes	2	6	7	2996
arrufí	2	83	arrufi	2	18	101	2997
arrugarà	2	6	arrugara	2	1	7	2998
arrugués	2	5	arrugues	4	1996	2001	2999
arruguí	2	0	arrugui	2	36	36	3000
arrugà	2	6	arruga	4	455	461	3001
arrugàrem	2	0	arrugarem	2	4	4	3002
arruixarà	2	1	arruixara	2	0	1	3003
arruixà	2	1	arruixa	2	16	17	3004
arruixés	2	1	arruixes	2	2	3	3005
arruixó	4	6	arruixo	2	0	6	3006
arrupí	2	1	arrupi	2	1	2	3007
arrusquerarà	2	0	arrusquerara	2	1	1	3008
arruà	2	0	arrua	2	4	4	3009
arrués	2	0	arrues	2	2	2	3010
arruïnarà	2	45	arruïnara	2	2	47	3011
arruïnà	2	44	arruïna	2	193	237	3012
arruïnàrem	2	0	arruïnarem	2	11	11	3013
arruïnés	2	22	arruïnes	2	3	25	3014
arruïní	2	0	arruïni	2	59	59	3015
arsènic	0	655	arsenic	2	28	683	3016
arsènica	0	3	arsenica	2	0	3	3017
arsèniques	0	1	arseniques	2	0	1	3018
arterialitzarà	2	1	arterialitzara	2	0	1	3019
artesà	0	5709	artesa	4	2149	7858	3020
articularà	2	249	articulara	2	6	255	3021
articulejàrem	2	1	articulejarem	2	0	1	3022
articulà	2	46	articula	2	2773	2819	3023
articulàrem	2	0	articularem	2	27	27	3024
articulés	2	36	articules	2	12	48	3025
articulí	2	0	articuli	2	232	232	3026
artigués	2	1	artigues	4	848	849	3027
artigà	2	0	artiga	4	648	648	3028
artigàs	2	1	artigas	4	1533	1534	3029
artillà	2	0	artilla	2	1	1	3030
artèria	4	1608	arteria	4	192	1800	3031
artèries	4	1717	arteries	4	107	1824	3032
arvernès	0	0	arvernes	0	1	1	3033
arvernés	0	0	arvernes	0	1	1	3034
arxivarà	2	147	arxivara	2	5	152	3035
arxivà	2	24	arxiva	2	489	513	3036
arxivàrem	2	0	arxivarem	2	9	9	3037
arxivàreu	2	0	arxivareu	2	1	1	3038
arxivés	2	39	arxives	2	11	50	3039
arxiví	2	1	arxivi	2	146	147	3040
arè	4	8	are	4	6764	6772	3041
aré	4	2	are	4	6764	6766	3042
ascendirà	2	224	ascendira	2	5	229	3043
ascendírem	2	2	ascendirem	2	88	90	3044
ascendíreu	2	0	ascendireu	2	3	3	3045
asclà	2	1	ascla	4	96	97	3046
asclés	2	0	ascles	4	142	142	3047
asfaltarà	2	54	asfaltara	2	0	54	3048
asfaltà	2	1	asfalta	2	39	40	3049
asfaltàrem	2	0	asfaltarem	2	3	3	3050
asfaltè	4	1	asfalte	2	5	6	3051
asfalté	4	0	asfalte	2	5	5	3052
asfaltés	2	4	asfaltes	2	0	4	3053
asfaltí	2	0	asfalti	2	16	16	3054
asfixiarà	2	8	asfixiara	2	0	8	3055
asfixià	2	2	asfixia	2	339	341	3056
asfixiàrem	2	0	asfixiarem	2	1	1	3057
asfixiés	2	1	asfixies	2	7	8	3058
asfíxia	4	853	asfixia	2	339	1192	3059
asfíxies	4	17	asfixies	2	7	24	3060
asilarà	2	1	asilara	2	0	1	3061
asilà	2	2	asila	2	9	11	3062
asilàrem	2	0	asilarem	2	1	1	3063
asilés	2	0	asiles	2	1	1	3064
asilí	2	0	asili	2	7	7	3065
aspergirà	2	1	aspergira	2	0	1	3066
aspiarà	2	0	aspiara	2	1	1	3067
aspirarà	2	59	aspirara	2	5	64	3068
aspirà	2	23	aspira	2	4589	4612	3069
aspiràrem	2	0	aspirarem	2	14	14	3070
aspirés	2	38	aspires	2	54	92	3071
aspirí	2	2	aspiri	2	239	241	3072
aspià	2	0	aspia	2	1	1	3073
aspiés	2	0	aspies	2	11	11	3074
asprà	2	3	aspra	2	723	726	3075
asprés	2	0	aspres	2	1007	1007	3076
asprí	2	0	aspri	2	2	2	3077
assabentarà	2	61	assabentara	2	12	73	3078
assabentà	2	252	assabenta	2	1195	1447	3079
assabentàrem	2	32	assabentarem	2	59	91	3080
assabentàreu	2	2	assabentareu	2	10	12	3081
assabentés	2	103	assabentes	2	139	242	3082
assabentí	2	5	assabenti	2	261	266	3083
assaborirà	2	11	assaborira	2	2	13	3084
assaborírem	2	5	assaborirem	2	40	45	3085
assaboríreu	2	0	assaborireu	2	19	19	3086
assaciarà	2	1	assaciara	2	0	1	3087
assacià	2	0	assacia	2	20	20	3088
assagetà	2	1	assageta	2	0	1	3089
assagués	2	1	assagues	2	0	1	3090
assagà	2	0	assaga	2	1	1	3091
assagés	2	11	assages	2	19	30	3092
assagí	2	1	assagi	2	24	25	3093
assajarà	2	49	assajara	2	0	49	3094
assajà	2	66	assaja	2	596	662	3095
assajàrem	2	4	assajarem	2	67	71	3096
assajàreu	2	0	assajareu	2	1	1	3097
assalarià	2	0	assalaria	2	1	1	3098
assaltarà	2	9	assaltara	2	2	11	3099
assaltà	2	91	assalta	2	371	462	3100
assaltàrem	2	0	assaltarem	2	6	6	3101
assaltàreu	2	0	assaltareu	2	2	2	3102
assaltés	2	28	assaltes	2	5	33	3103
assaltí	2	0	assalti	2	24	24	3104
assaonà	2	0	assaona	2	78	78	3105
assaonàrem	2	0	assaonarem	2	17	17	3106
assaonés	2	1	assaones	2	2	3	3107
assaoní	2	0	assaoni	2	2	2	3108
assassinarà	2	27	assassinara	2	1	28	3109
assassinà	2	123	assassina	2	1228	1351	3110
assassinàrem	2	0	assassinarem	2	2	2	3111
assassinàreu	2	0	assassinareu	2	2	2	3112
assassinés	2	59	assassines	2	242	301	3113
assassiní	2	1	assassini	2	29	30	3114
assaïnà	2	0	assaïna	2	1	1	3115
assecarà	2	38	assecara	2	5	43	3116
assecà	2	25	asseca	2	716	741	3117
assecàrem	2	1	assecarem	2	32	33	3118
assedegués	2	1	assedegues	2	0	1	3119
assedeguí	2	0	assedegui	2	2	2	3120
assedegà	2	1	assedega	2	8	9	3121
assegurarà	2	3318	assegurara	2	24	3342	3122
assegurà	2	700	assegura	2	33913	34613	3123
asseguràrem	2	0	assegurarem	2	385	385	3124
asseguràreu	2	1	assegurareu	2	45	46	3125
assegurés	2	334	assegures	2	195	529	3126
assegurí	2	0	asseguri	2	2088	2088	3127
assegués	2	113	assegues	2	16	129	3128
asseguí	2	0	assegui	2	324	324	3129
assemblarà	2	140	assemblara	2	1	141	3130
assemblà	2	4	assembla	2	5625	5629	3131
assemblàrem	2	0	assemblarem	2	7	7	3132
assemblàreu	2	0	assemblareu	2	2	2	3133
assemblés	2	180	assembles	2	328	508	3134
assemblí	2	0	assembli	2	718	718	3135
assentarà	2	65	assentara	2	4	69	3136
assentirà	2	2	assentira	2	0	2	3137
assentà	2	140	assenta	2	1102	1242	3138
assentàrem	2	4	assentarem	2	15	19	3139
assentàreu	2	2	assentareu	2	0	2	3140
assentés	2	26	assentes	2	18	44	3141
assentí	2	31	assenti	2	102	133	3142
assentírem	2	0	assentirem	2	1	1	3143
assentíreu	2	1	assentireu	2	0	1	3144
assentís	2	3	assentis	2	3	6	3145
assenyalarà	2	144	assenyalara	2	8	152	3146
assenyalà	2	553	assenyala	2	17586	18139	3147
assenyalàrem	2	3	assenyalarem	2	100	103	3148
assenyalàreu	2	0	assenyalareu	2	1	1	3149
assenyalés	2	105	assenyales	2	93	198	3150
assenyalí	2	3	assenyali	2	610	613	3151
assequés	2	48	asseques	2	18	66	3152
assequí	2	0	assequi	2	375	375	3153
asserenarà	2	5	asserenara	2	0	5	3154
asserenà	2	7	asserena	2	89	96	3155
asserenés	2	1	asserenes	2	1	2	3156
asserení	2	0	assereni	2	21	21	3157
assessorarà	2	742	assessorara	2	6	748	3158
assessorà	2	72	assessora	0	4597	4669	3159
assessoràrem	2	0	assessorarem	2	626	626	3160
assessorés	2	52	assessores	0	340	392	3161
assessorí	2	0	assessori	2	208	208	3162
assestarà	2	6	assestara	2	0	6	3163
assestà	2	10	assesta	2	21	31	3164
assestés	2	4	assestes	2	0	4	3165
assetgés	2	11	assetges	2	3	14	3166
assetgí	2	0	assetgi	2	24	24	3167
assetià	2	0	assetia	2	1	1	3168
assetjarà	2	11	assetjara	2	1	12	3169
assetjà	2	140	assetja	2	374	514	3170
assetjàrem	2	0	assetjarem	2	1	1	3171
asseuré	2	51	asseure	2	4655	4706	3172
asseverà	2	20	assevera	2	246	266	3173
asseverés	2	1	asseveres	2	0	1	3174
asseverí	2	0	asseveri	2	1	1	3175
assignarà	2	826	assignara	2	8	834	3176
assignà	2	210	assigna	2	2694	2904	3177
assignàrem	2	0	assignarem	2	107	107	3178
assignàreu	2	0	assignareu	2	6	6	3179
assignés	2	63	assignes	2	12	75	3180
assigní	2	0	assigni	2	383	383	3181
assimilarà	2	27	assimilara	2	0	27	3182
assimilà	2	63	assimila	2	578	641	3183
assimilàrem	2	0	assimilarem	2	10	10	3184
assimilàreu	2	1	assimilareu	2	1	2	3185
assimilés	2	21	assimiles	2	16	37	3186
assimilí	2	0	assimili	2	93	93	3187
assistirà	2	2060	assistira	2	28	2088	3188
assistírem	2	78	assistirem	2	731	809	3189
assistíreu	2	4	assistireu	2	75	79	3190
assitià	2	0	assitia	2	38	38	3191
assitiàreu	2	0	assitiareu	2	1	1	3192
assitií	2	1	assitii	2	0	1	3193
associarà	2	266	associara	2	5	271	3194
associà	2	151	associa	2	4629	4780	3195
associàrem	2	0	associarem	2	27	27	3196
associàreu	2	0	associareu	2	4	4	3197
associés	2	72	associes	2	63	135	3198
associí	2	8	associi	2	9	17	3199
assolarà	2	5	assolara	2	1	6	3200
assolellà	2	0	assolella	2	5	5	3201
assolellàreu	2	0	assolellareu	2	1	1	3202
assolirà	2	652	assolira	2	16	668	3203
assolà	2	108	assola	2	259	367	3204
assolés	2	6	assoles	2	165	171	3205
assolí	2	1734	assoli	2	31	1765	3206
assolírem	2	11	assolirem	2	377	388	3207
assolíreu	2	1	assolireu	2	19	20	3208
assolís	2	316	assolis	2	12	328	3209
assoní	2	0	assoni	2	1	1	3210
assortirà	2	22	assortira	2	0	22	3211
assortírem	2	0	assortirem	2	2	2	3212
assossegarà	2	1	assossegara	2	0	1	3213
assossegués	2	0	assossegues	2	1	1	3214
assosseguí	2	0	assossegui	2	3	3	3215
assossegà	2	2	assossega	2	30	32	3216
assotarà	2	2	assotara	2	0	2	3217
assotà	2	11	assota	2	176	187	3218
assotàreu	2	0	assotareu	2	1	1	3219
assotés	2	1	assotes	2	0	1	3220
assotí	2	1	assoti	2	5	6	3221
assuaujarà	2	1	assuaujara	2	0	1	3222
assuaujà	2	3	assuauja	2	7	10	3223
assumirà	2	2956	assumira	2	39	2995	3224
assumírem	2	12	assumirem	2	533	545	3225
assumíreu	2	0	assumireu	2	10	10	3226
assèiem	2	44	asseiem	2	322	366	3227
assèieu	2	0	asseieu	2	29	29	3228
assèver	4	1	assever	2	0	1	3229
asséiem	2	3	asseiem	2	322	325	3230
asséieu	2	0	asseieu	2	29	29	3231
astorarà	2	1	astorara	2	0	1	3232
astorà	2	5	astora	2	29	34	3233
astorés	2	0	astores	2	4	4	3234
astorí	2	0	astori	2	17	17	3235
astrolicàreu	2	1	astrolicareu	2	0	1	3236
atabacà	2	0	atabaca	2	1	1	3237
atabalarà	2	5	atabalara	2	0	5	3238
atabalà	2	1	atabala	2	201	202	3239
atabalàrem	2	0	atabalarem	2	1	1	3240
atabalàreu	2	0	atabalareu	2	1	1	3241
atabalés	2	14	atabales	2	17	31	3242
atabalí	2	0	atabali	2	24	24	3243
atabaqués	2	0	atabaques	2	2	2	3244
atacarà	2	158	atacara	2	8	166	3245
ataconà	2	0	atacona	2	4	4	3246
ataconés	2	1	atacones	2	0	1	3247
atacà	2	638	ataca	2	3436	4074	3248
atacàrem	2	2	atacarem	2	64	66	3249
atacàreu	2	0	atacareu	2	2	2	3250
atalaià	2	0	atalaia	2	260	260	3251
atalaiàrem	2	1	atalaiarem	2	2	3	3252
atalaiés	2	0	atalaies	2	40	40	3253
atallarà	2	5	atallara	2	0	5	3254
atallà	2	0	atalla	2	17	17	3255
atallàrem	2	0	atallarem	2	1	1	3256
atallés	2	2	atalles	2	0	2	3257
atallí	2	0	atalli	2	13	13	3258
atalussà	2	1	atalussa	2	0	1	3259
atalussés	2	0	atalusses	2	1	1	3260
atansarà	2	33	atansara	2	4	37	3261
atansà	2	76	atansa	2	629	705	3262
atansàrem	2	4	atansarem	2	37	41	3263
atansàreu	2	0	atansareu	2	1	1	3264
atansés	2	15	atanses	2	16	31	3265
atansí	2	2	atansi	2	63	65	3266
atapeírem	2	1	atapeirem	2	1	2	3267
ataquinés	2	0	ataquines	2	1	1	3268
ataqués	2	190	ataques	2	77	267	3269
ataquí	2	0	ataqui	2	277	277	3270
ataquín	2	0	ataquin	2	233	233	3271
atarantà	2	1	ataranta	2	0	1	3272
atarantés	2	0	atarantes	2	1	1	3273
atardà	2	0	atarda	2	9	9	3274
atardí	2	1	atardi	2	1	2	3275
ataüllà	2	0	ataülla	2	12	12	3276
ataüllàrem	2	1	ataüllarem	2	0	1	3277
ataüllés	2	0	ataülles	2	1	1	3278
atemorirà	2	2	atemorira	2	1	3	3279
atemptarà	2	17	atemptara	2	1	18	3280
atemptà	2	28	atempta	2	1141	1169	3281
atemptàrem	2	0	atemptarem	2	1	1	3282
atemptés	2	16	atemptes	2	2	18	3283
atemptí	2	0	atempti	2	542	542	3284
atendarà	2	1	atendara	2	0	1	3285
atendré	2	63	atendre	2	28337	28400	3286
atendà	2	1	atenda	2	5	6	3287
atendàrem	2	0	atendarem	2	1	1	3288
atendí	2	0	atendi	2	2	2	3289
atengués	2	115	atengues	2	1	116	3290
atenguí	2	1	atengui	2	752	753	3291
atenuarà	2	14	atenuara	2	0	14	3292
atenuà	2	7	atenua	2	244	251	3293
atenués	2	6	atenues	2	0	6	3294
atenyerà	2	5	atenyera	2	2	7	3295
atenyérem	2	1	atenyerem	2	1	2	3296
atenyés	2	1	atenyes	2	1	2	3297
atenyí	2	0	atenyi	2	14	14	3298
atenès	0	181	atenes	4	6558	6739	3299
atenés	0	5	atenes	4	6558	6563	3300
atermenà	2	0	atermena	2	1	1	3301
aterrarà	2	249	aterrara	2	5	254	3302
aterrirà	2	2	aterrira	2	0	2	3303
aterrà	2	99	aterra	2	1172	1271	3304
aterràrem	2	5	aterrarem	2	51	56	3305
aterràreu	2	0	aterrareu	2	4	4	3306
aterrés	2	65	aterres	2	26	91	3307
aterrí	2	5	aterri	2	96	101	3308
aterrís	2	1	aterris	2	11	12	3309
atestarà	2	2	atestara	2	0	2	3310
atestà	2	1	atesta	2	31	32	3311
atestés	2	1	atestes	2	1	2	3312
atestí	2	0	atesti	2	5	5	3313
atiarà	2	8	atiara	2	0	8	3314
atindré	2	15	atindre	2	7	22	3315
atingués	2	11	atingues	2	1	12	3316
atinguí	2	0	atingui	2	87	87	3317
atiparà	2	8	atipara	2	0	8	3318
atiplà	2	4	atipla	2	0	4	3319
atipà	2	1	atipa	2	104	105	3320
atipàrem	2	0	atiparem	2	5	5	3321
atipàreu	2	0	atipareu	2	6	6	3322
atipés	2	5	atipes	2	8	13	3323
atipí	2	0	atipi	2	11	11	3324
atirantà	2	0	atiranta	2	1	1	3325
atirantàrem	2	1	atirantarem	2	0	1	3326
atiranyarà	2	0	atiranyara	2	1	1	3327
atiranyés	2	0	atiranyes	2	1	1	3328
atià	2	26	atia	2	195	221	3329
atiàrem	2	1	atiarem	2	3	4	3330
atiés	2	3	aties	2	4	7	3331
atií	2	1	atii	2	2	3	3332
atomitzarà	2	1	atomitzara	2	0	1	3333
atomitzà	2	2	atomitza	2	20	22	3334
atomitzés	2	1	atomitzes	2	0	1	3335
atomitzí	2	0	atomitzi	2	2	2	3336
atonyinarà	2	1	atonyinara	2	0	1	3337
atonyinà	2	0	atonyina	2	24	24	3338
atonyinàrem	2	0	atonyinarem	2	1	1	3339
atonyinés	2	7	atonyines	2	2	9	3340
atonyiní	2	0	atonyini	2	4	4	3341
atordirà	2	2	atordira	2	0	2	3342
atorgarà	2	1633	atorgara	2	19	1652	3343
atorgués	2	195	atorgues	2	46	241	3344
atorguí	2	0	atorgui	2	858	858	3345
atorgà	2	989	atorga	2	14001	14990	3346
atorgàrem	2	2	atorgarem	2	51	53	3347
atorgàreu	2	3	atorgareu	2	2	5	3348
atorrollà	2	0	atorrolla	2	1	1	3349
atovó	4	25	atovo	2	0	25	3350
atracarà	2	61	atracara	2	4	65	3351
atracà	2	19	atraca	2	148	167	3352
atracàrem	2	1	atracarem	2	4	5	3353
atracàreu	2	0	atracareu	2	1	1	3354
atrací	2	1	atraci	2	0	1	3355
atrafegà	2	0	atrafega	2	1	1	3356
atragués	2	54	atragues	2	0	54	3357
atraguí	2	0	atragui	2	35	35	3358
atraparà	2	209	atrapara	2	6	215	3359
atrapà	2	30	atrapa	2	2120	2150	3360
atrapàrem	2	0	atraparem	2	29	29	3361
atrapàreu	2	0	atrapareu	2	2	2	3362
atrapés	2	61	atrapes	2	34	95	3363
atrapí	2	0	atrapi	2	218	218	3364
atraqués	2	21	atraques	2	7	28	3365
atraquí	2	0	atraqui	2	28	28	3366
atrauré	2	25	atraure	2	6203	6228	3367
atraçarà	2	1	atraçara	2	0	1	3368
atraçà	2	0	atraça	2	4	4	3369
atresorà	2	6	atresora	2	677	683	3370
atresoràrem	2	0	atresorarem	2	1	1	3371
atresorés	2	2	atresores	2	1	3	3372
atresorí	2	0	atresori	2	5	5	3373
atrevirà	2	192	atrevira	2	19	211	3374
atrevírem	2	4	atrevirem	2	75	79	3375
atrevíreu	2	0	atrevireu	2	6	6	3376
atribolà	2	1	atribola	2	0	1	3377
atribuírem	2	2	atribuirem	2	12	14	3378
atribuíreu	2	0	atribuireu	2	1	1	3379
atrinxerarà	2	1	atrinxerara	2	3	4	3380
atrinxerà	2	12	atrinxera	2	30	42	3381
atrinxeràreu	2	1	atrinxerareu	2	0	1	3382
atrinxerés	2	3	atrinxeres	2	1	4	3383
atrinxerí	2	0	atrinxeri	2	6	6	3384
atrofiarà	2	4	atrofiara	2	0	4	3385
atrofià	2	0	atrofia	2	117	117	3386
atrofiés	2	0	atrofies	2	7	7	3387
atronarà	2	1	atronara	2	0	1	3388
atronà	2	0	atrona	2	1	1	3389
atropellarà	2	12	atropellara	2	2	14	3390
atropellà	2	8	atropella	2	192	200	3391
atropellàreu	2	1	atropellareu	2	0	1	3392
atropellés	2	20	atropelles	2	10	30	3393
atropellí	2	0	atropelli	2	30	30	3394
atropà	2	0	atropa	2	18	18	3395
atropàrem	2	1	atroparem	2	0	1	3396
atrotinà	2	0	atrotina	2	1	1	3397
atrotinàreu	2	1	atrotinareu	2	0	1	3398
atròfia	4	511	atrofia	2	117	628	3399
atròfies	4	25	atrofies	2	7	32	3400
atufà	2	1	atufa	2	2	3	3401
atupà	2	0	atupa	2	89	89	3402
aturarà	2	1017	aturara	2	15	1032	3403
aturà	2	655	atura	4	7380	8035	3404
aturàrem	2	94	aturarem	2	610	704	3405
aturàreu	2	0	aturareu	2	20	20	3406
aturés	2	570	atures	4	217	787	3407
aturí	2	2	aturi	2	1887	1889	3408
atxul·làrem	2	0	atxul·larem	2	1	1	3409
atxul·lés	2	0	atxul·les	2	1	1	3410
atzufà	2	0	atzufa	2	1	1	3411
atès	2	34816	ates	4	232	35048	3412
atés	2	1524	ates	4	232	1756	3413
atònit	0	301	atonit	2	5	306	3414
atònits	0	338	atonits	2	9	347	3415
auditarà	2	21	auditara	2	0	21	3416
audità	2	0	audita	2	94	94	3417
auditàrem	2	0	auditarem	2	8	8	3418
audités	2	4	audites	2	1	5	3419
audití	2	0	auditi	2	17	17	3420
augmentarà	2	3247	augmentara	2	46	3293	3421
augmentà	2	821	augmenta	2	18846	19667	3422
augmentàrem	2	4	augmentarem	2	201	205	3423
augmentàreu	2	0	augmentareu	2	17	17	3424
augmentés	2	378	augmentes	2	65	443	3425
augmentí	2	0	augmenti	2	2818	2818	3426
augurarà	2	1	augurara	2	0	1	3427
augurà	2	16	augura	2	1021	1037	3428
auguràrem	2	0	augurarem	2	1	1	3429
augurés	2	2	augures	2	6	8	3430
augurí	2	2	auguri	4	638	640	3431
aureolarà	2	1	aureolara	2	0	1	3432
aureolà	2	0	aureola	2	183	183	3433
aureolés	2	0	aureoles	2	11	11	3434
aureolí	2	0	aureoli	2	3	3	3435
aurèola	4	442	aureola	2	183	625	3436
aurèoles	4	32	aureoles	2	11	43	3437
aurífic	0	1	aurific	2	1	2	3438
aurífica	0	3	aurifica	2	0	3	3439
aurífiques	0	2	aurifiques	2	0	2	3440
auscultarà	2	3	auscultara	2	0	3	3441
auscultà	2	0	ausculta	2	18	18	3442
auscultàrem	2	0	auscultarem	2	2	2	3443
auscultí	2	0	ausculti	2	2	2	3444
auspicià	2	2	auspicia	2	7	9	3445
autenticarà	2	1	autenticara	2	0	1	3446
autenticà	2	1	autentica	2	476	477	3447
autentificarà	2	2	autentificara	2	0	2	3448
autentificà	2	0	autentifica	2	24	24	3449
autentifiqués	2	2	autentifiques	2	0	2	3450
autentifiquí	2	0	autentifiqui	2	6	6	3451
autentiqués	2	2	autentiques	2	120	122	3452
autentiquí	2	0	autentiqui	2	15	15	3453
autoadministrà	2	0	autoadministra	2	1	1	3454
autoadministrí	2	0	autoadministri	2	1	1	3455
autoajudà	2	0	autoajuda	4	1049	1049	3456
autoajudés	2	0	autoajudes	2	3	3	3457
autoanomenà	2	7	autoanomena	2	128	135	3458
autoanomenés	2	2	autoanomenes	2	0	2	3459
autoanomení	2	0	autoanomeni	2	8	8	3460
autoassignà	2	0	autoassigna	2	2	2	3461
autocensurarà	2	3	autocensurara	2	0	3	3462
autocensurà	2	1	autocensura	4	501	502	3463
autocensuràrem	2	0	autocensurarem	2	3	3	3464
autocensurés	2	0	autocensures	4	6	6	3465
autocensurí	2	0	autocensuri	2	11	11	3466
autocontrolà	2	0	autocontrola	2	2	2	3467
autocontrolí	2	0	autocontroli	2	1	1	3468
autocriticà	2	0	autocritica	2	57	57	3469
autocritiqués	2	0	autocritiques	2	4	4	3470
autocrític	0	217	autocritic	2	3	220	3471
autocrítica	0	3042	autocritica	2	57	3099	3472
autocrítiques	0	52	autocritiques	2	4	56	3473
autodenominà	2	6	autodenomina	2	87	93	3474
autodenominés	2	3	autodenomines	2	0	3	3475
autodenominí	2	0	autodenomini	2	4	4	3476
autodestruírem	2	0	autodestruirem	2	3	3	3477
autodeterminà	2	0	autodetermina	2	21	21	3478
autodeterminàreu	2	0	autodeterminareu	2	1	1	3479
autodeterminés	2	2	autodetermines	2	0	2	3480
autodeterminí	2	0	autodetermini	2	4	4	3481
autodissoldré	2	0	autodissoldre	2	27	27	3482
autodissolguí	2	0	autodissolgui	2	2	2	3483
autoeditarà	2	2	autoeditara	2	0	2	3484
autoedità	2	10	autoedita	2	26	36	3485
autoestimulà	2	0	autoestimula	2	3	3	3486
autoexclogués	2	1	autoexclogues	2	0	1	3487
autoexcloguí	2	0	autoexclogui	2	7	7	3488
autoexclouré	2	0	autoexcloure	2	41	41	3489
autoexilià	2	4	autoexilia	2	1	5	3490
autofacturà	2	0	autofactura	2	2	2	3491
autofinancés	2	2	autofinances	2	0	2	3492
autofinancí	2	0	autofinanci	2	6	6	3493
autofinançarà	2	7	autofinançara	2	0	7	3494
autofinançà	2	1	autofinança	2	30	31	3495
autogestionarà	2	4	autogestionara	2	0	4	3496
autogestionà	2	1	autogestiona	2	60	61	3497
autogestionàrem	2	0	autogestionarem	2	2	2	3498
autogestionària	0	140	autogestionaria	2	7	147	3499
autogestionàries	0	67	autogestionaries	2	4	71	3500
autogestionés	2	0	autogestiones	2	1	1	3501
autogestioní	2	0	autogestioni	2	20	20	3502
autografià	2	0	autografia	4	13	13	3503
autoimposarà	2	1	autoimposara	2	0	1	3504
autoimposà	2	3	autoimposa	2	23	26	3505
autoimposàrem	2	0	autoimposarem	2	1	1	3506
autoimposés	2	1	autoimposes	2	2	3	3507
autoimposí	2	0	autoimposi	2	2	2	3508
autolesionà	2	0	autolesiona	2	3	3	3509
autolesionés	2	3	autolesiones	2	0	3	3510
autolesioní	2	0	autolesioni	2	1	1	3511
autolimitarà	2	3	autolimitara	2	0	3	3512
autolimità	2	0	autolimita	2	11	11	3513
autolimités	2	1	autolimites	2	1	2	3514
autolimití	2	0	autolimiti	2	2	2	3515
automarginà	2	1	automargina	2	2	3	3516
automarginí	2	0	automargini	2	1	1	3517
automatitzarà	2	15	automatitzara	2	0	15	3518
automatitzà	2	1	automatitza	2	143	144	3519
automatitzés	2	0	automatitzes	2	2	2	3520
automatitzí	2	0	automatitzi	2	23	23	3521
automedicà	2	0	automedica	2	10	10	3522
automediqués	2	0	automediques	2	1	1	3523
automediquí	2	0	automediqui	2	3	3	3524
autoproclamarà	2	1	autoproclamara	2	0	1	3525
autoproclamà	2	40	autoproclama	2	88	128	3526
autoproclamés	2	3	autoproclames	2	1	4	3527
autoproclamí	2	0	autoproclami	2	11	11	3528
autoqualificarà	2	1	autoqualificara	2	0	1	3529
autoqualificà	2	2	autoqualifica	2	22	24	3530
autoqualifiquí	2	0	autoqualifiqui	2	1	1	3531
autoregulà	2	0	autoregula	2	59	59	3532
autoregulí	2	0	autoreguli	2	12	12	3533
autoretratà	2	0	autoretrata	2	23	23	3534
autoretratés	2	2	autoretrates	2	0	2	3535
autoretratí	2	0	autoretrati	2	1	1	3536
autoritzarà	2	414	autoritzara	2	11	425	3537
autoritzà	2	302	autoritza	2	5787	6089	3538
autoritzàrem	2	0	autoritzarem	2	9	9	3539
autoritzés	2	161	autoritzes	2	134	295	3540
autoritzí	2	1	autoritzi	2	1138	1139	3541
autosuggestioní	2	0	autosuggestioni	2	1	1	3542
autèntic	0	20627	autentic	2	198	20825	3543
autèntica	0	19102	autentica	2	476	19578	3544
autèntiques	0	4409	autentiques	2	120	4529	3545
auxiliarà	2	5	auxiliara	2	3	8	3546
auxilià	2	14	auxilia	2	52	66	3547
auxiliés	2	4	auxilies	2	1	5	3548
auxilií	2	0	auxilii	2	1	1	3549
avalarà	2	68	avalara	2	2	70	3550
avalencianés	2	0	avalencianes	2	5	5	3551
avalotarà	2	0	avalotara	2	1	1	3552
avalotà	2	5	avalota	2	3	8	3553
avalotés	2	1	avalotes	2	2	3	3554
avaluarà	2	1211	avaluara	2	6	1217	3555
avaluà	2	26	avalua	2	2973	2999	3556
avaluàrem	2	6	avaluarem	2	242	248	3557
avaluàreu	2	0	avaluareu	2	3	3	3558
avalués	2	89	avalues	2	14	103	3559
avalà	2	21	avala	2	2249	2270	3560
avalàrem	2	0	avalarem	2	14	14	3561
avalés	2	77	avales	2	8	85	3562
avalí	2	0	avali	2	371	371	3563
avancé	4	57	avance	2	430	487	3564
avancés	2	408	avances	2	272	680	3565
avancí	2	2	avanci	2	2400	2402	3566
avantatgés	2	5	avantatges	4	28034	28039	3567
avantatgí	2	0	avantatgi	2	2	2	3568
avantatjà	2	6	avantatja	2	370	376	3569
avantposarà	2	5	avantposara	2	0	5	3570
avantposà	2	5	avantposa	2	69	74	3571
avantposàrem	2	1	avantposarem	2	0	1	3572
avantposés	2	0	avantposes	2	2	2	3573
avantposí	2	0	avantposi	2	7	7	3574
avançarà	2	774	avançara	2	34	808	3575
avançà	2	533	avança	2	12944	13477	3576
avançàrem	2	24	avançarem	2	568	592	3577
avançàreu	2	0	avançareu	2	22	22	3578
avariarà	2	1	avariara	2	0	1	3579
avarià	2	2	avaria	4	2821	2823	3580
avariés	2	6	avaries	4	2803	2809	3581
avarà	2	6	avara	0	88	94	3582
avarés	2	0	avares	0	8	8	3583
avarí	2	0	avari	2	5	5	3584
avassallà	2	0	avassalla	2	6	6	3585
avencés	2	1	avences	2	3	4	3586
avencí	2	0	avenci	2	8	8	3587
avenguí	2	0	avengui	2	3	3	3588
avenqués	2	0	avenques	2	1	1	3589
aventurarà	2	7	aventurara	2	4	11	3590
aventurà	2	21	aventura	4	34304	34325	3591
aventuràrem	2	1	aventurarem	2	11	12	3592
aventurés	2	10	aventures	4	18606	18616	3593
aventurí	2	0	aventuri	2	38	38	3594
avençà	2	3	avença	2	28	31	3595
avençàrem	2	0	avençarem	2	1	1	3596
averarà	2	0	averara	2	1	1	3597
avergonyirà	2	14	avergonyira	2	2	16	3598
avergonyírem	2	0	avergonyirem	2	10	10	3599
avergonyíreu	2	0	avergonyireu	2	2	2	3600
averà	2	0	avera	2	52	52	3601
averés	2	0	averes	2	1	1	3602
averí	2	0	averi	2	16	16	3603
avesarà	2	1	avesara	2	0	1	3604
avesà	2	4	avesa	2	11	15	3605
avesés	2	0	aveses	2	4	4	3606
avesí	2	0	avesi	2	5	5	3607
aveïnà	2	0	aveïna	2	93	93	3608
aveïní	2	0	aveïni	2	1	1	3609
aviarà	2	1	aviara	2	1	2	3610
aviciarà	2	1	aviciara	2	0	1	3611
avicià	2	1	avicia	2	8	9	3612
aviciàreu	2	0	aviciareu	2	1	1	3613
aviciés	2	0	avicies	2	1	1	3614
avicií	2	0	avicii	2	103	103	3615
avidà	2	0	avida	2	32	32	3616
avidés	2	0	avides	2	3	3	3617
avidí	2	0	avidi	2	16	16	3618
avilà	2	1	avila	2	247	248	3619
avilès	0	42	aviles	2	44	86	3620
avinagrarà	2	1	avinagrara	2	0	1	3621
avinagrà	2	0	avinagra	2	3	3	3622
avinagrí	2	0	avinagri	2	1	1	3623
avindré	2	5	avindre	2	11	16	3624
avinencés	2	0	avinences	4	23	23	3625
avinençà	2	0	avinença	4	155	155	3626
avingués	2	61	avingues	2	1	62	3627
avinguí	2	0	avingui	2	226	226	3628
avinà	2	0	avina	2	2	2	3629
avisarà	2	680	avisara	2	17	697	3630
avisà	2	133	avisa	2	4621	4754	3631
avisàrem	2	10	avisarem	2	490	500	3632
avisàreu	2	1	avisareu	2	13	14	3633
avisés	2	123	avises	2	112	235	3634
avisí	2	2	avisi	2	783	785	3635
avituallà	2	1	avitualla	2	9	10	3636
avituallàrem	2	0	avituallarem	2	1	1	3637
avituallés	2	0	avitualles	2	1	1	3638
avivarà	2	14	avivara	2	0	14	3639
avivà	2	6	aviva	2	384	390	3640
avivàrem	2	0	avivarem	2	1	1	3641
avivés	2	1	avives	2	1	2	3642
aviví	2	0	avivi	2	11	11	3643
aviàrem	2	0	aviarem	2	1	1	3644
aviària	0	640	aviaria	2	26	666	3645
aviàries	0	19	aviaries	2	3	22	3646
aviés	2	2	avies	2	276	278	3647
avií	2	1	avii	2	0	1	3648
avió	4	17221	avio	2	209	17430	3649
avocà	2	0	avoca	2	65	65	3650
avocàrem	2	0	avocarem	2	4	4	3651
avoqués	2	0	avoques	2	2	2	3652
avoquí	2	0	avoqui	2	1	1	3653
avorrirà	2	64	avorrira	2	3	67	3654
avorrírem	2	0	avorrirem	2	29	29	3655
avorríreu	2	0	avorrireu	2	26	26	3656
avortarà	2	18	avortara	2	0	18	3657
avortà	2	17	avorta	2	102	119	3658
avortàrem	2	0	avortarem	2	1	1	3659
avortés	2	19	avortes	2	1	20	3660
avortí	2	2	avorti	2	17	19	3661
avortó	4	3	avorto	2	4	7	3662
avé	2	311	ave	4	6984	7295	3663
avís	2	27462	avis	4	18267	45729	3664
aïllarà	2	46	aïllara	2	1	47	3665
aïllà	2	63	aïlla	2	720	783	3666
aïllàrem	2	1	aïllarem	2	12	13	3667
aïllàreu	2	0	aïllareu	2	1	1	3668
aïllés	2	13	aïlles	2	22	35	3669
aïllí	2	2	aïlli	2	105	107	3670
aïnà	2	0	aïna	4	192	192	3671
aïnés	2	0	aïnes	4	33	33	3672
aïrà	2	0	aïra	2	1	1	3673
aïrí	2	2	aïri	2	2	4	3674
aüixà	2	1	aüixa	2	1	2	3675
bacivà	2	0	baciva	0	4	4	3676
bacivés	2	0	bacives	0	1	1	3677
badallà	2	5	badalla	2	65	70	3678
badallés	2	0	badalles	2	5	5	3679
badallí	2	0	badalli	2	4	4	3680
badarià	0	1	badaria	2	5	6	3681
badarà	2	2	badara	2	12	14	3682
badocà	2	0	badoca	0	18	18	3683
badoquegés	2	0	badoqueges	2	1	1	3684
badoquegí	2	1	badoquegi	2	0	1	3685
badoquejà	2	0	badoqueja	2	2	2	3686
badoqués	2	0	badoques	0	5	5	3687
badà	2	22	bada	4	511	533	3688
badàrem	2	1	badarem	2	3	4	3689
badès	0	1	bades	4	310	311	3690
badí	2	1	badi	2	74	75	3691
baellà	0	0	baella	4	13	13	3692
bafanejà	2	0	bafaneja	2	2	2	3693
bagolà	2	0	bagola	2	1	1	3694
baixarà	2	1270	baixara	2	65	1335	3695
baixà	2	543	baixa	0	100754	101297	3696
baixàrem	2	87	baixarem	2	1678	1765	3697
baixàreu	2	2	baixareu	2	72	74	3698
baixí	2	9	baixi	2	1454	1463	3699
baixó	4	64	baixo	2	1626	1690	3700
baià	2	0	baia	0	425	425	3701
baiàrem	2	0	baiarem	2	1	1	3702
bajà	0	15	baja	4	612	627	3703
baladrejà	2	0	baladreja	2	7	7	3704
balafiarà	2	3	balafiara	2	0	3	3705
balafià	2	0	balafia	2	91	91	3706
balafiàrem	2	1	balafiarem	2	0	1	3707
balafiés	2	2	balafies	2	1	3	3708
balancegés	2	1	balanceges	2	3	4	3709
balancegí	2	0	balancegi	2	8	8	3710
balancejarà	2	1	balancejara	2	0	1	3711
balancejà	2	0	balanceja	2	156	156	3712
balancé	4	1	balance	2	528	529	3713
balancés	4	1	balances	4	1414	1415	3714
balancí	4	768	balanci	2	32	800	3715
balandregí	2	0	balandregi	2	1	1	3716
balandrejà	2	1	balandreja	2	4	5	3717
balançà	2	1	balança	4	4237	4238	3718
balançó	4	7	balanço	2	4	11	3719
balbotejà	2	0	balboteja	2	13	13	3720
balbucegés	2	0	balbuceges	2	1	1	3721
balbucejarà	2	0	balbucejara	2	1	1	3722
balbucejà	2	4	balbuceja	2	27	31	3723
balbà	2	0	balba	0	26	26	3724
balbés	2	0	balbes	0	22	22	3725
balbís	0	0	balbis	2	4	4	3726
balcanitzarà	2	1	balcanitzara	2	0	1	3727
balcanitzà	2	0	balcanitza	2	1	1	3728
balcà	2	4	balca	4	124	128	3729
balcàrem	2	0	balcarem	2	1	1	3730
balcó	4	11546	balco	2	137	11683	3731
balderejà	2	0	baldereja	2	1	1	3732
baldà	2	12	balda	4	175	187	3733
baldés	2	1	baldes	4	68	69	3734
balegí	2	0	balegi	2	1	1	3735
balejà	2	0	baleja	4	3	3	3736
balirà	2	0	balira	2	2	2	3737
ballotejà	2	0	balloteja	2	1	1	3738
ballà	2	66	balla	4	3274	3340	3739
ballàrem	2	29	ballarem	2	377	406	3740
ballàreu	2	0	ballareu	2	19	19	3741
ballés	2	80	balles	4	245	325	3742
ballí	2	3	balli	2	207	210	3743
balmà	2	0	balma	4	2282	2282	3744
balmàrem	2	0	balmarem	2	1	1	3745
balmés	2	2	balmes	4	3766	3768	3746
balmí	2	0	balmi	2	1	1	3747
balqués	2	0	balques	4	16	16	3748
balès	0	10	bales	4	3149	3159	3749
balés	0	18	bales	4	3149	3167	3750
balí	2	39	bali	4	1461	1500	3751
bambarà	2	0	bambara	2	85	85	3752
bambolejà	2	0	bamboleja	2	3	3	3753
bambollà	2	0	bambolla	4	113	113	3754
bambollés	2	0	bambolles	4	39	39	3755
bambà	2	0	bamba	4	240	240	3756
bambés	2	1	bambes	4	796	797	3757
bambí	2	0	bambi	2	179	179	3758
banalitzarà	2	3	banalitzara	2	1	4	3759
banalitzà	2	0	banalitza	2	162	162	3760
banalitzàrem	2	0	banalitzarem	2	2	2	3761
banalitzés	2	2	banalitzes	2	1	3	3762
banalitzí	2	0	banalitzi	2	23	23	3763
bancà	2	3	banca	4	12850	12853	3764
bancària	0	8662	bancaria	2	447	9109	3765
bancàries	0	5247	bancaries	2	160	5407	3766
bandegés	2	5	bandeges	2	3	8	3767
bandegí	2	0	bandegi	2	12	12	3768
bandejarà	2	14	bandejara	2	3	17	3769
bandejà	2	14	bandeja	2	211	225	3770
bandejàrem	2	2	bandejarem	2	1	3	3771
banderejàrem	2	1	banderejarem	2	0	1	3772
banquetejà	2	0	banqueteja	2	1	1	3773
banqués	2	0	banques	4	126	126	3774
bantú	0	87	bantu	0	235	322	3775
bantús	0	34	bantus	0	228	262	3776
banyarà	2	14	banyara	2	3	17	3777
banyegués	2	0	banyegues	2	1	1	3778
banyegà	2	0	banyega	2	2	2	3779
banyegàrem	2	1	banyegarem	2	0	1	3780
banyà	2	33	banya	4	2792	2825	3781
banyàrem	2	2	banyarem	2	91	93	3782
banyàreu	2	0	banyareu	2	8	8	3783
banyés	2	15	banyes	4	2803	2818	3784
banyí	2	0	banyi	2	54	54	3785
banyó	4	7	banyo	2	75	82	3786
baquetejarà	2	0	baquetejara	2	1	1	3787
barallarà	2	30	barallara	2	0	30	3788
barallà	2	11	baralla	4	4618	4629	3789
barallàrem	2	2	barallarem	2	36	38	3790
barallàreu	2	0	barallareu	2	3	3	3791
barallés	2	3	baralles	4	2768	2771	3792
barallí	2	0	baralli	2	25	25	3793
baratarà	2	4	baratara	2	1	5	3794
baratà	2	7	barata	0	4857	4864	3795
baratàrem	2	0	baratarem	2	3	3	3796
baratés	2	1	barates	0	2092	2093	3797
baratí	2	0	barati	2	5	5	3798
barbaritzà	2	2	barbaritza	2	0	2	3799
barbarà	2	417	barbara	2	3218	3635	3800
barbegés	2	0	barbeges	2	1	1	3801
barbollà	2	0	barbolla	4	10	10	3802
barbotejà	2	1	barboteja	2	4	5	3803
barbà	2	3	barba	4	4421	4424	3804
barbàries	4	113	barbaries	2	7	120	3805
barbés	2	4	barbes	4	691	695	3806
barbís	4	0	barbis	2	30	30	3807
barbó	4	14	barbo	2	12	26	3808
barcelonés	0	289	barcelones	4	232	521	3809
baremarà	2	18	baremara	2	0	18	3810
baremà	2	0	barema	2	12	12	3811
baremí	2	0	baremi	2	1	1	3812
barquejàrem	2	0	barquejarem	2	1	1	3813
barranquegés	2	1	barranqueges	2	0	1	3814
barrarà	2	21	barrara	2	1	22	3815
barregés	2	47	barreges	4	1235	1282	3816
barregí	2	0	barregi	2	301	301	3817
barrejarà	2	170	barrejara	2	3	173	3818
barrejà	2	32	barreja	4	27533	27565	3819
barrejàrem	2	1	barrejarem	2	493	494	3820
barrejàreu	2	0	barrejareu	2	33	33	3821
barrigà	2	1	barriga	2	303	304	3822
barrinà	2	1	barrina	4	289	290	3823
barrinàrem	2	0	barrinarem	2	1	1	3824
barrinés	2	0	barrines	4	16	16	3825
barriní	2	0	barrini	2	2	2	3826
barriscà	2	0	barrisca	4	1	1	3827
barrisqués	2	0	barrisques	4	1	1	3828
barrotà	2	0	barrota	2	10	10	3829
barrotàrem	2	0	barrotarem	2	1	1	3830
barrotés	2	2	barrotes	2	13	15	3831
barrotí	2	0	barroti	2	3	3	3832
barrà	2	21	barra	4	21183	21204	3833
barràrem	2	0	barrarem	2	2	2	3834
barrés	2	42	barres	4	8131	8173	3835
barrí	2	52	barri	4	115865	115917	3836
barrín	2	1	barrin	2	19	20	3837
barró	4	17	barro	2	234	251	3838
barutellà	2	1	barutella	2	0	1	3839
barxetà	0	1	barxeta	4	413	414	3840
basarà	2	968	basara	2	23	991	3841
bascarà	2	1	bascara	2	7	8	3842
bascularà	2	10	basculara	2	0	10	3843
basculà	2	2	bascula	2	260	262	3844
basculàrem	2	0	bascularem	2	1	1	3845
basculés	2	7	bascules	2	20	27	3846
basculí	2	1	basculi	2	11	12	3847
bascà	2	0	basca	0	4113	4113	3848
basificàreu	2	1	basificareu	2	0	1	3849
basquejarà	2	1	basquejara	2	0	1	3850
basquejà	2	0	basqueja	2	4	4	3851
basqués	2	0	basques	0	1075	1075	3852
bastaixés	2	0	bastaixes	2	1	1	3853
bastarà	2	316	bastara	2	3	319	3854
bastetà	0	0	basteta	4	1	1	3855
bastirà	2	33	bastira	2	3	36	3856
bastonejà	2	0	bastoneja	2	7	7	3857
bastà	2	28	basta	0	3118	3146	3858
bastàrem	2	1	bastarem	2	0	1	3859
bastàreu	2	1	bastareu	2	0	1	3860
bastés	2	37	bastes	0	96	133	3861
bastí	2	425	basti	2	240	665	3862
bastírem	2	2	bastirem	2	24	26	3863
bastíreu	2	0	bastireu	2	1	1	3864
bastís	2	26	bastis	2	7	33	3865
bastó	4	2624	basto	2	416	3040	3866
basà	2	251	basa	4	28504	28755	3867
basàrem	2	0	basarem	2	118	118	3868
basàreu	2	0	basareu	2	1	1	3869
basés	2	105	bases	4	54978	55083	3870
basí	2	4	basi	2	1314	1318	3871
batallarà	2	13	batallara	2	1	14	3872
batallà	2	37	batalla	4	44118	44155	3873
batallàrem	2	0	batallarem	2	1	1	3874
batallés	2	1	batalles	4	6468	6469	3875
batallí	2	0	batalli	2	8	8	3876
batalló	4	2577	batallo	2	9	2586	3877
batanà	2	0	batana	2	2	2	3878
batanés	2	124	batanes	2	6	130	3879
bategarà	2	23	bategara	2	1	24	3880
bategués	2	9	bategues	4	3	12	3881
bateguí	2	0	bategui	2	89	89	3882
bategà	2	9	batega	4	1564	1573	3883
bategàrem	2	1	bategarem	2	1	2	3884
bategés	2	35	bateges	2	10	45	3885
bategí	2	0	bategi	2	38	38	3886
batejarà	2	87	batejara	2	4	91	3887
batejà	2	268	bateja	2	330	598	3888
batejàrem	2	9	batejarem	2	27	36	3889
batejàreu	2	0	batejareu	2	1	1	3890
bateà	0	6	batea	4	1058	1064	3891
batifullés	2	0	batifulles	2	1	1	3892
batià	2	15	batia	2	184	199	3893
batiàrem	2	0	batiarem	2	1	1	3894
batiés	2	0	baties	2	3	3	3895
batollà	2	0	batolla	4	29	29	3896
batollés	2	0	batolles	4	12	12	3897
batré	2	3	batre	2	6022	6025	3898
batussà	2	0	batussa	4	250	250	3899
batussés	2	0	batusses	4	223	223	3900
batzegarà	2	1	batzegara	2	0	1	3901
batzegà	2	0	batzega	2	1	1	3902
batà	4	76	bata	4	1807	1883	3903
batés	2	21	bates	4	1059	1080	3904
batí	2	63	bati	2	57	120	3905
batíem	2	3	batiem	2	1	4	3906
batíeu	2	0	batieu	2	1	1	3907
bavarà	2	0	bavara	2	2	2	3908
bavarès	0	405	bavares	2	3	408	3909
bavarés	0	10	bavares	2	3	13	3910
bavegés	2	1	baveges	2	4	5	3911
bavegí	2	0	bavegi	2	2	2	3912
bavejarà	2	1	bavejara	2	0	1	3913
bavejà	2	0	baveja	2	19	19	3914
bavà	2	1	bava	4	660	661	3915
bavés	2	0	baves	4	79	79	3916
baví	2	2	bavi	2	5	7	3917
baí	2	0	bai	0	639	639	3918
beatificarà	2	9	beatificara	2	0	9	3919
beatificà	2	12	beatifica	2	16	28	3920
beatifiqués	2	1	beatifiques	2	1	2	3921
beatífic	0	56	beatific	2	0	56	3922
beatífica	0	65	beatifica	2	16	81	3923
beatífiques	0	7	beatifiques	2	1	8	3924
becarà	2	31	becara	2	0	31	3925
becà	2	0	beca	4	11765	11765	3926
becàrem	2	0	becarem	2	1	1	3927
becàreu	2	1	becareu	2	0	1	3928
becària	0	462	becaria	2	40	502	3929
becàries	0	81	becaries	2	5	86	3930
befarà	2	1	befara	2	0	1	3931
befà	2	0	befa	4	441	441	3932
befés	2	0	befes	4	44	44	3933
befí	2	0	befi	2	1	1	3934
begallà	2	0	begalla	2	1	1	3935
begués	2	65	begues	4	2314	2379	3936
beguí	0	8	begui	2	299	307	3937
belegués	2	0	belegues	2	1	1	3938
belegà	2	1	belega	2	0	1	3939
bellugarà	2	15	bellugara	2	0	15	3940
bellugués	2	12	bellugues	4	19	31	3941
belluguí	2	5	bellugui	2	65	70	3942
bellugà	2	8	belluga	4	674	682	3943
bellugàrem	2	0	bellugarem	2	6	6	3944
bellugó	4	1	bellugo	2	33	34	3945
belà	2	0	bela	4	325	325	3946
belàreu	2	0	belareu	2	1	1	3947
belés	2	1	beles	2	6	7	3948
belí	2	0	beli	2	96	96	3949
beneficarà	2	3	beneficara	2	0	3	3950
beneficiarà	2	1794	beneficiara	2	17	1811	3951
beneficià	2	104	beneficia	2	5126	5230	3952
beneficiàrem	2	1	beneficiarem	2	69	70	3953
beneficiàreu	2	0	beneficiareu	2	24	24	3954
beneficiària	0	1372	beneficiaria	2	697	2069	3955
beneficiàries	0	2628	beneficiaries	2	142	2770	3956
beneficiés	2	82	beneficies	2	49	131	3957
beneficií	2	12	beneficii	2	28	40	3958
beneficà	2	2	benefica	2	38	40	3959
benefiqués	2	0	benefiques	2	13	13	3960
benefiquí	2	1	benefiqui	2	0	1	3961
beneírem	2	0	beneirem	2	16	16	3962
beneíreu	2	2	beneireu	2	0	2	3963
benferrí	0	0	benferri	4	24	24	3964
beniferrí	0	0	beniferri	4	55	55	3965
benimelí	0	0	benimeli	4	76	76	3966
benissodà	0	0	benissoda	4	80	80	3967
benissuerà	0	0	benissuera	4	35	35	3968
benveuré	2	0	benveure	4	5	5	3969
benèfic	0	1904	benefic	2	20	1924	3970
benèfica	0	1658	benefica	2	38	1696	3971
benèfiques	0	998	benefiques	2	13	1011	3972
bequés	2	3	beques	4	19785	19788	3973
bequí	2	0	bequi	2	5	5	3974
berenarà	2	5	berenara	2	0	5	3975
berenà	2	2	berena	4	110	112	3976
berenàrem	2	18	berenarem	2	66	84	3977
berenàreu	2	0	berenareu	2	1	1	3978
berenés	2	0	berenes	4	18	18	3979
berení	2	0	bereni	2	3	3	3980
berlinès	0	330	berlines	4	98	428	3981
berlinés	0	16	berlines	4	98	114	3982
besarà	2	7	besara	2	6	13	3983
bescantà	2	0	bescanta	2	16	16	3984
bescantí	2	0	bescanti	2	1	1	3985
bescanviarà	2	31	bescanviara	2	1	32	3986
bescanvià	2	9	bescanvia	2	66	75	3987
bescanviàrem	2	2	bescanviarem	2	6	8	3988
bescanviàreu	2	0	bescanviareu	2	1	1	3989
bescanviés	2	3	bescanvies	2	1	4	3990
bescanvií	2	1	bescanvii	2	0	1	3991
bescavàreu	2	1	bescavareu	2	0	1	3992
bescaví	2	0	bescavi	2	1	1	3993
bescomptà	2	0	bescompta	2	1	1	3994
bescomptés	2	0	bescomptes	2	4	4	3995
bescuités	2	0	bescuites	2	1	1	3996
besllumenà	2	0	besllumena	2	1	1	3997
besllumà	2	0	beslluma	2	13	13	3998
besllumàrem	2	0	besllumarem	2	1	1	3999
besllumèn	2	0	besllumen	2	9	9	4000
besllumés	2	1	besllumes	2	0	1	4001
besnét	4	441	besnet	4	90	531	4002
besnéta	4	208	besneta	4	36	244	4003
besnétes	4	41	besnetes	4	10	51	4004
besnéts	4	374	besnets	4	57	431	4005
bessonà	2	1	bessona	2	582	583	4006
bessonés	2	0	bessones	2	2180	2180	4007
bessoní	2	0	bessoni	2	1	1	4008
bestialitzà	2	0	bestialitza	2	4	4	4009
bestiegí	2	0	bestiegi	2	1	1	4010
bestiejà	2	0	bestieja	2	1	1	4011
bestornà	2	1	bestorna	2	0	1	4012
besà	2	71	besa	2	764	835	4013
besàrem	2	5	besarem	2	5	10	4014
besàreu	2	0	besareu	2	4	4	4015
besés	2	12	beses	2	41	53	4016
besí	2	3	besi	2	55	58	4017
betés	4	12	betes	4	326	338	4018
beuré	2	165	beure	4	13142	13307	4019
bifurcarà	2	8	bifurcara	2	3	11	4020
bifurcà	2	3	bifurca	2	523	526	4021
bifurqués	2	1	bifurques	2	1	2	4022
bifurquí	2	0	bifurqui	2	6	6	4023
biguetà	0	2	bigueta	4	91	93	4024
billonés	2	0	billones	2	10	10	4025
binà	2	7	bina	2	42	49	4026
binària	0	778	binaria	2	75	853	4027
binàries	0	449	binaries	2	14	463	4028
binés	2	0	bines	2	4	4	4029
biní	2	0	bini	2	115	115	4030
bioacumulà	2	0	bioacumula	2	3	3	4031
biografiarà	2	1	biografiara	2	0	1	4032
biografià	2	3	biografia	4	10695	10698	4033
biografiés	2	0	biografies	4	3041	3041	4034
biografií	2	0	biografii	2	1	1	4035
bioscà	0	1	biosca	4	1269	1270	4036
biosintetitzà	2	0	biosintetitza	2	4	4	4037
biosintetitzí	2	0	biosintetitzi	2	1	1	4038
birbà	2	1	birba	2	123	124	4039
birbés	2	0	birbes	2	1	1	4040
birbó	4	0	birbo	2	2	2	4041
birlà	2	0	birla	4	20	20	4042
birlés	2	1	birles	4	114	115	4043
birlí	2	1	birli	2	3	4	4044
bisecarà	2	1	bisecara	2	0	1	4045
bisecà	2	0	biseca	2	3	3	4046
bisellà	2	0	bisella	2	2	2	4047
bisà	2	6	bisa	4	153	159	4048
bisés	2	1	bises	4	10	11	4049
bisí	2	0	bisi	2	20	20	4050
bisó	4	271	biso	2	25	296	4051
bitllà	2	1	bitlla	4	133	134	4052
bitllés	2	0	bitlles	4	2437	2437	4053
bità	2	0	bita	4	29	29	4054
bitè	4	3	bite	2	73	76	4055
bité	4	0	bite	2	73	73	4056
bités	2	0	bites	4	90	90	4057
bití	2	1	biti	2	14	15	4058
bitò	4	207	bito	2	44	251	4059
bitó	4	101	bito	2	44	145	4060
bivaquejà	2	0	bivaqueja	2	1	1	4061
blandà	2	0	blanda	2	96	96	4062
blandés	2	0	blandes	2	7	7	4063
blanejàreu	2	1	blanejareu	2	0	1	4064
blanquegés	2	3	blanqueges	2	2	5	4065
blanquegí	2	0	blanquegi	2	34	34	4066
blanquejarà	2	2	blanquejara	2	0	2	4067
blanquejà	2	3	blanqueja	2	91	94	4068
blanquejàrem	2	0	blanquejarem	2	16	16	4069
blasfemà	2	0	blasfema	0	71	71	4070
blasfemés	2	1	blasfemes	0	27	28	4071
blasfemí	2	0	blasfemi	2	1	1	4072
blasmarà	2	3	blasmara	2	0	3	4073
blasmà	2	18	blasma	2	86	104	4074
blasmàrem	2	0	blasmarem	2	4	4	4075
blasmàreu	2	1	blasmareu	2	0	1	4076
blasmés	2	3	blasmes	2	20	23	4077
blasmí	2	0	blasmi	2	12	12	4078
blasonà	2	0	blasona	2	2	2	4079
blasonés	2	0	blasones	2	7	7	4080
blastomà	2	0	blastoma	4	3	3	4081
blastomàreu	2	0	blastomareu	2	1	1	4082
blastomés	2	0	blastomes	4	1	1	4083
blavejà	2	0	blaveja	2	5	5	4084
blaürarà	2	2	blaürara	2	0	2	4085
blaürà	2	0	blaüra	4	4	4	4086
blaürés	2	0	blaüres	4	9	9	4087
bledà	0	3	bleda	4	974	977	4088
blegarà	2	2	blegara	2	0	2	4089
blegués	2	0	blegues	2	1	1	4090
bleguí	2	0	blegui	2	1	1	4091
blegà	2	0	blega	2	15	15	4092
bleixà	2	1	bleixa	2	7	8	4093
bleixí	2	0	bleixi	2	1	1	4094
blindarà	2	36	blindara	2	2	38	4095
blindà	2	4	blinda	2	188	192	4096
blindàrem	2	0	blindarem	2	9	9	4097
blindés	2	13	blindes	2	0	13	4098
blindí	2	0	blindi	2	83	83	4099
blocarà	2	16	blocara	2	1	17	4100
blocà	2	2	bloca	2	303	305	4101
bloguegés	2	0	blogueges	2	2	2	4102
bloguejà	2	0	blogueja	2	2	2	4103
bloquegés	2	61	bloqueges	2	25	86	4104
bloquegí	2	0	bloquegi	2	349	349	4105
bloquejarà	2	183	bloquejara	2	3	186	4106
bloquejà	2	35	bloqueja	2	1746	1781	4107
bloquejàrem	2	1	bloquejarem	2	19	20	4108
bloquejàreu	2	0	bloquejareu	2	2	2	4109
bloqués	2	1	bloques	2	26	27	4110
bloquí	2	0	bloqui	2	8	8	4111
bobinà	2	0	bobina	4	976	976	4112
bobinés	2	0	bobines	4	755	755	4113
bobiní	2	0	bobini	2	1	1	4114
bobò	4	1	bobo	0	186	187	4115
bocés	2	0	boces	4	2	2	4116
bocí	4	1303	boci	2	70	1373	4117
bofegués	2	0	bofegues	2	1	1	4118
bogegí	2	0	bogegi	2	1	1	4119
bogejà	2	0	bogeja	2	15	15	4120
bogués	2	0	bogues	4	75	75	4121
boguí	2	0	bogui	2	13	13	4122
bogà	2	1	boga	4	371	372	4123
boiarà	2	0	boiara	2	1	1	4124
boicotarà	2	3	boicotara	2	0	3	4125
boicotegés	2	9	boicoteges	2	3	12	4126
boicotegí	2	0	boicotegi	2	30	30	4127
boicotejarà	2	13	boicotejara	2	0	13	4128
boicotejà	2	19	boicoteja	2	84	103	4129
boicotejàrem	2	2	boicotejarem	2	1	3	4130
boicotejàreu	2	0	boicotejareu	2	1	1	4131
boicotà	2	0	boicota	2	4	4	4132
boicotàrem	2	0	boicotarem	2	1	1	4133
boicotés	2	1	boicotes	2	0	1	4134
boicotí	2	0	boicoti	2	1	1	4135
boirà	2	1	boira	4	9695	9696	4136
boirés	2	0	boires	4	1473	1473	4137
boirí	2	1	boiri	2	0	1	4138
boixà	2	1	boixa	4	160	161	4139
boixàreu	2	0	boixareu	2	133	133	4140
boixés	2	3	boixes	4	90	93	4141
boixí	2	2	boixi	2	0	2	4142
boià	2	5	boia	4	908	913	4143
boiés	2	0	boies	4	790	790	4144
bolcarà	2	53	bolcara	2	3	56	4145
bolcà	2	31	bolca	4	402	433	4146
bolcàrem	2	3	bolcarem	2	8	11	4147
boleià	2	0	boleia	4	10	10	4148
boleí	2	0	bolei	4	23	23	4149
bollirà	2	4	bollira	2	0	4	4150
bollà	2	0	bolla	4	351	351	4151
bollés	2	0	bolles	4	193	193	4152
bollí	2	0	bolli	2	8	8	4153
bollírem	2	0	bollirem	2	3	3	4154
bolqués	2	39	bolques	4	11	50	4155
bolquí	2	1	bolqui	2	30	31	4156
boló	4	9	bolo	4	719	728	4157
bombardegés	2	21	bombardeges	2	2	23	4158
bombardegí	2	0	bombardegi	2	24	24	4159
bombardejarà	2	15	bombardejara	2	0	15	4160
bombardejà	2	60	bombardeja	2	249	309	4161
bombardejàrem	2	1	bombardejarem	2	4	5	4162
bombardejàreu	2	0	bombardejareu	2	1	1	4163
bombarà	2	4	bombara	2	4	8	4164
bombegés	2	1	bombeges	2	0	1	4165
bombegí	2	0	bombegi	2	3	3	4166
bombejarà	2	4	bombejara	2	0	4	4167
bombejà	2	1	bombeja	2	108	109	4168
bombollegí	2	0	bombollegi	2	2	2	4169
bombollejarà	2	1	bombollejara	2	0	1	4170
bombollejà	2	0	bombolleja	2	10	10	4171
bombollà	2	0	bombolla	4	6082	6082	4172
bombollés	2	0	bombolles	4	3975	3975	4173
bombà	2	0	bomba	4	11164	11164	4174
bombés	2	2	bombes	4	8399	8401	4175
bombí	2	167	bombi	2	36	203	4176
bombó	4	487	bombo	2	1399	1886	4177
bonegués	2	1	bonegues	2	3	4	4178
bonegà	2	1	bonega	2	2	3	4179
bonegàreu	2	0	bonegareu	2	1	1	4180
bonegó	4	7	bonego	2	0	7	4181
bongós	4	6	bongos	4	130	136	4182
bonificarà	2	147	bonificara	2	3	150	4183
bonificà	2	0	bonifica	2	106	106	4184
bonificàrem	2	0	bonificarem	2	6	6	4185
bonificàreu	2	0	bonificareu	2	1	1	4186
bonifiqués	2	5	bonifiques	2	0	5	4187
bonifiquí	2	0	bonifiqui	2	29	29	4188
bonyigués	2	0	bonyigues	4	10	10	4189
bonyigà	2	0	bonyiga	4	25	25	4190
bonó	4	4	bono	4	1870	1874	4191
boquejarà	2	1	boquejara	2	0	1	4192
boquejà	2	0	boqueja	2	7	7	4193
borbollejà	2	0	borbolleja	2	4	4	4194
borbollejàrem	2	1	borbollejarem	2	0	1	4195
borbollà	2	0	borbolla	2	26	26	4196
borbollés	2	0	borbolles	2	1	1	4197
bordarà	2	5	bordara	2	0	5	4198
bordegí	2	0	bordegi	2	2	2	4199
bordejarà	2	3	bordejara	2	0	3	4200
bordejà	2	0	bordeja	2	77	77	4201
bordejàrem	2	0	bordejarem	2	8	8	4202
bordejàreu	2	0	bordejareu	2	1	1	4203
bordonà	2	0	bordona	2	5	5	4204
bordonés	2	2	bordones	2	10	12	4205
bordoní	2	0	bordoni	2	16	16	4206
bordà	2	1	borda	0	2734	2735	4207
bordàreu	2	0	bordareu	2	1	1	4208
bordés	2	3	bordes	4	1537	1540	4209
bordí	2	0	bordi	2	15	15	4210
bordís	4	4	bordis	2	2	6	4211
bordó	4	341	bordo	2	139	480	4212
borinotejàrem	2	1	borinotejarem	2	0	1	4213
borinotejàreu	2	1	borinotejareu	2	0	1	4214
borinà	2	1	borina	4	38	39	4215
borinés	2	0	borines	4	1	1	4216
boriní	2	0	borini	2	8	8	4217
borlà	2	0	borla	4	146	146	4218
borlàreu	2	1	borlareu	2	0	1	4219
borlés	2	0	borles	4	172	172	4220
borlí	2	1	borli	2	0	1	4221
bornejàrem	2	0	bornejarem	2	1	1	4222
bornà	2	0	borna	2	50	50	4223
bornés	2	0	bornes	2	23	23	4224
borní	2	2	borni	2	471	473	4225
borrasquejarà	2	1	borrasquejara	2	0	1	4226
borratxejà	2	0	borratxeja	2	1	1	4227
borrejarà	2	1	borrejara	2	0	1	4228
borrejà	2	1	borreja	2	0	1	4229
borrimà	2	0	borrima	2	1	1	4230
borronés	2	0	borrones	2	4	4	4231
borroní	2	0	borroni	2	2	2	4232
borrufà	2	0	borrufa	4	75	75	4233
borà	2	7	bora	4	696	703	4234
borí	2	6	bori	4	312	318	4235
borín	2	1	borin	2	19	20	4236
borís	2	588	boris	4	2299	2887	4237
boscós	0	395	boscos	4	28015	28410	4238
bosquetà	0	14	bosqueta	4	60	74	4239
bosqués	2	0	bosques	2	139	139	4240
bosquí	2	0	bosqui	2	7	7	4241
bossellí	2	0	bosselli	2	2	2	4242
botarà	2	15	botara	2	6	21	4243
botejarà	2	0	botejara	2	3	3	4244
botejà	2	0	boteja	2	2	2	4245
botirà	2	1	botira	2	0	1	4246
botonà	2	0	botona	2	7	7	4247
botonés	2	0	botones	2	62	62	4248
botoní	2	0	botoni	2	2	2	4249
botré	2	0	botre	2	10	10	4250
botzinà	2	1	botzina	4	518	519	4251
botzinés	2	1	botzines	4	153	154	4252
botà	2	23	bota	4	3060	3083	4253
botàrem	2	0	botarem	2	10	10	4254
boté	2	30	bote	2	665	695	4255
botés	2	14	botes	4	6155	6169	4256
botí	2	1825	boti	2	191	2016	4257
botís	2	1	botis	2	3	4	4258
botó	4	21097	boto	2	297	21394	4259
boxejà	2	0	boxeja	2	3	3	4260
boxà	2	0	boxa	4	1956	1956	4261
boxàreu	2	0	boxareu	2	1	1	4262
boxés	2	0	boxes	4	1182	1182	4263
boxí	2	1	boxi	2	5	6	4264
boà	4	13	boa	4	423	436	4265
boçà	2	1	boça	4	3	4	4266
bracejà	2	1	braceja	2	11	12	4267
bramarà	2	5	bramara	2	1	6	4268
bramulà	2	0	bramula	2	19	19	4269
bramulés	2	1	bramules	2	0	1	4270
bramulí	2	0	bramuli	2	1	1	4271
bramà	2	13	brama	4	723	736	4272
bramés	2	1	brames	4	19	20	4273
bramí	2	0	brami	2	22	22	4274
brancà	2	2	branca	4	11730	11732	4275
brancó	4	8	branco	2	158	166	4276
brandarà	2	4	brandara	2	0	4	4277
brandejà	2	0	brandeja	2	1	1	4278
brandirà	2	1	brandira	2	0	1	4279
brandà	2	8	branda	4	141	149	4280
brandàrem	2	0	brandarem	2	2	2	4281
brandés	2	0	brandes	4	69	69	4282
brandí	2	1	brandi	2	517	518	4283
brandís	2	0	brandis	2	58	58	4284
brandó	4	8	brando	2	359	367	4285
branqués	2	0	branques	4	12516	12516	4286
branquí	2	0	branqui	2	1	1	4287
braolà	2	2	braola	2	1	3	4288
bravegés	2	0	braveges	2	2	2	4289
bravegí	2	0	bravegi	2	2	2	4290
bravejà	2	1	braveja	2	25	26	4291
brecà	2	0	breca	2	4	4	4292
bregarà	2	5	bregara	2	0	5	4293
breguejà	2	0	bregueja	2	1	1	4294
bregués	2	2	bregues	4	164	166	4295
breguí	2	0	bregui	2	3	3	4296
bregà	2	5	brega	4	578	583	4297
bregàrem	2	0	bregarem	2	2	2	4298
bregàreu	2	0	bregareu	2	1	1	4299
brellà	2	0	brella	2	2	2	4300
brequés	2	0	breques	2	1	1	4301
brescà	2	0	bresca	4	221	221	4302
bresqués	2	0	bresques	4	146	146	4303
bressolarà	2	5	bressolara	2	0	5	4304
bressolà	2	4	bressola	4	1201	1205	4305
bressolàrem	2	0	bressolarem	2	1	1	4306
bressolés	2	3	bressoles	4	27	30	4307
bressolí	2	3	bressoli	2	11	14	4308
bressà	2	2	bressa	2	33	35	4309
bressàrem	2	1	bressarem	2	0	1	4310
bressés	2	0	bresses	2	1	1	4311
bressí	2	0	bressi	2	5	5	4312
bresà	2	0	bresa	4	95	95	4313
bresés	2	0	breses	4	1	1	4314
bresí	2	0	bresi	2	1	1	4315
brillarà	2	128	brillara	2	8	136	4316
brillà	2	34	brilla	4	2090	2124	4317
brillàrem	2	0	brillarem	2	1	1	4318
brillàreu	2	0	brillareu	2	3	3	4319
brillés	2	38	brilles	4	28	66	4320
brillí	2	0	brilli	2	252	252	4321
brilló	4	2	brillo	2	302	304	4322
brindarà	2	429	brindara	2	1	430	4323
brindà	2	49	brinda	2	3188	3237	4324
brindàrem	2	13	brindarem	2	126	139	4325
brindàreu	2	1	brindareu	2	3	4	4326
brindés	2	33	brindes	2	13	46	4327
brindí	2	0	brindi	2	223	223	4328
brisà	2	2	brisa	4	2516	2518	4329
brisés	2	0	brises	4	297	297	4330
britanitzà	2	0	britanitza	2	2	2	4331
brivà	2	0	briva	4	50	50	4332
briós	0	18	brios	4	4	22	4333
brodarà	2	2	brodara	2	0	2	4334
brodà	2	7	broda	2	248	255	4335
brodàrem	2	0	brodarem	2	3	3	4336
brodés	2	1	brodes	2	12	13	4337
brodí	2	0	brodi	2	14	14	4338
brofegà	2	1	brofega	2	0	1	4339
brogirà	2	1	brogira	2	0	1	4340
brollarà	2	53	brollara	2	1	54	4341
brollà	2	36	brolla	4	1757	1793	4342
brollàrem	2	1	brollarem	2	0	1	4343
brollàreu	2	1	brollareu	2	2	3	4344
brollés	2	26	brolles	4	372	398	4345
brollí	2	0	brolli	2	85	85	4346
bromegés	2	0	bromeges	2	1	1	4347
bromegí	2	0	bromegi	2	1	1	4348
bromejarà	2	1	bromejara	2	0	1	4349
bromejà	2	4	bromeja	2	121	125	4350
bromà	2	0	broma	4	9027	9027	4351
bromés	2	0	bromes	4	3188	3188	4352
bromí	2	0	bromi	2	4	4	4353
bronzegés	2	0	bronzeges	2	2	2	4354
bronzegí	2	0	bronzegi	2	2	2	4355
bronzejà	2	0	bronzeja	2	30	30	4356
bronzà	2	0	bronza	2	2	2	4357
bronzés	2	1	bronzes	2	754	755	4358
bronzí	2	1	bronzi	2	3	4	4359
broqués	2	0	broques	4	216	216	4360
brossà	2	0	brossa	4	10952	10952	4361
brossés	2	0	brosses	4	172	172	4362
brossí	2	0	brossi	2	1	1	4363
brostarà	2	4	brostara	2	0	4	4364
brostejà	2	0	brosteja	2	1	1	4365
brostà	2	0	brosta	4	38	38	4366
brostés	2	1	brostes	4	3	4	4367
brostí	2	0	brosti	2	1	1	4368
brotarà	2	14	brotara	2	1	15	4369
brotonà	2	0	brotona	2	1	1	4370
brotxà	2	0	brotxa	4	263	263	4371
brotxés	2	0	brotxes	4	93	93	4372
brotxí	2	1	brotxi	2	0	1	4373
brotà	2	11	brota	2	171	182	4374
brotàrem	2	0	brotarem	2	1	1	4375
brotés	2	5	brotes	2	36	41	4376
brotí	2	1	broti	2	25	26	4377
bruelà	2	3	bruela	2	2	5	4378
brufolí	2	0	brufoli	2	1	1	4379
brufà	2	1	brufa	2	3	4	4380
brufàrem	2	1	brufarem	2	1	2	4381
brufí	2	0	brufi	2	1	1	4382
brugolés	2	0	brugoles	2	1	1	4383
bruixà	2	0	bruixa	4	4833	4833	4384
bruixàrem	2	1	bruixarem	2	0	1	4385
bruixés	2	0	bruixes	4	7405	7405	4386
bruixí	2	0	bruixi	2	1	1	4387
bruixó	4	0	bruixo	2	2	2	4388
brullés	2	1	brulles	4	22	23	4389
brullí	2	0	brulli	2	1	1	4390
brunyírem	2	0	brunyirem	2	2	2	4391
brunzinàreu	2	1	brunzinareu	2	0	1	4392
brunzí	2	3	brunzi	2	1	4	4393
brunzín	2	0	brunzin	2	1	1	4394
brunzís	2	1	brunzis	2	0	1	4395
brusquegés	2	1	brusqueges	2	0	1	4396
brussel·lès	0	40	brussel·les	4	19213	19253	4397
brussel·lés	0	0	brussel·les	4	19213	19213	4398
brutejà	2	0	bruteja	2	12	12	4399
bròfega	0	15	brofega	2	0	15	4400
bròfegues	0	6	brofegues	2	0	6	4401
brúfol	4	20	brufol	4	0	20	4402
brúfols	4	6	brufols	4	0	6	4403
bubà	2	0	buba	4	88	88	4404
bubés	2	0	bubes	4	6	6	4405
bubí	2	2	bubi	2	60	62	4406
bubó	4	20	bubo	2	188	208	4407
bufarà	2	439	bufara	2	8	447	4408
bufegà	2	0	bufega	2	1	1	4409
bufetegés	2	1	bufeteges	2	0	1	4410
bufetejarà	2	1	bufetejara	2	0	1	4411
bufetejà	2	4	bufeteja	2	31	35	4412
bufà	2	38	bufa	0	2879	2917	4413
bufàrem	2	1	bufarem	2	15	16	4414
bufàreu	2	1	bufareu	2	1	2	4415
bufés	2	52	bufes	0	137	189	4416
bufí	2	114	bufi	2	227	341	4417
bufó	0	743	bufo	2	204	947	4418
bugonés	2	0	bugones	2	1	1	4419
buidarà	2	76	buidara	2	6	82	4420
buidà	2	28	buida	4	7193	7221	4421
buidàrem	2	5	buidarem	2	23	28	4422
buidàreu	2	0	buidareu	2	2	2	4423
buidés	2	46	buides	4	4774	4820	4424
buidí	2	0	buidi	2	131	131	4425
buixardà	2	0	buixarda	4	73	73	4426
buixardàrem	2	0	buixardarem	2	1	1	4427
buixardés	2	0	buixardes	4	1	1	4428
bullirà	2	42	bullira	2	0	42	4429
bullí	2	9	bulli	2	2039	2048	4430
bullírem	2	0	bullirem	2	114	114	4431
bullíreu	2	0	bullireu	2	7	7	4432
bullís	2	8	bullis	2	12	20	4433
burgès	0	2003	burges	4	39	2042	4434
burgés	0	340	burges	4	39	379	4435
burgí	2	1	burgi	2	8	9	4436
burinà	2	0	burina	2	4	4	4437
burinàrem	2	1	burinarem	2	0	1	4438
buriní	2	0	burini	2	3	3	4439
burjà	2	0	burja	4	4	4	4440
burlarà	2	5	burlara	2	3	8	4441
burlà	2	14	burla	4	2115	2129	4442
burlàreu	2	0	burlareu	2	3	3	4443
burlés	2	11	burles	4	727	738	4444
burlí	2	0	burli	2	21	21	4445
burocratitzà	2	0	burocratitza	2	12	12	4446
burocratitzés	2	1	burocratitzes	2	0	1	4447
burocratitzí	2	0	burocratitzi	2	3	3	4448
burxarà	2	9	burxara	2	0	9	4449
burxinarà	2	1	burxinara	2	0	1	4450
burxinà	2	0	burxina	2	2	2	4451
burxà	2	6	burxa	4	230	236	4452
burxés	2	5	burxes	4	4	9	4453
burxí	2	0	burxi	2	3	3	4454
burxín	2	0	burxin	2	9	9	4455
burxó	4	5	burxo	2	9	14	4456
buscallà	2	51	buscalla	2	27	78	4457
buscallés	2	0	buscalles	2	1	1	4458
buscarà	2	2398	buscara	2	44	2442	4459
buscà	2	274	busca	4	35105	35379	4460
buscàrem	2	28	buscarem	2	1133	1161	4461
buscàreu	2	2	buscareu	2	42	44	4462
busqués	2	409	busques	4	4480	4889	4463
busquí	2	4	busqui	2	3331	3335	4464
bussegés	2	1	busseges	2	9	10	4465
bussegí	2	0	bussegi	2	3	3	4466
bussejarà	2	1	bussejara	2	0	1	4467
bussejà	2	0	busseja	2	80	80	4468
bussejàrem	2	0	bussejarem	2	4	4	4469
bustiarà	2	2	bustiara	2	0	2	4470
bustià	2	0	bustia	2	100	100	4471
bustiés	2	0	busties	2	21	21	4472
butllà	2	0	butlla	4	1348	1348	4473
butllés	2	0	butlles	4	224	224	4474
butxaquejà	2	1	butxaqueja	2	2	3	4475
bàbol	4	1	babol	4	5	6	4476
bàner	4	256	baner	4	63	319	4477
bàners	4	218	baners	4	53	271	4478
bàrbar	0	533	barbar	2	31	564	4479
bàscula	4	953	bascula	2	260	1213	4480
bàscules	4	253	bascules	2	20	273	4481
bàsquet	4	26093	basquet	4	1214	27307	4482
bàsquets	4	68	basquets	4	10	78	4483
bàtec	4	9	batec	4	1973	1982	4484
bàtecs	4	3	batecs	4	1021	1024	4485
bàvar	0	14	bavar	2	11	25	4486
bàvara	0	24	bavara	2	2	26	4487
bàvares	0	2	bavares	2	3	5	4488
bèlit	4	654	belit	4	11	665	4489
bèlits	4	35	belits	4	1	36	4490
bèstia	0	5975	bestia	4	630	6605	4491
bèsties	0	4633	besties	4	231	4864	4492
bé	1	500916	be	4	29498	530414	4493
béns	4	31095	bens	4	3731	34826	4494
bígam	0	6	bigam	4	22	28	4495
bígams	0	2	bigams	4	1	3	4496
bòfega	4	3	bofega	2	0	3	4497
bòfegues	4	5	bofegues	2	1	6	4498
bòries	4	11	bories	2	6	17	4499
bòston	4	36	boston	4	4324	4360	4500
bóta	4	2442	bota	4	3060	5502	4501
bótes	4	1887	botes	4	6155	8042	4502
bústia	4	4661	bustia	2	100	4761	4503
bústies	4	1224	busties	2	21	1245	4504
cabdellà	2	4	cabdella	4	273	277	4505
cabdellàrem	2	0	cabdellarem	2	1	1	4506
cabdellés	2	0	cabdelles	2	1	1	4507
cabecés	2	2	cabeces	4	63	65	4508
cabestrés	2	0	cabestres	4	11	11	4509
cabetejà	2	0	cabeteja	2	1	1	4510
cabeçà	2	0	cabeça	4	316	316	4511
cablejarà	2	1	cablejara	2	0	1	4512
cablejà	2	0	cableja	2	3	3	4513
cablés	2	0	cables	2	5660	5660	4514
cabotejarà	2	1	cabotejara	2	0	1	4515
cabotejà	2	0	caboteja	2	1	1	4516
cabotejàrem	2	1	cabotejarem	2	0	1	4517
cabrafigués	2	0	cabrafigues	4	1	1	4518
cabrafigà	2	0	cabrafiga	4	82	82	4519
cabregés	2	0	cabreges	2	2	2	4520
cabregí	2	0	cabregi	2	5	5	4521
cabrejarà	2	0	cabrejara	2	1	1	4522
cabrejà	2	1	cabreja	2	45	46	4523
cabridà	2	0	cabrida	4	19	19	4524
cabridés	2	0	cabrides	4	5	5	4525
cabriolà	2	0	cabriola	4	58	58	4526
cabriolé	4	15	cabriole	2	1	16	4527
cabriolés	2	5	cabrioles	4	235	240	4528
cabrà	2	95	cabra	4	7220	7315	4529
cabré	2	3270	cabre	2	608	3878	4530
cabussarà	2	1	cabussara	2	0	1	4531
cabussà	2	0	cabussa	2	29	29	4532
cabussàrem	2	0	cabussarem	2	1	1	4533
cabussó	4	71	cabusso	2	3	74	4534
cacés	2	13	caces	4	1358	1371	4535
cací	2	0	caci	2	120	120	4536
cadellarà	2	2	cadellara	2	0	2	4537
cadellà	2	0	cadella	0	18	18	4538
cadenà	2	1	cadena	4	36131	36132	4539
cadenés	2	0	cadenes	4	12105	12105	4540
cadmià	2	0	cadmia	2	1	1	4541
caducarà	2	110	caducara	2	2	112	4542
caducà	2	9	caduca	0	1590	1599	4543
caduqués	2	18	caduques	0	217	235	4544
caduquí	2	1	caduqui	2	150	151	4545
cagaferràreu	2	1	cagaferrareu	2	0	1	4546
cagarà	2	77	cagara	2	3	80	4547
cagués	2	29	cagues	2	177	206	4548
caguí	2	0	cagui	2	154	154	4549
cagà	2	38	caga	2	850	888	4550
cagàrem	2	0	cagarem	2	25	25	4551
cagàreu	2	0	cagareu	2	8	8	4552
cagó	0	8	cago	2	263	271	4553
caigués	2	1186	caigues	2	30	1216	4554
caiguí	2	8	caigui	2	2895	2903	4555
cairegí	2	0	cairegi	2	1	1	4556
cairejà	2	0	caireja	2	1	1	4557
caironí	2	0	caironi	2	2	2	4558
cairà	2	0	caira	2	7	7	4559
cairàrem	2	2	cairarem	2	0	2	4560
cairés	2	0	caires	2	630	630	4561
caixó	4	301	caixo	4	9	310	4562
calabruixà	2	0	calabruixa	4	14	14	4563
calabruixés	2	0	calabruixes	4	3	3	4564
calabruixó	4	8	calabruixo	2	0	8	4565
calabrès	0	53	calabres	4	1	54	4566
calabrés	0	8	calabres	4	1	9	4567
calafatarà	2	1	calafatara	2	0	1	4568
calafategí	2	0	calafategi	2	1	1	4569
calafatejà	2	0	calafateja	2	1	1	4570
calafatés	2	2	calafates	2	3	5	4571
calafatí	2	0	calafati	2	1	1	4572
calandrà	2	2	calandra	4	191	193	4573
calandrés	2	1	calandres	4	10	11	4574
calandrí	2	2	calandri	2	1	3	4575
calarà	2	30	calara	2	5	35	4576
calbejà	2	0	calbeja	2	1	1	4577
calcarà	2	1	calcara	2	9	10	4578
calcarí	0	0	calcari	0	829	829	4579
calcificà	2	0	calcifica	2	5	5	4580
calcificàrem	2	0	calcificarem	2	1	1	4581
calcigués	2	0	calcigues	2	2	2	4582
calciguí	2	0	calcigui	2	10	10	4583
calcigà	2	0	calciga	2	67	67	4584
calcinarà	2	0	calcinara	2	1	1	4585
calcinà	2	6	calcina	4	55	61	4586
calcinés	2	1	calcines	4	0	1	4587
calciní	2	0	calcini	2	3	3	4588
calcularà	2	398	calculara	2	1	399	4589
calculà	2	105	calcula	2	11145	11250	4590
calculàrem	2	8	calcularem	2	85	93	4591
calculàreu	2	0	calculareu	2	2	2	4592
calculés	2	20	calcules	2	43	63	4593
calculí	2	0	calculi	2	156	156	4594
calcà	2	1	calca	4	79	80	4595
calcàrem	2	0	calcarem	2	4	4	4596
calcària	0	2497	calcaria	2	64	2561	4597
calcàries	0	1510	calcaries	2	64	1574	4598
calcès	0	0	calces	4	1249	1249	4599
calcés	0	9	calces	4	1249	1258	4600
calcí	2	3	calci	4	4846	4849	4601
calcín	2	1	calcin	2	16	17	4602
caldegés	2	1	caldeges	2	0	1	4603
caldegí	2	0	caldegi	2	1	1	4604
caldejà	2	2	caldeja	2	24	26	4605
caldós	0	504	caldos	4	350	854	4606
calefactà	2	0	calefacta	2	2	2	4607
calentegés	2	1	calenteges	2	0	1	4608
calfarà	2	2	calfara	2	2	4	4609
calfà	2	0	calfa	2	80	80	4610
calfàrem	2	0	calfarem	2	4	4	4611
calfàreu	2	0	calfareu	2	1	1	4612
calfés	2	0	calfes	2	6	6	4613
calfí	2	0	calfi	2	1	1	4614
calfó	4	7	calfo	2	2	9	4615
calibrarà	2	6	calibrara	2	0	6	4616
calibrà	2	0	calibra	2	75	75	4617
calibràrem	2	0	calibrarem	2	3	3	4618
calibrés	2	3	calibres	2	285	288	4619
calibrí	2	1	calibri	2	22	23	4620
callarà	2	56	callara	2	2	58	4621
callerès	0	5	calleres	4	3	8	4622
callerés	0	0	calleres	4	3	3	4623
callà	2	47	calla	2	2171	2218	4624
callàrem	2	8	callarem	2	250	258	4625
callàreu	2	1	callareu	2	5	6	4626
callés	2	92	calles	4	570	662	4627
callí	2	0	calli	2	297	297	4628
calmarà	2	84	calmara	2	0	84	4629
calmellà	0	0	calmella	4	34	34	4630
calmà	2	19	calma	0	14131	14150	4631
calmàrem	2	0	calmarem	2	4	4	4632
calmés	2	49	calmes	0	173	222	4633
calmí	2	0	calmi	2	165	165	4634
calorejà	2	0	caloreja	2	1	1	4635
calqués	2	4	calques	4	89	93	4636
calquí	2	0	calqui	2	27	27	4637
calumnià	2	4	calumnia	2	109	113	4638
calumniés	2	0	calumnies	2	143	143	4639
cal·ligrafià	2	0	cal·ligrafia	4	1461	1461	4640
cal·ligrafiàreu	2	2	cal·ligrafiareu	2	0	2	4641
cal·ligrafiés	2	0	cal·ligrafies	4	115	115	4642
calà	2	57	cala	4	17218	17275	4643
calàrem	2	2	calarem	2	8	10	4644
calàreu	2	0	calareu	2	1	1	4645
calçarà	2	5	calçara	2	0	5	4646
calçà	2	5	calça	4	550	555	4647
calçàrem	2	1	calçarem	2	19	20	4648
calçó	4	26	calço	2	79	105	4649
calè	0	3	cale	2	146	149	4650
calé	0	55	cale	2	146	201	4651
calés	2	961	cales	4	4629	5590	4652
calí	2	31	cali	4	502	533	4653
calís	4	10	calis	2	18	28	4654
caló	4	646	calo	2	76	722	4655
calúmnia	4	373	calumnia	2	109	482	4656
calúmnies	4	772	calumnies	2	143	915	4657
cambodjà	0	192	cambodja	4	2510	2702	4658
camejà	2	0	cameja	2	1	1	4659
camejàreu	2	0	camejareu	2	1	1	4660
camelès	0	0	cameles	4	34	34	4661
camelés	0	0	cameles	4	34	34	4662
caminarà	2	152	caminara	2	10	162	4663
caminà	2	91	camina	2	5233	5324	4664
caminàrem	2	41	caminarem	2	701	742	4665
caminàreu	2	0	caminareu	2	80	80	4666
caminés	2	84	camines	2	535	619	4667
caminí	2	1	camini	2	333	334	4668
camparà	2	6	campara	2	7	13	4669
campejà	2	0	campeja	2	13	13	4670
campirà	2	0	campira	2	1	1	4671
campàrem	2	0	camparem	2	2	2	4672
campés	2	11	campes	0	19	30	4673
camuflarà	2	5	camuflara	2	0	5	4674
camuflà	2	2	camufla	2	158	160	4675
camuflàrem	2	0	camuflarem	2	2	2	4676
camuflés	2	2	camufles	2	1	3	4677
camuflí	2	0	camufli	2	9	9	4678
canalitzarà	2	137	canalitzara	2	4	141	4679
canalitzà	2	30	canalitza	2	744	774	4680
canalitzàrem	2	0	canalitzarem	2	24	24	4681
canalitzés	2	20	canalitzes	2	10	30	4682
canalitzí	2	0	canalitzi	2	163	163	4683
cancel·larà	2	265	cancel·lara	2	8	273	4684
cancel·là	2	38	cancel·la	2	1254	1292	4685
cancel·làrem	2	1	cancel·larem	2	19	20	4686
cancel·làreu	2	0	cancel·lareu	2	1	1	4687
cancel·lés	2	85	cancel·les	2	52	137	4688
cancel·lí	2	0	cancel·li	2	170	170	4689
candí	2	64	candi	4	520	584	4690
candís	2	0	candis	0	4	4	4691
canejà	2	0	caneja	2	13	13	4692
canonegés	2	0	canoneges	2	2	2	4693
canonejà	2	0	canoneja	2	1	1	4694
canonitzarà	2	6	canonitzara	2	0	6	4695
canonitzà	2	33	canonitza	2	9	42	4696
canonitzàrem	2	0	canonitzarem	2	2	2	4697
canonitzí	2	0	canonitzi	2	2	2	4698
canonés	2	0	canones	2	3	3	4699
canoní	2	0	canoni	2	1	1	4700
cansarà	2	77	cansara	2	5	82	4701
cansà	2	38	cansa	2	1730	1768	4702
cansàrem	2	4	cansarem	2	435	439	4703
cansàreu	2	0	cansareu	2	27	27	4704
cansés	2	17	canses	2	197	214	4705
cansí	2	16	cansi	2	177	193	4706
cantarà	2	702	cantara	2	48	750	4707
cantellejarà	2	2	cantellejara	2	0	2	4708
cantussegés	2	0	cantusseges	2	2	2	4709
cantussejà	2	0	cantusseja	2	14	14	4710
cantussejàrem	2	0	cantussejarem	2	1	1	4711
cantà	2	507	canta	2	7603	8110	4712
cantàrem	2	32	cantarem	2	524	556	4713
cantàreu	2	3	cantareu	2	34	37	4714
cantés	2	243	cantes	2	258	501	4715
canviarà	2	5507	canviara	2	133	5640	4716
canvià	2	1541	canvia	2	23755	25296	4717
canviàrem	2	29	canviarem	2	794	823	4718
canviàreu	2	0	canviareu	2	53	53	4719
canviària	0	73	canviaria	2	1963	2036	4720
canviàries	0	38	canviaries	2	86	124	4721
canviés	2	944	canvies	2	656	1600	4722
canvií	2	46	canvii	2	324	370	4723
cançonejà	2	0	cançoneja	2	1	1	4724
capacitarà	2	150	capacitara	2	0	150	4725
capacità	2	12	capacita	2	997	1009	4726
capacitàrem	2	1	capacitarem	2	3	4	4727
capacités	2	9	capacites	2	4	13	4728
capacití	2	0	capaciti	2	142	142	4729
caparró	4	253	caparro	4	3	256	4730
caparrós	4	614	caparros	4	9	623	4731
capbaixà	2	0	capbaixa	0	2	2	4732
capbaixés	2	0	capbaixes	0	2	2	4733
capbrevà	2	6	capbreva	2	2	8	4734
capbussarà	2	8	capbussara	2	0	8	4735
capbussà	2	9	capbussa	2	256	265	4736
capbussàrem	2	1	capbussarem	2	9	10	4737
capbussàreu	2	0	capbussareu	2	1	1	4738
capbussés	2	2	capbusses	2	22	24	4739
capbussí	2	0	capbussi	2	11	11	4740
capbussó	4	78	capbusso	2	39	117	4741
capcinejà	2	0	capcineja	2	1	1	4742
capcés	2	0	capces	4	48	48	4743
capegés	2	1	capeges	2	1	2	4744
capegí	2	0	capegi	2	1	1	4745
capejà	2	0	capeja	2	11	11	4746
capellanejà	2	1	capellaneja	2	0	1	4747
capellés	2	0	capelles	4	4498	4498	4748
capellí	2	1	capelli	2	28	29	4749
capficarà	2	1	capficara	2	1	2	4750
capficà	2	5	capfica	2	71	76	4751
capficàrem	2	1	capficarem	2	0	1	4752
capficàreu	2	1	capficareu	2	0	1	4753
capficó	4	7	capfico	2	59	66	4754
capfiqués	2	2	capfiques	2	10	12	4755
capfiquí	2	0	capfiqui	2	15	15	4756
capgirarà	2	100	capgirara	2	4	104	4757
capgirà	2	66	capgira	2	733	799	4758
capgiràrem	2	0	capgirarem	2	18	18	4759
capgirés	2	31	capgires	2	10	41	4760
capgirí	2	0	capgiri	2	60	60	4761
capgiró	4	0	capgiro	2	7	7	4762
capguardà	2	0	capguarda	2	1	1	4763
capiculà	2	0	capicula	2	1	1	4764
capiculàrem	2	0	capicularem	2	1	1	4765
capirà	2	6	capira	2	5	11	4766
capitalitzarà	2	16	capitalitzara	2	0	16	4767
capitalitzà	2	5	capitalitza	2	96	101	4768
capitalitzàrem	2	0	capitalitzarem	2	3	3	4769
capitalitzés	2	4	capitalitzes	2	1	5	4770
capitalitzí	2	0	capitalitzi	2	17	17	4771
capitanegés	2	3	capitaneges	2	1	4	4772
capitanegí	2	0	capitanegi	2	7	7	4773
capitanejarà	2	22	capitanejara	2	0	22	4774
capitanejà	2	27	capitaneja	2	146	173	4775
capitanejàreu	2	0	capitanejareu	2	1	1	4776
capitolí	0	82	capitoli	4	537	619	4777
capitombà	2	0	capitomba	4	4	4	4778
capitombés	2	0	capitombes	4	2	2	4779
capitonà	2	0	capitona	2	1	1	4780
capitonés	2	1	capitones	2	1	2	4781
capitoní	2	0	capitoni	2	1	1	4782
capitularà	2	4	capitulara	2	0	4	4783
capitulà	2	67	capitula	2	50	117	4784
capitulés	2	5	capitules	2	0	5	4785
capitulí	2	0	capituli	2	5	5	4786
capllaçà	2	0	capllaça	2	1	1	4787
caplletrà	2	0	caplletra	4	198	198	4788
caplletrés	2	0	caplletres	4	116	116	4789
capllevà	2	1	caplleva	2	4	5	4790
capllevés	2	0	caplleves	2	1	1	4791
capolarà	2	1	capolara	2	0	1	4792
capolà	2	1	capola	2	14	15	4793
capolàrem	2	0	capolarem	2	2	2	4794
capolí	2	0	capoli	2	2	2	4795
caponà	2	0	capona	2	132	132	4796
caponés	2	0	capones	2	1	1	4797
caponí	2	0	caponi	2	8	8	4798
capotà	2	0	capota	4	127	127	4799
capotés	2	0	capotes	4	20	20	4800
capotí	2	1	capoti	2	0	1	4801
capritxós	0	281	capritxos	4	399	680	4802
caprí	0	198	capri	4	671	869	4803
captarà	2	105	captara	2	5	110	4804
capterrerà	2	0	capterrera	4	2	2	4805
captindré	2	0	captindre	2	2	2	4806
captingués	2	4	captingues	2	0	4	4807
captinguí	2	0	captingui	2	1	1	4808
captivarà	2	200	captivara	2	5	205	4809
captivà	2	53	captiva	0	1232	1285	4810
captivàrem	2	0	captivarem	2	2	2	4811
captivés	2	12	captives	0	104	116	4812
captiví	2	0	captivi	2	54	54	4813
capturarà	2	50	capturara	2	4	54	4814
capturà	2	205	captura	4	10128	10333	4815
capturàrem	2	5	capturarem	2	16	21	4816
capturàreu	2	0	capturareu	2	3	3	4817
capturés	2	55	captures	4	3594	3649	4818
capturí	2	1	capturi	2	97	98	4819
captà	2	59	capta	4	1823	1882	4820
captàrem	2	3	captarem	2	39	42	4821
captàreu	2	0	captareu	2	1	1	4822
capté	2	19	capte	2	21	40	4823
captén	2	0	capten	2	948	948	4824
captés	2	43	captes	4	86	129	4825
captí	2	0	capti	2	215	215	4826
captín	2	0	captin	2	154	154	4827
capà	2	1	capa	4	24760	24761	4828
capçà	2	0	capça	4	91	91	4829
capçó	4	3	capço	2	1	4	4830
capés	2	0	capes	4	13776	13776	4831
capí	2	3	capi	2	367	370	4832
capíeu	2	1	capieu	2	0	1	4833
capíreu	2	0	capireu	2	2	2	4834
capís	2	1	capis	2	58	59	4835
capíssem	2	1	capissem	2	0	1	4836
capítula	4	0	capitula	2	50	50	4837
capítules	4	1	capitules	2	0	1	4838
caracteritzarà	2	190	caracteritzara	2	3	193	4839
caracteritzà	2	443	caracteritza	2	16601	17044	4840
caracteritzàrem	2	1	caracteritzarem	2	8	9	4841
caracteritzés	2	18	caracteritzes	2	4	22	4842
caracteritzí	2	4	caracteritzi	2	150	154	4843
caragolà	2	5	caragola	4	72	77	4844
caragolàrem	2	0	caragolarem	2	1	1	4845
caragolés	2	0	caragoles	4	27	27	4846
caragolí	2	32	caragoli	2	3	35	4847
caramel·litzarà	2	9	caramel·litzara	2	0	9	4848
caramel·litzà	2	1	caramel·litza	2	17	18	4849
caramel·litzàrem	2	0	caramel·litzarem	2	3	3	4850
caramel·litzés	2	0	caramel·litzes	2	1	1	4851
caramel·litzí	2	0	caramel·litzi	2	37	37	4852
caramullà	2	1	caramulla	2	1	2	4853
caramullés	2	0	caramulles	2	1	1	4854
carbassejà	2	0	carbasseja	2	2	2	4855
carbonarà	2	0	carbonara	4	222	222	4856
carbonatà	2	0	carbonata	2	5	5	4857
carbonatés	2	1	carbonates	2	3	4	4858
carbonatí	2	0	carbonati	2	1	1	4859
carbonitruràrem	2	1	carbonitrurarem	2	0	1	4860
carbonitzà	2	2	carbonitza	2	9	11	4861
carbonitzàreu	2	1	carbonitzareu	2	0	1	4862
carbonà	2	0	carbona	2	93	93	4863
carbonària	0	15	carbonaria	2	11	26	4864
carbonàries	0	1	carbonaries	2	1	2	4865
carbonés	2	40	carbones	2	45	85	4866
carboní	2	1	carboni	2	15160	15161	4867
carburà	2	0	carbura	2	16	16	4868
carburés	2	0	carbures	2	2	2	4869
carburí	2	0	carburi	2	2	2	4870
cardarà	2	11	cardara	2	0	11	4871
cardiocirurgià	4	0	cardiocirurgia	4	2	2	4872
cardà	2	7	carda	4	538	545	4873
cardàmines	4	0	cardamines	4	1	1	4874
cardàrem	2	0	cardarem	2	25	25	4875
cardés	2	5	cardes	4	303	308	4876
cardí	2	1	cardi	2	63	64	4877
carenejà	2	0	careneja	2	43	43	4878
carenejàrem	2	0	carenejarem	2	11	11	4879
carenà	2	1	carena	4	6766	6767	4880
carenàrem	2	0	carenarem	2	11	11	4881
carenés	2	0	carenes	4	795	795	4882
cargolarà	2	1	cargolara	2	0	1	4883
cargolà	2	2	cargola	4	125	127	4884
cargolàrem	2	0	cargolarem	2	11	11	4885
cargolés	2	2	cargoles	4	26	28	4886
cargolí	2	36	cargoli	2	6	42	4887
caricaturitzà	2	2	caricaturitza	2	62	64	4888
caricaturitzés	2	0	caricaturitzes	2	2	2	4889
caricaturitzí	2	0	caricaturitzi	2	1	1	4890
caricaturà	2	0	caricatura	4	1994	1994	4891
caricaturés	2	0	caricatures	4	1951	1951	4892
carinà	2	0	carina	4	518	518	4893
carinària	4	0	carinaria	2	1	1	4894
cariní	2	0	carini	2	8	8	4895
carià	2	5	caria	2	67	72	4896
cariés	2	0	caries	2	222	222	4897
carií	2	1	carii	2	0	1	4898
carlà	4	30	carla	4	5798	5828	4899
carmelità	0	134	carmelita	4	501	635	4900
carmenà	2	0	carmena	2	308	308	4901
carmenés	2	0	carmenes	2	8	8	4902
carpetà	0	1	carpeta	4	12243	12244	4903
carpià	0	89	carpia	2	0	89	4904
carpí	2	43	carpi	4	187	230	4905
carranquejà	2	0	carranqueja	2	3	3	4906
carrarà	2	0	carrara	4	468	468	4907
carregarà	2	716	carregara	2	14	730	4908
carregués	2	86	carregues	2	301	387	4909
carreguí	2	5	carregui	2	489	494	4910
carregà	2	134	carrega	2	4862	4996	4911
carregàrem	2	9	carregarem	2	125	134	4912
carregàreu	2	2	carregareu	2	16	18	4913
carregés	2	0	carreges	2	11	11	4914
carregí	2	0	carregi	2	7	7	4915
carrejà	2	0	carreja	2	3	3	4916
carretegés	2	0	carreteges	2	1	1	4917
carretejarà	2	1	carretejara	2	0	1	4918
carretejà	2	0	carreteja	2	14	14	4919
carretejàrem	2	0	carretejarem	2	1	1	4920
carrinclonejà	2	0	carrincloneja	2	1	1	4921
carrà	2	62	carra	2	46	108	4922
carràrem	2	0	carrarem	2	1	1	4923
carrés	2	19	carres	2	354	373	4924
carrí	2	0	carri	2	39	39	4925
carró	4	15	carro	2	7419	7434	4926
cartegí	2	0	cartegi	2	1	1	4927
cartejarà	2	1	cartejara	2	0	1	4928
cartejà	2	7	carteja	2	9	16	4929
cartografià	2	13	cartografia	4	4798	4811	4930
cartografiàrem	2	0	cartografiarem	2	1	1	4931
cartografiés	2	0	cartografies	4	381	381	4932
cartoixà	0	283	cartoixa	4	1575	1858	4933
carà	4	15	cara	0	112124	112139	4934
carés	4	19	cares	0	20204	20223	4935
casarà	2	340	casara	2	19	359	4936
cascarà	2	0	cascara	2	6	6	4937
cascà	2	0	casca	4	92	92	4938
cascàrem	2	0	cascarem	2	1	1	4939
cascàreu	2	0	cascareu	2	2	2	4940
casqués	2	1	casques	4	27	28	4941
casquí	2	1	casqui	2	6	7	4942
cassarà	2	5	cassara	2	2	7	4943
cassàreu	2	1	cassareu	2	0	1	4944
cassés	2	5	casses	4	44	49	4945
cassí	2	2	cassi	4	268	270	4946
cassís	4	63	cassis	2	116	179	4947
cassó	4	2757	casso	2	84	2841	4948
castellanitzarà	2	1	castellanitzara	2	0	1	4949
castellanitzà	2	4	castellanitza	2	17	21	4950
castellanitzés	2	3	castellanitzes	2	1	4	4951
castellanès	0	1	castellanes	0	1347	1348	4952
castellanés	0	0	castellanes	0	1347	1347	4953
castigarà	2	154	castigara	2	6	160	4954
castigués	2	54	castigues	2	25	79	4955
castiguí	2	1	castigui	2	244	245	4956
castigà	2	53	castiga	2	1530	1583	4957
castigàrem	2	0	castigarem	2	21	21	4958
castigàreu	2	0	castigareu	2	3	3	4959
castrarà	2	1	castrara	2	0	1	4960
castrà	2	4	castra	2	96	100	4961
castrés	2	1	castres	4	218	219	4962
castrí	2	0	castri	2	44	44	4963
casà	2	3084	casa	4	389760	392844	4964
casàrem	2	7	casarem	2	34	41	4965
casàreu	2	1	casareu	2	12	13	4966
casés	2	238	cases	4	65322	65560	4967
casí	2	37	casi	4	6071	6108	4968
catabolitzà	2	0	catabolitza	2	4	4	4969
catalanejà	2	0	catalaneja	2	1	1	4970
catalanitzà	2	8	catalanitza	2	27	35	4971
catalanitzàrem	2	0	catalanitzarem	2	2	2	4972
catalanitzí	2	0	catalanitzi	2	4	4	4973
catalitzarà	2	10	catalitzara	2	0	10	4974
catalitzà	2	9	catalitza	2	185	194	4975
catalitzés	2	0	catalitzes	2	4	4	4976
catalitzí	2	0	catalitzi	2	14	14	4977
catalogarà	2	23	catalogara	2	0	23	4978
catalogués	2	12	catalogues	2	14	26	4979
cataloguí	2	0	catalogui	2	31	31	4980
catalogà	2	30	cataloga	2	333	363	4981
catalogàrem	2	0	catalogarem	2	5	5	4982
catapultarà	2	21	catapultara	2	1	22	4983
catapultà	2	15	catapulta	4	320	335	4984
catapultàreu	2	0	catapultareu	2	1	1	4985
catapultés	2	4	catapultes	4	132	136	4986
catapultí	2	0	catapulti	2	14	14	4987
catarrós	0	0	catarros	4	39	39	4988
categoritzarà	2	4	categoritzara	2	0	4	4989
categoritzà	2	5	categoritza	2	94	99	4990
categoritzàrem	2	0	categoritzarem	2	2	2	4991
categoritzés	2	0	categoritzes	2	1	1	4992
categoritzí	2	0	categoritzi	2	10	10	4993
catequitzà	2	2	catequitza	2	0	2	4994
catequitzàreu	2	1	catequitzareu	2	0	1	4995
catequitzés	2	1	catequitzes	2	0	1	4996
catorzè	0	504	catorze	3	9545	10049	4997
catorzé	0	27	catorze	3	9545	9572	4998
catxà	2	0	catxa	4	57	57	4999
catxàrem	2	0	catxarem	2	1	1	5000
catxés	2	89	catxes	4	78	167	5001
caucionà	2	0	cauciona	2	3	3	5002
caucionàreu	2	1	caucionareu	2	0	1	5003
cauré	2	171	caure	2	47017	47188	5004
causarà	2	604	causara	2	13	617	5005
causàrem	2	1	causarem	2	14	15	5006
causàreu	2	0	causareu	2	2	2	5007
causés	2	122	causes	4	32523	32645	5008
causí	2	4	causi	2	957	961	5009
cauteritzà	2	0	cauteritza	2	13	13	5010
cauteritzés	2	1	cauteritzes	2	0	1	5011
cauteritzí	2	0	cauteritzi	2	1	1	5012
cavalcarà	2	10	cavalcara	2	1	11	5013
cavalcà	2	19	cavalca	2	279	298	5014
cavalcàrem	2	1	cavalcarem	2	17	18	5015
cavalcàreu	2	0	cavalcareu	2	3	3	5016
cavallegí	2	1	cavallegi	2	0	1	5017
cavallejà	2	0	cavalleja	2	1	1	5018
cavalleregés	2	1	cavallereges	2	0	1	5019
cavallà	2	1	cavalla	4	47	48	5020
cavallés	2	4	cavalles	4	8	12	5021
cavallí	2	13	cavalli	2	143	156	5022
cavalló	4	57	cavallo	2	106	163	5023
cavalqués	2	5	cavalques	2	6	11	5024
cavalquí	2	0	cavalqui	2	10	10	5025
cavarà	2	8	cavara	2	1	9	5026
cavil·là	2	0	cavil·la	2	13	13	5027
cavil·lés	2	0	cavil·les	2	4	4	5028
cavà	2	36	cava	4	17893	17929	5029
cavàrem	2	0	cavarem	2	3	3	5030
cavàreu	2	0	cavareu	2	1	1	5031
cavés	2	2	caves	0	6838	6840	5032
caví	2	1	cavi	2	79	80	5033
cavó	4	2	cavo	2	24	26	5034
caçarà	2	10	caçara	2	1	11	5035
caçà	2	25	caça	4	13292	13317	5036
caçàrem	2	0	caçarem	2	6	6	5037
caçàreu	2	0	caçareu	2	3	3	5038
caçó	4	64	caço	2	42	106	5039
caús	2	1	caus	4	2094	2095	5040
cedirà	2	1357	cedira	2	24	1381	5041
cedírem	2	3	cedirem	2	197	200	5042
cedíreu	2	0	cedireu	2	1	1	5043
cegarà	2	1	cegara	2	1	2	5044
cegués	2	2	cegues	0	2854	2856	5045
ceguí	2	0	cegui	2	10	10	5046
cegà	2	4	cega	0	2473	2477	5047
cegó	4	3	cego	2	96	99	5048
celebrarà	2	38347	celebrara	2	170	38517	5049
celebrà	2	3455	celebra	2	55399	58854	5050
celebràrem	2	199	celebrarem	2	4584	4783	5051
celebràreu	2	1	celebrareu	2	30	31	5052
celebrés	2	637	celebres	2	156	793	5053
celebrí	2	1	celebri	2	2172	2173	5054
celà	2	3	cela	2	902	905	5055
celés	2	0	celes	2	46	46	5056
celí	2	1	celi	2	113	114	5057
cementà	2	0	cementa	2	1	1	5058
cementàreu	2	1	cementareu	2	0	1	5059
cementí	2	0	cementi	2	17	17	5060
cendrà	2	1	cendra	4	3256	3257	5061
cendràrem	2	1	cendrarem	2	0	1	5062
cendrés	2	2	cendres	4	4020	4022	5063
cendrí	2	0	cendri	2	1	1	5064
censurarà	2	13	censurara	2	4	17	5065
censurà	2	23	censura	4	12566	12589	5066
censuràrem	2	0	censurarem	2	7	7	5067
censuràreu	2	0	censurareu	2	1	1	5068
censurés	2	15	censures	4	337	352	5069
censurí	2	0	censuri	2	42	42	5070
censàrem	2	0	censarem	2	1	1	5071
censés	2	0	censes	2	1	1	5072
censí	2	0	censi	2	3	3	5073
centellejà	2	0	centelleja	2	11	11	5074
centralitzarà	2	105	centralitzara	2	3	108	5075
centralitzà	2	25	centralitza	2	456	481	5076
centralitzàrem	2	0	centralitzarem	2	10	10	5077
centralitzés	2	7	centralitzes	2	1	8	5078
centralitzí	2	0	centralitzi	2	52	52	5079
centrarà	2	3445	centrara	2	21	3466	5080
centrifugarà	2	1	centrifugara	2	0	1	5081
centrifugués	2	0	centrifugues	2	15	15	5082
centrifuguí	2	0	centrifugui	2	3	3	5083
centrifugà	2	0	centrifuga	2	76	76	5084
centrifugàrem	2	0	centrifugarem	2	1	1	5085
centrà	2	499	centra	2	17936	18435	5086
centràrem	2	18	centrarem	2	1415	1433	5087
centràreu	2	0	centrareu	2	2	2	5088
centrés	2	209	centres	2	160570	160779	5089
centrí	2	0	centri	2	1076	1076	5090
centrífug	0	84	centrifug	2	0	84	5091
centrífuga	0	334	centrifuga	2	76	410	5092
centrífugues	0	179	centrifugues	2	15	194	5093
centuplicà	2	0	centuplica	2	1	1	5094
centó	4	11	cento	4	108	119	5095
cenyirà	2	47	cenyira	2	2	49	5096
cenyírem	2	1	cenyirem	2	22	23	5097
cercarà	2	515	cercara	2	8	523	5098
cerciorarà	2	4	cerciorara	2	0	4	5099
cerciorà	2	0	cerciora	2	5	5	5100
cercioràrem	2	0	cerciorarem	2	4	4	5101
cerciorí	2	0	cerciori	2	14	14	5102
cerclà	2	0	cercla	2	17	17	5103
cerclàrem	2	0	cerclarem	2	1	1	5104
cerclés	2	1	cercles	2	8879	8880	5105
cerclí	2	0	cercli	2	1	1	5106
cercolés	2	0	cercoles	2	1	1	5107
cercà	2	269	cerca	4	38390	38659	5108
cercàrem	2	19	cercarem	2	259	278	5109
cercàreu	2	0	cercareu	2	18	18	5110
cercària	4	2	cercaria	2	78	80	5111
cercàries	4	1	cercaries	2	5	6	5112
ceretà	0	171	cereta	4	10	181	5113
cerndré	2	0	cerndre	2	7	7	5114
cernés	2	0	cernes	2	1	1	5115
cerní	2	8	cerni	2	127	135	5116
cerqués	2	85	cerques	4	3876	3961	5117
cerquí	2	3	cerqui	2	634	637	5118
certificarà	2	157	certificara	2	3	160	5119
certificà	2	33	certifica	2	2155	2188	5120
certificàrem	2	1	certificarem	2	3	4	5121
certifiqués	2	49	certifiques	2	10	59	5122
certifiquí	2	0	certifiqui	2	324	324	5123
cerós	0	22	ceros	4	27	49	5124
cessarà	2	204	cessara	2	6	210	5125
cessà	2	151	cessa	2	686	837	5126
cessàrem	2	0	cessarem	2	28	28	5127
cessés	2	118	cesses	2	4	122	5128
cessí	2	0	cessi	2	369	369	5129
cianurí	2	1	cianuri	2	0	1	5130
ciarà	2	1	ciara	4	48	49	5131
ciavogués	2	0	ciavogues	4	6	6	5132
ciavogà	2	0	ciavoga	4	18	18	5133
cicatritzarà	2	4	cicatritzara	2	0	4	5134
cicatritzà	2	0	cicatritza	2	50	50	5135
cicatritzés	2	5	cicatritzes	2	2	7	5136
cicatritzí	2	0	cicatritzi	2	26	26	5137
ciclitzà	2	0	ciclitza	2	2	2	5138
ciclostilés	2	1	ciclostiles	2	0	1	5139
ciclòpia	0	74	ciclopia	4	3	77	5140
ciclòpies	0	42	ciclopies	4	1	43	5141
cigonyà	2	0	cigonya	4	612	612	5142
cigonyés	2	0	cigonyes	4	758	758	5143
cilindrà	2	0	cilindra	2	1	1	5144
cilindrés	2	0	cilindres	2	1943	1943	5145
cilindrí	2	0	cilindri	2	2	2	5146
cimejà	2	0	cimeja	2	1	1	5147
cimentarà	2	3	cimentara	2	0	3	5148
cimentà	2	8	cimenta	2	40	48	5149
cimentés	2	4	cimentes	2	0	4	5150
cimentí	2	0	cimenti	2	3	3	5151
cimà	2	5	cima	4	705	710	5152
cimè	4	3	cime	2	271	274	5153
cimé	4	0	cime	2	271	271	5154
cimés	2	1	cimes	4	131	132	5155
cimí	2	3	cimi	2	27	30	5156
cinematografià	2	0	cinematografia	4	1140	1140	5157
cinematografiés	2	0	cinematografies	4	95	95	5158
cinglà	2	0	cingla	4	58	58	5159
cinglés	2	1	cingles	4	2705	2706	5160
cinquanta-quatrè	0	9	cinquanta-quatre	3	207	216	5161
cinquanta-quatré	0	0	cinquanta-quatre	3	207	207	5162
cinquantejàreu	2	1	cinquantejareu	2	0	1	5163
cintrà	2	0	cintra	4	164	164	5164
cintràrem	2	0	cintrarem	2	1	1	5165
cintrés	2	0	cintres	4	50	50	5166
cintrí	2	0	cintri	2	1	1	5167
cinturà	2	0	cintura	4	3960	3960	5168
cinturés	2	0	cintures	4	68	68	5169
cinturí	2	1	cinturi	2	0	1	5170
cinturó	4	6683	cinturo	2	56	6739	5171
cintà	2	0	cinta	4	14260	14260	5172
cintés	2	0	cintes	4	5407	5407	5173
cintí	2	0	cinti	2	9	9	5174
cintó	4	8	cinto	4	1534	1542	5175
circularitzarà	2	1	circularitzara	2	0	1	5176
circularitzí	2	0	circularitzi	2	2	2	5177
circularà	2	352	circulara	2	9	361	5178
circulà	2	57	circula	2	4101	4158	5179
circulàrem	2	0	circularem	2	51	51	5180
circulàreu	2	0	circulareu	2	9	9	5181
circulés	2	104	circules	2	56	160	5182
circulí	2	0	circuli	2	483	483	5183
circumcidà	2	2	circumcida	2	2	4	5184
circumcidàreu	2	0	circumcidareu	2	2	2	5185
circumcidés	2	3	circumcides	2	0	3	5186
circumcidí	2	0	circumcidi	2	1	1	5187
circumdarà	2	0	circumdara	2	1	1	5188
circumdà	2	1	circumda	2	110	111	5189
circumdí	2	0	circumdi	2	1	1	5190
circumnavegà	2	5	circumnavega	2	4	9	5191
circumscrigués	2	1	circumscrigues	2	0	1	5192
circumscriguí	2	0	circumscrigui	2	24	24	5193
circumscriuré	2	5	circumscriure	2	291	296	5194
circumstancià	2	0	circumstancia	2	168	168	5195
circumstanciés	2	4	circumstancies	2	628	632	5196
circumstància	4	10164	circumstancia	2	168	10332	5197
circumstàncies	4	33512	circumstancies	2	628	34140	5198
circumval·larà	2	7	circumval·lara	2	1	8	5199
circumval·là	2	2	circumval·la	2	46	48	5200
circumval·làrem	2	0	circumval·larem	2	1	1	5201
circumval·lí	2	0	circumval·li	2	1	1	5202
cirurgià	4	2627	cirurgia	4	12160	14787	5203
cirés	0	36	cires	4	18	54	5204
cisallà	2	0	cisalla	4	146	146	5205
cisallés	2	0	cisalles	4	47	47	5206
cisellarà	2	1	cisellara	2	0	1	5207
cisellà	2	7	cisella	2	9	16	5208
cisellí	2	0	ciselli	2	1	1	5209
cisà	2	0	cisa	4	394	394	5210
cisés	2	0	cises	4	34	34	5211
cisí	2	0	cisi	2	39	39	5212
citarà	2	168	citara	2	10	178	5213
cità	2	138	cita	4	39408	39546	5214
citàrem	2	3	citarem	2	248	251	5215
cités	2	83	cites	4	10368	10451	5216
cití	2	4	citi	2	628	632	5217
ciutadejà	2	0	ciutadeja	2	1	1	5218
civilitzarà	2	1	civilitzara	2	0	1	5219
civilitzà	2	1	civilitza	2	12	13	5220
cià	2	8	cia	4	4251	4259	5221
ciés	2	0	cies	4	874	874	5222
cií	2	0	cii	2	48	48	5223
clacà	2	0	claca	4	348	348	5224
clamarà	2	13	clamara	2	1	14	5225
clampí	2	0	clampi	2	1	1	5226
clamà	2	35	clama	2	795	830	5227
clamàrem	2	1	clamarem	2	6	7	5228
clamàreu	2	3	clamareu	2	0	3	5229
clamés	2	10	clames	2	4	14	5230
clamí	2	3	clami	2	21	24	5231
clapejà	2	0	clapeja	2	2	2	5232
clapotejà	2	0	clapoteja	2	3	3	5233
clapà	2	0	clapa	4	139	139	5234
clapàrem	2	0	claparem	2	1	1	5235
clapés	2	941	clapes	4	481	1422	5236
clapí	2	12	clapi	2	4	16	5237
clapó	4	0	clapo	2	2	2	5238
claqué	4	634	claque	2	22	656	5239
claqués	2	0	claques	4	9	9	5240
claquí	2	1	claqui	2	0	1	5241
claregés	2	3	clareges	2	0	3	5242
claregí	2	0	claregi	2	11	11	5243
clarejarà	2	5	clarejara	2	1	6	5244
clarejà	2	5	clareja	2	88	93	5245
clarificarà	2	18	clarificara	2	2	20	5246
clarificà	2	7	clarifica	2	250	257	5247
clarificàrem	2	0	clarificarem	2	5	5	5248
clarificàreu	2	0	clarificareu	2	1	1	5249
clarifiqués	2	6	clarifiques	2	2	8	5250
clarifiquí	2	0	clarifiqui	2	94	94	5251
classificarà	2	137	classificara	2	6	143	5252
classificà	2	198	classifica	2	2455	2653	5253
classificàrem	2	2	classificarem	2	49	51	5254
classifiqués	2	60	classifiques	2	17	77	5255
classifiquí	2	0	classifiqui	2	117	117	5256
claudicarà	2	12	claudicara	2	2	14	5257
claudicà	2	17	claudica	2	59	76	5258
claudicàrem	2	0	claudicarem	2	8	8	5259
claudiqués	2	7	claudiques	2	3	10	5260
claudiquí	2	0	claudiqui	2	6	6	5261
clausurarà	2	254	clausurara	2	2	256	5262
clausurà	2	98	clausura	4	4711	4809	5263
clausuràrem	2	0	clausurarem	2	6	6	5264
clausurés	2	26	clausures	4	32	58	5265
clausurí	2	0	clausuri	2	25	25	5266
clavarà	2	47	clavara	2	10	57	5267
clavillà	2	2	clavilla	4	73	75	5268
clavillés	2	0	clavilles	4	224	224	5269
clavilló	4	4	clavillo	2	0	4	5270
clavà	2	101	clava	4	1031	1132	5271
clavàrem	2	1	clavarem	2	31	32	5272
clavàreu	2	1	clavareu	2	1	2	5273
clavària	4	3	clavaria	2	126	129	5274
clavàries	4	1	clavaries	2	44	45	5275
clavés	2	49	claves	4	282	331	5276
claví	2	1	clavi	2	91	92	5277
clavó	4	3	clavo	2	168	171	5278
clenxinà	2	0	clenxina	2	1	1	5279
clenxinàreu	2	1	clenxinareu	2	0	1	5280
clenxinés	2	0	clenxines	2	1	1	5281
clenxà	2	0	clenxa	4	112	112	5282
clenxés	2	0	clenxes	4	15	15	5283
clenxí	2	1	clenxi	2	0	1	5284
clevillà	2	0	clevilla	2	3	3	5285
clevillés	2	0	clevilles	2	1	1	5286
clicarà	2	2	clicara	2	6	8	5287
clicà	2	0	clica	2	4114	4114	5288
clicàrem	2	0	clicarem	2	68	68	5289
clicàreu	2	0	clicareu	2	1	1	5290
climatitzarà	2	3	climatitzara	2	0	3	5291
climatitzà	2	0	climatitza	2	8	8	5292
climatitzí	2	0	climatitzi	2	2	2	5293
clipí	2	0	clipi	2	10	10	5294
cliqués	2	3	cliques	2	330	333	5295
cliquí	2	1	cliqui	2	214	215	5296
clissà	2	0	clissa	2	13	13	5297
clissés	2	4	clisses	2	2	6	5298
clissí	2	1	clissi	2	0	1	5299
clivellà	2	4	clivella	4	146	150	5300
clivellés	2	1	clivelles	4	285	286	5301
clivellí	2	0	clivelli	2	2	2	5302
clogués	2	12	clogues	2	0	12	5303
cloguí	2	0	clogui	2	31	31	5304
clonarà	2	6	clonara	2	0	6	5305
clonà	2	0	clona	2	167	167	5306
clonàrem	2	0	clonarem	2	4	4	5307
clonés	2	3	clones	2	49	52	5308
cloní	2	0	cloni	2	4	4	5309
cloquejà	2	1	cloqueja	2	2	3	5310
cloroformitzarà	2	1	cloroformitzara	2	0	1	5311
clorà	2	0	clora	2	6	6	5312
clorí	2	0	clori	2	6	6	5313
closcarà	2	1	closcara	2	0	1	5314
closcà	2	0	closca	4	3065	3065	5315
closqués	2	0	closques	4	982	982	5316
closquí	2	0	closqui	2	3	3	5317
clotà	2	0	clota	4	548	548	5318
clotés	2	0	clotes	4	197	197	5319
clotí	2	0	cloti	2	39	39	5320
clouré	2	4	cloure	2	3768	3772	5321
clusteritzà	2	0	clusteritza	2	1	1	5322
coaccionarà	2	2	coaccionara	2	0	2	5323
coaccionà	2	0	coacciona	2	55	55	5324
coaccionés	2	1	coacciones	2	2	3	5325
coaccioní	2	0	coaccioni	2	15	15	5326
coadjuvarà	2	3	coadjuvara	2	1	4	5327
coadjuvà	2	5	coadjuva	2	18	23	5328
coadjuvés	2	2	coadjuves	2	0	2	5329
coadjuví	2	0	coadjuvi	2	6	6	5330
coagularà	2	2	coagulara	2	0	2	5331
coagulà	2	0	coagula	2	66	66	5332
coagulàrem	2	0	coagularem	2	1	1	5333
coagulés	2	1	coagules	2	0	1	5334
coagulí	2	0	coaguli	2	26	26	5335
coalitzà	2	4	coalitza	2	1	5	5336
coalitzés	2	1	coalitzes	2	0	1	5337
coaptés	2	0	coaptes	2	1	1	5338
coartarà	2	8	coartara	2	0	8	5339
coartà	2	1	coarta	2	130	131	5340
coartés	2	2	coartes	2	0	2	5341
coartí	2	1	coarti	2	34	35	5342
coavaluà	2	0	coavalua	2	2	2	5343
coavalués	2	0	coavalues	2	1	1	5344
cobdicià	2	0	cobdicia	2	25	25	5345
cobdiciàrem	2	1	cobdiciarem	2	0	1	5346
cobdícia	4	1361	cobdicia	2	25	1386	5347
cobdícies	4	22	cobdicies	2	0	22	5348
cobegés	2	1	cobeges	2	1	2	5349
cobegí	2	0	cobegi	2	2	2	5350
cobejà	2	5	cobeja	2	48	53	5351
coblejà	2	0	cobleja	2	1	1	5352
cobrarà	2	1627	cobrara	2	30	1657	5353
cobricelarà	2	1	cobricelara	2	0	1	5354
cobricelà	2	0	cobricela	2	2	2	5355
cobrirà	2	1028	cobrira	2	22	1050	5356
cobrà	2	114	cobra	4	5233	5347	5357
cobràrem	2	3	cobrarem	2	218	221	5358
cobràreu	2	0	cobrareu	2	18	18	5359
cobrés	2	152	cobres	4	265	417	5360
cobrí	2	155	cobri	2	553	708	5361
cobrírem	2	4	cobrirem	2	274	278	5362
cobríreu	2	2	cobrireu	2	4	6	5363
cobrís	2	156	cobris	2	37	193	5364
cocreà	2	0	cocrea	2	3	3	5365
cocreàrem	2	0	cocrearem	2	1	1	5366
cocó	4	257	coco	4	5207	5464	5367
codesenvolupà	2	1	codesenvolupa	2	0	1	5368
codicil·lí	2	1	codicil·li	2	3	4	5369
codificarà	2	14	codificara	2	0	14	5370
codificà	2	13	codifica	2	624	637	5371
codificàrem	2	0	codificarem	2	2	2	5372
codifiqués	2	6	codifiques	2	0	6	5373
codifiquí	2	0	codifiqui	2	31	31	5374
codirigirà	2	5	codirigira	2	0	5	5375
codís	4	11	codis	4	10653	10664	5376
coeditarà	2	8	coeditara	2	0	8	5377
coedità	2	4	coedita	2	11	15	5378
coeducà	2	0	coeduca	2	34	34	5379
coegí	2	0	coegi	2	2	2	5380
coejà	2	0	coeja	2	5	5	5381
coercírem	2	1	coercirem	2	0	1	5382
coescriuré	2	0	coescriure	2	74	74	5383
coexistirà	2	15	coexistira	2	0	15	5384
coexistírem	2	0	coexistirem	2	1	1	5385
cofinancés	2	3	cofinances	2	0	3	5386
cofinancí	2	0	cofinanci	2	8	8	5387
cofinançarà	2	41	cofinançara	2	0	41	5388
cofinançà	2	1	cofinança	2	81	82	5389
cofinançàrem	2	0	cofinançarem	2	2	2	5390
cofundà	2	53	cofunda	2	19	72	5391
cofà	2	0	cofa	4	55	55	5392
cofés	2	1	cofes	4	14	15	5393
cofí	2	23	cofi	2	25	48	5394
cogità	2	2	cogita	2	32	34	5395
cogití	2	0	cogiti	2	24	24	5396
cognomenà	2	3	cognomena	2	4	7	5397
cognomení	2	0	cognomeni	2	1	1	5398
cognominà	2	1	cognomina	2	28	29	5399
cogués	2	12	cogues	2	0	12	5400
coguí	2	0	cogui	2	665	665	5401
cohabitarà	2	3	cohabitara	2	0	3	5402
cohabità	2	1	cohabita	2	67	68	5403
cohabités	2	1	cohabites	2	0	1	5404
cohabití	2	0	cohabiti	2	6	6	5405
cohesionarà	2	11	cohesionara	2	0	11	5406
cohesionà	2	2	cohesiona	2	263	265	5407
cohesionàrem	2	0	cohesionarem	2	1	1	5408
cohesionés	2	5	cohesiones	2	0	5	5409
cohesioní	2	0	cohesioni	2	67	67	5410
cohibirà	2	1	cohibira	2	0	1	5411
cohobà	2	0	cohoba	2	1	1	5412
cohonestà	2	0	cohonesta	2	2	2	5413
cohonestí	2	1	cohonesti	2	0	1	5414
coincidirà	2	1246	coincidira	2	26	1272	5415
coincidírem	2	51	coincidirem	2	222	273	5416
coincidíreu	2	0	coincidireu	2	53	53	5417
coixegés	2	0	coixeges	2	2	2	5418
coixegí	2	0	coixegi	2	4	4	5419
coixejarà	2	2	coixejara	2	0	2	5420
coixejà	2	0	coixeja	2	106	106	5421
colarà	2	45	colara	2	4	49	5422
colcà	2	0	colca	2	96	96	5423
colgarà	2	7	colgara	2	2	9	5424
colgués	2	4	colgues	4	4	8	5425
colguí	2	0	colgui	2	6	6	5426
colgà	2	9	colga	4	83	92	5427
colgàrem	2	0	colgarem	2	6	6	5428
coliderarà	2	1	coliderara	2	0	1	5429
coliderà	2	0	colidera	2	25	25	5430
coliderí	2	0	colideri	2	1	1	5431
collarà	2	7	collara	2	2	9	5432
collegés	2	0	colleges	2	169	169	5433
collegí	2	0	collegi	2	115	115	5434
collejà	2	0	colleja	2	20	20	5435
collirà	2	40	collira	2	2	42	5436
colltorçà	2	0	colltorça	2	2	2	5437
collà	2	9	colla	4	50805	50814	5438
collàrem	2	0	collarem	2	3	3	5439
collés	2	3	colles	4	19336	19339	5440
collí	2	16	colli	2	65	81	5441
collírem	2	0	collirem	2	105	105	5442
collíreu	2	0	collireu	2	11	11	5443
collís	2	8	collis	2	23	31	5444
colló	4	172	collo	2	36	208	5445
colonitzarà	2	13	colonitzara	2	0	13	5446
colonitzà	2	22	colonitza	2	161	183	5447
colonitzàrem	2	0	colonitzarem	2	2	2	5448
colonitzés	2	5	colonitzes	2	1	6	5449
colonitzí	2	0	colonitzi	2	6	6	5450
colorà	2	3	colora	2	20	23	5451
coloràreu	2	0	colorareu	2	1	1	5452
colorés	2	1	colores	2	375	376	5453
colorí	2	0	colori	2	47	47	5454
colpegés	2	44	colpeges	2	13	57	5455
colpegí	2	0	colpegi	2	69	69	5456
colpejarà	2	36	colpejara	2	12	48	5457
colpejà	2	103	colpeja	2	1176	1279	5458
colpejàrem	2	1	colpejarem	2	8	9	5459
colpejàreu	2	0	colpejareu	2	2	2	5460
colpirà	2	14	colpira	2	0	14	5461
colrà	2	0	colra	2	4	4	5462
colrí	2	0	colri	2	1	1	5463
columbí	0	1	columbi	4	5	6	5464
colzejà	2	0	colzeja	2	1	1	5465
colzà	2	1	colza	4	385	386	5466
colzés	2	0	colzes	4	840	840	5467
colzí	2	0	colzi	2	1	1	5468
col·laborarà	2	1513	col·laborara	2	11	1524	5469
col·laborà	2	3243	col·labora	2	16558	19801	5470
col·laboràrem	2	11	col·laborarem	2	370	381	5471
col·laboràreu	2	2	col·laborareu	2	33	35	5472
col·laborés	2	148	col·labores	2	141	289	5473
col·laborí	2	3	col·labori	2	692	695	5474
col·lacioní	2	0	col·lacioni	2	1	1	5475
col·lapsarà	2	47	col·lapsara	2	2	49	5476
col·lapsà	2	53	col·lapsa	2	354	407	5477
col·lapsàrem	2	0	col·lapsarem	2	8	8	5478
col·lapsàreu	2	0	col·lapsareu	2	2	2	5479
col·lapsés	2	32	col·lapses	2	344	376	5480
col·lapsí	2	0	col·lapsi	2	74	74	5481
col·leccionarà	2	3	col·leccionara	2	0	3	5482
col·leccionà	2	20	col·lecciona	2	351	371	5483
col·leccionàrem	2	0	col·leccionarem	2	1	1	5484
col·leccionàreu	2	1	col·leccionareu	2	0	1	5485
col·leccionés	2	6	col·lecciones	2	26	32	5486
col·leccioní	2	0	col·leccioni	2	6	6	5487
col·lectarà	2	1	col·lectara	2	0	1	5488
col·lectivitzà	2	7	col·lectivitza	2	10	17	5489
col·lectivitzàrem	2	1	col·lectivitzarem	2	2	3	5490
col·lectivitzés	2	1	col·lectivitzes	2	0	1	5491
col·lectivitzí	2	0	col·lectivitzi	2	2	2	5492
col·lectà	2	1	col·lecta	4	767	768	5493
col·lectàrem	2	1	col·lectarem	2	0	1	5494
col·lectés	2	0	col·lectes	4	202	202	5495
col·lectí	2	0	col·lecti	2	13	13	5496
col·legiarà	2	1	col·legiara	2	0	1	5497
col·legià	2	2	col·legia	2	15	17	5498
col·legiés	2	0	col·legies	2	4	4	5499
col·legií	2	0	col·legii	2	1	1	5500
col·legí	2	15	col·legi	4	59147	59162	5501
col·legís	2	0	col·legis	4	14426	14426	5502
col·lidirà	2	3	col·lidira	2	0	3	5503
col·lidírem	2	1	col·lidirem	2	0	1	5504
col·ligarà	2	1	col·ligara	2	0	1	5505
col·limés	2	1	col·limes	2	0	1	5506
col·lisionarà	2	1	col·lisionara	2	1	2	5507
col·lisionà	2	1	col·lisiona	2	29	30	5508
col·lisionàrem	2	0	col·lisionarem	2	1	1	5509
col·lisionés	2	4	col·lisiones	2	0	4	5510
col·lisioní	2	0	col·lisioni	2	8	8	5511
col·locarà	2	769	col·locara	2	17	786	5512
col·locà	2	414	col·loca	2	5648	6062	5513
col·locàrem	2	13	col·locarem	2	411	424	5514
col·locàreu	2	0	col·locareu	2	11	11	5515
col·loqués	2	78	col·loques	2	140	218	5516
col·loquí	2	10	col·loqui	2	7313	7323	5517
colà	2	16	cola	4	4449	4465	5518
colàrem	2	0	colarem	2	101	101	5519
colàreu	2	0	colareu	2	3	3	5520
colés	2	34	coles	4	510	544	5521
colí	2	11	coli	4	589	600	5522
colíder	4	179	colider	2	15	194	5523
colís	0	3	colis	2	22	25	5524
comanarà	2	2	comanara	2	0	2	5525
comandarà	2	40	comandara	2	1	41	5526
comandità	2	0	comandita	4	51	51	5527
comanditària	0	64	comanditaria	2	5	69	5528
comanditàries	0	18	comanditaries	2	1	19	5529
comandités	2	0	comandites	4	2	2	5530
comandà	2	314	comanda	4	13554	13868	5531
comandàrem	2	0	comandarem	2	1	1	5532
comandàreu	2	0	comandareu	2	2	2	5533
comandés	2	27	comandes	4	6782	6809	5534
comandí	2	0	comandi	2	19	19	5535
comanà	2	7	comana	4	48	55	5536
comanàrem	2	0	comanarem	2	1	1	5537
comanàreu	2	0	comanareu	2	1	1	5538
comanés	2	0	comanes	4	4	4	5539
comaní	2	0	comani	2	2	2	5540
comarcalitzà	2	1	comarcalitza	2	0	1	5541
comarcà	0	3	comarca	4	80882	80885	5542
comarà	2	0	comara	2	15	15	5543
comaré	2	0	comare	4	141	141	5544
combatré	2	9	combatre	2	22362	22371	5545
combatés	2	20	combates	2	12	32	5546
combatí	2	7	combati	2	154	161	5547
combinarà	2	923	combinara	2	3	926	5548
combinà	2	173	combina	2	17763	17936	5549
combinàrem	2	2	combinarem	2	235	237	5550
combinàreu	2	0	combinareu	2	1	1	5551
combinés	2	97	combines	2	121	218	5552
combiní	2	0	combini	2	500	500	5553
comboiarà	2	1	comboiara	2	1	2	5554
comboià	2	1	comboia	2	4	5	5555
comboí	2	0	comboi	4	1664	1664	5556
combregarà	2	3	combregara	2	0	3	5557
combregués	2	11	combregues	2	21	32	5558
combreguí	2	0	combregui	2	47	47	5559
combregà	2	11	combrega	2	222	233	5560
combregàrem	2	0	combregarem	2	5	5	5561
combregàreu	2	0	combregareu	2	1	1	5562
combés	4	0	combes	4	49	49	5563
comencés	2	2127	comences	2	2785	4912	5564
comencí	2	57	comenci	2	8777	8834	5565
comentarà	2	561	comentara	2	17	578	5566
comentà	2	631	comenta	2	12982	13613	5567
comentàrem	2	80	comentarem	2	1177	1257	5568
comentàreu	2	6	comentareu	2	26	32	5569
comentés	2	135	comentes	2	1277	1412	5570
comentí	2	13	comenti	2	377	390	5571
començarà	2	24598	començara	2	389	24987	5572
començà	2	13234	comença	2	106131	119365	5573
començàrem	2	649	començarem	2	6884	7533	5574
començàreu	2	12	començareu	2	243	255	5575
comercialitzarà	2	202	comercialitzara	2	3	205	5576
comercialitzà	2	66	comercialitza	2	2270	2336	5577
comercialitzàrem	2	0	comercialitzarem	2	11	11	5578
comercialitzàreu	2	0	comercialitzareu	2	1	1	5579
comercialitzés	2	20	comercialitzes	2	9	29	5580
comercialitzí	2	0	comercialitzi	2	111	111	5581
comerciarà	2	6	comerciara	2	0	6	5582
comercià	2	9	comercia	2	124	133	5583
comerciàrem	2	0	comerciarem	2	2	2	5584
comerciés	2	10	comercies	2	1	11	5585
cometré	2	34	cometre	2	8775	8809	5586
cometés	2	115	cometes	4	2832	2947	5587
cometí	2	3	cometi	2	323	326	5588
comissariarà	2	2	comissariara	2	0	2	5589
comissarià	2	2	comissaria	2	6199	6201	5590
comissariés	2	0	comissaries	2	884	884	5591
comissarà	2	1	comissara	2	0	1	5592
comissaríem	2	0	comissariem	2	2	2	5593
comissionarà	2	2	comissionara	2	0	2	5594
comissionà	2	13	comissiona	2	23	36	5595
comissionàrem	2	0	comissionarem	2	1	1	5596
comissionés	2	1	comissiones	2	26	27	5597
comissà	2	1	comissa	2	27	28	5598
comissària	4	14960	comissaria	2	6199	21159	5599
comissàries	4	218	comissaries	2	884	1102	5600
comissés	2	1	comisses	2	0	1	5601
comissí	2	2	comissi	2	15	17	5602
commemorarà	2	602	commemorara	2	1	603	5603
commemorà	2	104	commemora	2	5747	5851	5604
commemoràrem	2	6	commemorarem	2	108	114	5605
commemorés	2	26	commemores	2	1	27	5606
commemorí	2	0	commemori	2	54	54	5607
commensurà	2	0	commensura	2	1	1	5608
comminarà	2	2	comminara	2	0	2	5609
comminà	2	21	commina	2	94	115	5610
comminàrem	2	1	comminarem	2	0	1	5611
comminés	2	1	commines	2	4	5	5612
comminí	2	0	commini	2	6	6	5613
commocionarà	2	4	commocionara	2	0	4	5614
commocionà	2	25	commociona	2	48	73	5615
commocionàrem	2	1	commocionarem	2	0	1	5616
commocionés	2	1	commociones	2	0	1	5617
commocioní	2	0	commocioni	2	2	2	5618
commogués	2	4	commogues	2	0	4	5619
commoguí	2	0	commogui	2	48	48	5620
commouré	2	1	commoure	2	958	959	5621
commutarà	2	16	commutara	2	0	16	5622
commutà	2	22	commuta	2	1153	1175	5623
commutàreu	2	0	commutareu	2	2	2	5624
commutés	2	12	commutes	2	4	16	5625
commutí	2	0	commuti	2	22	22	5626
compactarà	2	12	compactara	2	0	12	5627
compactà	2	3	compacta	2	2575	2578	5628
compactàrem	2	0	compactarem	2	5	5	5629
compactàreu	2	0	compactareu	2	1	1	5630
compactés	2	2	compactes	2	1856	1858	5631
compactí	2	0	compacti	2	23	23	5632
compadirà	2	19	compadira	2	1	20	5633
compaginarà	2	145	compaginara	2	0	145	5634
compaginà	2	132	compagina	2	1823	1955	5635
compaginàrem	2	0	compaginarem	2	10	10	5636
compaginés	2	4	compagines	2	15	19	5637
compaginí	2	0	compagini	2	17	17	5638
compararà	2	113	comparara	2	3	116	5639
comparegués	2	103	comparegues	2	0	103	5640
compareguí	2	0	comparegui	2	354	354	5641
compartimentà	2	1	compartimenta	2	14	15	5642
compartimentés	2	0	compartimentes	2	1	1	5643
compartimentí	2	0	compartimenti	2	1	1	5644
compartirà	2	1521	compartira	2	15	1536	5645
compartírem	2	70	compartirem	2	1696	1766	5646
compartíreu	2	2	compartireu	2	109	111	5647
comparà	2	111	compara	2	4175	4286	5648
comparàrem	2	1	compararem	2	158	159	5649
comparàreu	2	0	comparareu	2	2	2	5650
comparés	2	44	compares	2	290	334	5651
comparí	2	2	compari	2	258	260	5652
compassarà	2	2	compassara	2	0	2	5653
compassà	2	0	compassa	2	23	23	5654
compassàreu	2	1	compassareu	2	0	1	5655
compassés	2	1	compasses	2	0	1	5656
compassí	2	0	compassi	2	3	3	5657
compatibilitzarà	2	23	compatibilitzara	2	3	26	5658
compatibilitzà	2	26	compatibilitza	2	137	163	5659
compatibilitzàrem	2	0	compatibilitzarem	2	2	2	5660
compatibilitzàreu	2	1	compatibilitzareu	2	0	1	5661
compatibilitzés	2	2	compatibilitzes	2	3	5	5662
compatibilitzí	2	0	compatibilitzi	2	52	52	5663
compatirà	2	7	compatira	2	0	7	5664
compatírem	2	0	compatirem	2	3	3	5665
compatíreu	2	0	compatireu	2	1	1	5666
compel·lirà	2	1	compel·lira	2	0	1	5667
compendiarà	2	1	compendiara	2	0	1	5668
compendià	2	1	compendia	2	47	48	5669
compendií	2	1	compendii	2	0	1	5670
compenetrà	2	3	compenetra	2	20	23	5671
compenetrés	2	1	compenetres	2	1	2	5672
compenetrí	2	0	compenetri	2	1	1	5673
compensarà	2	386	compensara	2	4	390	5674
compensà	2	25	compensa	2	1977	2002	5675
compensàrem	2	0	compensarem	2	37	37	5676
compensàreu	2	0	compensareu	2	5	5	5677
compensés	2	40	compenses	2	13	53	5678
compensí	2	1	compensi	2	369	370	5679
competirà	2	1084	competira	2	9	1093	5680
competírem	2	1	competirem	2	84	85	5681
competíreu	2	0	competireu	2	12	12	5682
compilarà	2	20	compilara	2	0	20	5683
compilà	2	46	compila	2	288	334	5684
compilàrem	2	0	compilarem	2	4	4	5685
compilés	2	2	compiles	2	5	7	5686
compilí	2	0	compili	2	23	23	5687
compixà	2	0	compixa	2	2	2	5688
complagués	2	6	complagues	2	0	6	5689
complaguí	2	0	complagui	2	58	58	5690
complanyerà	2	0	complanyera	2	1	1	5691
complauré	2	3	complaure	2	1222	1225	5692
complementarà	2	1150	complementara	2	6	1156	5693
complementà	2	68	complementa	2	6210	6278	5694
complementàrem	2	0	complementarem	2	61	61	5695
complementàreu	2	0	complementareu	2	1	1	5696
complementària	0	7308	complementaria	2	579	7887	5697
complementàries	0	8230	complementaries	2	350	8580	5698
complementés	2	45	complementes	2	28	73	5699
complementí	2	1	complementi	2	439	440	5700
completarà	2	1938	completara	2	14	1952	5701
completà	2	559	completa	0	49970	50529	5702
completàrem	2	13	completarem	2	208	221	5703
completàreu	2	1	completareu	2	8	9	5704
completés	2	169	completes	0	5752	5921	5705
completí	2	1	completi	2	731	732	5706
complexificà	2	0	complexifica	2	3	3	5707
complexà	2	0	complexa	0	13248	13248	5708
complexés	2	0	complexes	0	9251	9251	5709
complexí	2	0	complexi	2	36	36	5710
complicarà	2	232	complicara	2	1	233	5711
complicà	2	53	complica	2	2825	2878	5712
complicàrem	2	0	complicarem	2	14	14	5713
complicàreu	2	1	complicareu	2	1	2	5714
complimentarà	2	27	complimentara	2	0	27	5715
complimentà	2	2	complimenta	2	62	64	5716
complimentàrem	2	0	complimentarem	2	2	2	5717
complimentés	2	2	complimentes	2	4	6	5718
complimentí	2	0	complimenti	2	24	24	5719
compliqués	2	27	compliques	2	26	53	5720
compliquí	2	0	compliqui	2	135	135	5721
complirà	2	2110	complira	2	51	2161	5722
complírem	2	6	complirem	2	256	262	5723
complíreu	2	0	complireu	2	7	7	5724
compondré	2	11	compondre	2	5522	5533	5725
compongués	2	44	compongues	2	0	44	5726
componguí	2	0	compongui	2	65	65	5727
comportarà	2	3665	comportara	2	22	3687	5728
comportà	2	1299	comporta	4	29092	30391	5729
comportàrem	2	1	comportarem	2	15	16	5730
comportàreu	2	0	comportareu	2	2	2	5731
comportés	2	224	comportes	4	717	941	5732
comportí	2	0	comporti	2	1933	1933	5733
composarà	2	47	composara	2	4	51	5734
compostarà	2	1	compostara	2	0	1	5735
compostel·là	0	15	compostel·la	4	1063	1078	5736
compostà	2	0	composta	2	8688	8688	5737
compostàrem	2	0	compostarem	2	1	1	5738
compostés	2	0	compostes	2	2415	2415	5739
compostí	2	1	composti	2	2	3	5740
compostó	4	4	composto	2	10	14	5741
composà	2	104	composa	2	1655	1759	5742
composàrem	2	0	composarem	2	9	9	5743
composàreu	2	1	composareu	2	1	2	5744
composés	2	12	composes	2	14	26	5745
composí	2	0	composi	2	47	47	5746
comprarà	2	488	comprara	2	52	540	5747
comprendré	2	17	comprendre	2	27152	27169	5748
comprengués	2	101	comprengues	2	6	107	5749
comprenguí	2	5	comprengui	2	830	835	5750
comprimirà	2	23	comprimira	2	0	23	5751
comprimírem	2	0	comprimirem	2	1	1	5752
comprometré	2	10	comprometre	2	10454	10464	5753
comprometés	2	214	comprometes	2	7	221	5754
comprometí	2	2	comprometi	2	1007	1009	5755
comprovarà	2	849	comprovara	2	9	858	5756
comprovà	2	126	comprova	2	3895	4021	5757
comprovàrem	2	40	comprovarem	2	629	669	5758
comprovàreu	2	1	comprovareu	2	291	292	5759
comprovés	2	117	comproves	2	151	268	5760
comproví	2	2	comprovi	2	901	903	5761
comprà	2	797	compra	4	45332	46129	5762
compràrem	2	41	comprarem	2	343	384	5763
compràreu	2	1	comprareu	2	54	55	5764
comprèn	2	11205	compren	2	4751	15956	5765
comprès	2	4867	compres	4	15258	20125	5766
comprén	2	716	compren	2	4751	5467	5767
comprés	2	1391	compres	4	15258	16649	5768
compréssiu	2	4	compressiu	0	59	63	5769
comprí	2	19	compri	2	1071	1090	5770
comptabilitzarà	2	130	comptabilitzara	2	0	130	5771
comptabilitzà	2	15	comptabilitza	2	562	577	5772
comptabilitzàrem	2	1	comptabilitzarem	2	5	6	5773
comptabilitzés	2	11	comptabilitzes	2	1	12	5774
comptabilitzí	2	0	comptabilitzi	2	33	33	5775
comptarà	2	24401	comptara	2	104	24505	5776
comptà	2	1359	compta	2	80415	81774	5777
comptàrem	2	73	comptarem	2	3729	3802	5778
comptàreu	2	0	comptareu	2	60	60	5779
comptés	2	433	comptes	2	62278	62711	5780
comptí	2	1	compti	2	2536	2537	5781
compulsarà	2	10	compulsara	2	0	10	5782
compulsà	2	0	compulsa	4	137	137	5783
compulsàrem	2	0	compulsarem	2	6	6	5784
compulsés	2	0	compulses	4	33	33	5785
compulsí	2	0	compulsi	2	1	1	5786
compungírem	2	1	compungirem	2	0	1	5787
computarà	2	272	computara	2	2	274	5788
computà	2	2	computa	2	459	461	5789
computés	2	12	computes	2	3	15	5790
computí	2	0	computi	2	63	63	5791
comunicarà	2	2697	comunicara	2	14	2711	5792
comunicà	2	245	comunica	2	7625	7870	5793
comunicàrem	2	17	comunicarem	2	507	524	5794
comunicàreu	2	5	comunicareu	2	12	17	5795
comuniqués	2	240	comuniques	2	153	393	5796
comuniquí	2	2	comuniqui	2	1977	1979	5797
comunès	4	0	comunes	4	13904	13904	5798
comunés	4	1	comunes	4	13904	13905	5799
comà	2	4	coma	4	12829	12833	5800
comès	2	7083	comes	4	4111	11194	5801
comés	2	895	comes	4	4111	5006	5802
comís	2	205	comis	2	17	222	5803
concassàrem	2	1	concassarem	2	0	1	5804
concatenarà	2	2	concatenara	2	0	2	5805
concatenà	2	0	concatena	2	21	21	5806
concatení	2	0	concateni	2	2	2	5807
concebré	2	1	concebre	2	4641	4642	5808
concebés	2	35	concebes	2	0	35	5809
concebí	2	20	concebi	2	64	84	5810
concedirà	2	1077	concedira	2	45	1122	5811
concedírem	2	1	concedirem	2	60	61	5812
concedíreu	2	6	concedireu	2	4	10	5813
concelebrarà	2	5	concelebrara	2	0	5	5814
concelebrà	2	11	concelebra	2	19	30	5815
concelebrí	2	0	concelebri	2	1	1	5816
concentrarà	2	727	concentrara	2	8	735	5817
concentrà	2	231	concentra	2	6069	6300	5818
concentràrem	2	9	concentrarem	2	188	197	5819
concentràreu	2	0	concentrareu	2	2	2	5820
concentrés	2	129	concentres	2	83	212	5821
concentrí	2	0	concentri	2	486	486	5822
conceptualitzarà	2	1	conceptualitzara	2	0	1	5823
conceptualitzà	2	1	conceptualitza	2	93	94	5824
conceptualitzàrem	2	0	conceptualitzarem	2	4	4	5825
conceptualitzí	2	0	conceptualitzi	2	2	2	5826
conceptuà	2	1	conceptua	2	22	23	5827
concernirà	2	7	concernira	2	0	7	5828
concertarà	2	80	concertara	2	4	84	5829
concertà	2	31	concerta	2	197	228	5830
concertàrem	2	2	concertarem	2	44	46	5831
concertàreu	2	0	concertareu	2	1	1	5832
concertés	2	7	concertes	2	14	21	5833
concertí	2	15	concerti	2	112	127	5834
conciliarà	2	4	conciliara	2	2	6	5835
concilià	2	3	concilia	2	185	188	5836
conciliàrem	2	1	conciliarem	2	4	5	5837
conciliàreu	2	0	conciliareu	2	1	1	5838
conciliés	2	2	concilies	2	1	3	5839
concilií	2	0	concilii	2	5	5	5840
concitarà	2	4	concitara	2	2	6	5841
concità	2	9	concita	2	68	77	5842
concités	2	3	concites	2	0	3	5843
concití	2	0	conciti	2	23	23	5844
conclogués	2	87	conclogues	2	0	87	5845
concloguí	2	0	conclogui	2	611	611	5846
conclouré	2	270	concloure	2	15534	15804	5847
concordarà	2	5	concordara	2	0	5	5848
concordà	2	3	concorda	2	1133	1136	5849
concordés	2	6	concordes	2	288	294	5850
concordí	2	0	concordi	4	128	128	5851
concretarà	2	658	concretara	2	10	668	5852
concretà	2	162	concreta	0	19997	20159	5853
concretàrem	2	1	concretarem	2	177	178	5854
concretàreu	2	0	concretareu	2	6	6	5855
concretés	2	64	concretes	0	19204	19268	5856
concretí	2	0	concreti	2	589	589	5857
conculcarà	2	2	conculcara	2	0	2	5858
conculcà	2	0	conculca	2	88	88	5859
conculquí	2	0	conculqui	2	21	21	5860
concursarà	2	20	concursara	2	0	20	5861
concursà	2	10	concursa	2	139	149	5862
concursàrem	2	0	concursarem	2	2	2	5863
concursés	2	3	concurses	2	10	13	5864
concursí	2	0	concursi	2	12	12	5865
condecorarà	2	7	condecorara	2	1	8	5866
condecorà	2	18	condecora	2	41	59	5867
condecorés	2	1	condecores	2	0	1	5868
condecorí	2	0	condecori	2	14	14	5869
condemnarà	2	155	condemnara	2	16	171	5870
condemnà	2	428	condemna	4	14321	14749	5871
condemnàrem	2	0	condemnarem	2	38	38	5872
condemnàreu	2	0	condemnareu	2	3	3	5873
condemnés	2	176	condemnes	4	2062	2238	5874
condemní	2	0	condemni	2	495	495	5875
condensarà	2	21	condensara	2	1	22	5876
condensà	2	8	condensa	2	700	708	5877
condensés	2	4	condenses	2	3	7	5878
condensí	2	0	condensi	2	50	50	5879
condescendirà	2	1	condescendira	2	0	1	5880
condicionarà	2	592	condicionara	2	6	598	5881
condicionà	2	104	condiciona	2	3453	3557	5882
condicionàrem	2	0	condicionarem	2	16	16	5883
condicionés	2	36	condiciones	2	774	810	5884
condicioní	2	0	condicioni	2	327	327	5885
condimentarà	2	6	condimentara	2	0	6	5886
condimentà	2	2	condimenta	2	99	101	5887
condimentàrem	2	0	condimentarem	2	10	10	5888
condimentàreu	2	0	condimentareu	2	1	1	5889
condimentés	2	0	condimentes	2	2	2	5890
condimentí	2	0	condimenti	2	3	3	5891
condirà	2	7	condira	2	1	8	5892
condoldré	2	0	condoldre	2	6	6	5893
condonarà	2	8	condonara	2	0	8	5894
condonà	2	5	condona	2	22	27	5895
condonés	2	5	condones	2	3	8	5896
condoní	2	0	condoni	2	15	15	5897
conduírem	2	3	conduirem	2	89	92	5898
conduíreu	2	1	conduireu	2	8	9	5899
conegués	2	1029	conegues	2	85	1114	5900
coneguí	2	29	conegui	2	4875	4904	5901
confabularà	2	3	confabulara	2	0	3	5902
confabulà	2	1	confabula	2	23	24	5903
confabulés	2	2	confabules	2	0	2	5904
confeccionarà	2	156	confeccionara	2	3	159	5905
confeccionà	2	76	confecciona	2	1328	1404	5906
confeccionàrem	2	6	confeccionarem	2	110	116	5907
confeccionàreu	2	0	confeccionareu	2	2	2	5908
confeccionés	2	17	confecciones	2	36	53	5909
confeccioní	2	0	confeccioni	2	52	52	5910
confederà	2	0	confedera	2	6	6	5911
confederàreu	2	0	confederareu	2	1	1	5912
confederí	2	0	confederi	2	2	2	5913
confegirà	2	9	confegira	2	0	9	5914
confegírem	2	0	confegirem	2	5	5	5915
confegíreu	2	0	confegireu	2	1	1	5916
conferenciarà	2	4	conferenciara	2	0	4	5917
conferencià	2	3	conferencia	2	1699	1702	5918
conferenciàrem	2	0	conferenciarem	2	1	1	5919
conferenciés	2	1	conferencies	2	551	552	5920
conferirà	2	78	conferira	2	0	78	5921
conferència	4	70763	conferencia	2	1699	72462	5922
conferències	4	30143	conferencies	2	551	30694	5923
conferírem	2	0	conferirem	2	5	5	5924
confessarà	2	55	confessara	2	4	59	5925
confessà	2	211	confessa	2	3316	3527	5926
confessàrem	2	1	confessarem	2	12	13	5927
confessàreu	2	1	confessareu	2	1	2	5928
confessés	2	72	confesses	2	43	115	5929
confessí	2	1	confessi	2	129	130	5930
confiarà	2	127	confiara	2	5	132	5931
configurarà	2	207	configurara	2	2	209	5932
configurà	2	126	configura	2	5107	5233	5933
configuràrem	2	2	configurarem	2	61	63	5934
configuràreu	2	0	configurareu	2	7	7	5935
configurés	2	30	configures	2	33	63	5936
configurí	2	0	configuri	2	263	263	5937
confinarà	2	1	confinara	2	0	1	5938
confinà	2	8	confina	2	106	114	5939
confinàrem	2	0	confinarem	2	1	1	5940
confinés	2	1	confines	2	29	30	5941
confiní	2	0	confini	2	22	22	5942
confirmarà	2	651	confirmara	2	19	670	5943
confirmà	2	626	confirma	2	11551	12177	5944
confirmàrem	2	0	confirmarem	2	315	315	5945
confirmàreu	2	2	confirmareu	2	12	14	5946
confirmés	2	458	confirmes	2	406	864	5947
confirmí	2	0	confirmi	2	1031	1031	5948
confiscà	2	65	confisca	2	59	124	5949
confiscàrem	2	1	confiscarem	2	1	2	5950
confisqués	2	24	confisques	2	0	24	5951
confisquí	2	0	confisqui	2	11	11	5952
confitarà	2	1	confitara	2	0	1	5953
confità	2	0	confita	0	29	29	5954
confitàrem	2	0	confitarem	2	8	8	5955
confités	2	1	confites	0	1	2	5956
confití	2	0	confiti	2	25	25	5957
confià	2	256	confia	2	6376	6632	5958
confiàrem	2	4	confiarem	2	52	56	5959
confiàreu	2	3	confiareu	2	5	8	5960
confiés	2	100	confies	2	316	416	5961
confií	2	13	confii	2	63	76	5962
conflictivitzà	2	0	conflictivitza	2	3	3	5963
confluírem	2	0	confluirem	2	19	19	5964
confondré	2	4	confondre	2	8068	8072	5965
confongués	2	69	confongues	2	7	76	5966
confonguí	2	0	confongui	2	371	371	5967
conformarà	2	218	conformara	2	4	222	5968
conformà	2	102	conforma	2	3682	3784	5969
conformàrem	2	1	conformarem	2	111	112	5970
conformàreu	2	0	conformareu	2	6	6	5971
conformés	2	30	conformes	2	850	880	5972
conformí	2	0	conformi	2	204	204	5973
confortarà	2	4	confortara	2	0	4	5974
confortà	2	3	conforta	2	107	110	5975
confortés	2	1	confortes	2	0	1	5976
confortí	2	0	conforti	2	29	29	5977
confraternitzà	2	2	confraternitza	2	6	8	5978
confraternitzàrem	2	0	confraternitzarem	2	3	3	5979
confraternitzés	2	1	confraternitzes	2	1	2	5980
confrontarà	2	28	confrontara	2	1	29	5981
confrontà	2	15	confronta	4	612	627	5982
confrontàrem	2	1	confrontarem	2	14	15	5983
confrontàreu	2	1	confrontareu	2	0	1	5984
confrontés	2	2	confrontes	4	12	14	5985
confrontí	2	0	confronti	2	38	38	5986
confugí	2	0	confugi	2	5	5	5987
confutà	2	0	confuta	2	1	1	5988
congelarà	2	83	congelara	2	1	84	5989
congelà	2	21	congela	2	569	590	5990
congelàrem	2	1	congelarem	2	26	27	5991
congelàreu	2	0	congelareu	2	1	1	5992
congelés	2	35	congeles	2	32	67	5993
congelí	2	0	congeli	2	112	112	5994
congeniarà	2	1	congeniara	2	0	1	5995
congenià	2	3	congenia	2	22	25	5996
congeniàrem	2	0	congeniarem	2	2	2	5997
congeniàreu	2	0	congeniareu	2	1	1	5998
congeniés	2	0	congenies	2	2	2	5999
congestionarà	2	2	congestionara	2	0	2	6000
congestionà	2	0	congestiona	2	25	25	6001
congestionés	2	1	congestiones	2	0	1	6002
congestioní	2	0	congestioni	2	5	5	6003
conglomerarà	2	1	conglomerara	2	0	1	6004
conglomerà	2	0	conglomera	2	4	4	6005
congoixà	2	0	congoixa	4	14	14	6006
congoixés	2	0	congoixes	4	3	3	6007
congraciarà	2	1	congraciara	2	0	1	6008
congracià	2	0	congracia	2	3	3	6009
congratularà	2	2	congratulara	2	1	3	6010
congratulà	2	10	congratula	2	457	467	6011
congratulàrem	2	0	congratularem	2	2	2	6012
congratulés	2	0	congratules	2	1	1	6013
congratulí	2	0	congratuli	2	7	7	6014
congregarà	2	123	congregara	2	0	123	6015
congregués	2	5	congregues	2	0	5	6016
congreguí	2	0	congregui	2	18	18	6017
congregà	2	66	congrega	2	513	579	6018
congregàrem	2	2	congregarem	2	2	4	6019
congriarà	2	1	congriara	2	0	1	6020
congrià	2	5	congria	2	64	69	6021
congriés	2	2	congries	2	0	2	6022
congrés	4	71318	congres	4	833	72151	6023
conhortà	2	4	conhorta	2	15	19	6024
conhortí	2	0	conhorti	2	1	1	6025
conillà	2	0	conilla	0	109	109	6026
conillés	2	2	conilles	4	64	66	6027
conilló	4	2	conillo	2	0	2	6028
conjecturà	2	8	conjectura	4	633	641	6029
conjecturés	2	0	conjectures	4	525	525	6030
conjecturí	2	0	conjecturi	2	1	1	6031
conjugarà	2	23	conjugara	2	6	29	6032
conjugués	2	3	conjugues	2	39	42	6033
conjuguí	2	0	conjugui	2	40	40	6034
conjugà	2	19	conjuga	2	1056	1075	6035
conjugàrem	2	0	conjugarem	2	10	10	6036
conjuminarà	2	14	conjuminara	2	1	15	6037
conjuminà	2	6	conjumina	2	261	267	6038
conjuminàrem	2	0	conjuminarem	2	2	2	6039
conjuminés	2	3	conjumines	2	2	5	6040
conjuminí	2	0	conjumini	2	33	33	6041
conjuntarà	2	2	conjuntara	2	0	2	6042
conjuntà	2	0	conjunta	0	24838	24838	6043
conjuntés	2	2	conjuntes	0	4703	4705	6044
conjuntí	2	0	conjunti	2	3	3	6045
conjurarà	2	5	conjurara	2	0	5	6046
conjurà	2	9	conjura	4	388	397	6047
conjuràrem	2	0	conjurarem	2	5	5	6048
conjurés	2	3	conjures	4	42	45	6049
conjurí	2	0	conjuri	2	12	12	6050
conllogà	2	0	conlloga	4	93	93	6051
connectarà	2	1302	connectara	2	14	1316	6052
connectà	2	59	connecta	2	10435	10494	6053
connectàrem	2	4	connectarem	2	210	214	6054
connectàreu	2	0	connectareu	2	24	24	6055
connectés	2	117	connectes	2	239	356	6056
connectí	2	0	connecti	2	990	990	6057
connotarà	2	2	connotara	2	0	2	6058
connotà	2	1	connota	2	76	77	6059
connotàrem	2	0	connotarem	2	1	1	6060
connotés	2	6	connotes	2	0	6	6061
conquerirà	2	41	conquerira	2	7	48	6062
conquerírem	2	0	conquerirem	2	22	22	6063
conqueríreu	2	0	conquerireu	2	1	1	6064
conquistarà	2	51	conquistara	2	5	56	6065
conquistà	2	59	conquista	4	1216	1275	6066
conquistàrem	2	1	conquistarem	2	13	14	6067
conquistés	2	14	conquistes	4	175	189	6068
conquistí	2	1	conquisti	2	11	12	6069
conquès	0	4	conques	4	2902	2906	6070
conqués	0	2	conques	4	2902	2904	6071
conrearà	2	21	conreara	2	2	23	6072
conreà	2	463	conrea	2	1336	1799	6073
conreàrem	2	0	conrearem	2	5	5	6074
conreàreu	2	1	conreareu	2	0	1	6075
conreés	2	19	conrees	2	16	35	6076
conrà	2	0	conra	2	57	57	6077
conrés	2	1	conres	2	2	3	6078
conrí	2	0	conri	2	3	3	6079
conró	4	14	conro	2	2	16	6080
consagrarà	2	74	consagrara	2	1	75	6081
consagrà	2	375	consagra	2	903	1278	6082
consagràrem	2	0	consagrarem	2	8	8	6083
consagràreu	2	0	consagrareu	2	1	1	6084
consagrés	2	34	consagres	2	3	37	6085
consagrí	2	0	consagri	2	69	69	6086
conscienciarà	2	22	conscienciara	2	2	24	6087
conscienciegí	2	0	conscienciegi	2	2	2	6088
conscienciejà	2	0	consciencieja	2	1	1	6089
consciencià	2	9	consciencia	2	1446	1455	6090
conscienciàrem	2	2	conscienciarem	2	6	8	6091
conscienciés	2	3	consciencies	2	31	34	6092
consciencií	2	2	consciencii	2	1	3	6093
consciència	4	45943	consciencia	2	1446	47389	6094
consciències	4	1905	consciencies	2	31	1936	6095
consensuarà	2	68	consensuara	2	3	71	6096
consensuà	2	5	consensua	2	162	167	6097
consensuàrem	2	1	consensuarem	2	25	26	6098
consensués	2	7	consensues	2	2	9	6099
consentirà	2	84	consentira	2	3	87	6100
consentí	2	37	consenti	2	84	121	6101
consentírem	2	1	consentirem	2	102	103	6102
consentíreu	2	1	consentireu	2	2	3	6103
consentís	2	30	consentis	2	5	35	6104
conservarà	2	778	conservara	2	20	798	6105
conservà	2	431	conserva	4	23697	24128	6106
conservàrem	2	5	conservarem	2	500	505	6107
conservàreu	2	1	conservareu	2	16	17	6108
conservés	2	169	conserves	4	2240	2409	6109
conserví	2	0	conservi	2	936	936	6110
considerarà	2	2653	considerara	2	75	2728	6111
considerà	2	1073	considera	2	70598	71671	6112
consideràrem	2	42	considerarem	2	656	698	6113
consideràreu	2	1	considerareu	2	11	12	6114
considerés	2	940	consideres	2	915	1855	6115
considerí	2	6	consideri	2	9072	9078	6116
consignarà	2	80	consignara	2	0	80	6117
consignà	2	22	consigna	4	3063	3085	6118
consignàrem	2	0	consignarem	2	3	3	6119
consignés	2	12	consignes	4	3388	3400	6120
consigní	2	0	consigni	2	55	55	6121
consirà	2	3	consira	2	5	8	6122
consistirà	2	4820	consistira	2	16	4836	6123
consolarà	2	28	consolara	2	1	29	6124
consoldà	2	0	consolda	4	32	32	6125
consoldés	2	0	consoldes	4	1	1	6126
consolidarà	2	430	consolidara	2	15	445	6127
consolidà	2	500	consolida	2	6143	6643	6128
consolidàrem	2	0	consolidarem	2	65	65	6129
consolidàreu	2	0	consolidareu	2	2	2	6130
consolidés	2	115	consolides	2	5	120	6131
consolidí	2	0	consolidi	2	807	807	6132
consolà	2	10	consola	4	4584	4594	6133
consolàrem	2	1	consolarem	2	11	12	6134
consolés	2	9	consoles	4	1628	1637	6135
consolí	2	0	consoli	2	48	48	6136
consonantés	2	0	consonantes	2	5	5	6137
consonà	2	0	consona	2	10	10	6138
consoní	2	0	consoni	2	2	2	6139
consorciarà	2	1	consorciara	2	0	1	6140
consorcià	2	1	consorcia	2	1	2	6141
conspirarà	2	8	conspirara	2	0	8	6142
conspirà	2	28	conspira	2	151	179	6143
conspiràrem	2	0	conspirarem	2	1	1	6144
conspirés	2	17	conspires	2	1	18	6145
conspirí	2	0	conspiri	2	5	5	6146
constantà	4	17	constanta	4	34	51	6147
constarà	2	2745	constara	2	17	2762	6148
constatarà	2	55	constatara	2	2	57	6149
constatà	2	150	constata	2	5172	5322	6150
constatàrem	2	18	constatarem	2	94	112	6151
constatàreu	2	0	constatareu	2	17	17	6152
constatés	2	54	constates	2	46	100	6153
constatí	2	13	constati	2	185	198	6154
constel·là	2	0	constel·la	2	7	7	6155
constel·làrem	2	0	constel·larem	2	3	3	6156
constel·lés	2	0	constel·les	2	1	1	6157
consternà	2	5	consterna	2	24	29	6158
consternàreu	2	1	consternareu	2	0	1	6159
constiparà	2	2	constipara	2	0	2	6160
constipà	2	0	constipa	2	11	11	6161
constipàrem	2	0	constiparem	2	1	1	6162
constipés	2	1	constipes	2	4	5	6163
constipí	2	0	constipi	2	6	6	6164
constitucionalitzarà	2	1	constitucionalitzara	2	0	1	6165
constitucionalitzà	2	0	constitucionalitza	2	5	5	6166
constitucionalitzí	2	0	constitucionalitzi	2	1	1	6167
constituírem	2	14	constituirem	2	36	50	6168
constituíreu	2	0	constituireu	2	1	1	6169
constrenyérem	2	0	constrenyerem	2	2	2	6170
constrenyés	2	1	constrenyes	2	0	1	6171
constrenyí	2	0	constrenyi	2	11	11	6172
construírem	2	18	construirem	2	718	736	6173
construíreu	2	0	construireu	2	25	25	6174
constà	2	84	consta	2	34004	34088	6175
constàrem	2	0	constarem	2	1	1	6176
constàreu	2	0	constareu	2	4	4	6177
constés	2	196	constes	2	13	209	6178
constí	2	8	consti	2	3768	3776	6179
consultarà	2	257	consultara	2	1	258	6180
consultà	2	46	consulta	4	70044	70090	6181
consultàrem	2	4	consultarem	2	70	74	6182
consultàreu	2	2	consultareu	2	4	6	6183
consultés	2	85	consultes	4	22394	22479	6184
consultí	2	2	consulti	2	1852	1854	6185
consumarà	2	32	consumara	2	1	33	6186
consumirà	2	194	consumira	2	3	197	6187
consumà	2	47	consuma	2	214	261	6188
consumés	2	20	consumes	2	0	20	6189
consumí	2	23	consumi	2	45	68	6190
consumírem	2	1	consumirem	2	61	62	6191
consumíreu	2	0	consumireu	2	17	17	6192
consumís	2	69	consumis	2	7	76	6193
consòrcia	4	44	consorcia	2	1	45	6194
consòrcies	4	2	consorcies	2	0	2	6195
contactarà	2	531	contactara	2	1	532	6196
contactà	2	141	contacta	2	4637	4778	6197
contactàrem	2	11	contactarem	2	466	477	6198
contactàreu	2	0	contactareu	2	2	2	6199
contactés	2	60	contactes	2	19757	19817	6200
contactí	2	1	contacti	2	1498	1499	6201
contagiarà	2	28	contagiara	2	5	33	6202
contagià	2	18	contagia	2	547	565	6203
contagiàrem	2	0	contagiarem	2	6	6	6204
contagiàreu	2	0	contagiareu	2	1	1	6205
contagiés	2	19	contagies	2	18	37	6206
contagií	2	1	contagii	2	2	3	6207
contagió	4	5	contagio	2	33	38	6208
contaminarà	2	35	contaminara	2	1	36	6209
contaminà	2	12	contamina	2	1393	1405	6210
contaminàrem	2	0	contaminarem	2	6	6	6211
contaminés	2	36	contamines	2	26	62	6212
contaminí	2	0	contamini	2	140	140	6213
contarà	2	636	contara	2	60	696	6214
contemperà	2	0	contempera	2	1	1	6215
contemplarà	2	270	contemplara	2	21	291	6216
contemplà	2	92	contempla	2	12970	13062	6217
contemplàrem	2	18	contemplarem	2	205	223	6218
contemplàreu	2	1	contemplareu	2	29	30	6219
contemplés	2	131	contemples	2	115	246	6220
contemplí	2	0	contempli	2	1275	1275	6221
contemporitzà	2	2	contemporitza	2	9	11	6222
contendré	2	0	contendre	2	21	21	6223
contenguí	2	0	contengui	2	58	58	6224
contestarà	2	341	contestara	2	22	363	6225
contestà	2	910	contesta	4	3155	4065	6226
contestàrem	2	8	contestarem	2	338	346	6227
contestàreu	2	0	contestareu	2	12	12	6228
contestés	2	157	contestes	4	206	363	6229
contestí	2	96	contesti	2	451	547	6230
contextualitzarà	2	31	contextualitzara	2	3	34	6231
contextualitzà	2	9	contextualitza	2	461	470	6232
contextualitzàrem	2	0	contextualitzarem	2	10	10	6233
contextualitzés	2	4	contextualitzes	2	3	7	6234
contextualitzí	2	0	contextualitzi	2	27	27	6235
contindré	2	8	contindre	2	250	258	6236
contingués	2	178	contingues	2	4	182	6237
continguí	2	0	contingui	2	2786	2786	6238
continuarà	2	16973	continuara	2	199	17172	6239
continuà	2	4265	continua	2	118815	123080	6240
continuàrem	2	129	continuarem	2	8855	8984	6241
continuàreu	2	2	continuareu	2	145	147	6242
continués	2	1280	continues	2	2513	3793	6243
contorbà	2	7	contorba	2	6	13	6244
contorbés	2	0	contorbes	2	1	1	6245
contornejà	2	0	contorneja	2	18	18	6246
contornejàrem	2	0	contornejarem	2	1	1	6247
contornà	2	28	contorna	2	6	34	6248
contornés	2	2	contornes	2	0	2	6249
contorní	2	0	contorni	2	1	1	6250
contorçarà	2	1	contorçara	2	0	1	6251
contraargumentà	2	0	contraargumenta	2	8	8	6252
contraatacarà	2	11	contraatacara	2	0	11	6253
contraatacà	2	42	contraataca	2	255	297	6254
contraatacàrem	2	0	contraatacarem	2	1	1	6255
contraataqués	2	4	contraataques	2	2	6	6256
contraataquí	2	0	contraataqui	2	2	2	6257
contrabalancí	2	0	contrabalanci	2	1	1	6258
contrabalançà	2	0	contrabalança	2	5	5	6259
contractarà	2	478	contractara	2	16	494	6260
contracturà	2	0	contractura	4	254	254	6261
contracturés	2	0	contractures	4	476	476	6262
contractà	2	185	contracta	4	2356	2541	6263
contractàrem	2	3	contractarem	2	44	47	6264
contractàreu	2	0	contractareu	2	4	4	6265
contractés	2	111	contractes	4	27405	27516	6266
contractí	2	0	contracti	2	539	539	6267
contradigués	2	21	contradigues	2	0	21	6268
contradiguí	2	0	contradigui	2	340	340	6269
contrafirmà	2	0	contrafirma	4	8	8	6270
contraforadà	2	0	contraforada	2	1	1	6271
contragués	2	19	contragues	2	1	20	6272
contraguí	2	0	contragui	2	16	16	6273
contraindicà	2	0	contraindica	2	17	17	6274
contraindiquí	2	0	contraindiqui	2	8	8	6275
contramaní	2	0	contramani	2	1	1	6276
contramarcà	2	0	contramarca	4	21	21	6277
contramarqués	2	0	contramarques	4	3	3	6278
contramarxà	2	0	contramarxa	4	56	56	6279
contramarxàrem	2	0	contramarxarem	2	1	1	6280
contramarxés	2	0	contramarxes	4	5	5	6281
contraminà	2	0	contramina	4	2	2	6282
contraminés	2	0	contramines	4	5	5	6283
contrapassàrem	2	0	contrapassarem	2	1	1	6284
contraperfilàrem	2	1	contraperfilarem	2	0	1	6285
contrapesà	2	0	contrapesa	2	12	12	6286
contrapesàrem	2	1	contrapesarem	2	0	1	6287
contrapesés	2	1	contrapeses	2	2	3	6288
contrapesí	2	0	contrapesi	2	1	1	6289
contraplaqués	2	0	contraplaques	2	1	1	6290
contraposarà	2	11	contraposara	2	0	11	6291
contraposà	2	19	contraposa	2	876	895	6292
contraposàrem	2	0	contraposarem	2	5	5	6293
contraposés	2	11	contraposes	2	4	15	6294
contraposí	2	0	contraposi	2	28	28	6295
contraprogramarà	2	3	contraprogramara	2	0	3	6296
contraprogramà	2	0	contraprograma	2	12	12	6297
contraprogramés	2	1	contraprogrames	2	1	2	6298
contraprogramí	2	0	contraprogrami	2	2	2	6299
contrapuntejà	2	0	contrapunteja	2	6	6	6300
contrapuntejàrem	2	0	contrapuntejarem	2	1	1	6301
contrapuntà	2	0	contrapunta	2	11	11	6302
contrapuntàreu	2	1	contrapuntareu	2	0	1	6303
contrarestarà	2	14	contrarestara	2	1	15	6304
contrarestà	2	9	contraresta	2	233	242	6305
contrarestàrem	2	0	contrarestarem	2	6	6	6306
contrarestés	2	13	contrarestes	2	3	16	6307
contrarestí	2	0	contraresti	2	59	59	6308
contrarià	2	10	contraria	2	1006	1016	6309
contrariàrem	2	0	contrariarem	2	1	1	6310
contrariés	2	1	contraries	2	252	253	6311
contrarií	2	1	contrarii	2	3	4	6312
contrasegellàreu	2	1	contrasegellareu	2	0	1	6313
contrasignarà	2	1	contrasignara	2	0	1	6314
contrasignà	2	0	contrasigna	2	1	1	6315
contrastarà	2	65	contrastara	2	1	66	6316
contrastà	2	18	contrasta	2	4401	4419	6317
contrastàrem	2	1	contrastarem	2	21	22	6318
contrastàreu	2	0	contrastareu	2	2	2	6319
contrastés	2	18	contrastes	2	59	77	6320
contrastí	2	0	contrasti	2	67	67	6321
contrauré	2	0	contraure	2	1516	1516	6322
contravenguí	2	0	contravengui	2	2	2	6323
contravindré	2	1	contravindre	2	4	5	6324
contravingués	2	6	contravingues	2	0	6	6325
contravinguí	2	0	contravingui	2	125	125	6326
contraxaparà	2	1	contraxapara	2	0	1	6327
contraxapà	2	0	contraxapa	2	1	1	6328
contribuírem	2	3	contribuirem	2	310	313	6329
contribuíreu	2	0	contribuireu	2	50	50	6330
contristà	2	0	contrista	2	4	4	6331
contristàreu	2	0	contristareu	2	1	1	6332
contristí	2	1	contristi	2	0	1	6333
controlarà	2	555	controlara	2	10	565	6334
controlà	2	76	controla	2	7529	7605	6335
controlàrem	2	2	controlarem	2	126	128	6336
controlàreu	2	0	controlareu	2	12	12	6337
controlés	2	163	controles	2	333	496	6338
controlí	2	0	controli	2	905	905	6339
contrària	0	7287	contraria	2	1006	8293	6340
contràries	0	3558	contraries	2	252	3810	6341
contusionés	2	0	contusiones	2	2	2	6342
contà	2	326	conta	2	7010	7336	6343
contàrem	2	50	contarem	2	442	492	6344
contàreu	2	0	contareu	2	41	41	6345
contès	2	4	contes	2	43556	43560	6346
conté	2	51081	conte	2	38143	89224	6347
contén	2	11	conten	2	2173	2184	6348
contés	2	56	contes	2	43556	43612	6349
contí	2	9	conti	2	505	514	6350
contín	2	5	contin	2	121	126	6351
contínua	0	15926	continua	2	118815	134741	6352
contínues	0	3299	continues	2	2513	5812	6353
convalidarà	2	32	convalidara	2	2	34	6354
convalidà	2	2	convalida	2	108	110	6355
convalidàrem	2	0	convalidarem	2	1	1	6356
convalidés	2	4	convalides	2	0	4	6357
convalidí	2	0	convalidi	2	20	20	6358
convencerà	2	159	convencera	2	10	169	6359
convencérem	2	2	convencerem	2	49	51	6360
convencéreu	2	0	convencereu	2	29	29	6361
convencés	2	91	convences	2	38	129	6362
convencí	2	2	convenci	2	302	304	6363
convenguí	2	1	convengui	2	43	44	6364
convergirà	2	20	convergira	2	1	21	6365
convergírem	2	0	convergirem	2	5	5	6366
conversarà	2	287	conversara	2	0	287	6367
conversejà	2	0	converseja	2	1	1	6368
conversà	2	19	conversa	0	26722	26741	6369
conversàrem	2	12	conversarem	2	181	193	6370
conversés	2	4	converses	0	22731	22735	6371
conversí	2	1	conversi	2	35	36	6372
convertirà	2	6544	convertira	2	129	6673	6373
convertírem	2	14	convertirem	2	453	467	6374
convertíreu	2	3	convertireu	2	95	98	6375
convidarà	2	1088	convidara	2	14	1102	6376
convidà	2	413	convida	2	19952	20365	6377
convidàrem	2	23	convidarem	2	344	367	6378
convidàreu	2	0	convidareu	2	5	5	6379
convidés	2	180	convides	2	163	343	6380
convidí	2	1	convidi	2	610	611	6381
convindré	2	2	convindre	2	43	45	6382
convingués	2	113	convingues	2	2	115	6383
convinguí	2	1	convingui	2	1970	1971	6384
convisqués	2	14	convisques	2	0	14	6385
convisquí	2	0	convisqui	2	213	213	6386
conviuré	2	3	conviure	2	8789	8792	6387
convocarà	2	1709	convocara	2	33	1742	6388
convocà	2	707	convoca	2	14312	15019	6389
convocàrem	2	13	convocarem	2	309	322	6390
convocàreu	2	0	convocareu	2	2	2	6391
convoqués	2	319	convoques	2	36	355	6392
convoquí	2	0	convoqui	2	1285	1285	6393
convulsarà	2	1	convulsara	2	0	1	6394
convulsionarà	2	3	convulsionara	2	0	3	6395
convulsionà	2	3	convulsiona	2	19	22	6396
convulsionària	4	1	convulsionaria	2	1	2	6397
convulsionés	2	0	convulsiones	2	5	5	6398
convulsioní	2	0	convulsioni	2	1	1	6399
convulsà	2	3	convulsa	0	1059	1062	6400
convulsés	2	0	convulses	0	154	154	6401
convulsí	2	0	convulsi	2	2	2	6402
conxorxarà	2	1	conxorxara	2	0	1	6403
conxorxà	2	0	conxorxa	4	571	571	6404
conxorxés	2	0	conxorxes	4	140	140	6405
conxorxí	2	0	conxorxi	2	1	1	6406
conxà	2	0	conxa	4	1295	1295	6407
conxés	2	1	conxes	4	43	44	6408
conxí	2	0	conxi	2	251	251	6409
cooperarà	2	96	cooperara	2	1	97	6410
cooperà	2	20	coopera	2	788	808	6411
cooperàrem	2	1	cooperarem	2	51	52	6412
cooperàreu	2	1	cooperareu	2	0	1	6413
cooperés	2	44	cooperes	2	21	65	6414
cooperí	2	0	cooperi	2	205	205	6415
cooptà	2	1	coopta	2	6	7	6416
cooptés	2	0	cooptes	2	2	2	6417
cooptí	2	0	coopti	2	1	1	6418
coordinarà	2	696	coordinara	2	20	716	6419
coordinà	2	104	coordina	2	5019	5123	6420
coordinàrem	2	3	coordinarem	2	77	80	6421
coordinàreu	2	0	coordinareu	2	2	2	6422
coordinés	2	57	coordines	2	7	64	6423
coordiní	2	0	coordini	2	400	400	6424
coorganitzarà	2	5	coorganitzara	2	0	5	6425
coorganitzà	2	2	coorganitza	2	206	208	6426
coorganitzàrem	2	0	coorganitzarem	2	2	2	6427
coorganitzés	2	1	coorganitzes	2	0	1	6428
copaguí	2	0	copagui	2	1	1	6429
copagà	2	0	copaga	2	8	8	6430
coparà	2	9	copara	2	0	9	6431
copegés	2	5	copeges	2	2	7	6432
copegí	2	0	copegi	2	15	15	6433
copejarà	2	8	copejara	2	0	8	6434
copejà	2	10	copeja	2	102	112	6435
copel·là	2	0	copel·la	4	4	4	6436
copel·làreu	2	0	copel·lareu	2	1	1	6437
copiarà	2	134	copiara	2	3	137	6438
copilotà	2	0	copilota	2	2	2	6439
copilotàrem	2	0	copilotarem	2	1	1	6440
copià	2	44	copia	2	3376	3420	6441
copiàrem	2	2	copiarem	2	45	47	6442
copiàreu	2	1	copiareu	2	4	5	6443
copiés	2	26	copies	2	538	564	6444
copií	2	8	copii	2	34	42	6445
copió	4	7	copio	2	650	657	6446
coproduírem	2	0	coproduirem	2	1	1	6447
copsarà	2	24	copsara	2	0	24	6448
copsà	2	22	copsa	2	365	387	6449
copsàrem	2	3	copsarem	2	57	60	6450
copsàreu	2	0	copsareu	2	21	21	6451
copsés	2	9	copses	2	14	23	6452
copsí	2	1	copsi	2	24	25	6453
copularà	2	1	copulara	2	0	1	6454
copulà	2	0	copula	2	30	30	6455
copulés	2	1	copules	2	2	3	6456
copulí	2	4	copuli	2	1	5	6457
copà	2	5	copa	4	46403	46408	6458
copés	2	0	copes	4	6315	6315	6459
copí	2	2	copi	2	117	119	6460
copó	4	61	copo	2	20	81	6461
coquetegés	2	2	coqueteges	2	1	3	6462
coquetegí	2	0	coquetegi	2	2	2	6463
coquetejà	2	4	coqueteja	2	76	80	6464
coquetó	0	88	coqueto	0	9	97	6465
coquitzí	2	0	coquitzi	2	1	1	6466
corallà	2	0	coralla	2	2	2	6467
corallí	2	0	coralli	2	7	7	6468
coralà	2	0	corala	2	1	1	6469
coralés	2	0	corales	2	23	23	6470
corbarà	2	11	corbara	2	0	11	6471
corbà	2	4	corba	0	6888	6892	6472
corbés	2	2	corbes	0	4547	4549	6473
corcarà	2	1	corcara	2	1	2	6474
corcà	2	10	corca	2	85	95	6475
cordarà	2	3	cordara	2	1	4	6476
cordellà	2	0	cordella	2	3	3	6477
cordellés	2	0	cordelles	4	100	100	6478
corderà	2	0	cordera	4	73	73	6479
corderés	2	0	corderes	4	2	2	6480
cordà	2	329	corda	4	15917	16246	6481
cordàrem	2	1	cordarem	2	0	1	6482
cordés	2	0	cordes	4	8824	8824	6483
cordí	2	3	cordi	2	24	27	6484
cordó	4	3640	cordo	2	45	3685	6485
coregés	2	2	coreges	2	2	4	6486
coregí	2	0	coregi	2	1	1	6487
corejà	2	2	coreja	2	39	41	6488
corejàrem	2	0	corejarem	2	1	1	6489
coreografià	2	6	coreografia	4	4688	4694	6490
coreografiés	2	0	coreografies	4	3175	3175	6491
coreà	0	1753	corea	4	11295	13048	6492
corferí	2	1	corferi	2	0	1	6493
corfondré	2	0	corfondre	2	1	1	6494
corfà	2	0	corfa	4	173	173	6495
corfés	2	0	corfes	4	37	37	6496
corfí	2	0	corfi	2	3	3	6497
corglaçà	2	5	corglaça	2	2	7	6498
cornejà	2	0	corneja	2	11	11	6499
cornuà	2	0	cornua	2	3	3	6500
cornà	2	0	corna	2	57	57	6501
cornés	2	1	cornes	2	40	41	6502
corní	2	0	corni	2	69	69	6503
coronarà	2	91	coronara	2	3	94	6504
coronà	2	116	corona	4	23722	23838	6505
coronàrem	2	1	coronarem	2	25	26	6506
coronàreu	2	0	coronareu	2	2	2	6507
coronària	0	493	coronaria	2	53	546	6508
coronàries	0	373	coronaries	2	15	388	6509
coronés	2	21	corones	4	2458	2479	6510
coroní	2	0	coroni	2	37	37	6511
corporificà	2	0	corporifica	2	5	5	6512
corporitzà	2	0	corporitza	2	5	5	6513
corprendré	2	0	corprendre	2	59	59	6514
corprengués	2	1	corprengues	2	0	1	6515
corprenguí	2	0	corprengui	2	7	7	6516
corqués	2	2	corques	2	1	3	6517
corquí	2	0	corqui	2	9	9	6518
corredactà	2	0	corredacta	2	1	1	6519
corregirà	2	218	corregira	2	8	226	6520
corregnà	2	1	corregna	2	0	1	6521
corregírem	2	1	corregirem	2	144	145	6522
corregíreu	2	0	corregireu	2	8	8	6523
correlacionarà	2	2	correlacionara	2	0	2	6524
correlacionà	2	1	correlaciona	2	211	212	6525
correlacionés	2	0	correlaciones	2	2	2	6526
correlacioní	2	0	correlacioni	2	6	6	6527
correlà	2	0	correla	2	2	2	6528
correlés	2	0	correles	2	1	1	6529
correrà	2	924	correra	4	28	952	6530
correspondré	2	3	correspondre	2	4139	4142	6531
correspongués	2	179	correspongues	2	0	179	6532
corresponguí	2	0	correspongui	2	4845	4845	6533
corresponsabilitzarà	2	3	corresponsabilitzara	2	1	4	6534
corresponsabilitzà	2	0	corresponsabilitza	2	17	17	6535
corresponsabilitzés	2	0	corresponsabilitzes	2	1	1	6536
corresponsabilitzí	2	0	corresponsabilitzi	2	12	12	6537
corriolejà	2	0	corrioleja	2	1	1	6538
corroborarà	2	10	corroborara	2	0	10	6539
corroborà	2	24	corrobora	2	836	860	6540
corroboràrem	2	0	corroborarem	2	4	4	6541
corroboràreu	2	1	corroborareu	2	0	1	6542
corroborés	2	17	corrobores	2	8	25	6543
corroborí	2	0	corrobori	2	50	50	6544
corrompré	2	1	corrompre	2	436	437	6545
corrompés	2	8	corrompes	2	0	8	6546
corrompí	2	1	corrompi	2	22	23	6547
corrugués	2	0	corrugues	2	1	1	6548
corrugà	2	0	corruga	2	2	2	6549
corruixés	2	0	corruixes	2	4	4	6550
corsecarà	2	2	corsecara	2	0	2	6551
corsecà	2	2	corseca	0	38	40	6552
corsequés	2	1	corseques	0	0	1	6553
corsequí	2	0	corsequi	2	2	2	6554
cortegés	2	1	corteges	2	0	1	6555
cortegí	2	0	cortegi	2	2	2	6556
cortejarà	2	1	cortejara	2	0	1	6557
cortejà	2	1	corteja	2	9	10	6558
cortesà	0	389	cortesa	0	85	474	6559
cosificà	2	0	cosifica	2	62	62	6560
cosificàrem	2	0	cosificarem	2	1	1	6561
cosifiqués	2	0	cosifiques	2	1	1	6562
cosifiquí	2	0	cosifiqui	2	3	3	6563
cosirà	2	16	cosira	2	1	17	6564
cossolà	2	0	cossola	2	3	3	6565
cossà	2	0	cossa	4	238	238	6566
cossés	2	0	cosses	4	322	322	6567
cossí	2	22	cossi	2	151	173	6568
costarà	2	4366	costara	2	73	4439	6569
costegés	2	2	costeges	2	0	2	6570
costegí	2	1	costegi	2	4	5	6571
costejarà	2	24	costejara	2	2	26	6572
costejàrem	2	1	costejarem	2	2	3	6573
costipà	2	0	costipa	2	6	6	6574
costojà	0	0	costoja	4	143	143	6575
costà	2	461	costa	4	122995	123456	6576
costàrem	2	0	costarem	2	1	1	6577
costés	2	288	costes	4	11228	11516	6578
costí	2	5	costi	2	3313	3318	6579
costós	0	1703	costos	4	32182	33885	6580
cosírem	2	0	cosirem	2	45	45	6581
cosíreu	2	0	cosireu	2	1	1	6582
cotarà	2	3	cotara	2	0	3	6583
cotilèdons	4	57	cotiledons	4	20	77	6584
cotitzarà	2	43	cotitzara	2	0	43	6585
cotitzà	2	2	cotitza	2	509	511	6586
cotitzàrem	2	0	cotitzarem	2	8	8	6587
cotitzés	2	8	cotitzes	2	6	14	6588
cotitzí	2	0	cotitzi	2	66	66	6589
cotnà	2	1	cotna	4	55	56	6590
cotnés	2	0	cotnes	4	70	70	6591
cotorrejà	2	0	cotorreja	2	2	2	6592
cotà	2	4	cota	0	5641	5645	6593
cotés	2	8	cotes	4	3518	3526	6594
cotí	2	9	coti	2	26	35	6595
cotó	4	9964	coto	2	431	10395	6596
courà	2	87	coura	2	11	98	6597
couré	2	1	coure	2	16605	16606	6598
courés	2	0	coures	2	46	46	6599
covarà	2	8	covara	2	0	8	6600
covà	2	5	cova	4	18592	18597	6601
covés	2	2	coves	4	9306	9308	6602
coví	2	1	covi	2	27	28	6603
coàgul	4	279	coagul	2	5	284	6604
cranquejà	2	0	cranqueja	2	1	1	6605
cranà	2	0	crana	2	5	5	6606
cranés	2	0	cranes	2	14	14	6607
craní	2	0	crani	2	2676	2676	6608
craticulà	2	0	craticula	2	1	1	6609
cratícula	4	0	craticula	2	1	1	6610
crearà	2	5057	creara	2	77	5134	6611
crebantés	2	0	crebantes	2	1	1	6612
crebantí	2	0	crebanti	2	4	4	6613
crebà	2	0	creba	2	45	45	6614
crebés	2	1	crebes	2	0	1	6615
cregués	2	408	cregues	2	94	502	6616
creguí	2	3	cregui	2	4119	4122	6617
creixérem	2	1	creixerem	2	79	80	6618
creixéreu	2	0	creixereu	2	8	8	6619
creixés	2	231	creixes	4	113	344	6620
creixí	2	4	creixi	2	1967	1971	6621
cremarà	2	323	cremara	2	19	342	6622
cremà	2	900	crema	4	24830	25730	6623
cremàrem	2	1	cremarem	2	125	126	6624
cremàreu	2	0	cremareu	2	21	21	6625
cremés	2	172	cremes	4	3747	3919	6626
cremí	2	0	cremi	2	729	729	6627
creosotà	2	0	creosota	4	41	41	6628
crepità	2	0	crepita	2	25	25	6629
crepè	4	44	crepe	2	78	122	6630
crepès	4	2	crepes	2	199	201	6631
crepé	4	6	crepe	2	78	84	6632
crepés	2	3	crepes	2	199	202	6633
crepí	2	4	crepi	2	2	6	6634
crepó	4	0	crepo	2	5	5	6635
crespà	2	0	crespa	0	21	21	6636
crespés	2	0	crespes	0	8	8	6637
crespó	4	117	crespo	4	2998	3115	6638
cresqués	2	32	cresques	2	234	266	6639
cresquí	2	1	cresqui	2	10	11	6640
crestegí	2	1	crestegi	2	0	1	6641
crestejà	2	0	cresteja	2	17	17	6642
crestejàrem	2	0	crestejarem	2	11	11	6643
crestà	2	1	cresta	4	3735	3736	6644
crestés	2	0	crestes	4	1504	1504	6645
crestó	4	32	cresto	2	1	33	6646
cretès	0	0	cretes	4	82	82	6647
cretés	0	0	cretes	4	82	82	6648
creuarà	2	366	creuara	2	6	372	6649
creuré	2	172	creure	2	33310	33482	6650
creuà	2	365	creua	2	4647	5012	6651
creuàrem	2	30	creuarem	2	1162	1192	6652
creuàreu	2	0	creuareu	2	130	130	6653
creués	2	113	creues	2	242	355	6654
creuí	2	1	creui	2	182	183	6655
creà	2	4220	crea	2	34094	38314	6656
creàrem	2	36	crearem	2	1584	1620	6657
creàreu	2	0	creareu	2	86	86	6658
creés	2	539	crees	2	534	1073	6659
creí	2	29	crei	2	344	373	6660
criarà	2	26	criara	2	0	26	6661
cribrà	2	0	cribra	2	1	1	6662
cridarà	2	383	cridara	2	51	434	6663
cridà	2	973	crida	4	43858	44831	6664
cridàrem	2	8	cridarem	2	147	155	6665
cridàreu	2	3	cridareu	2	10	13	6666
cridés	2	293	crides	4	3054	3347	6667
cridí	2	4	cridi	2	843	847	6668
criminalitzarà	2	7	criminalitzara	2	0	7	6669
criminalitzà	2	4	criminalitza	2	430	434	6670
criminalitzàrem	2	0	criminalitzarem	2	3	3	6671
criminalitzés	2	7	criminalitzes	2	5	12	6672
criminalitzí	2	0	criminalitzi	2	69	69	6673
criptografià	2	0	criptografia	4	728	728	6674
crismà	2	0	crisma	4	131	131	6675
crismés	2	0	crismes	4	3	3	6676
crismó	4	102	crismo	2	0	102	6677
crisparà	2	2	crispara	2	0	2	6678
crispà	2	3	crispa	4	68	71	6679
crispàrem	2	1	crisparem	2	1	2	6680
crispàreu	2	0	crispareu	2	1	1	6681
cristal·litzarà	2	45	cristal·litzara	2	3	48	6682
cristal·litzà	2	53	cristal·litza	2	390	443	6683
cristal·litzàrem	2	0	cristal·litzarem	2	2	2	6684
cristal·litzés	2	6	cristal·litzes	2	0	6	6685
cristal·litzí	2	0	cristal·litzi	2	60	60	6686
cristianitzà	2	3	cristianitza	2	16	19	6687
cristianà	2	0	cristiana	4	15264	15264	6688
cristianés	2	0	cristianes	2	4478	4478	6689
cristianí	2	0	cristiani	2	22	22	6690
crisòtil	4	16	crisotil	4	21	37	6691
criticarà	2	86	criticara	2	12	98	6692
criticà	2	416	critica	2	7215	7631	6693
criticàrem	2	9	criticarem	2	50	59	6694
criticàreu	2	0	criticareu	2	6	6	6695
critiqués	2	98	critiques	2	915	1013	6696
critiquí	2	2	critiqui	2	311	313	6697
crivellà	2	0	crivella	2	15	15	6698
crivellàreu	2	1	crivellareu	2	0	1	6699
crivellés	2	0	crivelles	2	3	3	6700
crivellí	2	0	crivelli	2	19	19	6701
crià	2	70	cria	4	6416	6486	6702
criàrem	2	1	criarem	2	5	6	6703
criés	2	24	cries	4	2206	2230	6704
crií	2	0	crii	2	3	3	6705
cromatà	2	0	cromata	2	2	2	6706
cromatí	2	0	cromati	2	1	1	6707
cromà	2	0	croma	4	416	416	6708
cromés	2	0	cromes	4	17	17	6709
cromí	2	0	cromi	2	9	9	6710
cromós	0	2	cromos	4	1560	1562	6711
cronificarà	2	5	cronificara	2	0	5	6712
cronificà	2	0	cronifica	2	93	93	6713
cronificàrem	2	0	cronificarem	2	2	2	6714
cronifiqués	2	1	cronifiques	2	0	1	6715
cronifiquí	2	0	cronifiqui	2	36	36	6716
cronometrarà	2	15	cronometrara	2	0	15	6717
cronometrà	2	0	cronometra	2	60	60	6718
cronometràrem	2	0	cronometrarem	2	2	2	6719
cronometrés	2	2	cronometres	2	4	6	6720
cronometrí	2	0	cronometri	2	3	3	6721
cronòmetre	4	951	cronometre	2	32	983	6722
cronòmetres	4	126	cronometres	2	4	130	6723
croquisà	2	0	croquisa	2	1	1	6724
croquís	2	0	croquis	4	1064	1064	6725
crucificarà	2	9	crucificara	2	1	10	6726
crucificà	2	1	crucifica	2	23	24	6727
crucificàrem	2	0	crucificarem	2	2	2	6728
crucificàreu	2	0	crucificareu	2	1	1	6729
crucifiqués	2	0	crucifiques	2	1	1	6730
crucifiquí	2	0	crucifiqui	2	3	3	6731
cruejà	2	0	crueja	2	2	2	6732
cruixirà	2	2	cruixira	2	0	2	6733
cruixí	2	1	cruixi	2	5	6	6734
cruixís	2	3	cruixis	2	0	3	6735
cruià	2	0	cruia	2	10	10	6736
cruiés	2	0	cruies	2	1	1	6737
cruspirà	2	18	cruspira	2	0	18	6738
cruspírem	2	1	cruspirem	2	13	14	6739
cruspíreu	2	0	cruspireu	2	2	2	6740
cruí	2	0	crui	4	30	30	6741
cràter	4	5123	crater	4	228	5351	6742
cràters	4	1661	craters	4	45	1706	6743
crèiem	2	1209	creiem	2	36257	37466	6744
crèieu	2	33	creieu	2	4977	5010	6745
créiem	2	43	creiem	2	36257	36300	6746
créieu	2	5	creieu	2	4977	4982	6747
crémor	4	18	cremor	4	382	400	6748
crémors	4	0	cremors	4	20	20	6749
crític	0	27486	critic	2	232	27718	6750
crítica	0	53230	critica	2	7215	60445	6751
crítiques	0	22663	critiques	2	915	23578	6752
crúor	4	1	cruor	4	9	10	6753
cubellès	0	0	cubelles	4	3887	3887	6754
cubellés	0	0	cubelles	4	3887	3887	6755
cubicà	2	0	cubica	2	15	15	6756
cubiqués	2	0	cubiques	2	3	3	6757
cubooctàedre	4	1	cubooctaedre	4	2	3	6758
cubà	0	2368	cuba	4	12658	15026	6759
cucarà	2	0	cucara	2	1	1	6760
cucà	2	0	cuca	4	1272	1272	6761
cuegí	2	0	cuegi	2	2	2	6762
cuejarà	2	5	cuejara	2	0	5	6763
cuejà	2	1	cueja	2	147	148	6764
cuejàreu	2	0	cuejareu	2	1	1	6765
cuetejà	2	0	cueteja	2	4	4	6766
cuguçós	0	4	cuguços	4	5	9	6767
cuidarà	2	241	cuidara	2	10	251	6768
cuidà	2	50	cuida	2	3128	3178	6769
cuidàrem	2	3	cuidarem	2	162	165	6770
cuidàreu	2	0	cuidareu	2	3	3	6771
cuidés	2	93	cuides	2	193	286	6772
cuidí	2	1	cuidi	2	425	426	6773
cuinarà	2	163	cuinara	2	14	177	6774
cuinà	2	11	cuina	4	96525	96536	6775
cuinàrem	2	0	cuinarem	2	249	249	6776
cuinàreu	2	0	cuinareu	2	8	8	6777
cuinés	2	27	cuines	4	5057	5084	6778
cuiní	2	2	cuini	2	173	175	6779
cuirassà	2	0	cuirassa	4	616	616	6780
cuirassés	2	0	cuirasses	4	171	171	6781
cuitarà	2	1	cuitara	2	1	2	6782
cuità	2	11	cuita	2	3047	3058	6783
cuitàrem	2	0	cuitarem	2	1	1	6784
cuités	2	2	cuites	2	1842	1844	6785
cuití	2	0	cuiti	2	1	1	6786
culejà	2	1	culeja	2	3	4	6787
cullerà	0	4	cullera	4	8268	8272	6788
cullà	0	3	culla	4	1152	1155	6789
culminarà	2	1505	culminara	2	5	1510	6790
culminà	2	514	culmina	2	2871	3385	6791
culminàrem	2	0	culminarem	2	44	44	6792
culminés	2	52	culmines	2	4	56	6793
culminí	2	0	culmini	2	231	231	6794
culotés	2	0	culotes	2	8	8	6795
culpabilitzarà	2	1	culpabilitzara	2	0	1	6796
culpabilitzà	2	2	culpabilitza	2	168	170	6797
culpabilitzés	2	3	culpabilitzes	2	4	7	6798
culpabilitzí	2	0	culpabilitzi	2	21	21	6799
culparà	2	24	culpara	2	1	25	6800
culpà	2	50	culpa	4	26842	26892	6801
culpàrem	2	0	culparem	2	12	12	6802
culpàreu	2	0	culpareu	2	1	1	6803
culpés	2	22	culpes	4	1269	1291	6804
culpí	2	0	culpi	2	66	66	6805
cultivarà	2	14	cultivara	2	3	17	6806
cultivà	2	88	cultiva	4	1470	1558	6807
cultivàrem	2	1	cultivarem	2	27	28	6808
cultivés	2	15	cultives	4	26	41	6809
cultiví	2	0	cultivi	2	33	33	6810
culturitzà	2	0	culturitza	2	26	26	6811
culturitzàreu	2	1	culturitzareu	2	1	2	6812
culturitzés	2	4	culturitzes	2	1	5	6813
culturitzí	2	0	culturitzi	2	1	1	6814
culà	2	3	cula	2	30	33	6815
culàrem	2	0	cularem	2	1	1	6816
culés	2	229	cules	2	25	254	6817
culí	2	22	culi	2	6	28	6818
cuqués	2	0	cuques	4	667	667	6819
cuquí	2	1	cuqui	2	128	129	6820
curarà	2	129	curara	2	2	131	6821
curaré	2	18	curare	4	51	69	6822
cursarà	2	163	cursara	2	4	167	6823
cursà	2	492	cursa	4	71398	71890	6824
cursàrem	2	2	cursarem	2	5	7	6825
cursàreu	2	1	cursareu	2	8	9	6826
cursés	2	19	curses	4	20952	20971	6827
cursí	2	3	cursi	2	641	644	6828
curtcircuitarà	2	1	curtcircuitara	2	0	1	6829
curtcircuità	2	4	curtcircuita	2	16	20	6830
curtcircuités	2	1	curtcircuites	2	0	1	6831
curtegés	2	0	curteges	2	1	1	6832
curtejà	2	0	curteja	2	6	6	6833
curullà	2	1	curulla	0	257	258	6834
curullés	2	1	curulles	0	112	113	6835
curullí	2	0	curulli	2	4	4	6836
curà	2	32	cura	4	47872	47904	6837
curàrem	2	0	curarem	2	20	20	6838
curàreu	2	0	curareu	2	1	1	6839
curés	2	48	cures	4	9002	9050	6840
curí	2	0	curi	2	267	267	6841
curós	0	850	curos	4	55	905	6842
custodiarà	2	77	custodiara	2	0	77	6843
custodià	2	19	custodia	2	1302	1321	6844
custodiàrem	2	0	custodiarem	2	3	3	6845
custodiés	2	9	custodies	2	12	21	6846
custodí	2	0	custodi	4	512	512	6847
custodíem	2	0	custodiem	2	58	58	6848
custodíeu	2	0	custodieu	2	2	2	6849
custodírem	2	1	custodirem	2	0	1	6850
custodís	2	0	custodis	0	192	192	6851
custòdies	0	98	custodies	2	12	110	6852
càbria	4	7	cabria	2	296	303	6853
càbries	4	5	cabries	2	0	5	6854
càlam	4	52	calam	2	17	69	6855
càlat	4	11	calat	2	1744	1755	6856
càlats	4	1	calats	2	256	257	6857
càlcic	0	277	calcic	2	4	281	6858
càlcul	4	16702	calcul	2	138	16840	6859
càmfora	4	121	camfora	2	0	121	6860
càmfores	4	2	camfores	2	0	2	6861
càmper	4	29	camper	4	937	966	6862
càmpers	4	14	campers	4	121	135	6863
cànon	4	4846	canon	2	2000	6846	6864
cànons	4	2650	canons	4	4100	6750	6865
càntar	4	2	cantar	2	18820	18822	6866
càntera	4	6	cantera	4	960	966	6867
cànteres	4	9	canteres	4	176	185	6868
càpia	2	14	capia	2	5	19	6869
càpien	2	13	capien	2	6	19	6870
càries	0	1196	caries	2	222	1418	6871
càrrava	4	0	carrava	2	1	1	6872
càrrega	4	34555	carrega	2	4862	39417	6873
càrregues	4	9872	carregues	2	301	10173	6874
càrter	4	91	carter	4	2655	2746	6875
càrters	4	13	carters	4	307	320	6876
cèlebre	0	5875	celebre	2	385	6260	6877
cèlebres	0	2128	celebres	2	156	2284	6878
cèrcol	4	967	cercol	2	28	995	6879
cèrvia	4	1	cervia	4	34	35	6880
cércol	4	33	cercol	2	28	61	6881
cíat	4	0	ciat	2	26	26	6882
cíats	4	0	ciats	2	10	10	6883
cínamom	4	3	cinamom	4	6	9	6884
cítara	4	132	citara	2	10	142	6885
cítares	4	35	citares	2	2	37	6886
còlera	4	1810	colera	4	933	2743	6887
còleres	4	14	coleres	0	0	14	6888
còlon	4	1682	colon	4	1278	2960	6889
còlons	4	4	colons	4	4111	4115	6890
còmput	4	2157	comput	2	65	2222	6891
cònsol	4	6381	consol	4	4005	10386	6892
cònsols	4	1538	consols	4	120	1658	6893
còpia	4	21333	copia	2	3376	24709	6894
còpies	4	10306	copies	2	538	10844	6895
còpula	4	236	copula	2	30	266	6896
còpules	4	41	copules	2	2	43	6897
còtons	4	0	cotons	4	161	161	6898
cóc	4	308	coc	4	984	1292	6899
cócs	4	123	cocs	4	161	284	6900
cóm	4	1771	com	1	4404388	4406159	6901
cóms	4	30	coms	4	155	185	6902
cóp	4	12	cop	4	287554	287566	6903
cóps	4	5	cops	4	31738	31743	6904
córner	4	1413	corner	4	1426	2839	6905
córners	4	193	corners	4	184	377	6906
cóssos	4	54	cossos	4	27152	27206	6907
cúbic	0	904	cubic	2	68	972	6908
cúbica	0	453	cubica	2	15	468	6909
cúbiques	0	232	cubiques	2	3	235	6910
cúries	4	86	curies	4	9	95	6911
dadà	0	251	dada	4	13754	14005	6912
dallarà	2	0	dallara	2	29	29	6913
dallà	2	17	dalla	4	545	562	6914
dallàs	2	0	dallas	4	1255	1255	6915
dallés	2	2	dalles	4	73	75	6916
dallí	2	6	dalli	2	139	145	6917
dallò	4	50	dallo	2	22	72	6918
damasquinà	2	0	damasquina	4	5	5	6919
damasquinés	2	0	damasquines	4	3	3	6920
damnificà	2	1	damnifica	2	2	3	6921
damnà	2	4	damna	2	3	7	6922
damnés	2	6	damnes	2	0	6	6923
damà	4	20	dama	4	6620	6640	6924
damàs	4	17	damas	4	274	291	6925
dansarà	2	10	dansara	2	14	24	6926
dansà	2	375	dansa	4	45871	46246	6927
dansàrem	2	1	dansarem	2	21	22	6928
dansés	2	3	danses	4	10551	10554	6929
dansí	2	0	dansi	2	36	36	6930
danyarà	2	53	danyara	2	4	57	6931
danyà	2	28	danya	2	471	499	6932
danyàrem	2	0	danyarem	2	3	3	6933
danyés	2	23	danyes	2	5	28	6934
danyí	2	15	danyi	2	96	111	6935
dardarà	2	0	dardara	2	3	3	6936
dardà	2	7	darda	2	3	10	6937
dardés	2	2	dardes	2	2	4	6938
darrerà	0	4	darrera	0	83973	83977	6939
darà	2	43	dara	2	225	268	6940
datarà	2	2	datara	2	2	4	6941
datà	2	23	data	4	128937	128960	6942
datàrem	2	1	datarem	2	1	2	6943
datés	2	2	dates	4	29261	29263	6944
datí	2	1	dati	2	124	125	6945
daurarà	2	2	daurara	2	0	2	6946
daurà	2	28	daura	4	480	508	6947
dauràrem	2	0	daurarem	2	33	33	6948
dauràreu	2	0	daurareu	2	1	1	6949
daurés	2	1	daures	2	2	3	6950
davallarà	2	40	davallara	2	0	40	6951
davallà	2	86	davalla	2	1023	1109	6952
davallàrem	2	12	davallarem	2	80	92	6953
davallàreu	2	1	davallareu	2	11	12	6954
davallés	2	10	davalles	2	2	12	6955
davallí	2	0	davalli	2	27	27	6956
davantegés	2	0	davanteges	2	1	1	6957
davantejà	2	0	davanteja	2	1	1	6958
deambularà	2	2	deambulara	2	0	2	6959
deambulà	2	4	deambula	2	161	165	6960
deambulàrem	2	0	deambularem	2	4	4	6961
deambulés	2	2	deambules	2	0	2	6962
deambulí	2	0	deambuli	2	5	5	6963
debanarà	2	4	debanara	2	0	4	6964
debanà	2	0	debana	2	8	8	6965
debategà	2	0	debatega	2	1	1	6966
debatré	2	25	debatre	2	18638	18663	6967
debatés	2	106	debates	2	56	162	6968
debatí	2	5	debati	2	538	543	6969
debel·là	2	0	debel·la	2	1	1	6970
debel·làreu	2	0	debel·lareu	2	1	1	6971
debilitarà	2	35	debilitara	2	0	35	6972
debilità	2	38	debilita	2	606	644	6973
debilitàrem	2	0	debilitarem	2	5	5	6974
debilités	2	14	debilites	2	8	22	6975
debilití	2	0	debiliti	2	47	47	6976
debutarà	2	742	debutara	2	10	752	6977
debutà	2	675	debuta	2	1611	2286	6978
debutàrem	2	0	debutarem	2	3	3	6979
debutàreu	2	1	debutareu	2	0	1	6980
debutés	2	31	debutes	2	3	34	6981
debutí	2	0	debuti	2	30	30	6982
decaigués	2	52	decaigues	2	0	52	6983
decaiguí	2	0	decaigui	2	184	184	6984
decalarà	2	1	decalara	2	0	1	6985
decalà	2	0	decala	2	1	1	6986
decalés	2	0	decales	2	1	1	6987
decampà	2	0	decampa	2	1	1	6988
decampàreu	2	1	decampareu	2	0	1	6989
decandirà	2	1	decandira	2	0	1	6990
decandírem	2	0	decandirem	2	1	1	6991
decantarà	2	97	decantara	2	7	104	6992
decantà	2	348	decanta	2	1098	1446	6993
decantàrem	2	4	decantarem	2	60	64	6994
decantàreu	2	0	decantareu	2	3	3	6995
decantés	2	75	decantes	2	38	113	6996
decantí	2	2	decanti	2	164	166	6997
decapitarà	2	3	decapitara	2	0	3	6998
decapità	2	12	decapita	2	44	56	6999
decapités	2	4	decapites	2	2	6	7000
decapití	2	0	decapiti	2	3	3	7001
decapà	2	0	decapa	2	5	5	7002
decapàrem	2	0	decaparem	2	1	1	7003
decapés	2	1	decapes	2	2	3	7004
decauré	2	0	decaure	2	849	849	7005
decebré	2	19	decebre	2	1262	1281	7006
decebés	2	19	decebes	2	0	19	7007
decebí	2	0	decebi	2	64	64	7008
decepcionarà	2	29	decepcionara	2	1	30	7009
decepcionà	2	1	decepciona	2	116	117	7010
decepcionàrem	2	0	decepcionarem	2	3	3	7011
decepcionés	2	3	decepciones	2	8	11	7012
decepcioní	2	0	decepcioni	2	18	18	7013
decidirà	2	4287	decidira	2	158	4445	7014
decidírem	2	291	decidirem	2	975	1266	7015
decidíreu	2	4	decidireu	2	74	78	7016
declamarà	2	11	declamara	2	1	12	7017
declamà	2	4	declama	2	64	68	7018
declamés	2	0	declames	2	1	1	7019
declamí	2	0	declami	2	1	1	7020
declararà	2	557	declarara	2	49	606	7021
declarà	2	1713	declara	2	9214	10927	7022
declaràrem	2	6	declararem	2	47	53	7023
declaràreu	2	0	declarareu	2	3	3	7024
declarés	2	671	declares	2	95	766	7025
declarí	2	8	declari	2	1342	1350	7026
declinarà	2	18	declinara	2	1	19	7027
declinà	2	136	declina	2	1560	1696	7028
declinàrem	2	1	declinarem	2	6	7	7029
declinés	2	14	declines	2	4	18	7030
decliní	2	0	declini	2	36	36	7031
decolorà	2	0	decolora	2	13	13	7032
decolorí	2	0	decolori	2	3	3	7033
decomissarà	2	2	decomissara	2	0	2	7034
decomissà	2	1	decomissa	2	20	21	7035
decomissés	2	3	decomisses	2	0	3	7036
decomissí	2	0	decomissi	2	3	3	7037
decorarà	2	108	decorara	2	4	112	7038
decorticà	2	0	decortica	2	4	4	7039
decorà	2	115	decora	2	1032	1147	7040
decoràrem	2	5	decorarem	2	229	234	7041
decoràreu	2	0	decorareu	2	8	8	7042
decorés	2	18	decores	2	28	46	7043
decorí	2	0	decori	2	37	37	7044
decreixérem	2	0	decreixerem	2	2	2	7045
decreixés	2	1	decreixes	2	2	3	7046
decreixí	2	1	decreixi	2	25	26	7047
decrepità	2	0	decrepita	2	7	7	7048
decrepités	2	0	decrepites	2	2	2	7049
decretarà	2	34	decretara	2	6	40	7050
decretà	2	304	decreta	2	516	820	7051
decretàrem	2	2	decretarem	2	1	3	7052
decretés	2	85	decretes	2	4	89	7053
decretí	2	0	decreti	2	90	90	7054
decrèpit	0	208	decrepit	2	4	212	7055
decrèpita	0	102	decrepita	2	7	109	7056
decrèpites	0	34	decrepites	2	2	36	7057
decuplicà	2	1	decuplica	2	3	4	7058
decurvàrem	2	0	decurvarem	2	1	1	7059
decurví	2	1	decurvi	2	0	1	7060
decàedre	4	0	decaedre	4	2	2	7061
dedicarà	2	2330	dedicara	2	66	2396	7062
dedicà	2	3157	dedica	2	22053	25210	7063
dedicàrem	2	74	dedicarem	2	1538	1612	7064
dedicàreu	2	3	dedicareu	2	25	28	7065
dediqués	2	651	dediques	2	792	1443	7066
dediquí	2	10	dediqui	2	1725	1735	7067
deduírem	2	1	deduirem	2	22	23	7068
deduíreu	2	0	deduireu	2	8	8	7069
defallirà	2	30	defallira	2	1	31	7070
defallírem	2	0	defallirem	2	157	157	7071
defallíreu	2	0	defallireu	2	1	1	7072
defecarà	2	1	defecara	2	0	1	7073
defecà	2	3	defeca	2	36	39	7074
defendré	2	16	defendre	2	1584	1600	7075
defenestrarà	2	1	defenestrara	2	0	1	7076
defenestrà	2	2	defenestra	2	8	10	7077
defenestràrem	2	0	defenestrarem	2	2	2	7078
defenestrés	2	1	defenestres	2	0	1	7079
defengués	2	2	defengues	2	2	4	7080
defenguí	2	0	defengui	2	11	11	7081
defensarà	2	1610	defensara	2	21	1631	7082
defensà	2	1177	defensa	4	119016	120193	7083
defensàrem	2	14	defensarem	2	672	686	7084
defensàreu	2	1	defensareu	2	14	15	7085
defensés	2	290	defenses	4	5963	6253	7086
defensí	2	4	defensi	2	1942	1946	7087
defequés	2	0	defeques	2	1	1	7088
defequí	2	0	defequi	2	9	9	7089
definirà	2	842	definira	2	20	862	7090
definírem	2	4	definirem	2	262	266	7091
definíreu	2	0	definireu	2	7	7	7092
deflactí	2	0	deflacti	2	1	1	7093
defolià	2	0	defolia	2	4	4	7094
deformarà	2	10	deformara	2	0	10	7095
deformà	2	8	deforma	2	405	413	7096
deformàrem	2	0	deformarem	2	1	1	7097
deformàreu	2	0	deformareu	2	1	1	7098
deformés	2	8	deformes	2	110	118	7099
deformí	2	0	deformi	2	59	59	7100
defraudarà	2	113	defraudara	2	1	114	7101
defraudà	2	14	defrauda	2	197	211	7102
defraudàrem	2	0	defraudarem	2	35	35	7103
defraudés	2	6	defraudes	2	2	8	7104
defraudí	2	0	defraudi	2	31	31	7105
defugirà	2	24	defugira	2	1	25	7106
defugí	2	29	defugi	4	131	160	7107
defugírem	2	0	defugirem	2	23	23	7108
defugís	2	15	defugis	4	16	31	7109
degenerarà	2	15	degenerara	2	0	15	7110
degenerà	2	27	degenera	2	147	174	7111
degenerés	2	17	degeneres	2	50	67	7112
degenerí	2	0	degeneri	2	76	76	7113
deglutírem	2	0	deglutirem	2	2	2	7114
degollarà	2	3	degollara	2	0	3	7115
degollà	2	52	degolla	4	76	128	7116
degollàrem	2	0	degollarem	2	2	2	7117
degollés	2	2	degolles	4	0	2	7118
degollí	2	0	degolli	2	2	2	7119
degotarà	2	2	degotara	2	0	2	7120
degotegés	2	0	degoteges	2	1	1	7121
degotegí	2	0	degotegi	2	2	2	7122
degotejarà	2	2	degotejara	2	0	2	7123
degotejà	2	0	degoteja	2	18	18	7124
degotejàrem	2	1	degotejarem	2	0	1	7125
degotejàreu	2	0	degotejareu	2	1	1	7126
degotà	2	0	degota	2	91	91	7127
degotí	2	1	degoti	2	14	15	7128
degotís	4	16	degotis	2	1	17	7129
degradarà	2	35	degradara	2	3	38	7130
degradà	2	12	degrada	2	763	775	7131
degradàrem	2	0	degradarem	2	2	2	7132
degradés	2	22	degrades	2	9	31	7133
degradí	2	0	degradi	2	113	113	7134
degustarà	2	34	degustara	2	0	34	7135
degustà	2	6	degusta	2	397	403	7136
degustàrem	2	5	degustarem	2	177	182	7137
degustàreu	2	0	degustareu	2	41	41	7138
degustés	2	4	degustes	2	43	47	7139
degustí	2	0	degusti	2	19	19	7140
degués	2	113	degues	2	1	114	7141
deguí	2	10	degui	2	316	326	7142
degà	4	5267	dega	2	70	5337	7143
deixarà	2	11424	deixara	2	352	11776	7144
deixatà	2	0	deixata	2	26	26	7145
deixatàrem	2	0	deixatarem	2	10	10	7146
deixatàreu	2	0	deixatareu	2	1	1	7147
deixatí	2	0	deixati	2	1	1	7148
deixondirà	2	2	deixondira	2	0	2	7149
deixondà	2	0	deixonda	2	1	1	7150
deixondí	2	5	deixondi	2	0	5	7151
deixuplinà	2	0	deixuplina	4	4	4	7152
deixuplinés	2	0	deixuplines	4	9	9	7153
deixà	2	5972	deixa	4	86645	92617	7154
deixàrem	2	207	deixarem	2	7568	7775	7155
deixàreu	2	12	deixareu	2	454	466	7156
deixés	2	3237	deixes	4	4438	7675	7157
deixí	2	50	deixi	2	11357	11407	7158
dejectà	2	0	dejecta	2	7	7	7159
dejectés	2	0	dejectes	2	1	1	7160
dejunarà	2	2	dejunara	2	0	2	7161
dejunà	2	5	dejuna	2	23	28	7162
dejunàrem	2	0	dejunarem	2	2	2	7163
dejunàreu	2	0	dejunareu	2	3	3	7164
dejunés	2	1	dejunes	2	18	19	7165
dejuní	2	0	dejuni	2	1584	1584	7166
delatarà	2	24	delatara	2	1	25	7167
delatà	2	11	delata	2	591	602	7168
delatàrem	2	0	delatarem	2	1	1	7169
delatés	2	32	delates	2	5	37	7170
delatí	2	0	delati	2	35	35	7171
delecionés	2	0	deleciones	2	1	1	7172
delecioní	2	0	delecioni	2	1	1	7173
delectarà	2	191	delectara	2	2	193	7174
delectà	2	34	delecta	2	349	383	7175
delectàrem	2	0	delectarem	2	10	10	7176
delectàreu	2	0	delectareu	2	18	18	7177
delectés	2	5	delectes	2	4	9	7178
delectí	2	1	delecti	2	26	27	7179
delegarà	2	53	delegara	2	2	55	7180
delegués	2	25	delegues	2	7	32	7181
deleguí	2	0	delegui	2	524	524	7182
delegà	2	56	delega	2	595	651	7183
delegàrem	2	0	delegarem	2	8	8	7184
delegés	2	0	deleges	2	3	3	7185
delegí	2	0	delegi	2	2	2	7186
deleixés	2	0	deleixes	2	7	7	7187
deleixí	2	0	deleixi	2	5	5	7188
delejà	2	1	deleja	2	7	8	7189
delerà	2	0	delera	4	10	10	7190
delerés	2	0	deleres	4	2	2	7191
delerí	2	0	deleri	2	1	1	7192
delfinès	0	3	delfines	4	45	48	7193
delfinés	0	0	delfines	4	45	45	7194
deliberarà	2	63	deliberara	2	0	63	7195
deliberà	2	11	delibera	2	145	156	7196
deliberàrem	2	0	deliberarem	2	11	11	7197
deliberés	2	2	deliberes	2	0	2	7198
deliberí	2	0	deliberi	2	27	27	7199
delimitarà	2	97	delimitara	2	2	99	7200
delimità	2	14	delimita	2	1217	1231	7201
delimitàrem	2	0	delimitarem	2	4	4	7202
delimités	2	14	delimites	2	2	16	7203
delimití	2	0	delimiti	2	110	110	7204
delinearà	2	1	delineara	2	0	1	7205
delineà	2	4	delinea	2	25	29	7206
delineàrem	2	0	delinearem	2	2	2	7207
delineés	2	1	delinees	2	0	1	7208
delineí	2	0	delinei	2	1	1	7209
delirarà	2	0	delirara	2	1	1	7210
delirà	2	0	delira	2	42	42	7211
delirés	2	1	delires	2	6	7	7212
delirí	2	0	deliri	2	1630	1630	7213
delitarà	2	12	delitara	2	0	12	7214
delità	2	4	delita	2	17	21	7215
delitàrem	2	2	delitarem	2	1	3	7216
delités	2	0	delites	2	17	17	7217
delití	2	0	deliti	2	1	1	7218
delmarà	2	5	delmara	2	0	5	7219
delmà	2	25	delma	4	30	55	7220
delmés	2	1	delmes	4	437	438	7221
delmí	2	0	delmi	2	6	6	7222
deltòedre	4	1	deltoedre	4	0	1	7223
delí	2	1	deli	4	146	147	7224
delírem	2	0	delirem	2	3	3	7225
delíreu	2	0	delireu	2	1	1	7226
delís	2	3	delis	0	25	28	7227
demacrà	2	1	demacra	2	0	1	7228
demanarà	2	5695	demanara	2	103	5798	7229
demandarà	2	70	demandara	2	1	71	7230
demandà	2	34	demanda	4	44273	44307	7231
demandàrem	2	0	demandarem	2	8	8	7232
demandàreu	2	0	demandareu	2	1	1	7233
demandés	2	16	demandes	4	18839	18855	7234
demandí	2	0	demandi	2	63	63	7235
demanà	2	2657	demana	2	58829	61486	7236
demanàrem	2	163	demanarem	2	1726	1889	7237
demanàreu	2	7	demanareu	2	95	102	7238
demanés	2	1222	demanes	2	1469	2691	7239
demaní	2	16	demani	2	4565	4581	7240
demarcarà	2	1	demarcara	2	0	1	7241
demarcà	2	1	demarca	4	18	19	7242
demarqués	2	1	demarques	4	0	1	7243
demarquí	2	0	demarqui	2	3	3	7244
demetré	2	0	demetre	2	8	8	7245
demetés	2	0	demetes	2	1	1	7246
demetí	2	1	demeti	2	1	2	7247
democratitzarà	2	9	democratitzara	2	0	9	7248
democratitzà	2	3	democratitza	2	101	104	7249
democratitzàrem	2	0	democratitzarem	2	2	2	7250
democratitzés	2	4	democratitzes	2	0	4	7251
democratitzí	2	0	democratitzi	2	24	24	7252
demolirà	2	17	demolira	2	0	17	7253
demonitzà	2	1	demonitza	2	54	55	7254
demonitzàrem	2	0	demonitzarem	2	1	1	7255
demonitzí	2	0	demonitzi	2	6	6	7256
demorarà	2	47	demorara	2	1	48	7257
demorà	2	9	demora	4	3248	3257	7258
demoràrem	2	0	demorarem	2	1	1	7259
demorés	2	8	demores	4	717	725	7260
demorí	2	0	demori	2	89	89	7261
demostrarà	2	959	demostrara	2	13	972	7262
demostrà	2	1052	demostra	2	31869	32921	7263
demostràrem	2	12	demostrarem	2	337	349	7264
demostràreu	2	0	demostrareu	2	13	13	7265
demostrés	2	313	demostres	2	289	602	7266
demostrí	2	4	demostri	2	2097	2101	7267
demudí	2	0	demudi	2	1	1	7268
demà	4	65619	dema	4	554	66173	7269
demès	2	479	demes	4	605	1084	7270
demés	2	7945	demes	4	605	8550	7271
denegarà	2	179	denegara	2	6	185	7272
denegués	2	72	denegues	2	3	75	7273
deneguí	2	0	denegui	2	135	135	7274
denegà	2	62	denega	2	595	657	7275
denegàrem	2	1	denegarem	2	3	4	7276
denejàrem	2	0	denejarem	2	1	1	7277
denigrarà	2	4	denigrara	2	0	4	7278
denigrà	2	2	denigra	2	122	124	7279
denigrés	2	6	denigres	2	4	10	7280
denigrí	2	0	denigri	2	12	12	7281
denominarà	2	109	denominara	2	1	110	7282
denominà	2	142	denomina	2	3190	3332	7283
denominàrem	2	2	denominarem	2	37	39	7284
denominés	2	22	denomines	2	3	25	7285
denominí	2	0	denomini	2	60	60	7286
denotarà	2	10	denotara	2	0	10	7287
denotà	2	6	denota	2	2376	2382	7288
denotàrem	2	0	denotarem	2	5	5	7289
denotàreu	2	0	denotareu	2	3	3	7290
denotés	2	12	denotes	2	5	17	7291
denotí	2	0	denoti	2	42	42	7292
densificarà	2	2	densificara	2	0	2	7293
densificà	2	3	densifica	2	24	27	7294
densificàreu	2	1	densificareu	2	0	1	7295
densifiqués	2	1	densifiques	2	0	1	7296
densifiquí	2	0	densifiqui	2	2	2	7297
dentalitzà	2	0	dentalitza	2	1	1	7298
dentà	2	0	denta	2	4	4	7299
dentària	0	84	dentaria	2	26	110	7300
dentàries	0	110	dentaries	2	23	133	7301
dentés	2	0	dentes	2	5	5	7302
dentí	2	2	denti	2	5	7	7303
denudà	2	1	denuda	2	0	1	7304
denunciarà	2	440	denunciara	2	40	480	7305
denuncià	2	617	denuncia	2	13096	13713	7306
denunciàrem	2	35	denunciarem	2	180	215	7307
denunciàreu	2	1	denunciareu	2	2	3	7308
denunciés	2	276	denuncies	2	675	951	7309
denuncií	2	13	denuncii	2	27	40	7310
denúncia	4	20595	denuncia	2	13096	33691	7311
denúncies	4	8323	denuncies	2	675	8998	7312
depararà	2	189	deparara	2	1	190	7313
departirà	2	4	departira	2	0	4	7314
departírem	2	0	departirem	2	2	2	7315
deparà	2	15	depara	2	470	485	7316
deparés	2	2	depares	2	3	5	7317
deparí	2	0	depari	2	32	32	7318
depassarà	2	15	depassara	2	0	15	7319
depassà	2	12	depassa	2	500	512	7320
depassàrem	2	0	depassarem	2	6	6	7321
depassés	2	10	depasses	2	2	12	7322
depassí	2	0	depassi	2	64	64	7323
depauperà	2	0	depaupera	2	3	3	7324
dependré	2	5	dependre	2	4819	4824	7325
depengués	2	360	depengues	2	5	365	7326
depenguí	2	1	depengui	2	859	860	7327
depengés	2	1	depenges	2	1	2	7328
depenjarà	2	1	depenjara	2	0	1	7329
depenjà	2	0	depenja	2	6	6	7330
depilarà	2	1	depilara	2	0	1	7331
depilà	2	0	depila	2	37	37	7332
depilàrem	2	0	depilarem	2	1	1	7333
depilés	2	4	depiles	2	10	14	7334
depilí	2	0	depili	2	7	7	7335
deplorà	2	4	deplora	2	169	173	7336
deplorés	2	4	deplores	2	0	4	7337
deplorí	2	0	deplori	2	4	4	7338
deportarà	2	12	deportara	2	0	12	7339
deportà	2	27	deporta	2	29	56	7340
deportàrem	2	0	deportarem	2	2	2	7341
deportés	2	5	deportes	2	854	859	7342
deportí	2	0	deporti	2	16	16	7343
deposarà	2	3	deposara	2	2	5	7344
depositarà	2	9	depositara	2	1	10	7345
deposità	2	10	deposita	2	82	92	7346
depositàrem	2	0	depositarem	2	3	3	7347
depositària	0	18	depositaria	2	5	23	7348
depositàries	0	10	depositaries	2	2	12	7349
deposités	2	0	deposites	2	6	6	7350
deposití	2	0	depositi	2	8	8	7351
deposà	2	69	deposa	2	24	93	7352
deposés	2	16	deposes	2	1	17	7353
deposí	2	0	deposi	2	17	17	7354
depravà	2	0	deprava	2	1	1	7355
depreciarà	2	5	depreciara	2	0	5	7356
deprecià	2	3	deprecia	2	39	42	7357
depreciàrem	2	0	depreciarem	2	2	2	7358
depreciés	2	1	deprecies	2	1	2	7359
deprecií	2	1	deprecii	2	3	4	7360
depredà	2	1	depreda	2	58	59	7361
depredí	2	0	depredi	2	1	1	7362
deprendré	2	0	deprendre	2	66	66	7363
deprenguí	2	0	deprengui	2	2	2	7364
deprimirà	2	9	deprimira	2	0	9	7365
deprimírem	2	0	deprimirem	2	2	2	7366
depurarà	2	16	depurara	2	1	17	7367
depurà	2	9	depura	2	217	226	7368
depuràrem	2	0	depurarem	2	6	6	7369
depurés	2	9	depures	2	0	9	7370
depurí	2	0	depuri	2	38	38	7371
depòsit	4	504	deposit	2	129	633	7372
derivarà	2	397	derivara	2	8	405	7373
derivà	2	271	deriva	4	14319	14590	7374
derivàrem	2	0	derivarem	2	21	21	7375
derivés	2	80	derives	4	461	541	7376
deriví	2	0	derivi	2	1095	1095	7377
derogarà	2	87	derogara	2	2	89	7378
derogués	2	27	derogues	2	1	28	7379
deroguí	2	0	derogui	2	200	200	7380
derogà	2	42	deroga	2	941	983	7381
derogàrem	2	0	derogarem	2	38	38	7382
derramà	2	2	derrama	4	94	96	7383
derramàrem	2	0	derramarem	2	1	1	7384
derramés	2	0	derrames	4	196	196	7385
derramí	2	0	derrami	2	1	1	7386
derraparà	2	1	derrapara	2	0	1	7387
derrapà	2	1	derrapa	2	35	36	7388
derrapàreu	2	0	derrapareu	2	1	1	7389
derrapés	2	1	derrapes	2	10	11	7390
derrapí	2	0	derrapi	2	4	4	7391
derrocarà	2	6	derrocara	2	1	7	7392
derrocà	2	36	derroca	2	56	92	7393
derrocàrem	2	0	derrocarem	2	3	3	7394
derroqués	2	9	derroques	2	4	13	7395
derroquí	2	0	derroqui	2	11	11	7396
derrotarà	2	38	derrotara	2	2	40	7397
derrotà	2	582	derrota	4	22996	23578	7398
derrotàrem	2	0	derrotarem	2	30	30	7399
derrotàreu	2	0	derrotareu	2	1	1	7400
derrotés	2	48	derrotes	4	5724	5772	7401
derrotí	2	0	derroti	2	38	38	7402
desabillés	2	2	desabilles	2	0	2	7403
desabrigà	2	0	desabriga	2	5	5	7404
desacalorí	2	0	desacalori	2	1	1	7405
desacatarà	2	1	desacatara	2	0	1	7406
desacatà	2	0	desacata	2	9	9	7407
desacatés	2	1	desacates	2	0	1	7408
desacatí	2	0	desacati	2	1	1	7409
desaccelerarà	2	15	desaccelerara	2	0	15	7410
desaccelerà	2	6	desaccelera	2	52	58	7411
desaccelerés	2	3	desacceleres	2	3	6	7412
desaccelerí	2	0	desacceleri	2	19	19	7413
desaccentuà	2	0	desaccentua	2	1	1	7414
desacidificàreu	2	1	desacidificareu	2	0	1	7415
desaclimatà	2	0	desaclimata	2	1	1	7416
desaclimatàrem	2	1	desaclimatarem	2	0	1	7417
desacoblarà	2	1	desacoblara	2	0	1	7418
desacoblà	2	1	desacobla	2	33	34	7419
desacoblàrem	2	0	desacoblarem	2	1	1	7420
desacoblí	2	0	desacobli	2	2	2	7421
desacomplexà	2	0	desacomplexa	2	4	4	7422
desacomplexí	2	0	desacomplexi	2	1	1	7423
desaconsellarà	2	2	desaconsellara	2	1	3	7424
desaconsellà	2	15	desaconsella	2	389	404	7425
desaconsellàrem	2	0	desaconsellarem	2	2	2	7426
desaconsellés	2	3	desaconselles	2	1	4	7427
desaconsellí	2	0	desaconselli	2	19	19	7428
desacordà	2	0	desacorda	2	1	1	7429
desacorralés	2	1	desacorrales	2	0	1	7430
desacostumà	2	0	desacostuma	2	1	1	7431
desacostumàrem	2	0	desacostumarem	2	1	1	7432
desacostumí	2	0	desacostumi	2	1	1	7433
desacostés	2	1	desacostes	2	0	1	7434
desacreditarà	2	10	desacreditara	2	0	10	7435
desacredità	2	11	desacredita	2	225	236	7436
desacredités	2	5	desacredites	2	5	10	7437
desacredití	2	0	desacrediti	2	17	17	7438
desactivarà	2	131	desactivara	2	7	138	7439
desactivà	2	11	desactiva	2	1694	1705	7440
desactivàrem	2	0	desactivarem	2	8	8	7441
desactivés	2	9	desactives	2	61	70	7442
desactiví	2	0	desactivi	2	146	146	7443
desadobàrem	2	1	desadobarem	2	0	1	7444
desafeccionarà	2	1	desafeccionara	2	0	1	7445
desafeccionà	2	0	desafecciona	2	2	2	7446
desafectarà	2	2	desafectara	2	0	2	7447
desafectà	2	1	desafecta	4	43	44	7448
desafectés	2	2	desafectes	4	181	183	7449
desafectí	2	0	desafecti	2	4	4	7450
desaferrà	2	0	desaferra	2	2	2	7451
desaferrés	2	0	desaferres	2	1	1	7452
desafiarà	2	53	desafiara	2	0	53	7453
desafinarà	2	2	desafinara	2	0	2	7454
desafinà	2	0	desafina	2	65	65	7455
desafinés	2	1	desafines	2	4	5	7456
desafiní	2	0	desafini	2	8	8	7457
desafià	2	55	desafia	2	987	1042	7458
desafiàrem	2	0	desafiarem	2	9	9	7459
desafiàreu	2	1	desafiareu	2	1	2	7460
desafiés	2	24	desafies	2	10	34	7461
desafií	2	2	desafii	2	3	5	7462
desaforà	2	0	desafora	2	2	2	7463
desagradarà	2	13	desagradara	2	1	14	7464
desagradà	2	6	desagrada	2	482	488	7465
desagradés	2	7	desagrades	2	1	8	7466
desagradí	2	0	desagradi	2	61	61	7467
desagregués	2	1	desagregues	2	0	1	7468
desagregà	2	1	desagrega	2	39	40	7469
desagreujà	2	0	desagreuja	2	1	1	7470
desagruparà	2	1	desagrupara	2	0	1	7471
desagrupà	2	0	desagrupa	2	42	42	7472
desaiguarà	2	1	desaiguara	2	1	2	7473
desaiguà	2	1	desaigua	2	243	244	7474
desaigüés	2	1	desaigües	2	333	334	7475
desaigüí	2	0	desaigüi	2	1	1	7476
desairà	2	0	desaira	2	1	1	7477
desairés	2	0	desaires	2	33	33	7478
desajustarà	2	2	desajustara	2	0	2	7479
desajustà	2	0	desajusta	2	15	15	7480
desajustés	2	0	desajustes	2	1	1	7481
desajustí	2	0	desajusti	2	3	3	7482
desalienà	2	0	desaliena	2	1	1	7483
desalienàreu	2	0	desalienareu	2	1	1	7484
desaliení	2	0	desalieni	2	1	1	7485
desalineà	2	0	desalinea	2	1	1	7486
desallotgés	2	18	desallotges	2	2	20	7487
desallotgí	2	0	desallotgi	2	25	25	7488
desallotjarà	2	19	desallotjara	2	3	22	7489
desallotjà	2	7	desallotja	2	89	96	7490
desallotjàrem	2	0	desallotjarem	2	3	3	7491
desallotjàreu	2	0	desallotjareu	2	1	1	7492
desamagà	2	0	desamaga	2	5	5	7493
desaminà	2	0	desamina	2	2	2	7494
desamistançà	2	0	desamistança	2	2	2	7495
desamorarà	2	1	desamorara	2	0	1	7496
desamortitzà	2	0	desamortitza	2	1	1	7497
desamortitzés	2	1	desamortitzes	2	0	1	7498
desamurí	2	1	desamuri	2	0	1	7499
desamà	2	1	desama	2	117	118	7500
desamín	2	0	desamin	2	1	1	7501
desancorà	2	0	desancora	2	4	4	7502
desancorés	2	1	desancores	2	0	1	7503
desangoixà	2	0	desangoixa	2	2	2	7504
desanimarà	2	12	desanimara	2	1	13	7505
desanimà	2	7	desanima	2	226	233	7506
desanimàrem	2	1	desanimarem	2	5	6	7507
desanimés	2	15	desanimes	2	17	32	7508
desanimí	2	0	desanimi	2	51	51	7509
desanà	2	0	desana	2	2	2	7510
desaparedà	2	1	desapareda	2	0	1	7511
desaparedí	2	1	desaparedi	2	0	1	7512
desaparegués	2	413	desaparegues	2	5	418	7513
desapareguí	2	0	desaparegui	2	1132	1132	7514
desaparellà	2	0	desaparella	2	4	4	7515
desaparroquianí	2	1	desaparroquiani	2	0	1	7516
desapeguí	2	0	desapegui	2	1	1	7517
desapegà	2	0	desapega	2	1	1	7518
desapleguí	2	1	desaplegui	2	0	1	7519
desaplicà	2	0	desaplica	2	1	1	7520
desapoderà	2	0	desapodera	2	3	3	7521
desaprendré	2	0	desaprendre	2	340	340	7522
desaprenguí	2	0	desaprengui	2	6	6	7523
desaprofitarà	2	16	desaprofitara	2	2	18	7524
desaprofità	2	19	desaprofita	2	279	298	7525
desaprofitàrem	2	2	desaprofitarem	2	26	28	7526
desaprofitàreu	2	1	desaprofitareu	2	1	2	7527
desaprofités	2	12	desaprofites	2	12	24	7528
desaprofití	2	0	desaprofiti	2	49	49	7529
desaprovarà	2	4	desaprovara	2	1	5	7530
desaprovà	2	21	desaprova	2	118	139	7531
desaprovàrem	2	0	desaprovarem	2	1	1	7532
desaprovàreu	2	0	desaprovareu	2	1	1	7533
desaprovés	2	1	desaproves	2	0	1	7534
desaproví	2	0	desaprovi	2	9	9	7535
desapuntà	2	0	desapunta	2	3	3	7536
desapuntés	2	0	desapuntes	2	2	2	7537
desapuntí	2	0	desapunti	2	1	1	7538
desarborà	2	1	desarbora	2	8	9	7539
desarmarà	2	10	desarmara	2	0	10	7540
desarmà	2	19	desarma	2	125	144	7541
desarmàrem	2	0	desarmarem	2	3	3	7542
desarmés	2	14	desarmes	2	4	18	7543
desarmí	2	0	desarmi	2	19	19	7544
desarramadàrem	2	1	desarramadarem	2	0	1	7545
desarramadés	2	0	desarramades	2	1	1	7546
desarrapà	2	0	desarrapa	2	2	2	7547
desarrebossí	2	0	desarrebossi	2	1	1	7548
desarreglà	2	0	desarregla	2	1	1	7549
desarreglàreu	2	1	desarreglareu	2	0	1	7550
desarreglés	2	0	desarregles	2	1	1	7551
desarregní	2	1	desarregni	2	0	1	7552
desarrelarà	2	2	desarrelara	2	0	2	7553
desarrelà	2	0	desarrela	2	16	16	7554
desarrelés	2	1	desarreles	2	2	3	7555
desarrelí	2	0	desarreli	2	6	6	7556
desarrestarà	2	0	desarrestara	2	1	1	7557
desarrimí	2	1	desarrimi	2	0	1	7558
desarrissà	2	0	desarrissa	2	1	1	7559
desarrugà	2	0	desarruga	2	1	1	7560
desarrugàreu	2	1	desarrugareu	2	0	1	7561
desarticulà	2	15	desarticula	2	46	61	7562
desarticulàrem	2	0	desarticularem	2	1	1	7563
desarticulés	2	1	desarticules	2	0	1	7564
desarticulí	2	0	desarticuli	2	3	3	7565
desarxivà	2	0	desarxiva	2	5	5	7566
desarà	2	360	desara	2	2	362	7567
desarèn	2	0	desaren	2	2	2	7568
desassemblarà	2	1	desassemblara	2	0	1	7569
desassetgí	2	0	desassetgi	2	1	1	7570
desassetjà	2	1	desassetja	2	0	1	7571
desassignarà	2	1	desassignara	2	0	1	7572
desassignà	2	0	desassigna	2	15	15	7573
desassimilà	2	0	desassimila	2	2	2	7574
desassocià	2	0	desassocia	2	16	16	7575
desassociés	2	0	desassocies	2	1	1	7576
desassossegués	2	0	desassossegues	2	1	1	7577
desassosseguí	2	0	desassossegui	2	1	1	7578
desassossegà	2	0	desassossega	2	14	14	7579
desassossegàreu	2	1	desassossegareu	2	0	1	7580
desatacà	2	0	desataca	2	7	7	7581
desatendré	2	0	desatendre	2	395	395	7582
desatendí	2	2	desatendi	2	0	2	7583
desatengués	2	5	desatengues	2	0	5	7584
desatenguí	2	0	desatengui	2	19	19	7585
desatesà	2	0	desatesa	2	206	206	7586
desatesés	2	0	desateses	2	282	282	7587
desatrossà	2	0	desatrossa	2	2	2	7588
desatrossés	2	0	desatrosses	2	2	2	7589
desautoritzarà	2	6	desautoritzara	2	2	8	7590
desautoritzà	2	14	desautoritza	2	146	160	7591
desautoritzàrem	2	0	desautoritzarem	2	1	1	7592
desautoritzés	2	12	desautoritzes	2	0	12	7593
desautoritzí	2	0	desautoritzi	2	42	42	7594
desavencés	2	0	desavences	2	2	2	7595
desavesarà	2	1	desavesara	2	0	1	7596
desavesà	2	0	desavesa	2	1	1	7597
desavès	2	0	desaves	2	2	2	7598
desavén	2	0	desaven	2	46	46	7599
desbalbà	2	0	desbalba	2	1	1	7600
desballestarà	2	6	desballestara	2	0	6	7601
desballestà	2	12	desballesta	2	29	41	7602
desballestàrem	2	0	desballestarem	2	1	1	7603
desballestés	2	0	desballestes	2	1	1	7604
desballestí	2	0	desballesti	2	6	6	7605
desbancarà	2	12	desbancara	2	0	12	7606
desbancà	2	13	desbanca	2	90	103	7607
desbandarà	2	2	desbandara	2	0	2	7608
desbandà	2	2	desbanda	2	4	6	7609
desbanqués	2	5	desbanques	2	0	5	7610
desbanquí	2	0	desbanqui	2	10	10	7611
desbaratarà	2	9	desbaratara	2	4	13	7612
desbaratà	2	11	desbarata	2	56	67	7613
desbaratàrem	2	0	desbaratarem	2	2	2	7614
desbaratés	2	5	desbarates	2	1	6	7615
desbaratí	2	0	desbarati	2	12	12	7616
desbarrà	2	0	desbarra	2	24	24	7617
desbarràrem	2	1	desbarrarem	2	0	1	7618
desbarrés	2	1	desbarres	2	3	4	7619
desbarrí	2	0	desbarri	2	4	4	7620
desbastà	2	0	desbasta	2	2	2	7621
desbastàreu	2	0	desbastareu	2	1	1	7622
desbastí	2	0	desbasti	2	1	1	7623
desblocarà	2	3	desblocara	2	0	3	7624
desblocà	2	1	desbloca	2	76	77	7625
desblocàrem	2	0	desblocarem	2	1	1	7626
desbloquegés	2	10	desbloqueges	2	6	16	7627
desbloquegí	2	0	desbloquegi	2	105	105	7628
desbloquejarà	2	63	desbloquejara	2	6	69	7629
desbloquejà	2	3	desbloqueja	2	360	363	7630
desbloquejàrem	2	0	desbloquejarem	2	14	14	7631
desbloquejàreu	2	0	desbloquejareu	2	1	1	7632
desbloquí	2	0	desbloqui	2	4	4	7633
desbocarà	2	1	desbocara	2	0	1	7634
desbocà	2	1	desboca	2	38	39	7635
desboqués	2	5	desboques	2	0	5	7636
desboquí	2	0	desboqui	2	6	6	7637
desbordarà	2	29	desbordara	2	5	34	7638
desbordà	2	49	desborda	2	911	960	7639
desbordàrem	2	0	desbordarem	2	11	11	7640
desbordàreu	2	0	desbordareu	2	2	2	7641
desbordés	2	33	desbordes	2	18	51	7642
desbordí	2	0	desbordi	2	99	99	7643
desboscà	2	0	desbosca	2	4	4	7644
desbotonà	2	0	desbotona	2	4	4	7645
desbotonés	2	3	desbotones	2	1	4	7646
desbotoní	2	1	desbotoni	2	1	2	7647
desbotà	2	1	desbota	2	0	1	7648
desbrancàreu	2	1	desbrancareu	2	0	1	7649
desbranquí	2	0	desbranqui	2	1	1	7650
desbravà	2	0	desbrava	2	1	1	7651
desbraví	2	0	desbravi	2	1	1	7652
desbridà	2	0	desbrida	2	2	2	7653
desbrinàrem	2	0	desbrinarem	2	1	1	7654
desbrossarà	2	25	desbrossara	2	0	25	7655
desbrossà	2	1	desbrossa	2	27	28	7656
desbrossàrem	2	0	desbrossarem	2	1	1	7657
desbrossés	2	3	desbrosses	2	2	5	7658
desbrossí	2	0	desbrossi	2	1	1	7659
desbudellarà	2	1	desbudellara	2	0	1	7660
desbudellà	2	0	desbudella	2	3	3	7661
desburocratitzí	2	0	desburocratitzi	2	1	1	7662
descabalés	2	0	descabales	2	1	1	7663
descabdellarà	2	4	descabdellara	2	0	4	7664
descabdellà	2	5	descabdella	2	80	85	7665
descabdellàrem	2	1	descabdellarem	2	0	1	7666
descabdellés	2	1	descabdelles	2	4	5	7667
descabdellí	2	0	descabdelli	2	4	4	7668
descabellà	2	0	descabella	2	1	1	7669
descafeïnà	2	0	descafeïna	2	3	3	7670
descafeïnés	2	1	descafeïnes	2	0	1	7671
descafeïní	2	0	descafeïni	2	3	3	7672
descalcificà	2	0	descalcifica	2	7	7	7673
descalcifiquí	2	0	descalcifiqui	2	1	1	7674
descalcés	2	3	descalces	0	401	404	7675
descalcí	2	0	descalci	2	7	7	7676
descalibrà	2	0	descalibra	2	1	1	7677
descalçarà	2	2	descalçara	2	0	2	7678
descalçà	2	6	descalça	0	395	401	7679
descalçàrem	2	0	descalçarem	2	2	2	7680
descambuixà	2	0	descambuixa	2	3	3	7681
descaminà	2	0	descamina	2	2	2	7682
descamisà	2	0	descamisa	2	1	1	7683
descansarà	2	211	descansara	2	5	216	7684
descansà	2	33	descansa	2	3409	3442	7685
descansàrem	2	14	descansarem	2	153	167	7686
descansàreu	2	0	descansareu	2	10	10	7687
descansés	2	46	descanses	2	88	134	7688
descansí	2	1	descansi	2	742	743	7689
descantà	2	0	descanta	2	1	1	7690
descantés	2	0	descantes	2	1	1	7691
descanvià	2	0	descanvia	2	1	1	7692
descanyotà	2	0	descanyota	2	1	1	7693
descapitalitzà	2	0	descapitalitza	2	7	7	7694
descapitalitzàrem	2	0	descapitalitzarem	2	1	1	7695
descapotarà	2	1	descapotara	2	0	1	7696
descaragolà	2	0	descaragola	2	2	2	7697
descaragolàrem	2	0	descaragolarem	2	1	1	7698
descarbonitzà	2	0	descarbonitza	2	1	1	7699
descarboxilà	2	0	descarboxila	2	5	5	7700
descarboxilàreu	2	0	descarboxilareu	2	1	1	7701
descargolarà	2	2	descargolara	2	0	2	7702
descargolà	2	0	descargola	2	17	17	7703
descarnà	2	0	descarna	2	4	4	7704
descarní	2	0	descarni	2	1	1	7705
descarregarà	2	161	descarregara	2	1	162	7706
descarregués	2	46	descarregues	2	326	372	7707
descarreguí	2	1	descarregui	2	290	291	7708
descarregà	2	64	descarrega	2	4980	5044	7709
descarregàrem	2	11	descarregarem	2	45	56	7710
descarregàreu	2	1	descarregareu	2	12	13	7711
descarrilarà	2	9	descarrilara	2	0	9	7712
descarrilà	2	8	descarrila	2	38	46	7713
descarrilàrem	2	0	descarrilarem	2	2	2	7714
descarrilés	2	12	descarriles	2	1	13	7715
descarrilí	2	0	descarrili	2	32	32	7716
descartarà	2	92	descartara	2	3	95	7717
descartà	2	72	descarta	2	4687	4759	7718
descartàrem	2	4	descartarem	2	34	38	7719
descartàreu	2	0	descartareu	2	1	1	7720
descartés	2	48	descartes	4	2542	2590	7721
descartí	2	1	descarti	2	237	238	7722
descarà	2	1	descara	2	13	14	7723
descarí	2	0	descari	2	2	2	7724
descastellanitzà	2	0	descastellanitza	2	1	1	7725
descastàrem	2	1	descastarem	2	0	1	7726
descasà	2	0	descasa	2	3	3	7727
descasàrem	2	1	descasarem	2	0	1	7728
descasés	2	0	descases	2	2	2	7729
descatalanitzarà	2	1	descatalanitzara	2	1	2	7730
descatalanitzés	2	1	descatalanitzes	2	0	1	7731
descatalogarà	2	0	descatalogara	2	1	1	7732
descatalogués	2	1	descatalogues	2	0	1	7733
descataloguí	2	0	descatalogui	2	3	3	7734
descatalogà	2	0	descataloga	2	7	7	7735
descavalcarà	2	3	descavalcara	2	0	3	7736
descavalcà	2	3	descavalca	2	11	14	7737
descavalcàrem	2	5	descavalcarem	2	1	6	7738
descavalqués	2	1	descavalques	2	0	1	7739
descelerí	2	0	desceleri	2	1	1	7740
descelà	2	0	descela	2	1	1	7741
descelàreu	2	1	descelareu	2	0	1	7742
descendirà	2	87	descendira	2	2	89	7743
descendírem	2	3	descendirem	2	87	90	7744
descendíreu	2	0	descendireu	2	2	2	7745
descentralitzarà	2	10	descentralitzara	2	0	10	7746
descentralitzà	2	1	descentralitza	2	53	54	7747
descentralitzàrem	2	0	descentralitzarem	2	4	4	7748
descentralitzés	2	3	descentralitzes	2	1	4	7749
descentralitzí	2	0	descentralitzi	2	19	19	7750
descentrarà	2	3	descentrara	2	0	3	7751
descentrà	2	0	descentra	2	22	22	7752
descentrés	2	2	descentres	2	0	2	7753
descentrí	2	0	descentri	2	7	7	7754
desclassificarà	2	1	desclassificara	2	0	1	7755
desclassificà	2	3	desclassifica	2	14	17	7756
desclassifiqués	2	1	desclassifiques	2	0	1	7757
desclassifiquí	2	0	desclassifiqui	2	19	19	7758
desclassà	2	0	desclassa	2	2	2	7759
desclavarà	2	2	desclavara	2	0	2	7760
desclavà	2	9	desclava	2	8	17	7761
desclavés	2	3	desclaves	2	0	3	7762
desclaví	2	0	desclavi	2	3	3	7763
desclogués	2	1	desclogues	2	0	1	7764
descloguí	2	0	desclogui	2	1	1	7765
descloscà	2	0	desclosca	2	1	1	7766
desclouré	2	1	descloure	2	51	52	7767
descobrirà	2	2486	descobrira	2	28	2514	7768
descobrírem	2	71	descobrirem	2	4450	4521	7769
descobríreu	2	1	descobrireu	2	1601	1602	7770
descodificarà	2	9	descodificara	2	0	9	7771
descodificà	2	1	descodifica	2	88	89	7772
descodifiqués	2	3	descodifiques	2	0	3	7773
descodifiquí	2	0	descodifiqui	2	13	13	7774
descohesionà	2	0	descohesiona	2	2	2	7775
descolgués	2	1	descolgues	2	0	1	7776
descolgà	2	0	descolga	2	3	3	7777
descollonà	2	0	descollona	2	8	8	7778
descollonàrem	2	0	descollonarem	2	1	1	7779
descollonés	2	0	descollones	2	2	2	7780
descolloní	2	0	descolloni	2	2	2	7781
descollà	2	2	descolla	2	14	16	7782
descollés	2	0	descolles	2	1	1	7783
descolonitzà	2	0	descolonitza	2	6	6	7784
descolonitzí	2	0	descolonitzi	2	4	4	7785
descolorirà	2	2	descolorira	2	1	3	7786
descolorà	2	0	descolora	2	2	2	7787
descolorés	2	1	descolores	2	0	1	7788
descolorí	2	1	descolori	2	0	1	7789
descolorís	2	1	descoloris	2	0	1	7790
descol·locarà	2	6	descol·locara	2	0	6	7791
descol·locà	2	5	descol·loca	2	151	156	7792
descol·loqués	2	3	descol·loques	2	5	8	7793
descol·loquí	2	0	descol·loqui	2	5	5	7794
descompartíreu	2	1	descompartireu	2	0	1	7795
descompassà	2	0	descompassa	2	4	4	7796
descompensarà	2	1	descompensara	2	0	1	7797
descompensà	2	2	descompensa	2	15	17	7798
descompensés	2	0	descompenses	2	1	1	7799
descompensí	2	0	descompensi	2	2	2	7800
descompilà	2	0	descompila	2	3	3	7801
descomplauré	2	0	descomplaure	2	2	2	7802
descompondré	2	8	descompondre	2	593	601	7803
descompongués	2	1	descompongues	2	0	1	7804
descomponguí	2	0	descompongui	2	14	14	7805
descomprimirà	2	2	descomprimira	2	0	2	7806
descomprimírem	2	0	descomprimirem	2	3	3	7807
descomprometré	2	0	descomprometre	2	1	1	7808
descomptarà	2	270	descomptara	2	0	270	7809
descomptà	2	2	descompta	2	181	183	7810
descomptàrem	2	0	descomptarem	2	17	17	7811
descomptàreu	2	0	descomptareu	2	1	1	7812
descomptés	2	9	descomptes	2	13546	13555	7813
descomptí	2	0	descompti	2	23	23	7814
desconcentrà	2	0	desconcentra	2	31	31	7815
desconcentràrem	2	0	desconcentrarem	2	1	1	7816
desconcentrés	2	2	desconcentres	2	1	3	7817
desconcentrí	2	0	desconcentri	2	4	4	7818
desconcertarà	2	11	desconcertara	2	0	11	7819
desconcertà	2	12	desconcerta	2	367	379	7820
desconcertàrem	2	0	desconcertarem	2	1	1	7821
desconcertés	2	0	desconcertes	2	3	3	7822
desconcertí	2	0	desconcerti	2	9	9	7823
desconegués	2	18	desconegues	2	2	20	7824
desconeguí	2	0	desconegui	2	125	125	7825
desconfiarà	2	10	desconfiara	2	1	11	7826
desconfigurà	2	0	desconfigura	2	9	9	7827
desconfigurés	2	3	desconfigures	2	0	3	7828
desconfigurí	2	0	desconfiguri	2	3	3	7829
desconfirà	2	0	desconfira	2	1	1	7830
desconfià	2	8	desconfia	2	401	409	7831
desconfiàrem	2	0	desconfiarem	2	2	2	7832
desconfiàreu	2	1	desconfiareu	2	0	1	7833
desconfiés	2	12	desconfies	2	22	34	7834
desconfií	2	10	desconfii	2	9	19	7835
desconfortàreu	2	1	desconfortareu	2	0	1	7836
desconfíem	2	0	desconfiem	2	98	98	7837
desconfíeu	2	0	desconfieu	2	77	77	7838
descongelarà	2	10	descongelara	2	0	10	7839
descongelà	2	0	descongela	2	317	317	7840
descongelàrem	2	1	descongelarem	2	6	7	7841
descongelés	2	3	descongeles	2	6	9	7842
descongelí	2	0	descongeli	2	38	38	7843
descongestionarà	2	27	descongestionara	2	0	27	7844
descongestionà	2	0	descongestiona	2	41	41	7845
descongestionàrem	2	0	descongestionarem	2	1	1	7846
descongestionés	2	2	descongestiones	2	1	3	7847
descongestioní	2	0	descongestioni	2	9	9	7848
desconhortà	2	0	desconhorta	2	2	2	7849
desconhortí	2	0	desconhorti	2	2	2	7850
desconjuntà	2	0	desconjunta	2	3	3	7851
desconnectarà	2	39	desconnectara	2	1	40	7852
desconnectà	2	8	desconnecta	2	515	523	7853
desconnectàrem	2	0	desconnectarem	2	14	14	7854
desconnectàreu	2	0	desconnectareu	2	5	5	7855
desconnectés	2	18	desconnectes	2	56	74	7856
desconnectí	2	0	desconnecti	2	102	102	7857
desconsellà	2	0	desconsella	2	3	3	7858
desconsiderarà	2	0	desconsiderara	2	1	1	7859
desconsiderà	2	2	desconsidera	2	18	20	7860
desconsolarà	2	0	desconsolara	2	1	1	7861
desconsolà	2	1	desconsola	2	2	3	7862
desconstruírem	2	0	desconstruirem	2	1	1	7863
descontaminarà	2	3	descontaminara	2	0	3	7864
descontaminà	2	0	descontamina	2	14	14	7865
descontaminés	2	1	descontamines	2	0	1	7866
descontaminí	2	0	descontamini	2	3	3	7867
descontentarà	2	1	descontentara	2	0	1	7868
descontentà	2	1	descontenta	0	257	258	7869
descontentés	2	0	descontentes	0	63	63	7870
descontextualitzà	2	1	descontextualitza	2	30	31	7871
descontextualitzàrem	2	0	descontextualitzarem	2	2	2	7872
descontextualitzí	2	0	descontextualitzi	2	2	2	7873
descontracturarà	2	1	descontracturara	2	0	1	7874
descontracturà	2	0	descontractura	2	5	5	7875
descontrolarà	2	4	descontrolara	2	0	4	7876
descontrolà	2	5	descontrola	2	95	100	7877
descontrolés	2	18	descontroles	2	2	20	7878
descontrolí	2	0	descontroli	2	31	31	7879
desconvidà	2	0	desconvida	2	1	1	7880
desconvocarà	2	10	desconvocara	2	0	10	7881
desconvocà	2	6	desconvoca	2	78	84	7882
desconvocàrem	2	0	desconvocarem	2	4	4	7883
desconvoqués	2	20	desconvoques	2	0	20	7884
desconvoquí	2	0	desconvoqui	2	28	28	7885
descoordinà	2	0	descoordina	2	1	1	7886
descoordinés	2	1	descoordines	2	0	1	7887
descoratgés	2	1	descoratges	4	1	2	7888
descoratgí	2	0	descoratgi	2	6	6	7889
descoratjarà	2	12	descoratjara	2	0	12	7890
descoratjà	2	3	descoratja	2	49	52	7891
descordarà	2	2	descordara	2	0	2	7892
descordà	2	4	descorda	2	54	58	7893
descordàrem	2	0	descordarem	2	1	1	7894
descordés	2	2	descordes	2	10	12	7895
descordí	2	0	descordi	2	3	3	7896
descorfà	2	0	descorfa	2	1	1	7897
descosirà	2	1	descosira	2	0	1	7898
descremà	2	0	descrema	2	1	1	7899
descremés	2	0	descremes	2	1	1	7900
descreuré	2	0	descreure	2	12	12	7901
descreà	2	0	descrea	2	1	1	7902
descreí	2	1	descrei	2	0	1	7903
descrigués	2	18	descrigues	2	1	19	7904
descriguí	2	1	descrigui	2	389	390	7905
descriminalitzí	2	0	descriminalitzi	2	1	1	7906
descriuré	2	173	descriure	2	16830	17003	7907
descuidarà	2	6	descuidara	2	0	6	7908
descuidà	2	7	descuida	2	208	215	7909
descuidàrem	2	0	descuidarem	2	5	5	7910
descuidés	2	13	descuides	2	94	107	7911
descuidí	2	0	descuidi	2	38	38	7912
desculpabilitzà	2	0	desculpabilitza	2	1	1	7913
desculàrem	2	0	descularem	2	1	1	7914
descurarà	2	3	descurara	2	0	3	7915
descurà	2	2	descura	2	72	74	7916
descuràrem	2	0	descurarem	2	4	4	7917
descurés	2	3	descures	2	0	3	7918
descurí	2	0	descuri	2	14	14	7919
descàrrega	4	9399	descarrega	2	4980	14379	7920
descàrregues	4	3121	descarregues	2	326	3447	7921
desdejunarà	2	1	desdejunara	2	0	1	7922
desdejunà	2	1	desdejuna	2	17	18	7923
desdejunàrem	2	3	desdejunarem	2	3	6	7924
desdejuní	2	1	desdejuni	2	836	837	7925
desdenyà	2	1	desdenya	2	32	33	7926
desdenyàrem	2	1	desdenyarem	2	0	1	7927
desdenyés	2	1	desdenyes	2	3	4	7928
desdibuixarà	2	2	desdibuixara	2	0	2	7929
desdibuixà	2	5	desdibuixa	2	352	357	7930
desdibuixés	2	5	desdibuixes	2	1	6	7931
desdibuixí	2	0	desdibuixi	2	28	28	7932
desdigués	2	17	desdigues	2	0	17	7933
desdiguí	2	0	desdigui	2	30	30	7934
desdoblarà	2	57	desdoblara	2	0	57	7935
desdoblegués	2	1	desdoblegues	2	0	1	7936
desdobleguí	2	0	desdoblegui	2	1	1	7937
desdoblegà	2	0	desdoblega	2	14	14	7938
desdoblà	2	7	desdobla	2	171	178	7939
desdoblàrem	2	0	desdoblarem	2	4	4	7940
desdoblés	2	5	desdobles	2	4	9	7941
desdoblí	2	0	desdobli	2	31	31	7942
desdotà	2	0	desdota	2	1	1	7943
desdramatitzarà	2	1	desdramatitzara	2	1	2	7944
desdramatitzà	2	0	desdramatitza	2	17	17	7945
desdramatitzàrem	2	0	desdramatitzarem	2	1	1	7946
desdramatitzí	2	0	desdramatitzi	2	1	1	7947
desedificarà	2	0	desedificara	2	1	1	7948
deseixirà	2	1	deseixira	2	0	1	7949
deselectritzà	2	0	deselectritza	2	1	1	7950
deselectritzàreu	2	1	deselectritzareu	2	0	1	7951
desembadocàreu	2	1	desembadocareu	2	0	1	7952
desembafàrem	2	1	desembafarem	2	0	1	7953
desembalatgí	2	1	desembalatgi	2	0	1	7954
desemballestés	2	0	desemballestes	2	1	1	7955
desembalà	2	0	desembala	2	1	1	7956
desembarassarà	2	2	desembarassara	2	0	2	7957
desembarassà	2	2	desembarassa	2	8	10	7958
desembarassés	2	1	desembarasses	2	1	2	7959
desembarcarà	2	83	desembarcara	2	4	87	7960
desembarcà	2	244	desembarca	2	374	618	7961
desembarcàrem	2	1	desembarcarem	2	60	61	7962
desembarcàreu	2	1	desembarcareu	2	3	4	7963
desembarqués	2	24	desembarques	2	8	32	7964
desembarquí	2	0	desembarqui	2	66	66	7965
desembarrancàrem	2	0	desembarrancarem	2	1	1	7966
desembarrà	2	0	desembarra	2	1	1	7967
desembassà	2	0	desembassa	2	6	6	7968
desembassí	2	0	desembassi	2	6	6	7969
desembastarà	2	0	desembastara	2	1	1	7970
desembastonà	2	1	desembastona	2	0	1	7971
desembastà	2	0	desembasta	2	1	1	7972
desembeinà	2	14	desembeina	2	7	21	7973
desembeiní	2	2	desembeini	2	0	2	7974
desembenà	2	0	desembena	2	1	1	7975
desembení	2	0	desembeni	2	1	1	7976
desembocarà	2	248	desembocara	2	4	252	7977
desembocà	2	180	desemboca	2	2941	3121	7978
desembocàrem	2	0	desembocarem	2	17	17	7979
desembocàreu	2	0	desembocareu	2	81	81	7980
desemboirà	2	0	desemboira	2	6	6	7981
desembolcallà	2	0	desembolcalla	2	3	3	7982
desembolicarà	2	4	desembolicara	2	1	5	7983
desembolicà	2	1	desembolica	2	122	123	7984
desembolicàrem	2	0	desembolicarem	2	1	1	7985
desemboliqués	2	1	desemboliques	2	7	8	7986
desemboliquí	2	0	desemboliqui	2	8	8	7987
desemboqués	2	39	desemboques	2	1	40	7988
desemboquí	2	0	desemboqui	2	193	193	7989
desemborsarà	2	12	desemborsara	2	0	12	7990
desemborsà	2	1	desemborsa	2	31	32	7991
desemborsés	2	2	desemborses	2	1	3	7992
desemborsí	2	0	desemborsi	2	9	9	7993
desemboscà	2	0	desembosca	2	1	1	7994
desembossarà	2	1	desembossara	2	0	1	7995
desembossà	2	1	desembossa	2	4	5	7996
desembossí	2	0	desembossi	2	1	1	7997
desembotonà	2	0	desembotona	2	1	1	7998
desembotorní	2	0	desembotorni	2	1	1	7999
desembragà	2	0	desembraga	2	1	1	8000
desembriagués	2	1	desembriagues	2	0	1	8001
desembriagàreu	2	1	desembriagareu	2	0	1	8002
desembromés	2	1	desembromes	2	0	1	8003
desembruixés	2	0	desembruixes	2	1	1	8004
desembullà	2	0	desembulla	2	9	9	8005
desembullàreu	2	1	desembullareu	2	0	1	8006
desembullí	2	0	desembulli	2	1	1	8007
desembussarà	2	1	desembussara	2	0	1	8008
desembussà	2	0	desembussa	2	4	4	8009
desembussàreu	2	1	desembussareu	2	0	1	8010
desembussí	2	0	desembussi	2	7	7	8011
desembutxacarà	2	3	desembutxacara	2	1	4	8012
desembutxacà	2	0	desembutxaca	2	3	3	8013
desemmallàreu	2	2	desemmallareu	2	0	2	8014
desemmarcà	2	0	desemmarca	2	1	1	8015
desemmarcàrem	2	0	desemmarcarem	2	1	1	8016
desemmascararà	2	12	desemmascarara	2	0	12	8017
desemmascarà	2	9	desemmascara	2	172	181	8018
desemmascaràrem	2	0	desemmascararem	2	4	4	8019
desemmascarés	2	2	desemmascares	2	1	3	8020
desemmascarí	2	0	desemmascari	2	10	10	8021
desemmidonarà	2	0	desemmidonara	2	1	1	8022
desemmorrallàrem	2	0	desemmorrallarem	2	1	1	8023
desemmotllarà	2	4	desemmotllara	2	0	4	8024
desemmotllà	2	0	desemmotlla	2	48	48	8025
desemmotllàrem	2	0	desemmotllarem	2	15	15	8026
desemmotllàreu	2	0	desemmotllareu	2	1	1	8027
desemmotllés	2	0	desemmotlles	2	2	2	8028
desemmotllí	2	0	desemmotlli	2	7	7	8029
desemmotlà	2	0	desemmotla	2	1	1	8030
desemmotlàrem	2	0	desemmotlarem	2	1	1	8031
desempallegarà	2	6	desempallegara	2	0	6	8032
desempallegués	2	1	desempallegues	2	0	1	8033
desempalleguí	2	0	desempallegui	2	8	8	8034
desempallegà	2	3	desempallega	2	26	29	8035
desempallegàrem	2	0	desempallegarem	2	4	4	8036
desempallegàreu	2	0	desempallegareu	2	1	1	8037
desempallàrem	2	0	desempallarem	2	1	1	8038
desempaperà	2	0	desempapera	2	1	1	8039
desempaquetarà	2	2	desempaquetara	2	0	2	8040
desempaquetà	2	0	desempaqueta	2	17	17	8041
desempaquetés	2	1	desempaquetes	2	0	1	8042
desempaquetí	2	0	desempaqueti	2	1	1	8043
desempararà	2	2	desemparara	2	0	2	8044
desemparà	2	2	desempara	2	51	53	8045
desemparés	2	1	desempares	2	0	1	8046
desempatarà	2	23	desempatara	2	2	25	8047
desempatà	2	0	desempata	2	15	15	8048
desempatàrem	2	0	desempatarem	2	1	1	8049
desempatés	2	1	desempates	2	0	1	8050
desempatí	2	0	desempati	2	1	1	8051
desempegà	2	1	desempega	2	1	2	8052
desempescàrem	2	1	desempescarem	2	0	1	8053
desempestà	2	1	desempesta	2	0	1	8054
desempestàreu	2	0	desempestareu	2	1	1	8055
desempilà	2	0	desempila	2	2	2	8056
desempolsarà	2	1	desempolsara	2	0	1	8057
desempolseguí	2	0	desempolsegui	2	1	1	8058
desempolsegà	2	0	desempolsega	2	2	2	8059
desempolsà	2	0	desempolsa	2	13	13	8060
desempolsí	2	0	desempolsi	2	1	1	8061
desempresonàrem	2	0	desempresonarem	2	1	1	8062
desenamorarà	2	1	desenamorara	2	0	1	8063
desenamorà	2	2	desenamora	2	5	7	8064
desenamorés	2	0	desenamores	2	2	2	8065
desenamorí	2	0	desenamori	2	1	1	8066
desencaborií	2	1	desencaborii	2	0	1	8067
desencadellarà	2	0	desencadellara	2	1	1	8068
desencadellí	2	0	desencadelli	2	2	2	8069
desencadenarà	2	218	desencadenara	2	2	220	8070
desencadenà	2	284	desencadena	2	1176	1460	8071
desencadenàrem	2	0	desencadenarem	2	2	2	8072
desencadenàreu	2	0	desencadenareu	2	1	1	8073
desencadenés	2	37	desencadenes	2	3	40	8074
desencadení	2	0	desencadeni	2	110	110	8075
desencaixarà	2	2	desencaixara	2	0	2	8076
desencaixonà	2	1	desencaixona	2	0	1	8077
desencaixà	2	0	desencaixa	2	35	35	8078
desencaixàrem	2	0	desencaixarem	2	1	1	8079
desencaixàreu	2	0	desencaixareu	2	1	1	8080
desencaixés	2	1	desencaixes	2	0	1	8081
desencaixí	2	0	desencaixi	2	3	3	8082
desencallarà	2	20	desencallara	2	1	21	8083
desencallà	2	2	desencalla	2	109	111	8084
desencallàrem	2	0	desencallarem	2	1	1	8085
desencallés	2	19	desencalles	2	0	19	8086
desencallí	2	0	desencalli	2	111	111	8087
desencaminà	2	0	desencamina	2	2	2	8088
desencaminés	2	2	desencamines	2	0	2	8089
desencantarà	2	2	desencantara	2	0	2	8090
desencantà	2	11	desencanta	2	15	26	8091
desencantés	2	2	desencantes	2	1	3	8092
desencantí	2	0	desencanti	2	7	7	8093
desencaparrà	2	0	desencaparra	2	1	1	8094
desencapsulà	2	0	desencapsula	2	1	1	8095
desencapullí	2	0	desencapulli	2	1	1	8096
desencarcarà	2	1	desencarcara	2	0	1	8097
desencasellà	2	0	desencasella	2	1	1	8098
desencasquetàreu	2	2	desencasquetareu	2	0	2	8099
desencavalcà	2	0	desencavalca	2	1	1	8100
desencepàreu	2	1	desencepareu	2	0	1	8101
desencercolàrem	2	1	desencercolarem	2	0	1	8102
desencercolàreu	2	2	desencercolareu	2	0	2	8103
desencertà	2	1	desencerta	2	0	1	8104
desencisà	2	2	desencisa	2	14	16	8105
desencisàrem	2	1	desencisarem	2	0	1	8106
desencisés	2	1	desencises	2	0	1	8107
desencisí	2	0	desencisi	2	3	3	8108
desenclavà	2	0	desenclava	2	1	1	8109
desencofrà	2	0	desencofra	2	1	1	8110
desencofràreu	2	0	desencofrareu	2	1	1	8111
desencoixinàrem	2	1	desencoixinarem	2	0	1	8112
desencoixinàreu	2	1	desencoixinareu	2	0	1	8113
desencolà	2	0	desencola	2	1	1	8114
desencoratgés	2	1	desencoratges	2	0	1	8115
desencoratgí	2	0	desencoratgi	2	2	2	8116
desencoratjà	2	3	desencoratja	2	13	16	8117
desencorralí	2	1	desencorrali	2	0	1	8118
desencovenés	2	1	desencovenes	2	0	1	8119
desencreuellàreu	2	1	desencreuellareu	2	0	1	8120
desencreuà	2	0	desencreua	2	1	1	8121
desencriptarà	2	2	desencriptara	2	0	2	8122
desencriptà	2	0	desencripta	2	27	27	8123
desencriptés	2	1	desencriptes	2	0	1	8124
desencriptí	2	0	desencripti	2	2	2	8125
desencubellàrem	2	1	desencubellarem	2	0	1	8126
desencubà	2	0	desencuba	2	2	2	8127
desendollà	2	1	desendolla	2	25	26	8128
desendollàrem	2	0	desendollarem	2	1	1	8129
desendollés	2	0	desendolles	2	1	1	8130
desendollí	2	0	desendolli	2	5	5	8131
desendreçà	2	0	desendreça	2	8	8	8132
desenfadà	2	0	desenfada	2	18	18	8133
desenfadés	2	1	desenfades	2	1	2	8134
desenfarfegà	2	0	desenfarfega	2	1	1	8135
desenfebràreu	2	0	desenfebrareu	2	1	1	8136
desenfilarà	2	1	desenfilara	2	0	1	8137
desenfocarà	2	2	desenfocara	2	0	2	8138
desenfocà	2	0	desenfoca	2	45	45	8139
desenfocàrem	2	0	desenfocarem	2	1	1	8140
desenfoqués	2	2	desenfoques	2	1	3	8141
desenfoquí	2	0	desenfoqui	2	7	7	8142
desenfrenà	2	0	desenfrena	2	2	2	8143
desenfrení	2	0	desenfreni	2	1	1	8144
desenfundarà	2	2	desenfundara	2	0	2	8145
desenfundà	2	4	desenfunda	2	24	28	8146
desenfundés	2	2	desenfundes	2	2	4	8147
desenfundí	2	0	desenfundi	2	1	1	8148
desenfuriarà	2	1	desenfuriara	2	0	1	8149
desenganxarà	2	20	desenganxara	2	0	20	8150
desenganxà	2	4	desenganxa	2	196	200	8151
desenganxàrem	2	2	desenganxarem	2	7	9	8152
desenganxés	2	12	desenganxes	2	12	24	8153
desenganxí	2	0	desenganxi	2	135	135	8154
desenganyarà	2	1	desenganyara	2	0	1	8155
desenganyà	2	10	desenganya	2	26	36	8156
desenganyés	2	3	desenganyes	2	1	4	8157
desenganyí	2	0	desenganyi	2	12	12	8158
desengavanyà	2	1	desengavanya	2	0	1	8159
desengorgés	2	1	desengorges	2	0	1	8160
desengormandírem	2	1	desengormandirem	2	0	1	8161
desengranà	2	0	desengrana	2	3	3	8162
desengraví	2	0	desengravi	2	1	1	8163
desengreixà	2	0	desengreixa	2	13	13	8164
desengreixàrem	2	0	desengreixarem	2	1	1	8165
desengreixí	2	0	desengreixi	2	1	1	8166
desengrunàrem	2	0	desengrunarem	2	1	1	8167
desenllací	2	0	desenllaci	2	1	1	8168
desenllardarà	2	0	desenllardara	2	1	1	8169
desenllaçà	2	0	desenllaça	2	38	38	8170
desenllepolirà	2	1	desenllepolira	2	0	1	8171
desenllustrà	2	0	desenllustra	2	1	1	8172
desenllustràreu	2	0	desenllustrareu	2	1	1	8173
desennuvolà	2	0	desennuvola	2	2	2	8174
desenquadernà	2	0	desenquaderna	2	3	3	8175
desenquadrés	2	1	desenquadres	2	0	1	8176
desenrajolarà	2	3	desenrajolara	2	0	3	8177
desenrajolí	2	0	desenrajoli	2	2	2	8178
desenravenàreu	2	1	desenravenareu	2	0	1	8179
desenredarà	2	3	desenredara	2	0	3	8180
desenredà	2	1	desenreda	2	15	16	8181
desenredés	2	0	desenredes	2	1	1	8182
desenrocarà	2	2	desenrocara	2	0	2	8183
desenrocà	2	0	desenroca	2	2	2	8184
desenrojolarà	2	1	desenrojolara	2	0	1	8185
desenrojolàrem	2	1	desenrojolarem	2	0	1	8186
desenrolí	2	0	desenroli	2	1	1	8187
desenroqués	2	1	desenroques	2	0	1	8188
desenroquí	2	0	desenroqui	2	1	1	8189
desenroscà	2	0	desenrosca	2	7	7	8190
desenroscàrem	2	1	desenroscarem	2	1	2	8191
desenrosqués	2	0	desenrosques	2	2	2	8192
desenrosquí	2	0	desenrosqui	2	2	2	8193
desenrotllarà	2	51	desenrotllara	2	1	52	8194
desenrotllà	2	29	desenrotlla	2	283	312	8195
desenrotllàrem	2	1	desenrotllarem	2	5	6	8196
desenrotllés	2	3	desenrotlles	2	4	7	8197
desenrotllí	2	0	desenrotlli	2	7	7	8198
desenruní	2	0	desenruni	2	1	1	8199
desensacàreu	2	1	desensacareu	2	0	1	8200
desensivellàrem	2	0	desensivellarem	2	1	1	8201
desensorrà	2	1	desensorra	2	0	1	8202
desensorràrem	2	0	desensorrarem	2	1	1	8203
desentelarà	2	1	desentelara	2	0	1	8204
desentelà	2	1	desentela	2	4	5	8205
desentendré	2	1	desentendre	2	632	633	8206
desentengués	2	15	desentengues	2	0	15	8207
desentenguí	2	1	desentengui	2	62	63	8208
desenteranyinarà	2	0	desenteranyinara	2	1	1	8209
desenteranyinés	2	2	desenteranyines	2	0	2	8210
desenterrarà	2	11	desenterrara	2	1	12	8211
desenterrà	2	11	desenterra	2	62	73	8212
desenterràrem	2	1	desenterrarem	2	4	5	8213
desenterrés	2	2	desenterres	2	0	2	8214
desenterrí	2	0	desenterri	2	12	12	8215
desentonarà	2	5	desentonara	2	0	5	8216
desentonà	2	4	desentona	2	154	158	8217
desentonàrem	2	0	desentonarem	2	1	1	8218
desentonés	2	6	desentones	2	1	7	8219
desentoní	2	0	desentoni	2	25	25	8220
desentortolligà	2	1	desentortolliga	2	2	3	8221
desentranyarà	2	4	desentranyara	2	0	4	8222
desentranyà	2	1	desentranya	2	58	59	8223
desentranyés	2	2	desentranyes	2	0	2	8224
desentrellaçà	2	0	desentrellaça	2	14	14	8225
desentrellés	2	1	desentrelles	2	0	1	8226
desentrenà	2	0	desentrena	2	1	1	8227
desentrullarà	2	1	desentrullara	2	0	1	8228
desentumírem	2	0	desentumirem	2	1	1	8229
desentusiasmí	2	1	desentusiasmi	2	0	1	8230
desenutjàreu	2	1	desenutjareu	2	0	1	8231
desenvergués	2	1	desenvergues	2	0	1	8232
desenverinàrem	2	0	desenverinarem	2	1	1	8233
desenvoluparà	2	6119	desenvolupara	2	43	6162	8234
desenvolupà	2	2184	desenvolupa	2	26999	29183	8235
desenvolupàrem	2	9	desenvoluparem	2	651	660	8236
desenvolupàreu	2	2	desenvolupareu	2	11	13	8237
desenvolupés	2	410	desenvolupes	2	129	539	8238
desenvolupí	2	5	desenvolupi	2	3276	3281	8239
desequilibrarà	2	10	desequilibrara	2	0	10	8240
desequilibrà	2	1	desequilibra	2	141	142	8241
desequilibrés	2	4	desequilibres	2	4	8	8242
desequilibrí	2	0	desequilibri	2	3588	3588	8243
desequipà	2	0	desequipa	2	4	4	8244
desequipés	2	0	desequipes	2	1	1	8245
desermà	2	1	deserma	2	0	1	8246
desertarà	2	6	desertara	2	0	6	8247
desertificà	2	0	desertifica	2	2	2	8248
desertitzarà	2	2	desertitzara	2	0	2	8249
desertitzà	2	2	desertitza	2	14	16	8250
desertitzí	2	0	desertitzi	2	1	1	8251
desertà	2	75	deserta	0	1233	1308	8252
desertàrem	2	1	desertarem	2	1	2	8253
desertés	2	6	desertes	0	318	324	8254
desertí	2	0	deserti	2	14	14	8255
desescalà	2	0	desescala	2	1	1	8256
desesmà	2	0	desesma	4	11	11	8257
desesperancés	2	0	desesperances	4	28	28	8258
desesperançà	2	0	desesperança	4	920	920	8259
desesperarà	2	5	desesperara	2	0	5	8260
desesperà	2	6	desespera	2	324	330	8261
desesperàrem	2	0	desesperarem	2	1	1	8262
desesperàreu	2	0	desesperareu	2	3	3	8263
desesperés	2	6	desesperes	2	17	23	8264
desesperí	2	0	desesperi	2	22	22	8265
desespinà	2	0	desespina	2	2	2	8266
desespiní	2	0	desespini	2	1	1	8267
desestabilitzarà	2	44	desestabilitzara	2	0	44	8268
desestabilitzà	2	8	desestabilitza	2	158	166	8269
desestabilitzàrem	2	0	desestabilitzarem	2	3	3	8270
desestabilitzés	2	15	desestabilitzes	2	2	17	8271
desestabilitzí	2	0	desestabilitzi	2	52	52	8272
desestacionalitzarà	2	3	desestacionalitzara	2	0	3	8273
desestacionalitzà	2	0	desestacionalitza	2	24	24	8274
desestacionalitzàrem	2	0	desestacionalitzarem	2	1	1	8275
desestacionalitzí	2	0	desestacionalitzi	2	2	2	8276
desestanyà	2	2	desestanya	2	0	2	8277
desestatitzà	2	0	desestatitza	2	1	1	8278
desestibà	2	0	desestiba	2	13	13	8279
desestigmatitzà	2	0	desestigmatitza	2	2	2	8280
desestimarà	2	29	desestimara	2	2	31	8281
desestimà	2	62	desestima	2	762	824	8282
desestimàrem	2	0	desestimarem	2	8	8	8283
desestimés	2	81	desestimes	2	6	87	8284
desestimí	2	0	desestimi	2	65	65	8285
desestressarà	2	1	desestressara	2	0	1	8286
desestressà	2	0	desestressa	2	10	10	8287
desestressí	2	0	desestressi	2	1	1	8288
desestructurarà	2	1	desestructurara	2	0	1	8289
desestructurà	2	0	desestructura	2	32	32	8290
desestructurés	2	0	desestructures	2	2	2	8291
desestructurí	2	0	desestructuri	2	2	2	8292
desfasarà	2	1	desfasara	2	0	1	8293
desfasà	2	1	desfasa	2	9	10	8294
desfasés	2	0	desfases	2	4	4	8295
desfasí	2	0	desfasi	2	7	7	8296
desfavorirà	2	1	desfavorira	2	0	1	8297
desfavorírem	2	0	desfavorirem	2	1	1	8298
desfeinàrem	2	1	desfeinarem	2	0	1	8299
desfermarà	2	41	desfermara	2	0	41	8300
desfermà	2	87	desferma	2	279	366	8301
desfermés	2	14	desfermes	2	2	16	8302
desfermí	2	0	desfermi	2	11	11	8303
desferrarà	2	1	desferrara	2	0	1	8304
desferrà	2	0	desferra	4	83	83	8305
desferrés	2	1	desferres	4	115	116	8306
desferrí	2	0	desferri	2	6	6	8307
desfibrà	2	0	desfibra	2	5	5	8308
desfibràreu	2	1	desfibrareu	2	0	1	8309
desficiegés	2	1	desficieges	2	0	1	8310
desficià	2	0	desficia	2	7	7	8311
desfigurarà	2	1	desfigurara	2	1	2	8312
desfigurà	2	6	desfigura	2	86	92	8313
desfigurés	2	3	desfigures	2	0	3	8314
desfigurí	2	0	desfiguri	2	6	6	8315
desfilarà	2	118	desfilara	2	7	125	8316
desfilà	2	41	desfila	4	371	412	8317
desfilàrem	2	9	desfilarem	2	18	27	8318
desfilàreu	2	0	desfilareu	2	1	1	8319
desfilés	2	13	desfiles	4	32	45	8320
desfilí	2	0	desfili	2	30	30	8321
desfià	2	0	desfia	2	2	2	8322
desflorà	2	0	desflora	2	1	1	8323
desflorés	2	1	desflores	2	0	1	8324
desfocalitzà	2	0	desfocalitza	2	2	2	8325
desfogarà	2	2	desfogara	2	1	3	8326
desfogués	2	4	desfogues	2	10	14	8327
desfoguí	2	0	desfogui	2	20	20	8328
desfogà	2	1	desfoga	2	48	49	8329
desfogàreu	2	0	desfogareu	2	1	1	8330
desfonà	2	0	desfona	2	2	2	8331
desfoní	2	0	desfoni	2	1	1	8332
desforestarà	2	1	desforestara	2	0	1	8333
desforestà	2	0	desforesta	2	9	9	8334
desforestí	2	0	desforesti	2	2	2	8335
desfosforilà	2	0	desfosforila	2	5	5	8336
desfosforà	2	0	desfosfora	2	1	1	8337
desfragmentà	2	0	desfragmenta	2	5	5	8338
desfragmentí	2	0	desfragmenti	2	1	1	8339
desfraràrem	2	1	desfrararem	2	0	1	8340
desfrenà	2	1	desfrena	2	4	5	8341
desfrenàrem	2	1	desfrenarem	2	0	1	8342
desfressà	2	0	desfressa	4	13	13	8343
desfressés	2	0	desfresses	4	14	14	8344
desfruitàrem	2	0	desfruitarem	2	5	5	8345
desfruitàreu	2	0	desfruitareu	2	4	4	8346
desfruités	2	2	desfruites	2	2	4	8347
desfruití	2	0	desfruiti	2	1	1	8348
desfullarà	2	1	desfullara	2	0	1	8349
desfullà	2	0	desfulla	2	23	23	8350
desfullàrem	2	0	desfullarem	2	3	3	8351
desfullés	2	1	desfulles	2	0	1	8352
desfullí	2	0	desfulli	2	2	2	8353
desféu	2	37	desfeu	2	292	329	8354
desganà	2	0	desgana	4	398	398	8355
desganés	2	0	desganes	4	8	8	8356
desgasificà	2	0	desgasifica	2	4	4	8357
desgastarà	2	11	desgastara	2	1	12	8358
desgastà	2	3	desgasta	2	359	362	8359
desgastàrem	2	0	desgastarem	2	1	1	8360
desgastés	2	3	desgastes	2	3	6	8361
desgastí	2	0	desgasti	2	49	49	8362
desgasà	2	0	desgasa	2	2	2	8363
desgasàrem	2	0	desgasarem	2	1	1	8364
desgavellà	2	1	desgavella	2	12	13	8365
desgavellí	2	0	desgavelli	2	1	1	8366
desgelarà	2	4	desgelara	2	0	4	8367
desgelà	2	3	desgela	2	7	10	8368
desgelàreu	2	1	desgelareu	2	0	1	8369
desgelés	2	1	desgeles	2	1	2	8370
desgelí	2	0	desgeli	2	3	3	8371
desglacés	2	3	desglaces	4	1	4	8372
desglací	2	0	desglaci	2	4	4	8373
desglaçarà	2	3	desglaçara	2	0	3	8374
desglaçà	2	1	desglaça	4	55	56	8375
desglaçàrem	2	0	desglaçarem	2	4	4	8376
desglevà	2	1	desgleva	2	0	1	8377
desglossarà	2	23	desglossara	2	0	23	8378
desglossà	2	4	desglossa	2	251	255	8379
desglossàrem	2	0	desglossarem	2	20	20	8380
desglossí	2	0	desglossi	2	12	12	8381
desgolfarà	2	0	desgolfara	2	1	1	8382
desgovernà	2	0	desgoverna	2	15	15	8383
desgraciarà	2	1	desgraciara	2	0	1	8384
desgracià	2	2	desgracia	2	836	838	8385
desgraciàreu	2	0	desgraciareu	2	1	1	8386
desgraciés	2	1	desgracies	2	111	112	8387
desgranarà	2	60	desgranara	2	0	60	8388
desgranà	2	28	desgrana	2	617	645	8389
desgranàrem	2	0	desgranarem	2	48	48	8390
desgranàreu	2	0	desgranareu	2	2	2	8391
desgranés	2	0	desgranes	2	5	5	8392
desgraní	2	0	desgrani	2	4	4	8393
desgravarà	2	13	desgravara	2	0	13	8394
desgravà	2	0	desgrava	2	51	51	8395
desgravàreu	2	0	desgravareu	2	8	8	8396
desgravés	2	2	desgraves	2	0	2	8397
desgraví	2	0	desgravi	2	10	10	8398
desgreixà	2	0	desgreixa	2	8	8	8399
desgreixàrem	2	0	desgreixarem	2	2	2	8400
desgrimpà	2	0	desgrimpa	2	7	7	8401
desgrimpàrem	2	0	desgrimparem	2	2	2	8402
desgràcia	4	14063	desgracia	2	836	14899	8403
desgràcies	4	2057	desgracies	2	111	2168	8404
desguassarà	2	2	desguassara	2	0	2	8405
desguassà	2	0	desguassa	2	424	424	8406
desguassí	2	0	desguassi	2	7	7	8407
desguerxés	2	0	desguerxes	2	1	1	8408
deshabilitarà	2	10	deshabilitara	2	0	10	8409
deshabilità	2	0	deshabilita	2	127	127	8410
deshabilitàrem	2	0	deshabilitarem	2	1	1	8411
deshabilités	2	0	deshabilites	2	14	14	8412
deshabilití	2	0	deshabiliti	2	16	16	8413
deshabituà	2	0	deshabitua	2	1	1	8414
deshabità	2	1	deshabita	2	4	5	8415
deshabitàrem	2	0	deshabitarem	2	1	1	8416
deshabités	2	0	deshabites	2	1	1	8417
deshabití	2	0	deshabiti	2	1	1	8418
desharmonitzà	2	0	desharmonitza	2	1	1	8419
desherbàrem	2	0	desherbarem	2	2	2	8420
desheretà	2	3	deshereta	2	4	7	8421
desheretés	2	3	desheretes	2	0	3	8422
deshidratarà	2	5	deshidratara	2	0	5	8423
deshidratà	2	0	deshidrata	2	69	69	8424
deshidratàrem	2	0	deshidratarem	2	1	1	8425
deshidratés	2	2	deshidrates	2	4	6	8426
deshidratí	2	0	deshidrati	2	23	23	8427
deshidrogenarà	2	1	deshidrogenara	2	0	1	8428
deshonestà	2	0	deshonesta	0	141	141	8429
deshonestés	2	0	deshonestes	0	104	104	8430
deshonorà	2	0	deshonora	2	9	9	8431
deshonrà	2	1	deshonra	4	186	187	8432
deshonrés	2	2	deshonres	4	3	5	8433
deshonrí	2	0	deshonri	2	2	2	8434
deshumanitzarà	2	4	deshumanitzara	2	0	4	8435
deshumanitzà	2	0	deshumanitza	2	96	96	8436
deshumanitzés	2	1	deshumanitzes	2	4	5	8437
deshumanitzí	2	0	deshumanitzi	2	4	4	8438
designarà	2	391	designara	2	3	394	8439
designà	2	259	designa	2	2570	2829	8440
designàrem	2	1	designarem	2	15	16	8441
designés	2	98	designes	2	30	128	8442
designí	2	0	designi	2	1043	1043	8443
desigualà	2	0	desiguala	2	3	3	8444
desigualés	2	1	desiguales	2	4	5	8445
desil·lusionarà	2	1	desil·lusionara	2	0	1	8446
desil·lusionà	2	4	desil·lusiona	2	26	30	8447
desil·lusionàrem	2	0	desil·lusionarem	2	1	1	8448
desil·lusionés	2	2	desil·lusiones	2	2	4	8449
desil·lusioní	2	0	desil·lusioni	2	4	4	8450
desimantàrem	2	0	desimantarem	2	1	1	8451
desincentivarà	2	10	desincentivara	2	0	10	8452
desincentivà	2	1	desincentiva	2	105	106	8453
desincentivés	2	1	desincentives	2	0	1	8454
desincentiví	2	0	desincentivi	2	18	18	8455
desinclinà	2	1	desinclina	2	3	4	8456
desincrustà	2	0	desincrusta	2	4	4	8457
desindexí	2	0	desindexi	2	1	1	8458
desindustrialitzà	2	2	desindustrialitza	2	1	3	8459
desinfectarà	2	7	desinfectara	2	0	7	8460
desinfectà	2	1	desinfecta	2	81	82	8461
desinfectàrem	2	0	desinfectarem	2	3	3	8462
desinfectés	2	1	desinfectes	2	0	1	8463
desinfectí	2	0	desinfecti	2	10	10	8464
desinflamarà	2	1	desinflamara	2	0	1	8465
desinflamà	2	0	desinflama	2	12	12	8466
desinflarà	2	15	desinflara	2	1	16	8467
desinflà	2	4	desinfla	2	155	159	8468
desinflàrem	2	1	desinflarem	2	1	2	8469
desinflàreu	2	0	desinflareu	2	1	1	8470
desinflés	2	8	desinfles	2	1	9	8471
desinflí	2	0	desinfli	2	32	32	8472
desinformà	2	0	desinforma	2	40	40	8473
desinformés	2	0	desinformes	2	2	2	8474
desinformí	2	0	desinformi	2	2	2	8475
desinhibirà	2	1	desinhibira	2	0	1	8476
desinquietà	2	0	desinquieta	0	1	1	8477
desinquietés	2	0	desinquietes	0	1	1	8478
desinsaculà	2	1	desinsacula	2	0	1	8479
desinsaculés	2	1	desinsacules	2	0	1	8480
desinsectà	2	0	desinsecta	2	2	2	8481
desinstal·larà	2	9	desinstal·lara	2	0	9	8482
desinstal·là	2	1	desinstal·la	2	104	105	8483
desinstal·làreu	2	0	desinstal·lareu	2	2	2	8484
desinstal·lés	2	1	desinstal·les	2	1	2	8485
desinstal·lí	2	0	desinstal·li	2	5	5	8486
desintegrarà	2	30	desintegrara	2	1	31	8487
desintegrà	2	30	desintegra	2	266	296	8488
desintegràrem	2	2	desintegrarem	2	0	2	8489
desintegràreu	2	0	desintegrareu	2	1	1	8490
desintegrés	2	13	desintegres	2	1	14	8491
desintegrí	2	0	desintegri	2	33	33	8492
desinteressarà	2	1	desinteressara	2	0	1	8493
desinteressà	2	4	desinteressa	2	8	12	8494
desinteressés	2	2	desinteresses	2	0	2	8495
desinteressí	2	0	desinteressi	2	5	5	8496
desintoxicarà	2	3	desintoxicara	2	0	3	8497
desintoxicà	2	0	desintoxica	2	54	54	8498
desintoxicàrem	2	0	desintoxicarem	2	1	1	8499
desintoxiqués	2	0	desintoxiques	2	1	1	8500
desintoxiquí	2	0	desintoxiqui	2	3	3	8501
desionitzí	2	0	desionitzi	2	1	1	8502
desistirà	2	25	desistira	2	4	29	8503
desistírem	2	1	desistirem	2	35	36	8504
desitgés	2	311	desitges	2	2547	2858	8505
desitgí	2	1	desitgi	2	4301	4302	8506
desitjarà	2	83	desitjara	2	20	103	8507
desitjà	2	65	desitja	2	15557	15622	8508
desitjàrem	2	10	desitjarem	2	43	53	8509
desitjàreu	2	0	desitjareu	2	32	32	8510
desitjós	0	376	desitjos	4	12847	13223	8511
desjudicialitzí	2	0	desjudicialitzi	2	2	2	8512
desjunyírem	2	0	desjunyirem	2	1	1	8513
deslegitimarà	2	1	deslegitimara	2	2	3	8514
deslegitimà	2	0	deslegitima	2	99	99	8515
deslegitimés	2	2	deslegitimes	2	0	2	8516
deslegitimí	2	0	deslegitimi	2	9	9	8517
deslletà	2	2	deslleta	2	10	12	8518
deslletés	2	1	deslletes	2	0	1	8519
deslletí	2	0	deslleti	2	5	5	8520
desllibertarà	2	0	desllibertara	2	1	1	8521
deslligarà	2	19	deslligara	2	1	20	8522
deslligués	2	13	deslligues	2	3	16	8523
deslliguí	2	0	deslligui	2	41	41	8524
deslligà	2	24	deslliga	2	200	224	8525
deslligàrem	2	1	deslligarem	2	2	3	8526
deslligàreu	2	0	deslligareu	2	3	3	8527
deslliurarà	2	34	deslliurara	2	0	34	8528
deslliurà	2	38	deslliura	2	149	187	8529
deslliuràrem	2	1	deslliurarem	2	18	19	8530
deslliuràreu	2	0	deslliurareu	2	1	1	8531
deslliurés	2	23	deslliures	2	5	28	8532
deslliurí	2	0	deslliuri	2	68	68	8533
desllogarà	2	0	desllogara	2	1	1	8534
desllomà	2	0	deslloma	2	1	1	8535
desllorigarà	2	4	desllorigara	2	0	4	8536
desllorigués	2	1	desllorigues	2	0	1	8537
deslloriguí	2	0	desllorigui	2	7	7	8538
desllorigà	2	1	deslloriga	2	20	21	8539
desllustrà	2	0	desllustra	2	1	1	8540
deslluírem	2	0	deslluirem	2	1	1	8541
deslocalitzarà	2	5	deslocalitzara	2	0	5	8542
deslocalitzà	2	0	deslocalitza	2	44	44	8543
deslocalitzàrem	2	0	deslocalitzarem	2	1	1	8544
deslocalitzí	2	0	deslocalitzi	2	2	2	8545
desmagnetitzarà	2	1	desmagnetitzara	2	0	1	8546
desmaiarà	2	4	desmaiara	2	0	4	8547
desmaià	2	8	desmaia	2	90	98	8548
desmaiés	2	4	desmaies	2	5	9	8549
desmamellàrem	2	0	desmamellarem	2	1	1	8550
desmamàrem	2	0	desmamarem	2	1	1	8551
desmamí	2	0	desmami	2	1	1	8552
desmanegarà	2	2	desmanegara	2	0	2	8553
desmanegués	2	1	desmanegues	2	0	1	8554
desmaneguí	2	0	desmanegui	2	1	1	8555
desmanegà	2	0	desmanega	2	20	20	8556
desmantellarà	2	23	desmantellara	2	1	24	8557
desmantellà	2	22	desmantella	2	145	167	8558
desmantellàrem	2	0	desmantellarem	2	4	4	8559
desmantellés	2	18	desmantelles	2	0	18	8560
desmantellí	2	0	desmantelli	2	64	64	8561
desmanà	2	0	desmana	2	2	2	8562
desmanés	2	0	desmanes	2	9	9	8563
desmaquillà	2	0	desmaquilla	2	24	24	8564
desmaquillés	2	0	desmaquilles	2	1	1	8565
desmarcarà	2	14	desmarcara	2	2	16	8566
desmarcà	2	16	desmarca	2	512	528	8567
desmarcàrem	2	0	desmarcarem	2	6	6	8568
desmarqués	2	16	desmarques	2	5	21	8569
desmarquí	2	0	desmarqui	2	51	51	8570
desmarxarà	2	1	desmarxara	2	0	1	8571
desmarxà	2	1	desmarxa	2	4	5	8572
desmarxés	2	2	desmarxes	2	0	2	8573
desmarxí	2	0	desmarxi	2	3	3	8574
desmaterialitzà	2	0	desmaterialitza	2	13	13	8575
desmaterialitzí	2	0	desmaterialitzi	2	1	1	8576
desmaximitzà	2	0	desmaximitza	2	12	12	8577
desmaí	2	0	desmai	4	327	327	8578
desmembrarà	2	3	desmembrara	2	1	4	8579
desmembrà	2	16	desmembra	2	24	40	8580
desmembrés	2	1	desmembres	2	0	1	8581
desmembrí	2	0	desmembri	2	2	2	8582
desmemorià	2	0	desmemoria	2	46	46	8583
desmemòria	4	333	desmemoria	2	46	379	8584
desmemòries	4	10	desmemories	2	0	10	8585
desmenjàreu	2	0	desmenjareu	2	1	1	8586
desmentirà	2	23	desmentira	2	0	23	8587
desmentí	2	20	desmenti	2	0	20	8588
desmentírem	2	0	desmentirem	2	14	14	8589
desmentís	2	31	desmentis	2	0	31	8590
desmereixés	2	2	desmereixes	2	0	2	8591
desmereixí	2	0	desmereixi	2	26	26	8592
desmeresqués	2	1	desmeresques	2	0	1	8593
desmesclàreu	2	0	desmesclareu	2	1	1	8594
desmesclés	2	0	desmescles	2	1	1	8595
desmilitaritzarà	2	1	desmilitaritzara	2	2	3	8596
desmilitaritzà	2	1	desmilitaritza	2	0	1	8597
desmilitaritzàrem	2	0	desmilitaritzarem	2	1	1	8598
desmilitaritzàreu	2	0	desmilitaritzareu	2	1	1	8599
desmilitaritzés	2	1	desmilitaritzes	2	0	1	8600
desmilitaritzí	2	0	desmilitaritzi	2	3	3	8601
desmillorarà	2	0	desmillorara	2	1	1	8602
desmillorà	2	1	desmillora	2	13	14	8603
desmillorí	2	0	desmillori	2	1	1	8604
desmineralitzà	2	0	desmineralitza	2	11	11	8605
desminimitzà	2	0	desminimitza	2	3	3	8606
desminà	2	0	desmina	2	3	3	8607
desmitificarà	2	2	desmitificara	2	1	3	8608
desmitificà	2	2	desmitifica	2	126	128	8609
desmitificàrem	2	0	desmitificarem	2	7	7	8610
desmitifiqués	2	0	desmitifiques	2	2	2	8611
desmitifiquí	2	0	desmitifiqui	2	7	7	8612
desmitologitzà	2	0	desmitologitza	2	1	1	8613
desmobilitzarà	2	9	desmobilitzara	2	0	9	8614
desmobilitzà	2	3	desmobilitza	2	24	27	8615
desmobilitzés	2	6	desmobilitzes	2	2	8	8616
desmobilitzí	2	0	desmobilitzi	2	4	4	8617
desmodulà	2	0	desmodula	2	1	1	8618
desmoralitzarà	2	1	desmoralitzara	2	0	1	8619
desmoralitzà	2	7	desmoralitza	2	51	58	8620
desmoralitzàrem	2	1	desmoralitzarem	2	2	3	8621
desmoralitzés	2	3	desmoralitzes	2	3	6	8622
desmoralitzí	2	0	desmoralitzi	2	10	10	8623
desmotivarà	2	4	desmotivara	2	0	4	8624
desmotivà	2	1	desmotiva	2	65	66	8625
desmotivés	2	2	desmotives	2	1	3	8626
desmotiví	2	0	desmotivi	2	8	8	8627
desmudarà	2	0	desmudara	2	1	1	8628
desmultiplexà	2	0	desmultiplexa	2	1	1	8629
desmuntarà	2	91	desmuntara	2	5	96	8630
desmuntà	2	42	desmunta	2	914	956	8631
desmuntàrem	2	0	desmuntarem	2	45	45	8632
desmuntàreu	2	0	desmuntareu	2	3	3	8633
desmuntés	2	23	desmuntes	2	26	49	8634
desmuntí	2	0	desmunti	2	154	154	8635
desnacionalitzí	2	0	desnacionalitzi	2	2	2	8636
desnaturalitzarà	2	2	desnaturalitzara	2	0	2	8637
desnaturalitzà	2	0	desnaturalitza	2	69	69	8638
desnaturalitzí	2	0	desnaturalitzi	2	78	78	8639
desnatà	2	0	desnata	2	2	2	8640
desnivellarà	2	0	desnivellara	2	1	1	8641
desnivellà	2	1	desnivella	2	5	6	8642
desnivellés	2	1	desnivelles	2	0	1	8643
desnivellí	2	0	desnivelli	2	2	2	8644
desnonarà	2	3	desnonara	2	0	3	8645
desnonà	2	0	desnona	2	62	62	8646
desnonés	2	3	desnones	2	0	3	8647
desnoní	2	0	desnoni	2	4	4	8648
desnucarà	2	0	desnucara	2	1	1	8649
desnuclearitzarà	2	1	desnuclearitzara	2	0	1	8650
desnuclearitzà	2	0	desnuclearitza	2	1	1	8651
desnucà	2	0	desnuca	2	1	1	8652
desnucàrem	2	0	desnucarem	2	1	1	8653
desnugués	2	0	desnugues	2	1	1	8654
desnugà	2	1	desnuga	2	0	1	8655
desnuà	2	0	desnua	2	7	7	8656
desobeírem	2	1	desobeirem	2	20	21	8657
desobliguí	2	1	desobligui	2	0	1	8658
desobrés	2	0	desobres	2	1	1	8659
desobstruírem	2	0	desobstruirem	2	1	1	8660
desocuparà	2	3	desocupara	2	0	3	8661
desocupà	2	1	desocupa	2	8	9	8662
desocupés	2	2	desocupes	2	2	4	8663
desocupí	2	0	desocupi	2	8	8	8664
desodoritzà	2	0	desodoritza	2	4	4	8665
desodoritzés	2	1	desodoritzes	2	0	1	8666
desolà	2	1	desola	2	25	26	8667
desolés	2	1	desoles	2	0	1	8668
desoperculà	2	0	desopercula	2	1	1	8669
desorbità	2	1	desorbita	2	1	2	8670
desorbití	2	0	desorbiti	2	1	1	8671
desordenarà	2	2	desordenara	2	0	2	8672
desordenà	2	0	desordena	2	29	29	8673
desordenés	2	1	desordenes	2	0	1	8674
desordení	2	0	desordeni	2	4	4	8675
desorellí	2	1	desorelli	2	0	1	8676
desorganitzà	2	2	desorganitza	2	22	24	8677
desorientarà	2	3	desorientara	2	0	3	8678
desorientà	2	3	desorienta	2	131	134	8679
desorientàrem	2	0	desorientarem	2	2	2	8680
desorientés	2	0	desorientes	2	5	5	8681
desorientí	2	0	desorienti	2	8	8	8682
desossà	2	0	desossa	2	12	12	8683
desossàrem	2	0	desossarem	2	7	7	8684
desossí	2	0	desossi	2	5	5	8685
desovà	2	0	desova	2	3	3	8686
desoxidà	2	0	desoxida	2	1	1	8687
desoírem	2	0	desoirem	2	2	2	8688
despacientà	2	0	despacienta	2	2	2	8689
despalmà	2	1	despalma	2	0	1	8690
despampolà	2	0	despampola	2	2	2	8691
despanyà	2	0	despanya	2	48	48	8692
despararà	2	1	desparara	2	0	1	8693
desparasità	2	0	desparasita	2	136	136	8694
desparasití	2	0	desparasiti	2	2	2	8695
desparedàreu	2	1	desparedareu	2	0	1	8696
desparellà	2	0	desparella	2	1	1	8697
desparellés	2	0	desparelles	2	1	1	8698
desparençàrem	2	0	desparençarem	2	1	1	8699
desparionàreu	2	0	desparionareu	2	1	1	8700
desparà	2	3	despara	2	8	11	8701
desparés	2	3	despares	2	5	8	8702
despassà	2	1	despassa	2	12	13	8703
despatologitzà	2	0	despatologitza	2	3	3	8704
despatologitzés	2	1	despatologitzes	2	0	1	8705
despatologitzí	2	0	despatologitzi	2	2	2	8706
despatriarcalitzà	2	0	despatriarcalitza	2	1	1	8707
despatrimonialitzà	2	0	despatrimonialitza	2	1	1	8708
despatxarà	2	14	despatxara	2	2	16	8709
despatxà	2	19	despatxa	2	213	232	8710
despatxàrem	2	0	despatxarem	2	2	2	8711
despatxés	2	12	despatxes	2	4	16	8712
despatxí	2	0	despatxi	2	22	22	8713
despecegarà	2	1	despecegara	2	0	1	8714
despecegà	2	0	despecega	0	2	2	8715
despedirà	2	15	despedira	2	0	15	8716
despedregarà	2	1	despedregara	2	0	1	8717
despedírem	2	1	despedirem	2	21	22	8718
despedíreu	2	0	despedireu	2	3	3	8719
despenalitzarà	2	2	despenalitzara	2	0	2	8720
despenalitzà	2	3	despenalitza	2	40	43	8721
despenalitzàrem	2	0	despenalitzarem	2	2	2	8722
despenalitzés	2	1	despenalitzes	2	0	1	8723
despenalitzí	2	0	despenalitzi	2	21	21	8724
despendré	2	0	despendre	2	269	269	8725
despenguí	2	0	despengui	2	1	1	8726
despengés	2	38	despenges	2	21	59	8727
despengí	2	0	despengi	2	44	44	8728
despenjarà	2	18	despenjara	2	4	22	8729
despenjà	2	20	despenja	2	308	328	8730
despenjàrem	2	1	despenjarem	2	3	4	8731
despentinarà	2	5	despentinara	2	0	5	8732
despentinà	2	2	despentina	2	86	88	8733
despentiní	2	0	despentini	2	10	10	8734
despenyà	2	2	despenya	2	4	6	8735
despersonalitzà	2	0	despersonalitza	2	28	28	8736
despersonalitzí	2	0	despersonalitzi	2	1	1	8737
despertarà	2	516	despertara	2	26	542	8738
despertà	2	541	desperta	0	8272	8813	8739
despertàrem	2	11	despertarem	2	95	106	8740
despertàreu	2	1	despertareu	2	19	20	8741
despertés	2	224	despertes	0	444	668	8742
despertí	2	2	desperti	2	794	796	8743
despintà	2	0	despinta	2	2	2	8744
despintés	2	1	despintes	2	0	1	8745
despintí	2	0	despinti	2	1	1	8746
despistarà	2	3	despistara	2	1	4	8747
despistà	2	4	despista	2	168	172	8748
despistàrem	2	0	despistarem	2	5	5	8749
despistés	2	8	despistes	2	129	137	8750
despistí	2	0	despisti	2	50	50	8751
despità	2	0	despita	2	2	2	8752
desplacés	2	139	desplaces	2	76	215	8753
desplací	2	1	desplaci	2	480	481	8754
desplagués	2	1	desplagues	2	0	1	8755
desplaguí	2	0	desplagui	2	2	2	8756
desplantés	2	0	desplantes	2	5	5	8757
desplauré	2	0	desplaure	2	16	16	8758
desplaçarà	2	1167	desplaçara	2	23	1190	8759
desplaçà	2	334	desplaça	2	3735	4069	8760
desplaçàrem	2	39	desplaçarem	2	658	697	8761
desplaçàreu	2	0	desplaçareu	2	15	15	8762
desplegarà	2	595	desplegara	2	2	597	8763
desplegués	2	57	desplegues	2	25	82	8764
despleguí	2	0	desplegui	2	273	273	8765
desplegà	2	239	desplega	2	3471	3710	8766
desplegàrem	2	5	desplegarem	2	73	78	8767
desplegàreu	2	0	desplegareu	2	2	2	8768
desplomarà	2	10	desplomara	2	3	13	8769
desplomà	2	22	desploma	2	180	202	8770
desplomés	2	16	desplomes	2	5	21	8771
desplomí	2	0	desplomi	2	26	26	8772
despoblarà	2	1	despoblara	2	0	1	8773
despoblà	2	19	despobla	2	11	30	8774
despoblés	2	2	despobles	2	0	2	8775
despoblí	2	0	despobli	2	4	4	8776
despolaritzà	2	0	despolaritza	2	13	13	8777
despolimeritzí	2	0	despolimeritzi	2	1	1	8778
despolititzà	2	1	despolititza	2	4	5	8779
despolititzàrem	2	0	despolititzarem	2	3	3	8780
despolititzés	2	0	despolititzes	2	2	2	8781
despolititzí	2	1	despolititzi	2	3	4	8782
despollà	2	0	despolla	2	1	1	8783
desponcellàrem	2	0	desponcellarem	2	1	1	8784
desponguí	2	0	despongui	2	1	1	8785
desportellà	2	1	desportella	2	0	1	8786
desposseírem	2	0	desposseirem	2	1	1	8787
despreciarà	2	1	despreciara	2	1	2	8788
desprecintarà	2	1	desprecintara	2	0	1	8789
desprecintà	2	0	desprecinta	2	1	1	8790
desprecintés	2	0	desprecintes	2	2	2	8791
desprecià	2	2	desprecia	2	81	83	8792
despreciàreu	2	1	despreciareu	2	0	1	8793
despreciés	2	1	desprecies	2	4	5	8794
desprendré	2	0	desprendre	2	1941	1941	8795
desprengués	2	41	desprengues	2	0	41	8796
desprenguí	2	0	desprengui	2	240	240	8797
despreocupà	2	2	despreocupa	2	62	64	8798
despreocupés	2	2	despreocupes	2	4	6	8799
despreocupí	2	0	despreocupi	2	17	17	8800
despressuritzà	2	2	despressuritza	2	3	5	8801
desprestigiarà	2	3	desprestigiara	2	0	3	8802
desprestigià	2	1	desprestigia	2	108	109	8803
desprestigiés	2	2	desprestigies	2	3	5	8804
desprisà	2	0	desprisa	2	1	1	8805
desprisí	2	0	desprisi	2	1	1	8806
desprogramà	2	0	desprograma	2	4	4	8807
desprogramés	2	0	desprogrames	2	1	1	8808
desprogramí	2	1	desprogrami	2	4	5	8809
desproporcionarà	2	1	desproporcionara	2	0	1	8810
desproporcionà	2	0	desproporciona	2	1	1	8811
desprotegirà	2	4	desprotegira	2	0	4	8812
desproveíreu	2	1	desproveireu	2	0	1	8813
despullarà	2	17	despullara	2	1	18	8814
despullà	2	32	despulla	4	800	832	8815
despullàrem	2	0	despullarem	2	7	7	8816
despullàreu	2	0	despullareu	2	1	1	8817
despullés	2	34	despulles	4	1592	1626	8818
despullí	2	0	despulli	2	54	54	8819
despuntarà	2	6	despuntara	2	2	8	8820
despuntà	2	20	despunta	2	296	316	8821
despuntàrem	2	0	despuntarem	2	1	1	8822
despuntés	2	2	despuntes	2	1	3	8823
despuntí	2	0	despunti	2	24	24	8824
despuçà	2	0	despuça	2	1	1	8825
desquadrarà	2	2	desquadrara	2	0	2	8826
desquadrà	2	1	desquadra	2	38	39	8827
desquadrés	2	3	desquadres	2	0	3	8828
desquadrí	2	0	desquadri	2	1	1	8829
desqualificarà	2	21	desqualificara	2	1	22	8830
desqualificà	2	6	desqualifica	2	189	195	8831
desqualificàrem	2	0	desqualificarem	2	2	2	8832
desqualifiqués	2	7	desqualifiques	2	8	15	8833
desqualifiquí	2	0	desqualifiqui	2	16	16	8834
desrapà	2	0	desrapa	2	18	18	8835
desrapàrem	2	0	desraparem	2	1	1	8836
desratitzarà	2	1	desratitzara	2	0	1	8837
desratitzí	2	0	desratitzi	2	1	1	8838
desregistrarà	2	1	desregistrara	2	0	1	8839
desregistrà	2	0	desregistra	2	3	3	8840
desregularà	2	3	desregulara	2	0	3	8841
desregulà	2	2	desregula	2	18	20	8842
desregulí	2	0	desreguli	2	4	4	8843
desresponsabilitzà	2	0	desresponsabilitza	2	9	9	8844
desresponsabilitzí	2	0	desresponsabilitzi	2	2	2	8845
desrissà	2	0	desrissa	2	1	1	8846
dessacralitzà	2	0	dessacralitza	2	12	12	8847
dessagnarà	2	1	dessagnara	2	1	2	8848
dessagnà	2	3	dessagna	2	90	93	8849
dessagnés	2	7	dessagnes	2	6	13	8850
dessagní	2	0	dessagni	2	8	8	8851
dessalinitzà	2	0	dessalinitza	2	8	8	8852
dessalà	2	0	dessala	2	14	14	8853
dessalàrem	2	0	dessalarem	2	4	4	8854
dessalí	2	0	dessali	2	2	2	8855
dessaturà	2	0	dessatura	2	18	18	8856
dessaturí	2	0	dessaturi	2	1	1	8857
dessecarà	2	1	dessecara	2	1	2	8858
dessecà	2	4	desseca	2	9	13	8859
desseleccionarà	2	5	desseleccionara	2	0	5	8860
desseleccionà	2	0	desselecciona	2	99	99	8861
desseleccioní	2	0	desseleccioni	2	1	1	8862
dessensibilitzí	2	0	dessensibilitzi	2	1	1	8863
dessequés	2	4	desseques	2	0	4	8864
dessequí	2	0	dessequi	2	1	1	8865
desserialitzà	2	0	desserialitza	2	3	3	8866
dessincronitzà	2	0	dessincronitza	2	4	4	8867
dessocà	2	0	dessoca	2	1	1	8868
dessoldà	2	0	dessolda	2	1	1	8869
dessolà	2	0	dessola	2	1	1	8870
dessoterrí	2	1	dessoterri	2	0	1	8871
dessucà	2	0	dessuca	2	1	1	8872
dessulfuràrem	2	1	dessulfurarem	2	0	1	8873
destacarà	2	372	destacara	2	10	382	8874
destacà	2	2025	destaca	2	52965	54990	8875
destacàrem	2	8	destacarem	2	543	551	8876
destacàreu	2	0	destacareu	2	2	2	8877
destalonà	2	0	destalona	2	1	1	8878
destaparà	2	42	destapara	2	6	48	8879
destapà	2	38	destapa	2	690	728	8880
destapàrem	2	1	destaparem	2	37	38	8881
destapàreu	2	0	destapareu	2	3	3	8882
destapés	2	41	destapes	2	16	57	8883
destapí	2	0	destapi	2	39	39	8884
destaqués	2	103	destaques	2	75	178	8885
destaquí	2	0	destaqui	2	719	719	8886
destarotarà	2	2	destarotara	2	2	4	8887
destarotà	2	4	destarota	2	37	41	8888
destarotés	2	2	destarotes	2	2	4	8889
destarotí	2	0	destaroti	2	6	6	8890
desteixirà	2	1	desteixira	2	0	1	8891
desteixírem	2	0	desteixirem	2	1	1	8892
destemprés	2	1	destempres	2	0	1	8893
destemptà	2	0	destempta	2	1	1	8894
destemptàrem	2	1	destemptarem	2	0	1	8895
destensarà	2	3	destensara	2	2	5	8896
destensà	2	1	destensa	2	34	35	8897
destensàrem	2	0	destensarem	2	2	2	8898
destensés	2	0	destenses	2	1	1	8899
destensí	2	0	destensi	2	2	2	8900
destenyirà	2	4	destenyira	2	0	4	8901
desterrarà	2	8	desterrara	2	0	8	8902
desterritorialitzà	2	0	desterritorialitza	2	3	3	8903
desterritorialitzí	2	0	desterritorialitzi	2	1	1	8904
desterrà	2	30	desterra	2	64	94	8905
desterràrem	2	0	desterrarem	2	3	3	8906
desterrés	2	6	desterres	2	0	6	8907
desterrí	2	0	desterri	2	21	21	8908
destesà	2	0	destesa	2	1	1	8909
destesés	2	0	desteses	2	1	1	8910
destesí	2	1	destesi	2	0	1	8911
destil·larà	2	7	destil·lara	2	0	7	8912
destil·là	2	5	destil·la	2	776	781	8913
destil·làrem	2	1	destil·larem	2	4	5	8914
destil·làreu	2	1	destil·lareu	2	0	1	8915
destil·lés	2	3	destil·les	2	5	8	8916
destil·lí	2	0	destil·li	2	15	15	8917
destinarà	2	5169	destinara	2	26	5195	8918
destintà	2	0	destinta	2	2	2	8919
destintàreu	2	0	destintareu	2	1	1	8920
destintí	2	0	destinti	2	1	1	8921
destinà	2	190	destina	2	5705	5895	8922
destinàrem	2	5	destinarem	2	261	266	8923
destinàreu	2	0	destinareu	2	1	1	8924
destinés	2	192	destines	2	26	218	8925
destiní	2	0	destini	2	960	960	8926
destorbarà	2	17	destorbara	2	1	18	8927
destorbà	2	3	destorba	2	166	169	8928
destorbés	2	22	destorbes	2	5	27	8929
destorbí	2	0	destorbi	2	104	104	8930
destorcerà	2	0	destorcera	2	1	1	8931
destorçarà	2	1	destorçara	2	0	1	8932
destralejà	2	1	destraleja	2	1	2	8933
destralejàreu	2	1	destralejareu	2	0	1	8934
destramà	2	0	destrama	2	3	3	8935
destravà	2	6	destrava	2	3	9	8936
destravàreu	2	1	destravareu	2	0	1	8937
destraví	2	0	destravi	2	1	1	8938
destrempà	2	0	destrempa	2	24	24	8939
destrempés	2	0	destrempes	2	1	1	8940
destrempí	2	0	destrempi	2	2	2	8941
destrenyéreu	2	0	destrenyereu	2	1	1	8942
destrenyés	2	1	destrenyes	2	0	1	8943
destrenà	2	1	destrena	2	7	8	8944
destriarà	2	12	destriara	2	0	12	8945
destrià	2	6	destria	2	140	146	8946
destriàrem	2	0	destriarem	2	9	9	8947
destriàreu	2	0	destriareu	2	1	1	8948
destriés	2	2	destries	2	8	10	8949
destrií	2	0	destrii	2	2	2	8950
destrompassés	2	0	destrompasses	2	1	1	8951
destronarà	2	9	destronara	2	0	9	8952
destronà	2	26	destrona	2	22	48	8953
destronés	2	11	destrones	2	0	11	8954
destroní	2	0	destroni	2	7	7	8955
destrossarà	2	33	destrossara	2	3	36	8956
destrossà	2	41	destrossa	4	1245	1286	8957
destrossàrem	2	1	destrossarem	2	10	11	8958
destrossàreu	2	0	destrossareu	2	1	1	8959
destrossés	2	26	destrosses	4	1554	1580	8960
destrossí	2	0	destrossi	2	57	57	8961
destrumfàrem	2	0	destrumfarem	2	1	1	8962
destruírem	2	2	destruirem	2	68	70	8963
destruíreu	2	1	destruireu	2	7	8	8964
destrà	2	0	destra	4	249	249	8965
destrés	2	1	destres	4	259	260	8966
destrí	2	0	destri	2	5	5	8967
desubicà	2	1	desubica	2	4	5	8968
desullarà	2	1	desullara	2	0	1	8969
desunflarà	2	1	desunflara	2	0	1	8970
desunflà	2	0	desunfla	2	8	8	8971
desunflí	2	0	desunfli	2	1	1	8972
desurbanitzà	2	0	desurbanitza	2	1	1	8973
desvagà	2	0	desvaga	2	1	1	8974
desvalisà	2	1	desvalisa	2	1	2	8975
desvalorarà	2	1	desvalorara	2	0	1	8976
desvaloritzarà	2	1	desvaloritzara	2	0	1	8977
desvaloritzà	2	1	desvaloritza	2	18	19	8978
desvaloritzés	2	0	desvaloritzes	2	1	1	8979
desvalorà	2	0	desvalora	2	12	12	8980
desvalorí	2	0	desvalori	2	3	3	8981
desvariegés	2	1	desvarieges	2	0	1	8982
desvariegí	2	0	desvariegi	2	1	1	8983
desvariejà	2	1	desvarieja	2	18	19	8984
desvarià	2	0	desvaria	2	5	5	8985
desvariés	2	1	desvaries	2	2	3	8986
desvelarà	2	87	desvelara	2	1	88	8987
desvelà	2	5	desvela	2	385	390	8988
desvelàrem	2	1	desvelarem	2	49	50	8989
desvelés	2	6	desveles	2	3	9	8990
desvelí	2	0	desveli	2	26	26	8991
desventrà	2	0	desventra	2	1	1	8992
desvertebrà	2	0	desvertebra	2	1	1	8993
desvestirà	2	2	desvestira	2	0	2	8994
desvetlarà	2	18	desvetlara	2	4	22	8995
desvetllarà	2	265	desvetllara	2	2	267	8996
desvetllà	2	102	desvetlla	2	1142	1244	8997
desvetllàrem	2	0	desvetllarem	2	196	196	8998
desvetllàreu	2	0	desvetllareu	2	2	2	8999
desvetllés	2	27	desvetlles	2	12	39	9000
desvetllí	2	0	desvetlli	2	103	103	9001
desvetlà	2	4	desvetla	2	58	62	9002
desvetlàrem	2	0	desvetlarem	2	3	3	9003
desvetlí	2	0	desvetli	2	1	1	9004
desviarà	2	223	desviara	2	7	230	9005
desvincularà	2	19	desvinculara	2	4	23	9006
desvinculà	2	30	desvincula	2	314	344	9007
desvinculàrem	2	1	desvincularem	2	4	5	9008
desvinculés	2	20	desvincules	2	4	24	9009
desvinculí	2	0	desvinculi	2	59	59	9010
desvirgués	2	0	desvirgues	2	1	1	9011
desvirguí	2	0	desvirgui	2	1	1	9012
desvirgà	2	0	desvirga	2	8	8	9013
desvirtualitzà	2	0	desvirtualitza	2	12	12	9014
desvirtualitzàrem	2	0	desvirtualitzarem	2	2	2	9015
desvirtualitzí	2	0	desvirtualitzi	2	1	1	9016
desvirtuarà	2	8	desvirtuara	2	0	8	9017
desvirtuà	2	7	desvirtua	2	329	336	9018
desvirtuàrem	2	0	desvirtuarem	2	1	1	9019
desvirtués	2	9	desvirtues	2	4	13	9020
desvitalitzà	2	0	desvitalitza	2	1	1	9021
desviuré	2	0	desviure	2	61	61	9022
desvià	2	59	desvia	2	1123	1182	9023
desviàrem	2	13	desviarem	2	333	346	9024
desviàreu	2	0	desviareu	2	6	6	9025
desviés	2	63	desvies	2	33	96	9026
desvií	2	5	desvii	2	15	20	9027
desvoràreu	2	2	desvorareu	2	0	2	9028
desvorés	2	0	desvores	2	1	1	9029
desxifrarà	2	16	desxifrara	2	0	16	9030
desxifrà	2	6	desxifra	2	148	154	9031
desxifràrem	2	0	desxifrarem	2	17	17	9032
desxifràreu	2	0	desxifrareu	2	1	1	9033
desxifrés	2	5	desxifres	2	5	10	9034
desxifrí	2	0	desxifri	2	13	13	9035
desà	2	17	desa	2	3944	3961	9036
desànim	4	1482	desanim	2	23	1505	9037
desàrem	2	0	desarem	2	32	32	9038
desàreu	2	0	desareu	2	13	13	9039
desè	0	4927	dese	2	66	4993	9040
desé	0	266	dese	2	66	332	9041
desés	2	9	deses	2	38	47	9042
desí	2	10	desi	2	309	319	9043
detallarà	2	282	detallara	2	2	284	9044
detallà	2	58	detalla	2	5038	5096	9045
detallàrem	2	2	detallarem	2	231	233	9046
detallés	2	23	detalles	2	207	230	9047
detallí	2	0	detalli	2	291	291	9048
detectarà	2	200	detectara	2	13	213	9049
detectà	2	132	detecta	2	5070	5202	9050
detectàrem	2	8	detectarem	2	56	64	9051
detectàreu	2	0	detectareu	2	13	13	9052
detectés	2	253	detectes	2	148	401	9053
detectí	2	0	detecti	2	829	829	9054
detenguí	2	0	detengui	2	5	5	9055
deteriorarà	2	50	deteriorara	2	0	50	9056
deteriorà	2	45	deteriora	2	536	581	9057
deterioràrem	2	0	deteriorarem	2	1	1	9058
deteriorés	2	35	deteriores	2	1	36	9059
deteriorí	2	0	deteriori	2	199	199	9060
determinarà	2	2573	determinara	2	22	2595	9061
determinà	2	442	determina	2	11323	11765	9062
determinàrem	2	3	determinarem	2	103	106	9063
determinàreu	2	0	determinareu	2	6	6	9064
determinés	2	155	determines	2	18	173	9065
determiní	2	0	determini	2	2749	2749	9066
detestarà	2	1	detestara	2	0	1	9067
detestà	2	2	detesta	2	252	254	9068
detestàrem	2	0	detestarem	2	1	1	9069
detestés	2	6	detestes	2	23	29	9070
detestí	2	0	detesti	2	13	13	9071
detindré	2	144	detindre	2	442	586	9072
detingués	2	97	detingues	2	14	111	9073
detinguí	2	1	detingui	2	293	294	9074
detonarà	2	5	detonara	2	0	5	9075
detonà	2	13	detona	2	48	61	9076
detonés	2	6	detones	2	0	6	9077
detoní	2	0	detoni	2	12	12	9078
detractés	2	2	detractes	2	0	2	9079
detrauré	2	0	detraure	2	15	15	9080
deturarà	2	15	deturara	2	0	15	9081
deturpà	2	0	deturpa	2	1	1	9082
deturà	2	53	detura	2	80	133	9083
deturàrem	2	0	deturarem	2	4	4	9084
deturés	2	7	detures	2	8	15	9085
deturí	2	1	deturi	2	18	19	9086
deuré	2	19	deure	4	14371	14390	9087
devaluarà	2	13	devaluara	2	0	13	9088
devaluà	2	3	devalua	2	167	170	9089
devaluàrem	2	0	devaluarem	2	2	2	9090
devalués	2	7	devalues	2	0	7	9091
devastarà	2	5	devastara	2	0	5	9092
devastà	2	74	devasta	2	59	133	9093
devastés	2	5	devastes	2	0	5	9094
devastí	2	0	devasti	2	6	6	9095
devorarà	2	38	devorara	2	1	39	9096
devorà	2	16	devora	7	1719	1735	9097
devoràrem	2	2	devorarem	2	6	8	9098
devoràreu	2	0	devorareu	2	2	2	9099
devorés	2	16	devores	2	17	33	9100
devorí	2	0	devori	2	39	39	9101
dextrinà	2	0	dextrina	4	16	16	9102
dextrinés	2	0	dextrines	4	17	17	9103
dextriní	2	0	dextrini	2	4	4	9104
deïficà	2	0	deïfica	2	9	9	9105
deïfiqués	2	1	deïfiques	2	0	1	9106
deïfiquí	2	0	deïfiqui	2	1	1	9107
diablejà	2	0	diableja	2	2	2	9108
diafragmà	2	0	diafragma	4	1194	1194	9109
diafragmés	2	0	diafragmes	4	82	82	9110
diagnosticarà	2	24	diagnosticara	2	1	25	9111
diagnosticà	2	30	diagnostica	2	760	790	9112
diagnostiqués	2	22	diagnostiques	2	41	63	9113
diagnostiquí	2	0	diagnostiqui	2	78	78	9114
diagnòstic	0	20437	diagnostic	2	233	20670	9115
diagnòstica	0	994	diagnostica	2	760	1754	9116
diagnòstiques	0	1070	diagnostiques	2	41	1111	9117
diagonalitzà	2	0	diagonalitza	2	2	2	9118
diagramà	2	0	diagrama	4	3101	3101	9119
diagramés	2	0	diagrames	4	1612	1612	9120
dialitzà	2	0	dialitza	2	1	1	9121
dialitzàreu	2	1	dialitzareu	2	0	1	9122
dialogarà	2	101	dialogara	2	3	104	9123
dialogués	2	16	dialogues	2	61	77	9124
dialoguí	2	0	dialogui	2	131	131	9125
dialogà	2	6	dialoga	2	621	627	9126
dialogàrem	2	1	dialogarem	2	52	53	9127
diamantés	2	0	diamantes	2	88	88	9128
diapositivà	2	0	diapositiva	4	1078	1078	9129
diapositivés	2	0	diapositives	4	2312	2312	9130
dibuixarà	2	332	dibuixara	2	6	338	9131
dibuixà	2	182	dibuixa	2	5749	5931	9132
dibuixàrem	2	12	dibuixarem	2	295	307	9133
dibuixàreu	2	0	dibuixareu	2	12	12	9134
dibuixés	2	95	dibuixes	2	166	261	9135
dibuixí	2	2	dibuixi	2	244	246	9136
dicotomitzà	2	0	dicotomitza	2	2	2	9137
dictaminarà	2	89	dictaminara	2	4	93	9138
dictaminà	2	93	dictamina	2	397	490	9139
dictaminés	2	65	dictamines	2	2	67	9140
dictaminí	2	0	dictamini	2	154	154	9141
dictarà	2	395	dictara	2	15	410	9142
dictà	2	243	dicta	2	1989	2232	9143
dictàrem	2	0	dictarem	2	5	5	9144
dictàreu	2	0	dictareu	2	2	2	9145
dictés	2	163	dictes	2	18	181	9146
dictí	2	1	dicti	2	733	734	9147
difamarà	2	1	difamara	2	1	2	9148
difamà	2	2	difama	2	48	50	9149
difamés	2	0	difames	2	2	2	9150
difamí	2	0	difami	2	12	12	9151
diferenciarà	2	106	diferenciara	2	2	108	9152
diferencià	2	31	diferencia	2	8014	8045	9153
diferenciàrem	2	0	diferenciarem	2	53	53	9154
diferenciàreu	2	0	diferenciareu	2	3	3	9155
diferenciés	2	56	diferencies	2	1321	1377	9156
diferencií	2	10	diferencii	2	11	21	9157
diferirà	2	45	diferira	2	0	45	9158
diferència	4	69244	diferencia	2	8014	77258	9159
diferències	4	36612	diferencies	2	1321	37933	9160
diferírem	2	0	diferirem	2	3	3	9161
dificultarà	2	365	dificultara	2	2	367	9162
dificultà	2	58	dificulta	2	4756	4814	9163
dificultàrem	2	0	dificultarem	2	2	2	9164
dificultàreu	2	0	dificultareu	2	1	1	9165
dificultés	2	31	dificultes	2	10	41	9166
dificultí	2	0	dificulti	2	321	321	9167
difondré	2	12	difondre	2	22905	22917	9168
difongués	2	87	difongues	2	2	89	9169
difonguí	2	0	difongui	2	330	330	9170
difractarà	2	1	difractara	2	0	1	9171
difractà	2	0	difracta	2	13	13	9172
diftongarà	2	1	diftongara	2	0	1	9173
diftongà	2	0	diftonga	2	3	3	9174
difuminarà	2	19	difuminara	2	1	20	9175
difuminà	2	5	difumina	2	470	475	9176
difuminàrem	2	0	difuminarem	2	1	1	9177
difuminés	2	8	difumines	2	2	10	9178
difuminí	2	0	difumini	2	34	34	9179
digerirà	2	3	digerira	2	0	3	9180
digerírem	2	0	digerirem	2	3	3	9181
digitalitzarà	2	37	digitalitzara	2	0	37	9182
digitalitzà	2	2	digitalitza	2	167	169	9183
digitalitzàrem	2	0	digitalitzarem	2	7	7	9184
digitalitzés	2	2	digitalitzes	2	1	3	9185
digitalitzí	2	0	digitalitzi	2	7	7	9186
digità	2	0	digita	2	16	16	9187
digití	2	0	digiti	2	5	5	9188
dignarà	2	8	dignara	2	0	8	9189
dignificarà	2	58	dignificara	2	4	62	9190
dignificà	2	6	dignifica	2	451	457	9191
dignificàrem	2	0	dignificarem	2	7	7	9192
dignifiqués	2	18	dignifiques	2	3	21	9193
dignifiquí	2	0	dignifiqui	2	98	98	9194
dignà	2	13	digna	4	8817	8830	9195
dignàreu	2	0	dignareu	2	2	2	9196
dignés	2	29	dignes	4	7340	7369	9197
digní	2	0	digni	2	81	81	9198
digués	2	3610	digues	2	2276	5886	9199
diguí	2	67	digui	2	15238	15305	9200
dilapidarà	2	1	dilapidara	2	0	1	9201
dilapidà	2	17	dilapida	2	62	79	9202
dilapidàrem	2	0	dilapidarem	2	1	1	9203
dilapidés	2	2	dilapides	2	0	2	9204
dilapidí	2	0	dilapidi	2	8	8	9205
dilatarà	2	16	dilatara	2	0	16	9206
dilatà	2	3	dilata	2	318	321	9207
dilatàrem	2	0	dilatarem	2	1	1	9208
dilatés	2	8	dilates	2	7	15	9209
dilatí	2	1	dilati	2	56	57	9210
diligenciarà	2	4	diligenciara	2	0	4	9211
diligencià	2	0	diligencia	2	74	74	9212
diligenciés	2	0	diligencies	2	48	48	9213
diligencií	2	0	diligencii	2	1	1	9214
diligència	4	2976	diligencia	2	74	3050	9215
diligències	4	2992	diligencies	2	48	3040	9216
dilucidarà	2	4	dilucidara	2	1	5	9217
dilucidà	2	4	dilucida	2	21	25	9218
dilucidàrem	2	0	dilucidarem	2	1	1	9219
dilucidàreu	2	0	dilucidareu	2	1	1	9220
dilucidés	2	1	dilucides	2	0	1	9221
dilucidí	2	1	dilucidi	2	13	14	9222
diluvià	2	2	diluvia	2	10	12	9223
diluvií	2	0	diluvii	2	2	2	9224
diluvió	4	0	diluvio	2	141	141	9225
diluírem	2	0	diluirem	2	11	11	9226
dimanarà	2	1	dimanara	2	0	1	9227
dimanà	2	0	dimana	2	46	46	9228
dimanés	2	1	dimanes	2	0	1	9229
dimaní	2	0	dimani	2	6	6	9230
dimensionarà	2	7	dimensionara	2	0	7	9231
dimensionà	2	0	dimensiona	2	79	79	9232
dimensionàrem	2	1	dimensionarem	2	4	5	9233
dimensionés	2	1	dimensiones	2	96	97	9234
dimensioní	2	0	dimensioni	2	10	10	9235
dimeritzà	2	0	dimeritza	2	2	2	9236
dimeritzí	2	0	dimeritzi	2	1	1	9237
dimidià	2	0	dimidia	2	1	1	9238
dimitirà	2	147	dimitira	2	15	162	9239
dimitírem	2	0	dimitirem	2	7	7	9240
dinamitarà	2	6	dinamitara	2	0	6	9241
dinamitzarà	2	253	dinamitzara	2	2	255	9242
dinamitzà	2	11	dinamitza	2	811	822	9243
dinamitzàrem	2	0	dinamitzarem	2	40	40	9244
dinamitzés	2	11	dinamitzes	2	5	16	9245
dinamitzí	2	0	dinamitzi	2	109	109	9246
dinamità	2	14	dinamita	4	811	825	9247
dinamitàrem	2	0	dinamitarem	2	1	1	9248
dinamités	2	5	dinamites	4	13	18	9249
dinamití	2	0	dinamiti	2	14	14	9250
dinarà	2	84	dinara	2	20	104	9251
dindà	2	0	dinda	2	2	2	9252
dindí	2	0	dindi	2	868	868	9253
dinyà	2	0	dinya	2	6	6	9254
dinyàrem	2	0	dinyarem	2	1	1	9255
dinyés	2	0	dinyes	2	4	4	9256
dinyí	2	0	dinyi	2	4	4	9257
dinà	2	18	dina	4	644	662	9258
dinàrem	2	72	dinarem	2	844	916	9259
dinàreu	2	0	dinareu	2	29	29	9260
dinés	2	32	dines	4	157	189	9261
diní	2	11	dini	2	126	137	9262
diplomà	2	55	diploma	4	6954	7009	9263
diplomés	2	0	diplomes	4	3712	3712	9264
dipositarà	2	145	dipositara	2	2	147	9265
diposità	2	75	diposita	2	1029	1104	9266
dipositàrem	2	4	dipositarem	2	55	59	9267
dipositàreu	2	2	dipositareu	2	3	5	9268
dipositària	0	303	dipositaria	2	49	352	9269
dipositàries	0	98	dipositaries	2	4	102	9270
diposités	2	24	diposites	2	34	58	9271
diposití	2	0	dipositi	2	169	169	9272
diputarà	2	37	diputara	2	1	38	9273
diputà	2	4	diputa	2	21	25	9274
diputés	2	1	diputes	2	6	7	9275
diputí	2	0	diputi	2	1	1	9276
dipòsit	4	16545	diposit	2	186	16731	9277
dirigirà	2	2262	dirigira	2	39	2301	9278
dirigírem	2	93	dirigirem	2	1357	1450	9279
dirigíreu	2	0	dirigireu	2	39	39	9280
dirimirà	2	72	dirimira	2	0	72	9281
dirimírem	2	0	dirimirem	2	1	1	9282
disbauxà	2	0	disbauxa	4	1643	1643	9283
disbauxés	2	0	disbauxes	4	90	90	9284
disceptàrem	2	1	disceptarem	2	0	1	9285
discernirà	2	9	discernira	2	0	9	9286
disciplinarà	2	2	disciplinara	2	0	2	9287
disciplinà	2	3	disciplina	4	17841	17844	9288
disciplinària	0	683	disciplinaria	2	59	742	9289
disciplinàries	0	666	disciplinaries	2	19	685	9290
disciplinés	2	1	disciplines	4	15088	15089	9291
discipliní	2	0	disciplini	2	5	5	9292
discontinuà	2	5	discontinua	2	118	123	9293
discontinués	2	0	discontinues	2	37	37	9294
discontínua	0	394	discontinua	2	118	512	9295
discontínues	0	154	discontinues	2	37	191	9296
discordà	2	0	discorda	2	3	3	9297
discordés	2	0	discordes	2	2	2	9298
discordí	2	0	discordi	2	1	1	9299
discreparà	2	5	discrepara	2	1	6	9300
discrepà	2	6	discrepa	2	330	336	9301
discrepàrem	2	2	discreparem	2	13	15	9302
discrepàreu	2	0	discrepareu	2	1	1	9303
discrepés	2	12	discrepes	2	16	28	9304
discrepí	2	0	discrepi	2	71	71	9305
discretitzà	2	0	discretitza	2	2	2	9306
discriminarà	2	35	discriminara	2	3	38	9307
discriminà	2	6	discrimina	2	836	842	9308
discriminàrem	2	0	discriminarem	2	3	3	9309
discriminés	2	14	discrimines	2	3	17	9310
discriminí	2	0	discrimini	2	159	159	9311
disculparà	2	22	disculpara	2	2	24	9312
disculpà	2	23	disculpa	4	1656	1679	9313
disculpàrem	2	1	disculparem	2	4	5	9314
disculpàreu	2	0	disculpareu	2	96	96	9315
disculpés	2	37	disculpes	4	4797	4834	9316
disculpí	2	1	disculpi	2	653	654	9317
discursejà	2	0	discurseja	2	6	6	9318
discutirà	2	409	discutira	2	0	409	9319
discutírem	2	13	discutirem	2	393	406	9320
discutíreu	2	0	discutireu	2	6	6	9321
disfressarà	2	22	disfressara	2	1	23	9322
disfressà	2	21	disfressa	4	4012	4033	9323
disfressàrem	2	8	disfressarem	2	42	50	9324
disfressàreu	2	0	disfressareu	2	6	6	9325
disfressés	2	10	disfresses	4	5398	5408	9326
disfressí	2	0	disfressi	2	65	65	9327
disfrutarà	2	63	disfrutara	2	9	72	9328
disfrutà	2	3	disfruta	2	1036	1039	9329
disfrutàrem	2	15	disfrutarem	2	167	182	9330
disfrutàreu	2	2	disfrutareu	2	116	118	9331
disfrutés	2	23	disfrutes	2	146	169	9332
disfrutí	2	0	disfruti	2	146	146	9333
disgregarà	2	4	disgregara	2	0	4	9334
disgregués	2	1	disgregues	2	0	1	9335
disgreguí	2	0	disgregui	2	11	11	9336
disgregà	2	15	disgrega	2	45	60	9337
disgustarà	2	6	disgustara	2	0	6	9338
disgustà	2	29	disgusta	2	146	175	9339
disgustés	2	10	disgustes	2	1	11	9340
disgustí	2	0	disgusti	2	23	23	9341
dislocà	2	1	disloca	2	28	29	9342
dislocàrem	2	1	dislocarem	2	0	1	9343
disloqués	2	1	disloques	2	2	3	9344
disloquí	2	0	disloqui	2	1	1	9345
disminuírem	2	0	disminuirem	2	34	34	9346
disminuíreu	2	0	disminuireu	2	4	4	9347
dismutà	2	0	dismuta	2	1	1	9348
dismètria	4	0	dismetria	4	8	8	9349
dismètries	4	1	dismetries	4	6	7	9350
dispararà	2	275	disparara	2	9	284	9351
disparà	2	268	dispara	2	2531	2799	9352
disparàrem	2	1	dispararem	2	11	12	9353
disparàreu	2	0	disparareu	2	2	2	9354
disparés	2	138	dispares	2	57	195	9355
disparí	2	0	dispari	2	221	221	9356
dispensarà	2	36	dispensara	2	2	38	9357
dispensà	2	21	dispensa	4	692	713	9358
dispensàrem	2	0	dispensarem	2	2	2	9359
dispensàreu	2	0	dispensareu	2	4	4	9360
dispensés	2	5	dispenses	4	79	84	9361
dispensí	2	0	dispensi	2	94	94	9362
dispersarà	2	19	dispersara	2	2	21	9363
dispersà	2	51	dispersa	0	1770	1821	9364
dispersàrem	2	1	dispersarem	2	5	6	9365
dispersàreu	2	0	dispersareu	2	1	1	9366
dispersés	2	25	disperses	0	1540	1565	9367
dispersí	2	0	dispersi	2	58	58	9368
disposarà	2	4847	disposara	2	28	4875	9369
disposà	2	412	disposa	2	70467	70879	9370
disposàrem	2	25	disposarem	2	1339	1364	9371
disposàreu	2	1	disposareu	2	458	459	9372
disposés	2	472	disposes	2	1737	2209	9373
disposí	2	0	disposi	2	5161	5161	9374
disputarà	2	6625	disputara	2	65	6690	9375
disputà	2	988	disputa	4	9746	10734	9376
disputàrem	2	1	disputarem	2	42	43	9377
disputés	2	98	disputes	4	3135	3233	9378
disputí	2	0	disputi	2	268	268	9379
disseccionarà	2	6	disseccionara	2	0	6	9380
disseccionà	2	0	dissecciona	2	221	221	9381
disseccionàrem	2	1	disseccionarem	2	2	3	9382
disseccionés	2	0	dissecciones	2	2	2	9383
disseccioní	2	0	disseccioni	2	1	1	9384
dissecà	2	0	disseca	2	16	16	9385
dissecàrem	2	1	dissecarem	2	0	1	9386
disseminarà	2	4	disseminara	2	0	4	9387
disseminà	2	2	dissemina	2	51	53	9388
disseminés	2	2	dissemines	2	0	2	9389
disseminí	2	0	dissemini	2	6	6	9390
dissentirà	2	0	dissentira	2	2	2	9391
dissentírem	2	0	dissentirem	2	1	1	9392
dissenyarà	2	361	dissenyara	2	4	365	9393
dissenyà	2	393	dissenya	2	2783	3176	9394
dissenyàrem	2	6	dissenyarem	2	281	287	9395
dissenyàreu	2	1	dissenyareu	2	8	9	9396
dissenyés	2	100	dissenyes	2	88	188	9397
dissenyí	2	1	dissenyi	2	231	232	9398
dissequés	2	0	disseques	2	1	1	9399
dissequí	2	0	dissequi	2	1	1	9400
dissertarà	2	65	dissertara	2	0	65	9401
dissertà	2	39	disserta	2	23	62	9402
dissertés	2	0	dissertes	2	1	1	9403
dissertí	2	0	disserti	2	1	1	9404
dissimularà	2	13	dissimulara	2	1	14	9405
dissimulà	2	3	dissimula	2	354	357	9406
dissimulàrem	2	0	dissimularem	2	8	8	9407
dissimulàreu	2	0	dissimulareu	2	1	1	9408
dissimulés	2	5	dissimules	2	14	19	9409
dissimulí	2	1	dissimuli	2	47	48	9410
dissiparà	2	34	dissipara	2	0	34	9411
dissipà	2	21	dissipa	2	216	237	9412
dissipàrem	2	0	dissiparem	2	1	1	9413
dissipés	2	13	dissipes	2	1	14	9414
dissipí	2	0	dissipi	2	57	57	9415
dissociarà	2	2	dissociara	2	0	2	9416
dissocià	2	1	dissocia	2	73	74	9417
dissociés	2	0	dissocies	2	1	1	9418
dissocií	2	0	dissocii	2	2	2	9419
dissoldré	2	3	dissoldre	2	3565	3568	9420
dissolgués	2	90	dissolgues	2	0	90	9421
dissolguí	2	0	dissolgui	2	224	224	9422
dissonà	2	0	dissona	2	5	5	9423
dissonés	2	1	dissones	2	0	1	9424
dissuadirà	2	26	dissuadira	2	0	26	9425
dissuadírem	2	0	dissuadirem	2	1	1	9426
dissímil	0	2	dissimil	2	1	3	9427
distanciarà	2	10	distanciara	2	1	11	9428
distancià	2	54	distancia	2	2778	2832	9429
distanciàrem	2	2	distanciarem	2	4	6	9430
distanciés	2	29	distancies	2	484	513	9431
distancií	2	0	distancii	2	3	3	9432
distarà	2	19	distara	2	0	19	9433
distendré	2	0	distendre	2	43	43	9434
distenguí	2	0	distengui	2	1	1	9435
distingirà	2	163	distingira	2	2	165	9436
distingírem	2	1	distingirem	2	91	92	9437
distingíreu	2	0	distingireu	2	13	13	9438
distorsionarà	2	29	distorsionara	2	1	30	9439
distorsionà	2	3	distorsiona	2	664	667	9440
distorsionàrem	2	1	distorsionarem	2	3	4	9441
distorsionés	2	9	distorsiones	2	11	20	9442
distorsioní	2	0	distorsioni	2	109	109	9443
distragués	2	35	distragues	2	1	36	9444
distraguí	2	1	distragui	2	1	2	9445
distrauré	2	10	distraure	2	151	161	9446
distribuírem	2	6	distribuirem	2	126	132	9447
distribuíreu	2	0	distribuireu	2	1	1	9448
distà	2	6	dista	2	1125	1131	9449
distància	4	50516	distancia	2	2778	53294	9450
distàncies	4	10616	distancies	2	484	11100	9451
distès	2	1585	distes	2	36	1621	9452
distén	2	5	disten	2	388	393	9453
distés	2	283	distes	2	36	319	9454
distí	2	1	disti	2	22	23	9455
distòpia	4	182	distopia	4	305	487	9456
distòpies	4	77	distopies	4	78	155	9457
ditejà	2	0	diteja	2	1	1	9458
dità	4	2	dita	2	13246	13248	9459
divagarà	2	2	divagara	2	0	2	9460
divagués	2	1	divagues	2	5	6	9461
divaguí	2	0	divagui	2	11	11	9462
divagà	2	0	divaga	2	96	96	9463
divagàrem	2	1	divagarem	2	4	5	9464
divergirà	2	7	divergira	2	1	8	9465
diversificarà	2	20	diversificara	2	1	21	9466
diversificà	2	27	diversifica	2	243	270	9467
diversificàrem	2	0	diversificarem	2	8	8	9468
diversifiqués	2	3	diversifiques	2	5	8	9469
diversifiquí	2	0	diversifiqui	2	46	46	9470
divertirà	2	97	divertira	2	2	99	9471
divertírem	2	6	divertirem	2	126	132	9472
divertíreu	2	0	divertireu	2	41	41	9473
dividirà	2	824	dividira	2	5	829	9474
dividírem	2	18	dividirem	2	222	240	9475
dividíreu	2	0	dividireu	2	5	5	9476
divinitzarà	2	1	divinitzara	2	0	1	9477
divinitzà	2	2	divinitza	2	18	20	9478
divinitzàrem	2	0	divinitzarem	2	1	1	9479
divinitzí	2	0	divinitzi	2	4	4	9480
divisarà	2	2	divisara	2	1	3	9481
divisà	2	7	divisa	4	2156	2163	9482
divisàrem	2	3	divisarem	2	39	42	9483
divisàreu	2	0	divisareu	2	6	6	9484
divisés	2	2	divises	4	1802	1804	9485
divisí	2	0	divisi	2	54	54	9486
divorciarà	2	5	divorciara	2	3	8	9487
divorcià	2	95	divorcia	2	120	215	9488
divorciàrem	2	0	divorciarem	2	2	2	9489
divorciàreu	2	0	divorciareu	2	1	1	9490
divorciés	2	10	divorcies	2	3	13	9491
divulgarà	2	114	divulgara	2	2	116	9492
divulgués	2	24	divulgues	2	5	29	9493
divulguí	2	0	divulgui	2	73	73	9494
divulgà	2	51	divulga	2	524	575	9495
divulgàrem	2	0	divulgarem	2	27	27	9496
diègesi	4	6	diegesi	4	6	12	9497
doblarà	2	190	doblara	2	4	194	9498
doblegarà	2	43	doblegara	2	2	45	9499
doblegués	2	15	doblegues	2	20	35	9500
dobleguí	2	0	doblegui	2	70	70	9501
doblegà	2	9	doblega	2	403	412	9502
doblegàrem	2	1	doblegarem	2	38	39	9503
doblegàreu	2	0	doblegareu	2	2	2	9504
doblà	2	48	dobla	4	879	927	9505
doblàrem	2	2	doblarem	2	29	31	9506
doblàreu	2	0	doblareu	2	2	2	9507
doblària	4	0	doblaria	2	48	48	9508
doblés	2	30	dobles	4	12473	12503	9509
doblí	2	0	dobli	2	375	375	9510
dobló	4	11	doblo	2	22	33	9511
doctorà	2	602	doctora	4	8746	9348	9512
doctorés	2	2	doctores	4	328	330	9513
doctorí	2	0	doctori	2	2	2	9514
documentarà	2	52	documentara	2	1	53	9515
documentà	2	79	documenta	2	3239	3318	9516
documentàrem	2	1	documentarem	2	24	25	9517
documentària	0	8	documentaria	2	6	14	9518
documentàries	0	7	documentaries	2	7	14	9519
documentés	2	14	documentes	2	25	39	9520
documentí	2	0	documenti	2	77	77	9521
dodecàedre	4	69	dodecaedre	4	49	118	9522
dodecàedres	4	4	dodecaedres	4	6	10	9523
dogmatitzà	2	0	dogmatitza	2	6	6	9524
dolarà	2	0	dolara	2	3	3	9525
dolcejà	2	0	dolceja	2	6	6	9526
doldré	2	1	doldre	2	250	251	9527
dolgués	2	5	dolgues	2	0	5	9528
dolguí	2	0	dolgui	2	134	134	9529
dolorejà	2	0	doloreja	2	1	1	9530
dolà	2	0	dola	2	14	14	9531
dolés	2	1	doles	2	7	8	9532
dolí	2	2	doli	2	31	33	9533
domarà	2	2	domara	2	0	2	9534
domesticarà	2	3	domesticara	2	0	3	9535
domesticà	2	6	domestica	2	170	176	9536
domestiqués	2	3	domestiques	2	51	54	9537
domestiquí	2	0	domestiqui	2	5	5	9538
domiciliarà	2	25	domiciliara	2	0	25	9539
domicilià	2	7	domicilia	2	24	31	9540
domiciliàrem	2	0	domiciliarem	2	17	17	9541
domiciliàreu	2	1	domiciliareu	2	1	2	9542
domiciliària	0	2234	domiciliaria	2	214	2448	9543
domiciliàries	0	237	domiciliaries	2	17	254	9544
domiciliés	2	2	domicilies	2	5	7	9545
domicilií	2	2	domicilii	2	2	4	9546
dominarà	2	253	dominara	2	7	260	9547
dominicà	0	472	dominica	4	523	995	9548
dominiquès	0	0	dominiques	0	580	580	9549
dominiqués	0	0	dominiques	0	580	580	9550
dominà	2	226	domina	2	6691	6917	9551
dominàrem	2	1	dominarem	2	30	31	9552
dominàreu	2	0	dominareu	2	5	5	9553
dominés	2	100	domines	2	245	345	9554
dominí	2	6	domini	2	42664	42670	9555
dominó	4	397	domino	2	711	1108	9556
domà	2	4	doma	4	875	879	9557
domàreu	2	1	domareu	2	0	1	9558
domèstic	0	6387	domestic	2	233	6620	9559
domèstica	0	4602	domestica	2	170	4772	9560
domèstiques	0	2838	domestiques	2	51	2889	9561
domés	2	52	domes	4	48	100	9562
domí	2	36	domi	2	139	175	9563
domín	2	2	domin	2	21	23	9564
domínica	4	9	dominica	4	523	532	9565
domíniques	4	7	dominiques	0	580	587	9566
donarà	2	29295	donara	2	549	29844	9567
donà	2	8572	dona	4	183509	192081	9568
donàrem	2	136	donarem	2	6735	6871	9569
donàreu	2	69	donareu	2	262	331	9570
donés	2	4696	dones	4	238199	242895	9571
doní	2	36	doni	2	16605	16641	9572
dopà	2	0	dopa	4	23	23	9573
dopés	2	1	dopes	4	1	2	9574
dopí	2	0	dopi	2	3	3	9575
dormirà	2	197	dormira	2	8	205	9576
dormisquegés	2	1	dormisqueges	2	0	1	9577
dormisquejà	2	0	dormisqueja	2	7	7	9578
dormisquejàrem	2	0	dormisquejarem	2	1	1	9579
dormitarà	2	2	dormitara	2	0	2	9580
dormità	2	0	dormita	2	28	28	9581
dormités	2	1	dormites	2	1	2	9582
dormí	2	43	dormi	2	394	437	9583
dormírem	2	13	dormirem	2	408	421	9584
dormíreu	2	0	dormireu	2	65	65	9585
dormís	2	110	dormis	2	77	187	9586
dosificarà	2	8	dosificara	2	0	8	9587
dosificà	2	3	dosifica	2	126	129	9588
dosificàreu	2	0	dosificareu	2	1	1	9589
dosifiqués	2	1	dosifiques	2	4	5	9590
dosifiquí	2	0	dosifiqui	2	8	8	9591
dosà	2	0	dosa	2	49	49	9592
dosàrem	2	0	dosarem	2	1	1	9593
dosè	0	3	dose	2	21	24	9594
dosé	0	0	dose	2	21	21	9595
dosés	2	0	doses	2	10	10	9596
dosí	2	1	dosi	2	8009	8010	9597
dotarà	2	729	dotara	2	20	749	9598
dotorejarà	2	1	dotorejara	2	0	1	9599
dotzè	0	1003	dotze	3	29206	30209	9600
dotzé	0	44	dotze	3	29206	29250	9601
dotà	2	158	dota	2	2218	2376	9602
dotàrem	2	3	dotarem	2	99	102	9603
dotés	2	98	dotes	2	33	131	9604
dotí	2	0	doti	2	605	605	9605
dragarà	2	3	dragara	2	0	3	9606
drageà	2	0	dragea	4	2	2	9607
drageés	2	0	dragees	4	30	30	9608
dragués	2	1	dragues	4	60	61	9609
draguí	2	0	dragui	2	84	84	9610
dragà	2	2	draga	4	1179	1181	9611
dramatitzarà	2	3	dramatitzara	2	0	3	9612
dramatitzà	2	3	dramatitza	2	57	60	9613
dramatitzàrem	2	0	dramatitzarem	2	6	6	9614
dramatitzés	2	0	dramatitzes	2	1	1	9615
dramatitzí	2	0	dramatitzi	2	7	7	9616
drapés	2	0	drapes	2	9	9	9617
drecés	2	0	dreces	2	1	1	9618
drecí	2	0	dreci	2	1	1	9619
drenarà	2	8	drenara	2	0	8	9620
drenà	2	4	drena	2	372	376	9621
drenés	2	1	drenes	2	2	3	9622
drení	2	1	dreni	2	26	27	9623
dretanitzà	2	0	dretanitza	2	2	2	9624
dretà	0	502	dreta	0	94183	94685	9625
dreçarà	2	2	dreçara	2	0	2	9626
dreçà	2	10	dreça	2	216	226	9627
driblà	2	1	dribla	2	27	28	9628
driblés	2	2	dribles	2	0	2	9629
driblí	2	0	dribli	2	1	1	9630
dringarà	2	2	dringara	2	0	2	9631
dringués	2	1	dringues	2	1	2	9632
dringuí	2	0	dringui	2	2	2	9633
dringà	2	1	dringa	2	26	27	9634
drogarà	2	1	drogara	2	0	1	9635
drogués	2	5	drogues	4	18682	18687	9636
droguí	2	0	drogui	2	4	4	9637
drogà	2	2	droga	4	6274	6276	9638
dropà	2	0	dropa	4	28	28	9639
dropés	2	0	dropes	4	6	6	9640
dualitzà	2	0	dualitza	2	6	6	9641
dualitzés	2	1	dualitzes	2	0	1	9642
dualitzí	2	0	dualitzi	2	1	1	9643
duanà	2	0	duana	4	1860	1860	9644
duanés	2	0	duanes	4	1757	1757	9645
duaní	2	0	duani	2	1	1	9646
dubtarà	2	259	dubtara	2	8	267	9647
dubtà	2	214	dubta	2	3264	3478	9648
dubtàrem	2	8	dubtarem	2	100	108	9649
dubtàreu	2	1	dubtareu	2	9	10	9650
dubtés	2	79	dubtes	2	37385	37464	9651
dubtí	2	2	dubti	2	2249	2251	9652
dugués	2	647	dugues	2	177	824	9653
duguí	2	2	dugui	2	3502	3504	9654
dugés	2	7	duges	4	6	13	9655
dugí	2	0	dugi	2	122	122	9656
dujà	2	0	duja	4	2	2	9657
dujàrem	2	0	dujarem	2	1	1	9658
dulcificarà	2	1	dulcificara	2	0	1	9659
dulcificà	2	2	dulcifica	2	15	17	9660
dulcifiquí	2	0	dulcifiqui	2	2	2	9661
duplicarà	2	254	duplicara	2	1	255	9662
duplicà	2	25	duplica	2	1322	1347	9663
duplicàrem	2	0	duplicarem	2	21	21	9664
duplicàreu	2	0	duplicareu	2	1	1	9665
dupliqués	2	16	dupliques	2	5	21	9666
dupliquí	2	0	dupliqui	2	135	135	9667
durarà	2	4556	durara	2	56	4612	9668
durà	2	19298	dura	0	33393	52691	9669
duràrem	2	0	durarem	2	12	12	9670
duràreu	2	0	durareu	2	1	1	9671
duré	2	262	dure	2	313	575	9672
durés	2	344	dures	0	8280	8624	9673
durí	2	32	duri	2	3029	3061	9674
dutxarà	2	3	dutxara	2	0	3	9675
dutxà	2	5	dutxa	4	9940	9945	9676
dutxàrem	2	4	dutxarem	2	13	17	9677
dutxés	2	10	dutxes	4	3456	3466	9678
dutxí	2	0	dutxi	2	11	11	9679
dàrem	2	0	darem	2	66	66	9680
dàreu	2	1	dareu	2	4	5	9681
dènou	3	55	denou	3	149	204	9682
dènous	4	0	denous	4	1	1	9683
dèsset	3	173	desset	3	197	370	9684
déna	4	5	dena	4	144	149	9685
dénes	4	6	denes	4	400	406	9686
déus	4	9675	deus	4	3589	13264	9687
díades	4	6	diades	4	2446	2452	9688
díedre	4	207	diedre	0	677	884	9689
díedres	4	40	diedres	0	104	144	9690
dígit	4	574	digit	2	73	647	9691
dígnat	0	0	dignat	2	291	291	9692
dígnats	0	0	dignats	2	1	1	9693
dígraf	4	394	digraf	4	12	406	9694
dígrafs	4	180	digrafs	4	5	185	9695
dòlar	4	2883	dolar	2	144	3027	9696
dòmino	4	918	domino	2	711	1629	9697
dòric	0	277	doric	4	10	287	9698
dóna	2	124591	dona	4	183509	308100	9699
dóner	4	4	doner	0	23	27	9700
dóners	4	1	doners	0	5	6	9701
dónes	2	1241	dones	4	238199	239440	9702
dóngola	4	2	dongola	4	19	21	9703
dúplica	4	7	duplica	2	1322	1329	9704
dúpliques	4	5	dupliques	2	5	10	9705
eclipsarà	2	22	eclipsara	2	0	22	9706
eclipsà	2	24	eclipsa	2	224	248	9707
eclipsés	2	16	eclipses	2	37	53	9708
eclipsí	2	0	eclipsi	2	2140	2140	9709
economitzà	2	0	economitza	2	27	27	9710
economitzés	2	1	economitzes	2	1	2	9711
economitzí	2	0	economitzi	2	14	14	9712
edetà	0	106	edeta	4	169	275	9713
edificarà	2	47	edificara	2	1	48	9714
edificà	2	314	edifica	2	249	563	9715
edificàrem	2	0	edificarem	2	9	9	9716
edificàreu	2	0	edificareu	2	1	1	9717
edifiqués	2	29	edifiques	2	4	33	9718
edifiquí	2	0	edifiqui	2	50	50	9719
editarà	2	783	editara	2	8	791	9720
edità	2	987	edita	4	7912	8899	9721
editàrem	2	9	editarem	2	111	120	9722
editàreu	2	0	editareu	2	6	6	9723
edités	2	55	edites	4	58	113	9724
edití	2	0	editi	2	173	173	9725
educarà	2	44	educara	2	3	47	9726
educà	2	98	educa	2	2408	2506	9727
educàrem	2	3	educarem	2	23	26	9728
educàreu	2	0	educareu	2	3	3	9729
edulcorà	2	0	edulcora	2	20	20	9730
edulcorí	2	0	edulcori	2	2	2	9731
eduqués	2	35	eduques	2	37	72	9732
eduquí	2	2	eduqui	2	154	156	9733
efectuarà	2	1803	efectuara	2	10	1813	9734
efectuà	2	286	efectua	2	2565	2851	9735
efectuàrem	2	4	efectuarem	2	79	83	9736
efectuàreu	2	0	efectuareu	2	2	2	9737
efectués	2	91	efectues	2	16	107	9738
efeminàreu	2	1	efeminareu	2	0	1	9739
efigiés	2	0	efigies	2	13	13	9740
efígie	4	340	efigie	2	33	373	9741
efígies	4	94	efigies	2	13	107	9742
eguinà	2	0	eguina	2	4	4	9743
eimèria	4	0	eimeria	4	7	7	9744
eixalàrem	2	0	eixalarem	2	1	1	9745
eixamenà	2	0	eixamena	2	3	3	9746
eixamenàreu	2	2	eixamenareu	2	0	2	9747
eixamorà	2	0	eixamora	2	10	10	9748
eixamorí	2	0	eixamori	2	1	1	9749
eixamplarà	2	64	eixamplara	2	1	65	9750
eixamplà	2	64	eixampla	4	1054	1118	9751
eixamplàrem	2	1	eixamplarem	2	28	29	9752
eixamplés	2	14	eixamples	4	200	214	9753
eixamplí	2	0	eixampli	2	73	73	9754
eixamés	2	0	eixames	2	1	1	9755
eixamí	2	1	eixami	2	0	1	9756
eixancà	2	0	eixanca	2	3	3	9757
eixanqués	2	0	eixanques	2	1	1	9758
eixanquí	2	0	eixanqui	2	1	1	9759
eixarmentàreu	2	0	eixarmentareu	2	1	1	9760
eixarmà	2	1	eixarma	2	1	2	9761
eixarmí	2	0	eixarmi	2	1	1	9762
eixarrancà	2	0	eixarranca	2	13	13	9763
eixarranqués	2	1	eixarranques	2	1	2	9764
eixatà	2	0	eixata	2	1	1	9765
eixaugarà	2	1	eixaugara	2	0	1	9766
eixauguí	2	1	eixaugui	2	0	1	9767
eixermà	2	0	eixerma	2	6	6	9768
eixermés	2	0	eixermes	2	2	2	9769
eixirà	2	981	eixira	2	94	1075	9770
eixivernà	2	0	eixiverna	2	1	1	9771
eixonà	2	0	eixona	2	1	1	9772
eixoní	2	1	eixoni	2	0	1	9773
eixorbà	2	2	eixorba	2	3	5	9774
eixordarà	2	1	eixordara	2	0	1	9775
eixordà	2	0	eixorda	2	15	15	9776
eixordí	2	5	eixordi	2	3	8	9777
eixugarà	2	56	eixugara	2	4	60	9778
eixugués	2	31	eixugues	2	7	38	9779
eixuguí	2	0	eixugui	2	81	81	9780
eixugà	2	33	eixuga	2	309	342	9781
eixugàrem	2	0	eixugarem	2	21	21	9782
eixugàreu	2	0	eixugareu	2	4	4	9783
eixugó	4	0	eixugo	2	61	61	9784
eixírem	2	46	eixirem	2	382	428	9785
eixíreu	2	2	eixireu	2	17	19	9786
ejacularà	2	2	ejaculara	2	1	3	9787
ejaculà	2	2	ejacula	2	37	39	9788
ejaculés	2	1	ejacules	2	2	3	9789
ejaculí	2	0	ejaculi	2	8	8	9790
ejectà	2	2	ejecta	2	14	16	9791
elaborarà	2	1603	elaborara	2	13	1616	9792
elaborà	2	430	elabora	2	8132	8562	9793
elaboràrem	2	21	elaborarem	2	590	611	9794
elaboràreu	2	1	elaborareu	2	15	16	9795
elaborés	2	234	elabores	2	32	266	9796
elaborí	2	1	elabori	2	1261	1262	9797
electrificarà	2	7	electrificara	2	0	7	9798
electrificà	2	7	electrifica	2	22	29	9799
electritzarà	2	1	electritzara	2	0	1	9800
electritzà	2	3	electritza	2	11	14	9801
electritzés	2	0	electritzes	2	1	1	9802
electrocutà	2	0	electrocuta	2	12	12	9803
electrocutés	2	2	electrocutes	2	1	3	9804
electrocutí	2	0	electrocuti	2	1	1	9805
electrolitzà	2	0	electrolitza	2	4	4	9806
elegirà	2	229	elegira	2	9	238	9807
elegírem	2	8	elegirem	2	39	47	9808
elegíreu	2	3	elegireu	2	1	4	9809
elevarà	2	559	elevara	2	7	566	9810
elevà	2	154	eleva	2	3604	3758	9811
elevàrem	2	0	elevarem	2	33	33	9812
elevàreu	2	0	elevareu	2	1	1	9813
elevés	2	61	eleves	2	20	81	9814
eleví	2	0	elevi	2	263	263	9815
elevó	4	2	elevo	2	28	30	9816
elidirà	2	1	elidira	2	0	1	9817
eliminarà	2	1184	eliminara	2	22	1206	9818
eliminà	2	200	elimina	2	8071	8271	9819
eliminàrem	2	3	eliminarem	2	231	234	9820
eliminàreu	2	0	eliminareu	2	17	17	9821
eliminés	2	204	elimines	2	122	326	9822
eliminí	2	0	elimini	2	977	977	9823
elogiarà	2	6	elogiara	2	0	6	9824
elogià	2	74	elogia	2	510	584	9825
elogiés	2	9	elogies	2	7	16	9826
elogií	2	0	elogii	2	1	1	9827
elucidà	2	3	elucida	2	4	7	9828
elucidí	2	0	elucidi	2	1	1	9829
elucubrarà	2	1	elucubrara	2	1	2	9830
elucubrà	2	1	elucubra	2	12	13	9831
eludirà	2	14	eludira	2	0	14	9832
eludírem	2	0	eludirem	2	11	11	9833
emanarà	2	10	emanara	2	0	10	9834
emanciparà	2	4	emancipara	2	0	4	9835
emancipà	2	8	emancipa	2	37	45	9836
emancipàrem	2	0	emanciparem	2	3	3	9837
emancipés	2	4	emancipes	2	0	4	9838
emancipí	2	0	emancipi	2	23	23	9839
emanà	2	18	emana	2	1301	1319	9840
emanés	2	9	emanes	2	3	12	9841
emaní	2	0	emani	2	78	78	9842
emasculàreu	2	1	emasculareu	2	0	1	9843
embadalirà	2	4	embadalira	2	0	4	9844
embadinà	2	0	embadina	2	1	1	9845
embadocà	2	0	embadoca	2	2	2	9846
embadoqués	2	0	embadoques	2	2	2	9847
embafarà	2	1	embafara	2	0	1	9848
embafà	2	0	embafa	2	84	84	9849
embafés	2	2	embafes	2	1	3	9850
embafí	2	0	embafi	2	7	7	9851
embagularà	2	0	embagulara	2	1	1	9852
embagués	2	1	embagues	2	0	1	9853
embalarà	2	3	embalara	2	0	3	9854
embalatgés	2	0	embalatges	4	955	955	9855
embalbí	2	1	embalbi	2	0	1	9856
embalcarà	2	1	embalcara	2	0	1	9857
embaldraguí	2	0	embaldragui	2	1	1	9858
emballestà	2	5	emballesta	2	0	5	9859
embalquí	2	0	embalqui	2	1	1	9860
embalsamà	2	2	embalsama	2	9	11	9861
embalsamàrem	2	1	embalsamarem	2	0	1	9862
embalsamés	2	0	embalsames	2	1	1	9863
embalà	2	2	embala	2	54	56	9864
embalàrem	2	0	embalarem	2	2	2	9865
embalés	2	1	embales	2	3	4	9866
embalí	2	0	embali	2	11	11	9867
embanderà	2	0	embandera	2	1	1	9868
embarassarà	2	1	embarassara	2	0	1	9869
embarassà	2	1	embarassa	2	21	22	9870
embarassàrem	2	1	embarassarem	2	0	1	9871
embarassés	2	3	embarasses	2	4	7	9872
embarassí	2	0	embarassi	2	2	2	9873
embarbussà	2	1	embarbussa	2	15	16	9874
embarbussés	2	1	embarbusses	2	1	2	9875
embarbussí	2	0	embarbussi	2	2	2	9876
embarcarà	2	82	embarcara	2	1	83	9877
embarcà	2	325	embarca	2	698	1023	9878
embarcàrem	2	10	embarcarem	2	162	172	9879
embarcàreu	2	0	embarcareu	2	10	10	9880
embardissà	2	1	embardissa	2	2	3	9881
embardissàrem	2	0	embardissarem	2	1	1	9882
embardissí	2	0	embardissi	2	1	1	9883
embargarà	2	10	embargara	2	0	10	9884
embargués	2	4	embargues	2	0	4	9885
embarguí	2	0	embargui	2	12	12	9886
embargà	2	5	embarga	2	104	109	9887
embargàrem	2	0	embargarem	2	2	2	9888
embarnillés	2	0	embarnilles	2	1	1	9889
embarqués	2	30	embarques	2	28	58	9890
embarquí	2	0	embarqui	2	206	206	9891
embarracà	2	0	embarraca	2	180	180	9892
embarrancarà	2	1	embarrancara	2	0	1	9893
embarrancà	2	11	embarranca	2	17	28	9894
embarrancàrem	2	0	embarrancarem	2	1	1	9895
embarranqués	2	3	embarranques	2	0	3	9896
embarranquí	2	0	embarranqui	2	7	7	9897
embarranquín	2	0	embarranquin	2	3	3	9898
embarrellàrem	2	1	embarrellarem	2	0	1	9899
embarreràreu	2	0	embarrerareu	2	1	1	9900
embarrilà	2	0	embarrila	2	1	1	9901
embarrà	2	0	embarra	2	4	4	9902
embassà	2	0	embassa	2	91	91	9903
embastarà	2	1	embastara	2	0	1	9904
embastà	2	1	embasta	4	32	33	9905
embastàrem	2	0	embastarem	2	1	1	9906
embastés	2	1	embastes	4	7	8	9907
embastí	2	0	embasti	2	3	3	9908
embegués	2	1	embegues	2	0	1	9909
embeguí	2	0	embegui	2	4	4	9910
embeinà	2	1	embeina	2	4	5	9911
embeinés	2	1	embeines	2	0	1	9912
embellirà	2	21	embellira	2	0	21	9913
embellírem	2	0	embellirem	2	4	4	9914
embenarà	2	2	embenara	2	0	2	9915
embenà	2	7	embena	2	33	40	9916
embenàrem	2	0	embenarem	2	1	1	9917
embenés	2	0	embenes	2	2	2	9918
embení	2	0	embeni	2	161	161	9919
embeuré	2	0	embeure	2	15	15	9920
emblanquinarà	2	2	emblanquinara	2	0	2	9921
emblanquinà	2	3	emblanquina	2	26	29	9922
emblanquinés	2	3	emblanquines	2	0	3	9923
emblà	2	0	embla	2	38	38	9924
emblés	2	0	embles	2	1	1	9925
embocà	2	1	emboca	2	8	9	9926
embocàrem	2	0	embocarem	2	1	1	9927
embocàreu	2	0	embocareu	2	1	1	9928
embogarà	2	1	embogara	2	0	1	9929
embogirà	2	3	embogira	2	0	3	9930
embogíreu	2	0	embogireu	2	1	1	9931
emboirà	2	4	emboira	2	54	58	9932
emboirés	2	5	emboires	2	0	5	9933
emboirí	2	0	emboiri	2	3	3	9934
embolarà	2	19	embolara	2	0	19	9935
embolcallarà	2	24	embolcallara	2	0	24	9936
embolcallà	2	37	embolcalla	2	804	841	9937
embolcallàrem	2	0	embolcallarem	2	8	8	9938
embolcallés	2	13	embolcalles	2	9	22	9939
embolcallí	2	0	embolcalli	2	35	35	9940
embolcarà	2	1	embolcara	2	0	1	9941
embolcà	2	1	embolca	2	8	9	9942
embolicarà	2	35	embolicara	2	0	35	9943
embolicà	2	26	embolica	2	1016	1042	9944
embolicàrem	2	2	embolicarem	2	55	57	9945
embolicàreu	2	0	embolicareu	2	4	4	9946
emboliqués	2	20	emboliques	2	43	63	9947
emboliquí	2	0	emboliqui	2	67	67	9948
embolà	2	9	embola	2	4	13	9949
embolàrem	2	1	embolarem	2	1	2	9950
embolí	2	0	emboli	2	6	6	9951
embonà	2	0	embona	2	1	1	9952
emboqués	2	0	emboques	2	1	1	9953
emboquí	2	0	emboqui	2	1	1	9954
emborbollí	2	0	emborbolli	2	1	1	9955
embornà	2	0	emborna	2	3	3	9956
emborrascà	2	0	emborrasca	2	1	1	9957
emborrassarà	2	1	emborrassara	2	0	1	9958
emborrassà	2	0	emborrassa	2	1	1	9959
emborrassés	2	1	emborrasses	2	0	1	9960
emborratxarà	2	1	emborratxara	2	0	1	9961
emborratxà	2	6	emborratxa	2	106	112	9962
emborratxàrem	2	0	emborratxarem	2	3	3	9963
emborratxàreu	2	0	emborratxareu	2	3	3	9964
emborratxés	2	4	emborratxes	2	2	6	9965
emborratxí	2	0	emborratxi	2	12	12	9966
emborrossí	2	1	emborrossi	2	0	1	9967
emborrà	2	0	emborra	2	1	1	9968
emborsà	2	0	emborsa	2	1	1	9969
emboscà	2	5	embosca	4	12	17	9970
embossà	2	0	embossa	2	13	13	9971
embossàreu	2	0	embossareu	2	1	1	9972
embossés	2	1	embosses	2	0	1	9973
embossí	2	0	embossi	2	2	2	9974
embotellarà	2	3	embotellara	2	0	3	9975
embotellà	2	0	embotella	2	150	150	9976
embotellàrem	2	0	embotellarem	2	6	6	9977
embotellés	2	0	embotelles	2	2	2	9978
embotellí	2	0	embotelli	2	2	2	9979
embotifarrà	2	0	embotifarra	2	1	1	9980
embotinà	2	0	embotina	2	1	1	9981
embotonà	2	0	embotona	2	4	4	9982
embotonés	2	0	embotones	2	1	1	9983
embotornà	2	1	embotorna	2	0	1	9984
embotxà	2	0	embotxa	2	1	1	9985
embotxés	2	0	embotxes	2	1	1	9986
embotà	2	0	embota	2	9	9	9987
embotés	2	1	embotes	2	0	1	9988
embotí	2	2	emboti	2	1	3	9989
embotírem	2	0	embotirem	2	4	4	9990
embotís	2	3	embotis	2	16	19	9991
embovà	2	0	embova	2	1	1	9992
emboçà	2	0	emboça	2	2	2	9993
embragués	2	0	embragues	2	4	4	9994
embragà	2	0	embraga	2	1	1	9995
embrancarà	2	1	embrancara	2	0	1	9996
embrancà	2	3	embranca	2	82	85	9997
embrancàrem	2	1	embrancarem	2	0	1	9998
embranqués	2	5	embranques	2	2	7	9999
embranquí	2	0	embranqui	2	9	9	10000
embriagarà	2	7	embriagara	2	0	7	10001
embriagués	2	1	embriagues	0	4	5	10002
embriaguí	2	0	embriagui	2	6	6	10003
embriagà	2	2	embriaga	0	127	129	10004
embriagàrem	2	0	embriagarem	2	1	1	10005
embridà	2	0	embrida	2	1	1	10006
embridí	2	0	embridi	2	1	1	10007
embrocà	2	0	embroca	2	1	1	10008
embrollà	2	0	embrolla	4	22	22	10009
embrollés	2	0	embrolles	4	1	1	10010
embromà	2	0	embroma	2	1	1	10011
embroqués	2	0	embroques	2	1	1	10012
embrossà	2	0	embrossa	2	13	13	10013
embrossí	2	1	embrossi	2	0	1	10014
embruixarà	2	4	embruixara	2	0	4	10015
embruixà	2	2	embruixa	2	114	116	10016
embruixés	2	1	embruixes	2	0	1	10017
embruixí	2	0	embruixi	2	2	2	10018
embrutarà	2	25	embrutara	2	3	28	10019
embrutà	2	5	embruta	2	577	582	10020
embrutàrem	2	1	embrutarem	2	19	20	10021
embrutàreu	2	0	embrutareu	2	5	5	10022
embrutés	2	24	embrutes	2	50	74	10023
embrutí	2	0	embruti	2	157	157	10024
embrutíreu	2	1	embrutireu	2	0	1	10025
embrutís	2	0	embrutis	2	16	16	10026
embuatarà	2	1	embuatara	2	1	2	10027
embuatà	2	0	embuata	2	1	1	10028
embuatés	2	0	embuates	2	1	1	10029
embullarà	2	3	embullara	2	0	3	10030
embullà	2	1	embulla	2	32	33	10031
embullàrem	2	1	embullarem	2	0	1	10032
embullés	2	0	embulles	2	1	1	10033
embullí	2	0	embulli	2	7	7	10034
embussarà	2	4	embussara	2	0	4	10035
embussà	2	1	embussa	2	34	35	10036
embussàrem	2	0	embussarem	2	1	1	10037
embussí	2	0	embussi	2	4	4	10038
embutxacarà	2	15	embutxacara	2	0	15	10039
embutxacà	2	12	embutxaca	2	84	96	10040
embutxacàreu	2	0	embutxacareu	2	1	1	10041
embutxaqués	2	3	embutxaques	2	1	4	10042
embutxaquí	2	0	embutxaqui	2	12	12	10043
embòlic	0	15	embolic	4	2823	2838	10044
embòlica	0	4	embolica	2	1016	1020	10045
embòlics	0	4	embolics	4	1316	1320	10046
embòliques	0	0	emboliques	2	43	43	10047
emergirà	2	83	emergira	2	1	84	10048
emetré	2	13	emetre	2	15091	15104	10049
emetés	2	275	emetes	2	2	277	10050
emetí	2	5	emeti	2	939	944	10051
emfasitzarà	2	3	emfasitzara	2	0	3	10052
emfasitzà	2	13	emfasitza	2	201	214	10053
emfasitzés	2	1	emfasitzes	2	0	1	10054
emfasitzí	2	0	emfasitzi	2	3	3	10055
emfatitzarà	2	12	emfatitzara	2	0	12	10056
emfatitzà	2	27	emfatitza	2	807	834	10057
emfatitzàrem	2	1	emfatitzarem	2	3	4	10058
emfatitzés	2	3	emfatitzes	2	3	6	10059
emfatitzí	2	0	emfatitzi	2	20	20	10060
emigrarà	2	12	emigrara	2	3	15	10061
emigrà	2	829	emigra	2	309	1138	10062
emigràrem	2	0	emigrarem	2	1	1	10063
emigrés	2	12	emigres	2	4	16	10064
emigrí	2	0	emigri	2	18	18	10065
emmagatzemarà	2	260	emmagatzemara	2	1	261	10066
emmagatzemà	2	6	emmagatzema	2	3378	3384	10067
emmagatzemàrem	2	0	emmagatzemarem	2	33	33	10068
emmagatzemàreu	2	0	emmagatzemareu	2	3	3	10069
emmagatzemés	2	8	emmagatzemes	2	25	33	10070
emmagatzemí	2	0	emmagatzemi	2	182	182	10071
emmainadés	2	0	emmainades	2	1	1	10072
emmalaltirà	2	7	emmalaltira	2	1	8	10073
emmalaltírem	2	0	emmalaltirem	2	1	1	10074
emmallà	2	0	emmalla	2	2	2	10075
emmanillarà	2	3	emmanillara	2	0	3	10076
emmanillà	2	1	emmanilla	2	28	29	10077
emmanillés	2	1	emmanilles	2	1	2	10078
emmanisés	2	0	emmanises	2	1	1	10079
emmarcarà	2	130	emmarcara	2	0	130	10080
emmarcà	2	62	emmarca	2	10885	10947	10081
emmarcàrem	2	1	emmarcarem	2	10	11	10082
emmaridà	2	4	emmarida	2	0	4	10083
emmarqués	2	10	emmarques	2	6	16	10084
emmarquí	2	0	emmarqui	2	102	102	10085
emmarà	2	0	emmara	2	3	3	10086
emmarí	2	0	emmari	2	1	1	10087
emmascararà	2	3	emmascarara	2	0	3	10088
emmascarà	2	6	emmascara	4	299	305	10089
emmascaràrem	2	0	emmascararem	2	1	1	10090
emmascarés	2	4	emmascares	4	1	5	10091
emmascarí	2	0	emmascari	2	27	27	10092
emmenarà	2	1	emmenara	2	1	2	10093
emmenà	2	11	emmena	2	23	34	10094
emmenés	2	1	emmenes	2	1	2	10095
emmení	2	1	emmeni	2	4	5	10096
emmerdarà	2	1	emmerdara	2	0	1	10097
emmerdà	2	0	emmerda	2	26	26	10098
emmerdés	2	0	emmerdes	2	2	2	10099
emmerdí	2	0	emmerdi	2	2	2	10100
emmerdís	2	0	emmerdis	2	4	4	10101
emmetxàrem	2	1	emmetxarem	2	0	1	10102
emmetzinà	2	10	emmetzina	2	17	27	10103
emmidonés	2	1	emmidones	2	0	1	10104
emmirallarà	2	2	emmirallara	2	1	3	10105
emmirallà	2	19	emmiralla	2	423	442	10106
emmirallàrem	2	0	emmirallarem	2	2	2	10107
emmirallés	2	7	emmiralles	2	8	15	10108
emmirallí	2	0	emmiralli	2	12	12	10109
emmordassà	2	0	emmordassa	2	35	35	10110
emmordassàreu	2	0	emmordassareu	2	1	1	10111
emmordassés	2	1	emmordasses	2	0	1	10112
emmordassí	2	0	emmordassi	2	5	5	10113
emmotllarà	2	5	emmotllara	2	0	5	10114
emmotllà	2	5	emmotlla	2	57	62	10115
emmotllàrem	2	0	emmotllarem	2	1	1	10116
emmotllés	2	3	emmotlles	2	1	4	10117
emmotllí	2	0	emmotlli	2	18	18	10118
emmotlà	2	0	emmotla	2	2	2	10119
emmudirà	2	5	emmudira	2	0	5	10120
emmudírem	2	0	emmudirem	2	1	1	10121
emmurallà	2	4	emmuralla	2	9	13	10122
emmurallés	2	2	emmuralles	2	0	2	10123
emmurriés	2	0	emmurries	2	1	1	10124
emmurés	2	3	emmures	2	0	3	10125
emmèn	2	0	emmen	4	24	24	10126
emocionarà	2	154	emocionara	2	6	160	10127
emocionà	2	49	emociona	2	2046	2095	10128
emocionàrem	2	1	emocionarem	2	30	31	10129
emocionàreu	2	0	emocionareu	2	33	33	10130
emocionés	2	20	emociones	2	226	246	10131
emocioní	2	0	emocioni	2	177	177	10132
empacà	2	0	empaca	2	88	88	10133
empadronarà	2	10	empadronara	2	0	10	10134
empadronà	2	3	empadrona	2	37	40	10135
empadronés	2	1	empadrones	2	2	3	10136
empadroní	2	0	empadroni	2	15	15	10137
empaitarà	2	12	empaitara	2	0	12	10138
empaità	2	7	empaita	2	159	166	10139
empaitàrem	2	0	empaitarem	2	2	2	10140
empaités	2	19	empaites	2	5	24	10141
empaití	2	0	empaiti	2	6	6	10142
empalarà	2	2	empalara	2	0	2	10143
empalleguí	2	0	empallegui	2	3	3	10144
empallegàreu	2	1	empallegareu	2	0	1	10145
empalmarà	2	3	empalmara	2	1	4	10146
empalmà	2	6	empalma	2	75	81	10147
empalmàrem	2	0	empalmarem	2	8	8	10148
empalmàreu	2	0	empalmareu	2	1	1	10149
empalmés	2	1	empalmes	2	20	21	10150
empalmí	2	0	empalmi	2	2	2	10151
empalomà	2	0	empaloma	2	1	1	10152
empalustrà	2	0	empalustra	2	1	1	10153
empalà	2	1	empala	2	5	6	10154
empalés	2	1	empales	2	1	2	10155
empalí	2	0	empali	2	1	1	10156
empantanegarà	2	1	empantanegara	2	0	1	10157
empantanegués	2	0	empantanegues	2	1	1	10158
empantaneguí	2	0	empantanegui	2	2	2	10159
empantanegà	2	0	empantanega	2	6	6	10160
empantanà	2	0	empantana	2	4	4	10161
empantanàrem	2	1	empantanarem	2	0	1	10162
empantanés	2	1	empantanes	2	0	1	10163
empantaní	2	0	empantani	2	1	1	10164
empanxonà	2	0	empanxona	2	1	1	10165
empanà	2	0	empana	2	5	5	10166
empanés	2	0	empanes	2	1	1	10167
empapatxarà	2	1	empapatxara	2	0	1	10168
empaperarà	2	2	empaperara	2	1	3	10169
empaperà	2	1	empapera	2	26	27	10170
empaperàrem	2	1	empaperarem	2	3	4	10171
empaperés	2	1	empaperes	2	1	2	10172
empaperí	2	1	empaperi	2	0	1	10173
empapussà	2	0	empapussa	2	2	2	10174
empapussés	2	0	empapusses	2	1	1	10175
empaquetarà	2	4	empaquetara	2	0	4	10176
empaquetà	2	3	empaqueta	2	97	100	10177
empaquetàrem	2	0	empaquetarem	2	6	6	10178
empaquetés	2	3	empaquetes	2	3	6	10179
empaquetí	2	0	empaqueti	2	4	4	10180
empaqués	2	0	empaques	2	1	1	10181
empararà	2	46	emparara	2	3	49	10182
emparaulà	2	0	emparaula	2	3	3	10183
emparaulés	2	0	emparaules	2	1	1	10184
emparedà	2	5	empareda	2	0	5	10185
emparellarà	2	2	emparellara	2	0	2	10186
emparellà	2	5	emparella	2	56	61	10187
emparellàrem	2	0	emparellarem	2	2	2	10188
emparellés	2	3	emparelles	2	1	4	10189
emparellí	2	0	emparelli	2	3	3	10190
emparentarà	2	1	emparentara	2	0	1	10191
emparentà	2	23	emparenta	2	167	190	10192
emparentàrem	2	0	emparentarem	2	1	1	10193
emparentés	2	4	emparentes	2	0	4	10194
emparentí	2	0	emparenti	2	1	1	10195
emparrà	2	0	emparra	2	13	13	10196
emparrés	2	1	emparres	2	0	1	10197
emparrí	2	0	emparri	2	3	3	10198
emparà	2	70	empara	4	5924	5994	10199
emparàrem	2	0	empararem	2	3	3	10200
emparés	2	31	empares	4	6	37	10201
emparí	2	0	empari	2	220	220	10202
empassarà	2	41	empassara	2	1	42	10203
empassegarà	2	1	empassegara	2	0	1	10204
empassegà	2	0	empassega	2	2	2	10205
empassolà	2	0	empassola	2	1	1	10206
empassolàrem	2	1	empassolarem	2	0	1	10207
empassolí	2	0	empassoli	2	2	2	10208
empassà	2	30	empassa	2	553	583	10209
empassàrem	2	0	empassarem	2	21	21	10210
empassàreu	2	1	empassareu	2	2	3	10211
empassés	2	43	empasses	2	69	112	10212
empassí	2	0	empassi	2	95	95	10213
empastarà	2	0	empastara	2	1	1	10214
empastifarà	2	5	empastifara	2	0	5	10215
empastifà	2	2	empastifa	2	107	109	10216
empastifàrem	2	0	empastifarem	2	3	3	10217
empastifàreu	2	0	empastifareu	2	2	2	10218
empastifés	2	1	empastifes	2	10	11	10219
empastifí	2	0	empastifi	2	10	10	10220
empastrarà	2	1	empastrara	2	0	1	10221
empastrà	2	6	empastra	2	10	16	10222
empastrés	2	0	empastres	2	18	18	10223
empastà	2	0	empasta	2	25	25	10224
empastàrem	2	0	empastarem	2	2	2	10225
empastés	2	2	empastes	2	14	16	10226
empastí	2	0	empasti	2	2	2	10227
empatarà	2	6	empatara	2	5	11	10228
empatitzarà	2	3	empatitzara	2	0	3	10229
empatitzà	2	0	empatitza	2	105	105	10230
empatitzàrem	2	0	empatitzarem	2	3	3	10231
empatitzés	2	3	empatitzes	2	21	24	10232
empatitzí	2	0	empatitzi	2	32	32	10233
empatollà	2	2	empatolla	2	23	25	10234
empatollés	2	1	empatolles	2	33	34	10235
empatollí	2	0	empatolli	2	2	2	10236
empatxà	2	0	empatxa	2	10	10	10237
empatxàrem	2	0	empatxarem	2	1	1	10238
empatxés	2	0	empatxes	2	2	2	10239
empatxí	2	0	empatxi	2	4	4	10240
empatxós	0	0	empatxos	4	23	23	10241
empatà	2	521	empata	2	730	1251	10242
empatàrem	2	2	empatarem	2	4	6	10243
empatés	2	37	empates	2	8	45	10244
empatí	2	1	empati	2	24	25	10245
empavesà	2	1	empavesa	2	0	1	10246
empebrà	2	0	empebra	2	9	9	10247
empebràrem	2	0	empebrarem	2	2	2	10248
empebrés	2	0	empebres	2	2	2	10249
empecadàrem	2	2	empecadarem	2	0	2	10250
empedrarà	2	1	empedrara	2	0	1	10251
empedrà	2	1	empedra	2	3	4	10252
empegarà	2	1	empegara	2	0	1	10253
empegués	2	0	empegues	2	2	2	10254
empeguí	2	0	empegui	2	2	2	10255
empegà	2	0	empega	2	14	14	10256
empelegà	2	0	empelega	2	1	1	10257
empeltarà	2	2	empeltara	2	1	3	10258
empeltà	2	5	empelta	2	90	95	10259
empeltàrem	2	0	empeltarem	2	2	2	10260
empeltés	2	3	empeltes	2	4	7	10261
empeltí	2	0	empelti	2	7	7	10262
empentarà	2	13	empentara	2	3	16	10263
empentà	2	15	empenta	4	9981	9996	10264
empentàreu	2	0	empentareu	2	1	1	10265
empentés	2	2	empentes	4	1019	1021	10266
empentí	2	0	empenti	2	18	18	10267
empentís	0	1	empentis	2	1	2	10268
empenyerà	2	72	empenyera	2	0	72	10269
empenyorarà	2	5	empenyorara	2	0	5	10270
empenyorà	2	24	empenyora	2	28	52	10271
empenyorés	2	1	empenyores	2	1	2	10272
empenyorí	2	0	empenyori	2	1	1	10273
empenyérem	2	0	empenyerem	2	13	13	10274
empenyés	2	64	empenyes	4	21	85	10275
empenyí	2	0	empenyi	2	202	202	10276
empenà	2	0	empena	2	3	3	10277
empenés	2	0	empenes	2	2	2	10278
emperlàrem	2	0	emperlarem	2	1	1	10279
empernà	2	0	emperna	2	2	2	10280
empesarà	2	1	empesara	2	0	1	10281
empescarà	2	14	empescara	2	0	14	10282
empescà	2	10	empesca	2	169	179	10283
empescàrem	2	0	empescarem	2	4	4	10284
empescàreu	2	0	empescareu	2	1	1	10285
empesqués	2	2	empesques	2	7	9	10286
empesquí	2	0	empesqui	2	6	6	10287
empestarà	2	1	empestara	2	0	1	10288
empestà	2	0	empesta	2	41	41	10289
empestés	2	0	empestes	2	2	2	10290
empesà	2	0	empesa	4	585	585	10291
empesàrem	2	0	empesarem	2	2	2	10292
empesàreu	2	1	empesareu	2	0	1	10293
empesés	2	0	empeses	4	291	291	10294
empetitirà	2	2	empetitira	2	0	2	10295
empinà	2	0	empina	2	23	23	10296
empiparà	2	7	empipara	2	0	7	10297
empipà	2	2	empipa	2	171	173	10298
empipàrem	2	0	empiparem	2	3	3	10299
empipàreu	2	0	empipareu	2	1	1	10300
empipés	2	3	empipes	2	6	9	10301
empipí	2	0	empipi	2	26	26	10302
empitjorarà	2	290	empitjorara	2	4	294	10303
empitjorà	2	99	empitjora	2	1188	1287	10304
empitjoràrem	2	0	empitjorarem	2	6	6	10305
empitjorés	2	26	empitjores	2	9	35	10306
empitjorí	2	0	empitjori	2	225	225	10307
emplacés	2	12	emplaces	2	4	16	10308
emplací	2	0	emplaci	2	32	32	10309
emplafoní	2	0	emplafoni	2	1	1	10310
emplastrés	2	0	emplastres	2	31	31	10311
emplatà	2	1	emplata	2	17	18	10312
emplatàrem	2	0	emplatarem	2	22	22	10313
emplatés	2	0	emplates	2	3	3	10314
emplaçarà	2	104	emplaçara	2	1	105	10315
emplaçà	2	38	emplaça	2	810	848	10316
emplaçàrem	2	1	emplaçarem	2	11	12	10317
emplenarà	2	110	emplenara	2	1	111	10318
emplenà	2	12	emplena	2	899	911	10319
emplenàrem	2	1	emplenarem	2	21	22	10320
emplenàreu	2	0	emplenareu	2	2	2	10321
emplenés	2	10	emplenes	2	34	44	10322
emplení	2	0	empleni	2	283	283	10323
emplomallà	2	0	emplomalla	2	1	1	10324
emplomà	2	0	emploma	2	2	2	10325
empobrirà	2	30	empobrira	2	1	31	10326
empobrírem	2	0	empobrirem	2	3	3	10327
empoderarà	2	4	empoderara	2	0	4	10328
empoderà	2	1	empodera	2	166	167	10329
empoderàrem	2	0	empoderarem	2	2	2	10330
empoderés	2	5	empoderes	2	6	11	10331
empoderí	2	0	empoderi	2	53	53	10332
empolainarà	2	2	empolainara	2	0	2	10333
empolainà	2	0	empolaina	2	11	11	10334
empolainàrem	2	1	empolainarem	2	1	2	10335
empolainés	2	0	empolaines	2	1	1	10336
empollà	2	0	empolla	2	9	9	10337
empollés	2	0	empolles	2	4	4	10338
empolsegà	2	1	empolsega	2	3	4	10339
empolsimà	2	0	empolsima	2	41	41	10340
empolsimàrem	2	0	empolsimarem	2	1	1	10341
empolsimés	2	0	empolsimes	2	1	1	10342
empolsimí	2	0	empolsimi	2	1	1	10343
empolsinà	2	0	empolsina	2	2	2	10344
empolsinàrem	2	0	empolsinarem	2	5	5	10345
empolsinàreu	2	0	empolsinareu	2	1	1	10346
empolsà	2	1	empolsa	2	36	37	10347
empolsàrem	2	0	empolsarem	2	16	16	10348
empolsín	2	0	empolsin	2	1	1	10349
empoltronirà	2	0	empoltronira	2	1	1	10350
empolvorà	2	0	empolvora	2	64	64	10351
empolvoràrem	2	0	empolvorarem	2	10	10	10352
empolvorés	2	0	empolvores	2	1	1	10353
empolvorí	2	0	empolvori	2	5	5	10354
empomà	2	2	empoma	2	9	11	10355
emporcà	2	1	emporca	2	0	1	10356
emporprarà	2	1	emporprara	2	0	1	10357
emporpràreu	2	1	emporprareu	2	0	1	10358
emportarà	2	560	emportara	2	18	578	10359
emportà	2	303	emporta	2	3285	3588	10360
emportàrem	2	7	emportarem	2	97	104	10361
emportàreu	2	0	emportareu	2	85	85	10362
emportés	2	228	emportes	2	338	566	10363
emportí	2	2	emporti	2	509	511	10364
emportín	2	0	emportin	2	317	317	10365
empostà	2	0	emposta	2	2	2	10366
empotarà	2	3	empotara	2	0	3	10367
empotà	2	0	empota	2	1	1	10368
empotàrem	2	0	empotarem	2	3	3	10369
empouà	2	1	empoua	2	1	2	10370
emprarà	2	553	emprara	2	8	561	10371
empremtarà	2	1	empremtara	2	0	1	10372
empremtà	2	0	empremta	4	6828	6828	10373
empremtés	2	0	empremtes	4	2741	2741	10374
emprendré	2	17	emprendre	2	13833	13850	10375
emprengués	2	109	emprengues	2	1	110	10376
emprenguí	2	4	emprengui	2	489	493	10377
emprenyarà	2	30	emprenyara	2	0	30	10378
emprenyà	2	8	emprenya	2	622	630	10379
emprenyàrem	2	0	emprenyarem	2	4	4	10380
emprenyàreu	2	0	emprenyareu	2	1	1	10381
emprenyés	2	18	emprenyes	2	22	40	10382
emprenyí	2	0	emprenyi	2	100	100	10383
empresonarà	2	8	empresonara	2	0	8	10384
empresonà	2	82	empresona	2	442	524	10385
empresonés	2	21	empresones	2	4	25	10386
empresoní	2	0	empresoni	2	43	43	10387
emprestà	2	0	empresta	2	2	2	10388
emprestés	2	0	emprestes	2	2	2	10389
emprovarà	2	1	emprovara	2	0	1	10390
emprovà	2	3	emprova	4	52	55	10391
emprovés	2	1	emproves	4	14	15	10392
emproví	2	0	emprovi	2	6	6	10393
emproà	2	0	emproa	2	4	4	10394
emproàrem	2	1	emproarem	2	0	1	10395
emprà	2	484	empra	2	5450	5934	10396
empràrem	2	6	emprarem	2	202	208	10397
empràreu	2	0	emprareu	2	15	15	10398
emprèn	2	2920	empren	2	3653	6573	10399
emprès	2	1951	empres	2	235	2186	10400
emprén	2	213	empren	2	3653	3866	10401
emprés	2	308	empres	2	235	543	10402
emprí	2	2	empri	2	447	449	10403
empudegà	2	0	empudega	2	24	24	10404
empunyarà	2	7	empunyara	2	0	7	10405
empunyà	2	6	empunya	2	73	79	10406
empunyàrem	2	0	empunyarem	2	1	1	10407
empunyés	2	4	empunyes	2	0	4	10408
empunyí	2	0	empunyi	2	1	1	10409
emularà	2	18	emulara	2	5	23	10410
emulsionarà	2	4	emulsionara	2	1	5	10411
emulsionà	2	0	emulsiona	2	37	37	10412
emulsionàrem	2	0	emulsionarem	2	6	6	10413
emulsionàreu	2	0	emulsionareu	2	1	1	10414
emulsionés	2	0	emulsiones	2	1	1	10415
emulsioní	2	0	emulsioni	2	31	31	10416
emulà	2	6	emula	2	259	265	10417
emulàrem	2	0	emularem	2	10	10	10418
emulàreu	2	0	emulareu	2	2	2	10419
emulés	2	5	emules	2	5	10	10420
emulí	2	0	emuli	2	21	21	10421
emès	2	9341	emes	4	159	9500	10422
emés	2	712	emes	4	159	871	10423
enaiguatejàreu	2	0	enaiguatejareu	2	1	1	10424
enaiguà	2	0	enaigua	2	4	4	10425
enaigüés	2	0	enaigües	2	2	2	10426
enaltirà	2	27	enaltira	2	0	27	10427
enaltírem	2	0	enaltirem	2	1	1	10428
enamorarà	2	276	enamorara	2	8	284	10429
enamoriscà	2	1	enamorisca	2	0	1	10430
enamorà	2	208	enamora	2	2836	3044	10431
enamoràrem	2	0	enamorarem	2	14	14	10432
enamoràreu	2	1	enamorareu	2	22	23	10433
enamorés	2	77	enamores	2	191	268	10434
enamorí	2	0	enamori	2	175	175	10435
enantà	2	0	enanta	2	3	3	10436
enantés	2	0	enantes	2	1	1	10437
enarborarà	2	1	enarborara	2	0	1	10438
enarborà	2	10	enarbora	2	96	106	10439
enarborí	2	0	enarbori	2	13	13	10440
enarcà	2	1	enarca	2	4	5	10441
enardirà	2	1	enardira	2	0	1	10442
enarqués	2	0	enarques	2	4	4	10443
enartés	2	0	enartes	2	3	3	10444
encabestrà	2	0	encabestra	2	1	1	10445
encabirà	2	35	encabira	2	0	35	10446
encaborià	2	1	encaboria	2	0	1	10447
encabotarà	2	0	encabotara	2	1	1	10448
encabotà	2	1	encabota	2	20	21	10449
encabotés	2	0	encabotes	2	3	3	10450
encabritarà	2	1	encabritara	2	0	1	10451
encabrità	2	6	encabrita	2	13	19	10452
encabritàrem	2	1	encabritarem	2	0	1	10453
encabrités	2	1	encabrites	2	1	2	10454
encabírem	2	0	encabirem	2	9	9	10455
encadellà	2	0	encadella	2	4	4	10456
encadellí	2	0	encadelli	2	1	1	10457
encadenarà	2	32	encadenara	2	1	33	10458
encadenà	2	23	encadena	2	926	949	10459
encadenàrem	2	0	encadenarem	2	6	6	10460
encadenés	2	9	encadenes	2	36	45	10461
encadení	2	0	encadeni	2	19	19	10462
encaixarà	2	93	encaixara	2	2	95	10463
encaixonarà	2	1	encaixonara	2	2	3	10464
encaixonà	2	1	encaixona	2	30	31	10465
encaixonàreu	2	1	encaixonareu	2	0	1	10466
encaixonés	2	0	encaixones	2	1	1	10467
encaixà	2	23	encaixa	2	4470	4493	10468
encaixàrem	2	6	encaixarem	2	11	17	10469
encaixàreu	2	0	encaixareu	2	2	2	10470
encaixés	2	102	encaixes	2	97	199	10471
encaixí	2	1	encaixi	2	580	581	10472
encalcinés	2	2	encalcines	2	0	2	10473
encalcés	2	2	encalces	2	5	7	10474
encalcí	2	0	encalci	2	6	6	10475
encalcín	2	0	encalcin	2	4	4	10476
encalentirà	2	1	encalentira	2	0	1	10477
encalentírem	2	0	encalentirem	2	8	8	10478
encalitjà	2	0	encalitja	2	1	1	10479
encallarà	2	6	encallara	2	0	6	10480
encallà	2	29	encalla	2	180	209	10481
encallàrem	2	0	encallarem	2	4	4	10482
encallés	2	13	encalles	2	14	27	10483
encallí	2	0	encalli	2	39	39	10484
encallís	2	0	encallis	2	1	1	10485
encalmarà	2	5	encalmara	2	0	5	10486
encalmà	2	2	encalma	2	17	19	10487
encalmés	2	1	encalmes	2	0	1	10488
encalmí	2	0	encalmi	2	4	4	10489
encalà	2	0	encala	2	2	2	10490
encalçarà	2	6	encalçara	2	0	6	10491
encalçà	2	7	encalça	2	86	93	10492
encalçàrem	2	0	encalçarem	2	2	2	10493
encambràrem	2	2	encambrarem	2	0	2	10494
encamellà	2	0	encamella	2	1	1	10495
encaminarà	2	46	encaminara	2	3	49	10496
encaminà	2	94	encamina	2	604	698	10497
encaminàrem	2	5	encaminarem	2	34	39	10498
encaminàreu	2	0	encaminareu	2	1	1	10499
encaminés	2	10	encamines	2	11	21	10500
encaminí	2	0	encamini	2	91	91	10501
encamisà	2	0	encamisa	2	2	2	10502
encamisàreu	2	1	encamisareu	2	0	1	10503
encanalà	2	0	encanala	2	1	1	10504
encanalés	2	0	encanales	2	1	1	10505
encanastràreu	2	0	encanastrareu	2	1	1	10506
encanonà	2	0	encanona	2	9	9	10507
encanonés	2	1	encanones	2	0	1	10508
encanoní	2	1	encanoni	2	0	1	10509
encantarà	2	1535	encantara	2	24	1559	10510
encantà	2	48	encanta	2	17795	17843	10511
encantàrem	2	0	encantarem	2	1	1	10512
encantàreu	2	0	encantareu	2	1	1	10513
encantària	4	5	encantaria	2	2080	2085	10514
encantàries	4	6	encantaries	2	1	7	10515
encantés	2	21	encantes	2	55	76	10516
encantí	2	0	encanti	2	94	94	10517
encanyonà	2	0	encanyona	2	2	2	10518
encanyà	2	0	encanya	2	1	1	10519
encanà	2	0	encana	2	7	7	10520
encaní	2	0	encani	2	1	1	10521
encaparrotà	2	0	encaparrota	2	1	1	10522
encaparrà	2	4	encaparra	2	27	31	10523
encaparràrem	2	0	encaparrarem	2	1	1	10524
encaparrés	2	2	encaparres	2	5	7	10525
encaparrí	2	0	encaparri	2	10	10	10526
encapellà	2	0	encapella	2	1	1	10527
encaperonàreu	2	0	encaperonareu	2	1	1	10528
encaperutxà	2	0	encaperutxa	2	1	1	10529
encapotà	2	0	encapota	2	2	2	10530
encapritxarà	2	0	encapritxara	2	1	1	10531
encapritxà	2	0	encapritxa	2	32	32	10532
encapritxés	2	1	encapritxes	2	3	4	10533
encapritxí	2	0	encapritxi	2	3	3	10534
encapsularà	2	1	encapsulara	2	0	1	10535
encapsulà	2	0	encapsula	2	54	54	10536
encapsulí	2	0	encapsuli	2	2	2	10537
encapsà	2	0	encapsa	2	5	5	10538
encapsàrem	2	0	encapsarem	2	2	2	10539
encaputxà	2	0	encaputxa	2	2	2	10540
encapçalarà	2	648	encapçalara	2	9	657	10541
encapçalà	2	419	encapçala	2	4683	5102	10542
encapçalàrem	2	5	encapçalarem	2	8	13	10543
encapçalés	2	87	encapçales	2	26	113	10544
encapçalí	2	0	encapçali	2	243	243	10545
encaramallés	2	0	encaramalles	2	1	1	10546
encararà	2	90	encarara	2	4	94	10547
encarbonarà	2	1	encarbonara	2	0	1	10548
encarboní	2	0	encarboni	2	1	1	10549
encarcarà	2	0	encarcara	2	13	13	10550
encarcarí	2	0	encarcari	2	1	1	10551
encarcerà	2	1	encarcera	2	3	4	10552
encarestià	2	0	encarestia	2	1	1	10553
encarirà	2	74	encarira	2	0	74	10554
encarnarà	2	73	encarnara	2	1	74	10555
encarnà	2	63	encarna	4	3226	3289	10556
encarnàrem	2	0	encarnarem	2	6	6	10557
encarnàreu	2	0	encarnareu	2	1	1	10558
encarnés	2	14	encarnes	2	13	27	10559
encarní	2	0	encarni	2	115	115	10560
encarranquiní	2	0	encarranquini	2	1	1	10561
encarregarà	2	3568	encarregara	2	43	3611	10562
encarregués	2	309	encarregues	2	88	397	10563
encarreguí	2	0	encarregui	2	931	931	10564
encarregà	2	1597	encarrega	2	11480	13077	10565
encarregàrem	2	7	encarregarem	2	398	405	10566
encarregàreu	2	1	encarregareu	2	5	6	10567
encarrellà	2	0	encarrella	2	1	1	10568
encarrerà	2	1	encarrera	2	0	1	10569
encarrilarà	2	3	encarrilara	2	1	4	10570
encarrilà	2	13	encarrila	2	76	89	10571
encarrilàrem	2	0	encarrilarem	2	3	3	10572
encarrilés	2	8	encarriles	2	3	11	10573
encarrilí	2	0	encarrili	2	17	17	10574
encartarà	2	7	encartara	2	0	7	10575
encartonà	2	0	encartona	2	1	1	10576
encartonés	2	1	encartones	2	0	1	10577
encartà	2	2	encarta	2	167	169	10578
encartés	2	0	encartes	2	1	1	10579
encartí	2	0	encarti	2	1	1	10580
encarà	2	240	encara	6	645974	646214	10581
encaràrem	2	3	encararem	2	81	84	10582
encaràreu	2	0	encarareu	2	3	3	10583
encarés	2	21	encares	2	61	82	10584
encarí	2	8	encari	2	95	103	10585
encarírem	2	0	encarirem	2	1	1	10586
encarís	2	7	encaris	2	10	17	10587
encasellarà	2	0	encasellara	2	1	1	10588
encasellà	2	0	encasella	2	46	46	10589
encasellàrem	2	0	encasellarem	2	1	1	10590
encasellés	2	1	encaselles	2	1	2	10591
encasellí	2	0	encaselli	2	8	8	10592
encasquetarà	2	1	encasquetara	2	0	1	10593
encasquetà	2	0	encasqueta	2	2	2	10594
encasquetés	2	1	encasquetes	2	0	1	10595
encasquetí	2	0	encasqueti	2	1	1	10596
encastarà	2	1	encastara	2	0	1	10597
encastellà	2	6	encastella	2	7	13	10598
encastà	2	9	encasta	2	62	71	10599
encastés	2	7	encastes	2	3	10	10600
encastí	2	0	encasti	2	7	7	10601
encasà	2	0	encasa	2	5	5	10602
encasí	2	0	encasi	2	1	1	10603
encaterinà	2	2	encaterina	2	22	24	10604
encaterinés	2	0	encaterines	2	1	1	10605
encateriní	2	0	encaterini	2	2	2	10606
encatifarà	2	1	encatifara	2	0	1	10607
encatifà	2	0	encatifa	2	12	12	10608
encausà	2	2	encausa	2	14	16	10609
encausàrem	2	0	encausarem	2	1	1	10610
encausés	2	1	encauses	2	0	1	10611
encausí	2	0	encausi	2	6	6	10612
encauà	2	1	encaua	2	2	3	10613
encaués	2	0	encaues	2	1	1	10614
encavalcarà	2	5	encavalcara	2	0	5	10615
encavalcà	2	0	encavalca	2	73	73	10616
encavallà	2	0	encavalla	2	4	4	10617
encavalquí	2	0	encavalqui	2	8	8	10618
encebà	2	0	enceba	2	37	37	10619
encebí	2	0	encebi	2	1	1	10620
encegarà	2	3	encegara	2	0	3	10621
encegués	2	4	encegues	2	2	6	10622
enceguí	2	0	encegui	2	22	22	10623
encegà	2	4	encega	2	129	133	10624
encelà	2	0	encela	2	1	1	10625
encendrà	2	406	encendra	2	6	412	10626
encendré	2	30	encendre	2	5865	5895	10627
encendrés	2	1	encendres	2	13	14	10628
encengués	2	72	encengues	2	7	79	10629
encenguí	2	1	encengui	2	262	263	10630
encensà	2	0	encensa	2	17	17	10631
encepeguí	2	0	encepegui	2	1	1	10632
encepegà	2	0	encepega	2	2	2	10633
encerclarà	2	20	encerclara	2	0	20	10634
encerclà	2	15	encercla	2	333	348	10635
encerclàrem	2	0	encerclarem	2	5	5	10636
encerclés	2	5	encercles	2	1	6	10637
encerclí	2	0	encercli	2	8	8	10638
encercà	2	1	encerca	2	5	6	10639
encerregà	2	0	encerrega	2	1	1	10640
encerrellàreu	2	1	encerrellareu	2	0	1	10641
encerrà	2	0	encerra	2	2	2	10642
encerrés	2	0	encerres	2	1	1	10643
encertarà	2	47	encertara	2	5	52	10644
encertà	2	50	encerta	2	960	1010	10645
encertàrem	2	2	encertarem	2	40	42	10646
encertàreu	2	0	encertareu	2	35	35	10647
encertés	2	30	encertes	2	183	213	10648
encertí	2	0	encerti	2	186	186	10649
encertís	2	0	encertis	2	34	34	10650
encervellà	2	0	encervella	2	1	1	10651
encerà	2	0	encera	2	10	10	10652
enceràreu	2	1	encerareu	2	0	1	10653
encerés	2	0	enceres	2	2	2	10654
encestà	2	0	encesta	2	2	2	10655
encetarà	2	631	encetara	2	6	637	10656
encetà	2	351	enceta	2	3061	3412	10657
encetàrem	2	50	encetarem	2	260	310	10658
encetàreu	2	0	encetareu	2	2	2	10659
encetés	2	27	encetes	2	34	61	10660
encetí	2	0	enceti	2	100	100	10661
encimbellà	2	5	encimbella	2	23	28	10662
encimbellí	2	0	encimbelli	2	2	2	10663
encimentà	2	1	encimenta	2	0	1	10664
encimentàrem	2	0	encimentarem	2	1	1	10665
encimentí	2	0	encimenti	2	1	1	10666
encimà	2	0	encima	2	192	192	10667
encimàrem	2	0	encimarem	2	1	1	10668
encimés	2	0	encimes	2	4	4	10669
encintà	2	0	encinta	0	40	40	10670
encintés	2	0	encintes	0	3	3	10671
encisarà	2	41	encisara	2	0	41	10672
encistellarà	2	0	encistellara	2	3	3	10673
encistellà	2	6	encistella	2	27	33	10674
encistellàrem	2	2	encistellarem	2	0	2	10675
encistellàreu	2	0	encistellareu	2	1	1	10676
encistellés	2	3	encistelles	2	2	5	10677
encistellí	2	0	encistelli	2	8	8	10678
encisà	2	7	encisa	2	195	202	10679
encisàrem	2	0	encisarem	2	2	2	10680
encisés	2	4	encises	2	0	4	10681
encisí	2	0	encisi	2	3	3	10682
enclaustrà	2	3	enclaustra	2	13	16	10683
enclaustrí	2	0	enclaustri	2	1	1	10684
enclavarà	2	1	enclavara	2	0	1	10685
enclavà	2	5	enclava	2	61	66	10686
enclavés	2	0	enclaves	2	7	7	10687
enclaví	2	0	enclavi	2	3	3	10688
encletxà	2	0	encletxa	2	74	74	10689
encletxés	2	0	encletxes	2	40	40	10690
enclogués	2	1	enclogues	2	0	1	10691
encloguí	2	0	enclogui	2	4	4	10692
enclotà	2	0	enclota	2	5	5	10693
enclotí	2	0	encloti	2	1	1	10694
enclouré	2	0	encloure	2	23	23	10695
encobertà	2	0	encoberta	2	1098	1098	10696
encobertés	2	0	encobertes	2	304	304	10697
encobrirà	2	2	encobrira	2	0	2	10698
encobríreu	2	0	encobrireu	2	1	1	10699
encofiarà	2	1	encofiara	2	0	1	10700
encofrà	2	0	encofra	2	2	2	10701
encofrés	2	0	encofres	2	1	1	10702
encofurnà	2	0	encofurna	2	3	3	10703
encoixinà	2	0	encoixina	2	10	10	10704
encoixí	2	0	encoixi	2	1	1	10705
encolarà	2	1	encolara	2	0	1	10706
encolomarà	2	6	encolomara	2	0	6	10707
encolomà	2	3	encoloma	2	25	28	10708
encolomés	2	1	encolomes	2	3	4	10709
encolomí	2	0	encolomi	2	6	6	10710
encolà	2	2	encola	2	41	43	10711
encolàrem	2	1	encolarem	2	14	15	10712
encolés	2	0	encoles	2	2	2	10713
encomanarà	2	77	encomanara	2	2	79	10714
encomanà	2	293	encomana	2	1721	2014	10715
encomanàrem	2	2	encomanarem	2	21	23	10716
encomanàreu	2	3	encomanareu	2	2	5	10717
encomanés	2	61	encomanes	2	114	175	10718
encomaní	2	4	encomani	2	278	282	10719
encomiarà	2	1	encomiara	2	0	1	10720
encomià	2	1	encomia	2	18	19	10721
encongirà	2	18	encongira	2	0	18	10722
encongírem	2	0	encongirem	2	3	3	10723
encongíreu	2	0	encongireu	2	1	1	10724
encontrarà	2	8	encontrara	2	5	13	10725
encontrà	2	13	encontra	2	235	248	10726
encontràrem	2	0	encontrarem	2	10	10	10727
encontràreu	2	1	encontrareu	2	5	6	10728
encontrés	2	0	encontres	2	2108	2108	10729
encontrí	2	1	encontri	2	0	1	10730
enconà	2	0	encona	2	3	3	10731
enconés	2	1	encones	2	0	1	10732
encoratgés	2	21	encoratges	2	15	36	10733
encoratgí	2	0	encoratgi	2	133	133	10734
encoratjarà	2	105	encoratjara	2	1	106	10735
encoratjà	2	169	encoratja	2	1344	1513	10736
encoratjàrem	2	0	encoratjarem	2	24	24	10737
encorbà	2	0	encorba	2	11	11	10738
encorbés	2	0	encorbes	2	3	3	10739
encorbí	2	0	encorbi	2	1	1	10740
encordarà	2	1	encordara	2	0	1	10741
encordà	2	1	encorda	4	4	5	10742
encordàrem	2	0	encordarem	2	1	1	10743
encordés	2	1	encordes	4	0	1	10744
encorní	2	0	encorni	2	1	1	10745
encorralà	2	0	encorrala	2	2	2	10746
encorsetà	2	0	encorseta	2	4	4	10747
encostiparà	2	3	encostipara	2	0	3	10748
encostipà	2	0	encostipa	2	2	2	10749
encostipí	2	0	encostipi	2	2	2	10750
encotillarà	2	1	encotillara	2	0	1	10751
encotillà	2	0	encotilla	2	48	48	10752
encotillàrem	2	0	encotillarem	2	1	1	10753
encotillés	2	1	encotilles	2	0	1	10754
encotillí	2	0	encotilli	2	6	6	10755
encovenà	2	1	encovena	2	0	1	10756
encovèn	2	0	encoven	2	1	1	10757
encoví	2	0	encovi	2	1	1	10758
encrespà	2	0	encrespa	2	12	12	10759
encrespí	2	0	encrespi	2	2	2	10760
encrestí	2	0	encresti	2	1	1	10761
encreuarà	2	2	encreuara	2	1	3	10762
encreuellés	2	0	encreuelles	2	1	1	10763
encreuà	2	5	encreua	2	87	92	10764
encreuàrem	2	1	encreuarem	2	1	2	10765
encreuí	2	0	encreui	2	3	3	10766
encriptarà	2	26	encriptara	2	0	26	10767
encriptà	2	0	encripta	2	192	192	10768
encriptàrem	2	0	encriptarem	2	1	1	10769
encriptés	2	1	encriptes	2	0	1	10770
encriptí	2	0	encripti	2	5	5	10771
encrocarà	2	1	encrocara	2	0	1	10772
encrostarà	2	1	encrostara	2	0	1	10773
encrostimí	2	0	encrostimi	2	1	1	10774
encrostà	2	0	encrosta	2	4	4	10775
encrostés	2	1	encrostes	2	0	1	10776
encrostí	2	0	encrosti	2	2	2	10777
encruà	2	0	encrua	2	2	2	10778
encubellí	2	1	encubelli	2	0	1	10779
encubà	2	0	encuba	2	5	5	10780
encuirassà	2	0	encuirassa	2	2	2	10781
enculà	2	0	encula	2	1	1	10782
encunyarà	2	5	encunyara	2	3	8	10783
encunyà	2	144	encunya	2	98	242	10784
encunyàrem	2	0	encunyarem	2	4	4	10785
encunyés	2	11	encunyes	2	1	12	10786
encunyí	2	0	encunyi	2	10	10	10787
encuriosirà	2	2	encuriosira	2	0	2	10788
encuriosírem	2	0	encuriosirem	2	1	1	10789
endanyà	2	1	endanya	2	0	1	10790
endarrerirà	2	107	endarrerira	2	4	111	10791
endarrerià	2	1	endarreria	2	44	45	10792
endarreríem	2	1	endarreriem	2	0	1	10793
endarrerírem	2	0	endarrerirem	2	3	3	10794
endegarà	2	62	endegara	2	0	62	10795
endegués	2	29	endegues	2	1	30	10796
endeguí	2	0	endegui	2	38	38	10797
endegà	2	116	endega	2	298	414	10798
endegàrem	2	1	endegarem	2	20	21	10799
endenyà	2	0	endenya	2	1	1	10800
enderià	2	1	enderia	2	3	4	10801
enderrocarà	2	103	enderrocara	2	3	106	10802
enderrocà	2	169	enderroca	2	189	358	10803
enderrocàrem	2	0	enderrocarem	2	5	5	10804
enderrocàreu	2	0	enderrocareu	2	2	2	10805
enderroqués	2	61	enderroques	2	1	62	10806
enderroquí	2	0	enderroqui	2	82	82	10807
endeutarà	2	15	endeutara	2	1	16	10808
endeutà	2	9	endeuta	2	61	70	10809
endeutàrem	2	1	endeutarem	2	5	6	10810
endeutés	2	2	endeutes	2	7	9	10811
endeutí	2	0	endeuti	2	27	27	10812
endevinarà	2	23	endevinara	2	0	23	10813
endevinà	2	17	endevina	2	1263	1280	10814
endevinàrem	2	1	endevinarem	2	11	12	10815
endevinàreu	2	0	endevinareu	2	25	25	10816
endevinés	2	25	endevines	2	127	152	10817
endeviní	2	0	endevini	2	84	84	10818
endimonià	2	1	endimonia	2	2	3	10819
endinsarà	2	568	endinsara	2	5	573	10820
endinsà	2	157	endinsa	2	5665	5822	10821
endinsàrem	2	24	endinsarem	2	1093	1117	10822
endinsàreu	2	2	endinsareu	2	106	108	10823
endinsés	2	30	endinses	2	170	200	10824
endinsí	2	0	endinsi	2	155	155	10825
endinyarà	2	2	endinyara	2	0	2	10826
endinyà	2	2	endinya	2	11	13	10827
endinyés	2	0	endinyes	2	1	1	10828
endinyí	2	0	endinyi	2	1	1	10829
endiumenjà	2	0	endiumenja	2	8	8	10830
endoblés	2	0	endobles	2	1	1	10831
endogalà	2	0	endogala	2	2	2	10832
endolcirà	2	13	endolcira	2	0	13	10833
endolcírem	2	0	endolcirem	2	6	6	10834
endollarà	2	2	endollara	2	1	3	10835
endollà	2	2	endolla	2	92	94	10836
endollàrem	2	0	endollarem	2	4	4	10837
endollés	2	1	endolles	2	14	15	10838
endollí	2	0	endolli	2	20	20	10839
endolà	2	2	endola	2	4	6	10840
endolàrem	2	0	endolarem	2	1	1	10841
endormiscarà	2	1	endormiscara	2	0	1	10842
endormiscà	2	3	endormisca	2	11	14	10843
endormisqués	2	1	endormisques	2	0	1	10844
endormisquí	2	0	endormisqui	2	1	1	10845
endossarà	2	1	endossara	2	0	1	10846
endossà	2	5	endossa	2	23	28	10847
endossés	2	1	endosses	2	2	3	10848
endossí	2	0	endossi	2	5	5	10849
endraparà	2	1	endrapara	2	0	1	10850
endrapà	2	2	endrapa	2	25	27	10851
endrapàrem	2	0	endraparem	2	2	2	10852
endrapés	2	0	endrapes	2	4	4	10853
endrapí	2	0	endrapi	2	3	3	10854
endrecés	2	8	endreces	4	25	33	10855
endrecí	2	1	endreci	2	33	34	10856
endreçarà	2	9	endreçara	2	0	9	10857
endreçà	2	6	endreça	4	452	458	10858
endreçàrem	2	0	endreçarem	2	8	8	10859
endreçàreu	2	0	endreçareu	2	1	1	10860
endugués	2	166	endugues	2	3	169	10861
enduguí	2	1	endugui	2	285	286	10862
endurarà	2	1	endurara	2	0	1	10863
endurirà	2	62	endurira	2	0	62	10864
endurà	2	672	endura	2	36	708	10865
enduré	2	86	endure	2	7	93	10866
endurés	2	0	endures	2	3	3	10867
endurí	2	41	enduri	2	2	43	10868
endurírem	2	0	endurirem	2	2	2	10869
endurís	2	16	enduris	2	0	16	10870
enemistarà	2	1	enemistara	2	0	1	10871
enemistà	2	38	enemista	2	8	46	10872
enemistí	2	0	enemisti	2	2	2	10873
energitzarà	2	0	energitzara	2	1	1	10874
energitzà	2	0	energitza	2	13	13	10875
enervarà	2	2	enervara	2	0	2	10876
enervà	2	1	enerva	2	74	75	10877
enervés	2	1	enerves	2	2	3	10878
enerví	2	0	enervi	2	5	5	10879
enfadarà	2	53	enfadara	2	5	58	10880
enfadà	2	34	enfada	2	796	830	10881
enfadàrem	2	0	enfadarem	2	10	10	10882
enfadàreu	2	0	enfadareu	2	1	1	10883
enfadés	2	57	enfades	2	89	146	10884
enfadí	2	0	enfadi	2	247	247	10885
enfaixà	2	0	enfaixa	2	10	10	10886
enfaixés	2	0	enfaixes	2	1	1	10887
enfaixí	2	0	enfaixi	2	1	1	10888
enfangarà	2	1	enfangara	2	1	2	10889
enfangués	2	0	enfangues	2	3	3	10890
enfanguí	2	0	enfangui	2	3	3	10891
enfangà	2	3	enfanga	2	42	45	10892
enfangàrem	2	0	enfangarem	2	3	3	10893
enfangàreu	2	0	enfangareu	2	2	2	10894
enfarcellés	2	1	enfarcelles	2	0	1	10895
enfardarà	2	1	enfardara	2	0	1	10896
enfarfeguí	2	0	enfarfegui	2	3	3	10897
enfarfegà	2	0	enfarfega	2	34	34	10898
enfarfollà	2	0	enfarfolla	2	1	1	10899
enfarinà	2	2	enfarina	2	84	86	10900
enfarinàrem	2	0	enfarinarem	2	38	38	10901
enfarinés	2	0	enfarines	2	11	11	10902
enfariní	2	0	enfarini	2	1	1	10903
enfavés	2	0	enfaves	2	1	1	10904
enfebrà	2	0	enfebra	2	2	2	10905
enfebrí	2	1	enfebri	2	0	1	10906
enfeixí	2	0	enfeixi	2	1	1	10907
enfeltrà	2	0	enfeltra	2	1	1	10908
enfeltrí	2	0	enfeltri	2	1	1	10909
enferritjà	2	0	enferritja	2	1	1	10910
enferràreu	2	0	enferrareu	2	1	1	10911
enferrí	2	0	enferri	2	1	1	10912
enferrís	2	1	enferris	2	0	1	10913
enfeudà	2	2	enfeuda	2	2	4	10914
enfigassés	2	0	enfigasses	2	1	1	10915
enfigassí	2	0	enfigassi	2	1	1	10916
enfilarà	2	148	enfilara	2	6	154	10917
enfilà	2	126	enfila	4	4238	4364	10918
enfilàrem	2	34	enfilarem	2	442	476	10919
enfilàreu	2	0	enfilareu	2	18	18	10920
enfilés	2	42	enfiles	4	67	109	10921
enfilí	2	1	enfili	2	108	109	10922
enfitorà	2	0	enfitora	2	1	1	10923
enfità	2	0	enfita	2	3	3	10924
enfités	2	0	enfites	2	1	1	10925
enflocà	2	9	enfloca	2	15	24	10926
enflocàrem	2	1	enflocarem	2	0	1	10927
enfloqués	2	0	enfloques	2	1	1	10928
enfocarà	2	103	enfocara	2	1	104	10929
enfocà	2	29	enfoca	2	1461	1490	10930
enfocàrem	2	2	enfocarem	2	78	80	10931
enfocàreu	2	0	enfocareu	2	3	3	10932
enfolcà	2	1	enfolca	2	0	1	10933
enfollirà	2	2	enfollira	2	0	2	10934
enfollírem	2	0	enfollirem	2	1	1	10935
enfondrà	2	2	enfondra	2	2	4	10936
enfondrés	2	2	enfondres	2	0	2	10937
enfonsarà	2	201	enfonsara	2	6	207	10938
enfonsà	2	217	enfonsa	2	1860	2077	10939
enfonsàrem	2	1	enfonsarem	2	35	36	10940
enfonsàreu	2	0	enfonsareu	2	4	4	10941
enfonsés	2	122	enfonses	2	54	176	10942
enfonsí	2	0	enfonsi	2	373	373	10943
enfonyà	2	0	enfonya	2	9	9	10944
enfonyés	2	1	enfonyes	2	0	1	10945
enfoqués	2	19	enfoques	2	63	82	10946
enfoquí	2	0	enfoqui	2	115	115	10947
enforcà	2	0	enforca	2	6	6	10948
enforcàrem	2	0	enforcarem	2	2	2	10949
enforinyàrem	2	0	enforinyarem	2	1	1	10950
enforinyí	2	0	enforinyi	2	1	1	10951
enformà	2	0	enforma	2	43	43	10952
enformàrem	2	0	enformarem	2	2	2	10953
enformí	2	0	enformi	2	1	1	10954
enfornarà	2	3	enfornara	2	0	3	10955
enfornà	2	2	enforna	2	164	166	10956
enfornàrem	2	2	enfornarem	2	89	91	10957
enfornés	2	0	enfornes	2	6	6	10958
enforquillà	2	2	enforquilla	2	4	6	10959
enfortirà	2	313	enfortira	2	2	315	10960
enfortírem	2	0	enfortirem	2	51	51	10961
enfortíreu	2	0	enfortireu	2	2	2	10962
enfoscà	2	0	enfosca	2	2	2	10963
enfosquirà	2	42	enfosquira	2	1	43	10964
enfosqués	2	0	enfosques	2	11	11	10965
enfosquí	2	24	enfosqui	2	3	27	10966
enfosquís	2	10	enfosquis	2	1	11	10967
enfredorís	2	1	enfredoris	2	0	1	10968
enfredà	2	1	enfreda	2	3	4	10969
enfredés	2	1	enfredes	2	0	1	10970
enfredí	2	0	enfredi	2	1	1	10971
enfrenà	2	0	enfrena	2	1	1	10972
enfrontarà	2	2911	enfrontara	2	25	2936	10973
enfrontà	2	706	enfronta	2	8432	9138	10974
enfrontàrem	2	4	enfrontarem	2	265	269	10975
enfrontàreu	2	0	enfrontareu	2	6	6	10976
enfrontés	2	89	enfrontes	2	185	274	10977
enfrontí	2	0	enfronti	2	393	393	10978
enfundarà	2	2	enfundara	2	1	3	10979
enfundà	2	2	enfunda	2	32	34	10980
enfundés	2	1	enfundes	2	3	4	10981
enfundí	2	1	enfundi	2	1	2	10982
enfurirà	2	3	enfurira	2	0	3	10983
enfurismarà	2	2	enfurismara	2	0	2	10984
enfurismà	2	42	enfurisma	2	57	99	10985
enfurismés	2	3	enfurismes	2	1	4	10986
enfurismí	2	0	enfurismi	2	5	5	10987
enfurià	2	0	enfuria	2	11	11	10988
enfurrunyàrem	2	1	enfurrunyarem	2	0	1	10989
enfurírem	2	0	enfurirem	2	1	1	10990
enfustà	2	0	enfusta	2	3	3	10991
enfutimés	2	1	enfutimes	2	0	1	10992
engabiarà	2	1	engabiara	2	0	1	10993
engabià	2	1	engabia	2	15	16	10994
engafetés	2	0	engafetes	2	2	2	10995
engafà	2	0	engafa	2	1	1	10996
engalanarà	2	56	engalanara	2	1	57	10997
engalanà	2	5	engalana	2	236	241	10998
engalanàrem	2	0	engalanarem	2	10	10	10999
engalaní	2	0	engalani	2	11	11	11000
engalavernà	2	0	engalaverna	2	4	4	11001
engalbà	2	0	engalba	4	65	65	11002
engalbàrem	2	0	engalbarem	2	2	2	11003
engalbés	2	0	engalbes	4	72	72	11004
engaliparà	2	2	engalipara	2	0	2	11005
engalipà	2	0	engalipa	2	30	30	11006
engalipí	2	0	engalipi	2	5	5	11007
engallinà	2	0	engallina	2	1	1	11008
engallà	2	0	engalla	2	1	1	11009
engalonà	2	0	engalona	2	2	2	11010
engaltà	2	4	engalta	2	81	85	11011
engaltàrem	2	0	engaltarem	2	1	1	11012
engaltés	2	7	engaltes	2	4	11	11013
engaltí	2	0	engalti	2	1	1	11014
engalzarà	2	1	engalzara	2	0	1	11015
engalzà	2	0	engalza	2	5	5	11016
engalzés	2	0	engalzes	2	1	1	11017
enganarà	2	1	enganara	2	0	1	11018
enganxarà	2	239	enganxara	2	10	249	11019
enganxà	2	28	enganxa	2	3906	3934	11020
enganxàrem	2	1	enganxarem	2	156	157	11021
enganxàreu	2	0	enganxareu	2	11	11	11022
enganxés	2	84	enganxes	2	203	287	11023
enganxí	2	1	enganxi	2	1216	1217	11024
enganxó	4	2	enganxo	2	335	337	11025
enganyarà	2	48	enganyara	2	1	49	11026
enganyà	2	39	enganya	2	1499	1538	11027
enganyàrem	2	1	enganyarem	2	82	83	11028
enganyàreu	2	0	enganyareu	2	9	9	11029
enganyés	2	39	enganyes	2	95	134	11030
enganyí	2	0	enganyi	2	352	352	11031
enganà	2	9	engana	2	33	42	11032
enganàrem	2	0	enganarem	2	2	2	11033
enganés	2	0	enganes	2	3	3	11034
enganí	2	0	engani	2	9	9	11035
engarbullà	2	1	engarbulla	2	0	1	11036
engargussà	2	1	engargussa	2	4	5	11037
engarjolarà	2	2	engarjolara	2	0	2	11038
engarjolà	2	2	engarjola	2	22	24	11039
engarjolàreu	2	0	engarjolareu	2	1	1	11040
engarjolés	2	1	engarjoles	2	1	2	11041
engarjolí	2	0	engarjoli	2	8	8	11042
engarlandà	2	2	engarlanda	2	1	3	11043
engarrofà	2	1	engarrofa	2	0	1	11044
engarrotarà	2	1	engarrotara	2	0	1	11045
engarrotà	2	0	engarrota	2	6	6	11046
engassàrem	2	0	engassarem	2	1	1	11047
engatjà	2	0	engatja	2	3	3	11048
engatà	2	0	engata	2	4	4	11049
engatí	2	0	engati	2	1	1	11050
engavanyà	2	0	engavanya	2	16	16	11051
engavanyés	2	1	engavanyes	2	1	2	11052
engavanyí	2	0	engavanyi	2	3	3	11053
engegantirà	2	1	engegantira	2	0	1	11054
engegarà	2	572	engegara	2	5	577	11055
engegués	2	78	engegues	2	63	141	11056
engeguí	2	0	engegui	2	231	231	11057
engegà	2	252	engega	2	3151	3403	11058
engegàrem	2	12	engegarem	2	131	143	11059
engegàreu	2	1	engegareu	2	2	3	11060
engendrarà	2	20	engendrara	2	0	20	11061
engendrà	2	85	engendra	2	427	512	11062
engendràrem	2	0	engendrarem	2	2	2	11063
engendràreu	2	1	engendrareu	2	0	1	11064
engendrés	2	9	engendres	2	46	55	11065
engendrí	2	0	engendri	2	14	14	11066
engerrà	2	0	engerra	2	1	1	11067
enginyarà	2	4	enginyara	2	0	4	11068
enginyà	2	11	enginya	4	51	62	11069
enginyàrem	2	0	enginyarem	2	2	2	11070
enginyés	2	2	enginyes	4	5	7	11071
enginyí	2	0	enginyi	2	4	4	11072
engiponà	2	2	engipona	2	8	10	11073
engiponés	2	0	engipones	2	2	2	11074
engirgolí	2	0	engirgoli	2	1	1	11075
englobarà	2	151	englobara	2	6	157	11076
englobà	2	15	engloba	2	5327	5342	11077
englobàrem	2	0	englobarem	2	4	4	11078
englobàreu	2	1	englobareu	2	0	1	11079
englobés	2	64	englobes	2	4	68	11080
englobí	2	0	englobi	2	323	323	11081
engolfà	2	0	engolfa	2	2	2	11082
engolirà	2	54	engolira	2	1	55	11083
engolà	2	2	engola	2	3	5	11084
engolés	2	1	engoles	2	0	1	11085
engolí	2	21	engoli	2	4	25	11086
engolírem	2	2	engolirem	2	0	2	11087
engolís	2	21	engolis	2	0	21	11088
engomí	2	0	engomi	2	2	2	11089
engorgà	2	0	engorga	2	1	1	11090
engorgí	2	0	engorgi	2	1	1	11091
engorjà	2	0	engorja	2	32	32	11092
engospés	2	1	engospes	2	0	1	11093
engraellàrem	2	1	engraellarem	2	0	1	11094
engranarà	2	1	engranara	2	0	1	11095
engrandirà	2	41	engrandira	2	0	41	11096
engrandírem	2	0	engrandirem	2	2	2	11097
engranerà	2	0	engranera	2	1	1	11098
engranà	2	0	engrana	2	25	25	11099
engraní	2	0	engrani	2	7	7	11100
engrapà	2	9	engrapa	2	25	34	11101
engrapés	2	0	engrapes	2	4	4	11102
engrapí	2	1	engrapi	2	1	2	11103
engravà	2	0	engrava	2	4	4	11104
engraví	2	0	engravi	2	1	1	11105
engreixarà	2	25	engreixara	2	3	28	11106
engreixinarà	2	1	engreixinara	2	0	1	11107
engreixinà	2	0	engreixina	2	1	1	11108
engreixinàreu	2	0	engreixinareu	2	1	1	11109
engreixà	2	4	engreixa	2	456	460	11110
engreixàrem	2	1	engreixarem	2	12	13	11111
engreixàreu	2	0	engreixareu	2	1	1	11112
engreixés	2	14	engreixes	2	17	31	11113
engreixí	2	0	engreixi	2	57	57	11114
engreixín	2	0	engreixin	2	29	29	11115
engrescarà	2	54	engrescara	2	0	54	11116
engrescà	2	34	engresca	2	514	548	11117
engrescàrem	2	3	engrescarem	2	17	20	11118
engrescàreu	2	0	engrescareu	2	1	1	11119
engresqués	2	17	engresques	2	16	33	11120
engresquí	2	0	engresqui	2	150	150	11121
engrillonà	2	1	engrillona	2	2	3	11122
engrillonàreu	2	1	engrillonareu	2	0	1	11123
engrinyés	2	0	engrinyes	4	1	1	11124
engroguirà	2	2	engroguira	2	0	2	11125
engronsà	2	0	engronsa	2	12	12	11126
engronsés	2	0	engronses	2	1	1	11127
engronsí	2	0	engronsi	2	2	2	11128
engronxà	2	0	engronxa	2	2	2	11129
engronxí	2	0	engronxi	2	2	2	11130
engrossirà	2	5	engrossira	2	0	5	11131
engruixirà	2	3	engruixira	2	0	3	11132
engruixà	2	1	engruixa	2	5	6	11133
engruixí	2	3	engruixi	2	0	3	11134
engruixís	2	1	engruixis	2	0	1	11135
engrunarà	2	2	engrunara	2	0	2	11136
engrunsà	2	0	engrunsa	2	1	1	11137
engrunsés	2	0	engrunses	2	1	1	11138
engrunà	2	0	engruna	4	512	512	11139
engrunés	2	0	engrunes	4	1218	1218	11140
engruní	2	0	engruni	2	5	5	11141
engualdrapàrem	2	0	engualdraparem	2	1	1	11142
enguantarà	2	1	enguantara	2	0	1	11143
enguerrà	2	0	enguerra	2	2	2	11144
enguixarà	2	1	enguixara	2	0	1	11145
enguixà	2	3	enguixa	2	4	7	11146
enguixàrem	2	0	enguixarem	2	4	4	11147
enherbà	2	0	enherba	2	1	1	11148
enjardinarà	2	14	enjardinara	2	0	14	11149
enjardinà	2	5	enjardina	2	12	17	11150
enjardinàrem	2	0	enjardinarem	2	2	2	11151
enjardinés	2	0	enjardines	2	1	1	11152
enjogassà	2	1	enjogassa	2	23	24	11153
enjogassés	2	0	enjogasses	2	3	3	11154
enjoià	2	0	enjoia	2	59	59	11155
enjovà	2	0	enjova	2	2	2	11156
enjoví	2	0	enjovi	2	1	1	11157
enjoí	2	0	enjoi	2	1	1	11158
enjudiciarà	2	11	enjudiciara	2	1	12	11159
enjudicià	2	0	enjudicia	2	32	32	11160
enjudiciàrem	2	0	enjudiciarem	2	2	2	11161
enlairarà	2	66	enlairara	2	1	67	11162
enlairà	2	99	enlaira	2	788	887	11163
enlairàrem	2	2	enlairarem	2	27	29	11164
enlairàreu	2	0	enlairareu	2	3	3	11165
enlairés	2	41	enlaires	2	15	56	11166
enlairí	2	0	enlairi	2	62	62	11167
enllacarà	2	3	enllacara	2	0	3	11168
enllacà	2	1	enllaca	2	3	4	11169
enllacàrem	2	0	enllacarem	2	3	3	11170
enllacés	2	41	enllaces	2	64	105	11171
enllací	2	0	enllaci	2	214	214	11172
enllagrimí	2	1	enllagrimi	2	0	1	11173
enllaminírem	2	0	enllaminirem	2	1	1	11174
enllandí	2	1	enllandi	2	0	1	11175
enllardissà	2	0	enllardissa	2	1	1	11176
enllardà	2	0	enllarda	2	3	3	11177
enllaunà	2	0	enllauna	2	8	8	11178
enllaunàrem	2	0	enllaunarem	2	1	1	11179
enllaçarà	2	568	enllaçara	2	7	575	11180
enllaçà	2	47	enllaça	2	5002	5049	11181
enllaçàrem	2	2	enllaçarem	2	214	216	11182
enllaçàreu	2	0	enllaçareu	2	12	12	11183
enllefiscarà	2	0	enllefiscara	2	1	1	11184
enllestirà	2	123	enllestira	2	1	124	11185
enllestírem	2	2	enllestirem	2	25	27	11186
enllestíreu	2	0	enllestireu	2	1	1	11187
enllistonàrem	2	1	enllistonarem	2	0	1	11188
enllistà	2	2	enllista	2	1	3	11189
enllità	2	3	enllita	2	3	6	11190
enllités	2	0	enllites	2	1	1	11191
enllití	2	0	enlliti	2	1	1	11192
enllosà	2	0	enllosa	2	1	1	11193
enllotà	2	0	enllota	2	1	1	11194
enlluentí	2	1	enlluenti	2	0	1	11195
enlluernarà	2	39	enlluernara	2	1	40	11196
enlluernà	2	19	enlluerna	2	524	543	11197
enlluernàrem	2	0	enlluernarem	2	5	5	11198
enlluernàreu	2	1	enlluernareu	2	1	2	11199
enlluernés	2	10	enlluernes	2	5	15	11200
enlluerní	2	0	enlluerni	2	45	45	11201
enllumenarà	2	4	enllumenara	2	0	4	11202
enllumenà	2	1	enllumena	2	23	24	11203
enllumenàreu	2	0	enllumenareu	2	1	1	11204
enllumení	2	0	enllumeni	2	1	1	11205
enllustrarà	2	1	enllustrara	2	0	1	11206
enllustrà	2	0	enllustra	2	9	9	11207
enllustràrem	2	0	enllustrarem	2	1	1	11208
enllustrés	2	0	enllustres	2	2	2	11209
enllustrí	2	0	enllustri	2	1	1	11210
enlluíreu	2	0	enlluireu	2	1	1	11211
ennigularà	2	1	ennigulara	2	0	1	11212
ennigulà	2	0	ennigula	2	1	1	11213
ennoblirà	2	3	ennoblira	2	0	3	11214
ennovà	2	0	ennova	2	2	2	11215
ennuegarà	2	3	ennuegara	2	0	3	11216
ennuegués	2	5	ennuegues	2	6	11	11217
ennueguí	2	0	ennuegui	2	21	21	11218
ennuegà	2	1	ennuega	2	78	79	11219
ennuegàrem	2	0	ennuegarem	2	3	3	11220
ennuvolarà	2	11	ennuvolara	2	0	11	11221
ennuvolà	2	4	ennuvola	2	62	66	11222
ennuvolés	2	1	ennuvoles	2	1	2	11223
ennuvolí	2	0	ennuvoli	2	13	13	11224
enorgullirà	2	1	enorgullira	2	0	1	11225
enorgullàrem	2	1	enorgullarem	2	0	1	11226
enorgullés	2	1	enorgulles	2	0	1	11227
enorgullí	2	4	enorgulli	2	0	4	11228
enorgullís	2	5	enorgullis	2	0	5	11229
enquadernarà	2	6	enquadernara	2	0	6	11230
enquadernà	2	2	enquaderna	2	28	30	11231
enquadernàrem	2	0	enquadernarem	2	12	12	11232
enquadernés	2	0	enquadernes	2	4	4	11233
enquaderní	2	1	enquaderni	2	1	2	11234
enquadrarà	2	13	enquadrara	2	0	13	11235
enquadrà	2	25	enquadra	2	381	406	11236
enquadràrem	2	0	enquadrarem	2	1	1	11237
enquadrés	2	1	enquadres	2	45	46	11238
enquadrí	2	0	enquadri	2	22	22	11239
enquestarà	2	6	enquestara	2	0	6	11240
enquestà	2	4	enquesta	4	22564	22568	11241
enquestés	2	1	enquestes	4	12416	12417	11242
enquestí	2	2	enquesti	2	0	2	11243
enquibíreu	2	0	enquibireu	2	1	1	11244
enquimerà	2	0	enquimera	2	2	2	11245
enquistarà	2	10	enquistara	2	1	11	11246
enquistà	2	1	enquista	2	59	60	11247
enquistàrem	2	0	enquistarem	2	2	2	11248
enquistés	2	4	enquistes	2	2	6	11249
enquistí	2	0	enquisti	2	24	24	11250
enquitranarà	2	5	enquitranara	2	0	5	11251
enquitranà	2	2	enquitrana	2	0	2	11252
enrabiarà	2	2	enrabiara	2	0	2	11253
enrabià	2	6	enrabia	2	78	84	11254
enrabiés	2	8	enrabies	2	2	10	11255
enrabií	2	0	enrabii	2	3	3	11256
enragés	2	25	enrages	2	0	25	11257
enraigà	2	1	enraiga	2	0	1	11258
enraià	2	0	enraia	2	1	1	11259
enrajolarà	2	3	enrajolara	2	0	3	11260
enrajolà	2	2	enrajola	2	16	18	11261
enrajolàrem	2	0	enrajolarem	2	1	1	11262
enrajà	2	0	enraja	2	1	1	11263
enramarà	2	2	enramara	2	0	2	11264
enrampà	2	3	enrampa	2	22	25	11265
enrampàrem	2	1	enramparem	2	0	1	11266
enrampés	2	1	enrampes	2	4	5	11267
enrampí	2	0	enrampi	2	1	1	11268
enramà	2	5	enrama	2	15	20	11269
enramàrem	2	0	enramarem	2	1	1	11270
enraonà	2	5	enraona	2	167	172	11271
enraonàrem	2	1	enraonarem	2	6	7	11272
enraonàreu	2	0	enraonareu	2	1	1	11273
enraonés	2	4	enraones	2	14	18	11274
enraoní	2	0	enraoni	2	9	9	11275
enrarirà	2	5	enrarira	2	0	5	11276
enrasà	2	0	enrasa	2	4	4	11277
enravenà	2	3	enravena	2	2	5	11278
enrecordarà	2	25	enrecordara	2	1	26	11279
enrecordà	2	1	enrecorda	2	110	111	11280
enrecordàrem	2	0	enrecordarem	2	11	11	11281
enrecordàreu	2	0	enrecordareu	2	15	15	11282
enrecordés	2	1	enrecordes	2	71	72	11283
enrecordí	2	0	enrecordi	2	27	27	11284
enredarà	2	15	enredara	2	0	15	11285
enrederirà	2	1	enrederira	2	0	1	11286
enrederà	2	1	enredera	2	45	46	11287
enrederí	2	2	enrederi	2	0	2	11288
enredoltà	2	0	enredolta	2	1	1	11289
enredortàreu	2	0	enredortareu	2	1	1	11290
enredrà	2	0	enredra	2	3	3	11291
enredà	2	5	enreda	2	190	195	11292
enredàrem	2	0	enredarem	2	3	3	11293
enredàreu	2	1	enredareu	2	1	2	11294
enredés	2	7	enredes	2	16	23	11295
enredí	2	0	enredi	2	25	25	11296
enregistrarà	2	220	enregistrara	2	2	222	11297
enregistrà	2	318	enregistra	2	1179	1497	11298
enregistràrem	2	3	enregistrarem	2	67	70	11299
enregistràreu	2	0	enregistrareu	2	1	1	11300
enregistrés	2	41	enregistres	2	15	56	11301
enregistrí	2	0	enregistri	2	69	69	11302
enretirarà	2	10	enretirara	2	0	10	11303
enretirà	2	18	enretira	2	84	102	11304
enretiràrem	2	1	enretirarem	2	7	8	11305
enretirés	2	6	enretires	2	4	10	11306
enretirí	2	1	enretiri	2	14	15	11307
enreveixinà	2	0	enreveixina	2	1	1	11308
enrevenxinà	2	0	enrevenxina	2	1	1	11309
enrevoltà	2	3	enrevolta	2	25	28	11310
enrinxolà	2	0	enrinxola	2	3	3	11311
enriolà	2	0	enriola	2	5	5	11312
enriquirà	2	312	enriquira	2	6	318	11313
enriquírem	2	2	enriquirem	2	40	42	11314
enriquíreu	2	0	enriquireu	2	8	8	11315
enrobustirà	2	1	enrobustira	2	0	1	11316
enrobustírem	2	0	enrobustirem	2	1	1	11317
enrocarà	2	2	enrocara	2	0	2	11318
enrocà	2	2	enroca	2	51	53	11319
enrodillà	2	0	enrodilla	2	3	3	11320
enrogallà	2	2	enrogalla	2	0	2	11321
enrogirà	2	2	enrogira	2	0	2	11322
enrogí	2	3	enrogi	2	0	3	11323
enrogís	2	1	enrogis	2	0	1	11324
enrojolà	2	1	enrojola	2	14	15	11325
enrojolés	2	1	enrojoles	2	2	3	11326
enrojolí	2	1	enrojoli	2	0	1	11327
enrojà	2	0	enroja	2	1	1	11328
enrolarà	2	3	enrolara	2	0	3	11329
enrolà	2	242	enrola	2	66	308	11330
enrolàrem	2	0	enrolarem	2	1	1	11331
enrolés	2	5	enroles	2	0	5	11332
enrolí	2	0	enroli	2	1	1	11333
enrondà	2	0	enronda	2	1	1	11334
enronià	2	0	enronia	2	1	1	11335
enroqués	2	2	enroques	2	7	9	11336
enroquí	2	0	enroqui	2	4	4	11337
enroscà	2	5	enrosca	2	37	42	11338
enroscàrem	2	0	enroscarem	2	2	2	11339
enrosqués	2	1	enrosques	2	2	3	11340
enrosquí	2	0	enrosqui	2	1	1	11341
enrossírem	2	0	enrossirem	2	42	42	11342
enrossíreu	2	0	enrossireu	2	6	6	11343
enrosà	2	0	enrosa	2	1	1	11344
enrotllarà	2	10	enrotllara	2	2	12	11345
enrotllà	2	3	enrotlla	2	253	256	11346
enrotllàrem	2	2	enrotllarem	2	41	43	11347
enrotllàreu	2	0	enrotllareu	2	1	1	11348
enrotllés	2	3	enrotlles	2	19	22	11349
enrotllí	2	0	enrotlli	2	16	16	11350
enrunarà	2	1	enrunara	2	1	2	11351
enrunà	2	14	enruna	2	18	32	11352
enrunàrem	2	0	enrunarem	2	1	1	11353
enrunés	2	2	enrunes	2	13	15	11354
enruní	2	0	enruni	2	1	1	11355
enrònia	4	16	enronia	2	1	17	11356
enrònies	4	15	enronies	2	0	15	11357
ensabonarà	2	1	ensabonara	2	0	1	11358
ensabonà	2	3	ensabona	2	17	20	11359
ensabonàrem	2	0	ensabonarem	2	2	2	11360
ensabonés	2	1	ensabones	2	17	18	11361
ensaboní	2	0	ensaboni	2	4	4	11362
ensacà	2	0	ensaca	2	5	5	11363
ensaginà	2	0	ensagina	2	1	1	11364
ensaginí	2	1	ensagini	2	0	1	11365
ensagnà	2	0	ensagna	2	8	8	11366
ensalgà	2	0	ensalga	2	1	1	11367
ensalivà	2	0	ensaliva	2	3	3	11368
ensalivàrem	2	0	ensalivarem	2	1	1	11369
ensalivés	2	0	ensalives	2	1	1	11370
ensaliví	2	0	ensalivi	2	1	1	11371
ensangonarà	2	1	ensangonara	2	0	1	11372
ensangonà	2	2	ensangona	2	1	3	11373
ensangoní	2	0	ensangoni	2	1	1	11374
ensarrià	2	3	ensarria	2	0	3	11375
ensarronarà	2	3	ensarronara	2	1	4	11376
ensarronà	2	0	ensarrona	2	6	6	11377
ensarronàreu	2	0	ensarronareu	2	1	1	11378
ensarronés	2	0	ensarrones	2	3	3	11379
ensarroní	2	0	ensarroni	2	1	1	11380
ensellà	2	1	ensella	2	9	10	11381
ensellés	2	0	enselles	2	1	1	11382
ensenyarà	2	1751	ensenyara	2	45	1796	11383
ensenyorirà	2	1	ensenyorira	2	0	1	11384
ensenyà	2	609	ensenya	4	11090	11699	11385
ensenyàrem	2	8	ensenyarem	2	1029	1037	11386
ensenyàreu	2	4	ensenyareu	2	22	26	11387
ensenyés	2	314	ensenyes	4	583	897	11388
ensenyí	2	1	ensenyi	2	862	863	11389
enseuà	2	0	enseua	2	2	2	11390
ensimà	2	0	ensima	2	2	2	11391
ensinistrarà	2	1	ensinistrara	2	0	1	11392
ensinistrà	2	7	ensinistra	2	50	57	11393
ensinistràrem	2	0	ensinistrarem	2	3	3	11394
ensinistràreu	2	0	ensinistrareu	2	1	1	11395
ensinistrés	2	3	ensinistres	2	1	4	11396
ensitgés	2	0	ensitges	2	1	1	11397
ensitjà	2	0	ensitja	2	4	4	11398
ensitjàreu	2	0	ensitjareu	2	1	1	11399
ensivellà	2	0	ensivella	2	1	1	11400
ensivellí	2	0	ensivelli	2	1	1	11401
ensobrà	2	0	ensobra	2	4	4	11402
ensofrí	2	1	ensofri	2	0	1	11403
ensomnià	2	0	ensomnia	2	1	1	11404
ensomniés	2	0	ensomnies	2	1	1	11405
ensonyà	2	0	ensonya	2	2	2	11406
ensopegarà	2	30	ensopegara	2	2	32	11407
ensopegués	2	18	ensopegues	2	78	96	11408
ensopeguí	2	5	ensopegui	2	45	50	11409
ensopegà	2	36	ensopega	2	456	492	11410
ensopegàrem	2	6	ensopegarem	2	32	38	11411
ensopegàreu	2	0	ensopegareu	2	4	4	11412
ensopirà	2	1	ensopira	2	0	1	11413
ensordíreu	2	1	ensordireu	2	0	1	11414
ensorrarà	2	65	ensorrara	2	2	67	11415
ensorrà	2	84	ensorra	2	527	611	11416
ensorràrem	2	1	ensorrarem	2	5	6	11417
ensorràreu	2	0	ensorrareu	2	2	2	11418
ensorrés	2	63	ensorres	2	8	71	11419
ensorrí	2	0	ensorri	2	116	116	11420
ensostrà	2	1	ensostra	2	0	1	11421
ensotà	2	0	ensota	6	14	14	11422
ensucrarà	2	1	ensucrara	2	0	1	11423
ensucrà	2	0	ensucra	2	16	16	11424
ensucràrem	2	0	ensucrarem	2	6	6	11425
ensucrés	2	0	ensucres	2	1	1	11426
ensucrí	2	0	ensucri	2	3	3	11427
ensulfatí	2	0	ensulfati	2	1	1	11428
ensulsià	2	1	ensulsia	2	0	1	11429
ensulsiés	2	2	ensulsies	2	0	2	11430
ensumarà	2	9	ensumara	2	0	9	11431
ensumà	2	7	ensuma	2	373	380	11432
ensumàrem	2	2	ensumarem	2	11	13	11433
ensumàreu	2	0	ensumareu	2	1	1	11434
ensumés	2	10	ensumes	2	38	48	11435
ensumí	2	0	ensumi	2	17	17	11436
ensutjà	2	0	ensutja	2	1	1	11437
entabanarà	2	2	entabanara	2	0	2	11438
entabanà	2	1	entabana	2	33	34	11439
entabanés	2	3	entabanes	2	2	5	11440
entabaní	2	0	entabani	2	3	3	11441
entaferrà	2	4	entaferra	2	3	7	11442
entaforarà	2	2	entaforara	2	0	2	11443
entaforà	2	7	entafora	2	36	43	11444
entaforàrem	2	0	entaforarem	2	2	2	11445
entaforés	2	1	entafores	2	5	6	11446
entaforí	2	0	entafori	2	5	5	11447
entallà	2	1	entalla	4	13	14	11448
entallés	2	0	entalles	4	16	16	11449
entallí	2	0	entalli	2	2	2	11450
entapissarà	2	1	entapissara	2	0	1	11451
entapissà	2	2	entapissa	2	42	44	11452
entapissàrem	2	0	entapissarem	2	2	2	11453
entapissàreu	2	0	entapissareu	2	1	1	11454
entapissí	2	0	entapissi	2	1	1	11455
entarimà	2	0	entarima	2	1	1	11456
entatxarà	2	1	entatxara	2	0	1	11457
entatxonà	2	0	entatxona	2	1	1	11458
entatxoní	2	0	entatxoni	2	2	2	11459
entaularà	2	40	entaulara	2	0	40	11460
entaulà	2	86	entaula	2	158	244	11461
entaulàrem	2	2	entaularem	2	29	31	11462
entaulés	2	25	entaules	2	7	32	11463
entaulí	2	0	entauli	2	90	90	11464
entebionà	2	0	entebiona	2	1	1	11465
entelarà	2	6	entelara	2	0	6	11466
entelà	2	2	entela	2	143	145	11467
entelàrem	2	0	entelarem	2	2	2	11468
entelés	2	5	enteles	2	1	6	11469
entelí	2	0	enteli	2	24	24	11470
entendarà	2	1	entendara	2	0	1	11471
entendrirà	2	8	entendrira	2	1	9	11472
entendré	2	303	entendre	4	110439	110742	11473
entendrírem	2	0	entendrirem	2	1	1	11474
entendríreu	2	0	entendrireu	2	1	1	11475
entendà	2	0	entenda	2	1	1	11476
entendàreu	2	0	entendareu	2	1	1	11477
entendés	2	0	entendes	2	1	1	11478
entendí	2	3	entendi	2	1	4	11479
entengués	2	502	entengues	2	26	528	11480
entenguí	2	5	entengui	2	3555	3560	11481
enteranyinà	2	0	enteranyina	2	8	8	11482
enterbolirà	2	7	enterbolira	2	0	7	11483
entercà	2	1	enterca	0	15	16	11484
enterqués	2	0	enterques	0	2	2	11485
enterrarà	2	48	enterrara	2	0	48	11486
enterrossà	2	0	enterrossa	2	1	1	11487
enterrà	2	51	enterra	2	414	465	11488
enterràrem	2	4	enterrarem	2	37	41	11489
enterràreu	2	0	enterrareu	2	3	3	11490
enterrés	2	28	enterres	2	17	45	11491
enterrí	2	0	enterri	2	67	67	11492
entestarà	2	5	entestara	2	5	10	11493
entestà	2	14	entesta	2	589	603	11494
entestàrem	2	1	entestarem	2	1	2	11495
entestés	2	11	entestes	2	19	30	11496
entestí	2	1	entesti	2	89	90	11497
entimà	2	1	entima	4	5	6	11498
entimés	2	0	entimes	4	1	1	11499
entintarà	2	1	entintara	2	0	1	11500
entintà	2	0	entinta	2	63	63	11501
entintàrem	2	0	entintarem	2	2	2	11502
entintàreu	2	1	entintareu	2	0	1	11503
entintés	2	0	entintes	2	2	2	11504
entinà	2	0	entina	2	2	2	11505
entoixà	2	0	entoixa	2	1	1	11506
entollà	2	0	entolla	2	17	17	11507
entollí	2	0	entolli	2	6	6	11508
entomarà	2	21	entomara	2	0	21	11509
entomà	2	14	entoma	2	198	212	11510
entomàrem	2	0	entomarem	2	10	10	11511
entomàreu	2	0	entomareu	2	1	1	11512
entomés	2	8	entomes	2	10	18	11513
entomí	2	1	entomi	2	40	41	11514
entonarà	2	34	entonara	2	0	34	11515
entonà	2	36	entona	2	246	282	11516
entonàrem	2	2	entonarem	2	9	11	11517
entonàreu	2	1	entonareu	2	2	3	11518
entonés	2	11	entones	2	6	17	11519
entoní	2	0	entoni	2	27	27	11520
entorcíreu	2	0	entorcireu	2	1	1	11521
entornarà	2	3	entornara	2	0	3	11522
entornà	2	8	entorna	2	29	37	11523
entornàrem	2	0	entornarem	2	1	1	11524
entornés	2	2	entornes	2	1	3	11525
entorní	2	1	entorni	2	4	5	11526
entorpirà	2	20	entorpira	2	1	21	11527
entorpírem	2	1	entorpirem	2	0	1	11528
entortillà	2	0	entortilla	2	1	1	11529
entortolligarà	2	1	entortolligara	2	0	1	11530
entortolligués	2	2	entortolligues	2	0	2	11531
entortolliguí	2	0	entortolligui	2	3	3	11532
entortolligà	2	0	entortolliga	2	43	43	11533
entortà	2	0	entorta	2	2	2	11534
entorxà	2	0	entorxa	2	4	4	11535
entorxés	2	0	entorxes	2	6	6	11536
entossudirà	2	2	entossudira	2	0	2	11537
entossudírem	2	0	entossudirem	2	2	2	11538
entotsolà	2	2	entotsola	2	3	5	11539
entrampà	2	0	entrampa	2	6	6	11540
entrampàrem	2	0	entramparem	2	1	1	11541
entrapà	2	21	entrapa	2	7	28	11542
entrarà	2	4762	entrara	2	184	4946	11543
entravessarà	2	4	entravessara	2	0	4	11544
entravessà	2	3	entravessa	2	20	23	11545
entravessí	2	0	entravessi	2	6	6	11546
entravès	2	0	entraves	2	138	138	11547
entrebancarà	2	6	entrebancara	2	0	6	11548
entrebancà	2	10	entrebanca	2	140	150	11549
entrebancàrem	2	0	entrebancarem	2	2	2	11550
entrebanqués	2	6	entrebanques	2	9	15	11551
entrebanquí	2	0	entrebanqui	2	17	17	11552
entrebatré	2	0	entrebatre	2	1	1	11553
entrebesés	2	1	entrebeses	2	0	1	11554
entrebesí	2	0	entrebesi	2	1	1	11555
entrecamà	2	0	entrecama	2	3	3	11556
entrecamés	2	0	entrecames	2	7	7	11557
entrecavalcà	2	0	entrecavalca	2	1	1	11558
entrecavés	2	0	entrecaves	2	2	2	11559
entrecreuarà	2	5	entrecreuara	2	0	5	11560
entrecreuà	2	0	entrecreua	2	70	70	11561
entrecreués	2	1	entrecreues	2	0	1	11562
entrecreuí	2	0	entrecreui	2	1	1	11563
entrecuixà	2	0	entrecuixa	2	10	10	11564
entrecuixàrem	2	1	entrecuixarem	2	0	1	11565
entrecuixés	2	0	entrecuixes	2	2	2	11566
entreforcà	2	0	entreforca	2	1	1	11567
entregarà	2	1450	entregara	2	25	1475	11568
entregirà	2	0	entregira	2	2	2	11569
entregués	2	132	entregues	4	1664	1796	11570
entreguí	2	0	entregui	2	266	266	11571
entregà	2	259	entrega	4	30152	30411	11572
entregàrem	2	11	entregarem	2	261	272	11573
entregàreu	2	0	entregareu	2	17	17	11574
entrellacés	2	2	entrellaces	2	2	4	11575
entrellací	2	0	entrellaci	2	8	8	11576
entrellaçarà	2	7	entrellaçara	2	0	7	11577
entrellaçà	2	2	entrellaça	2	318	320	11578
entrellaçàrem	2	0	entrellaçarem	2	2	2	11579
entrelligassà	2	1	entrelligassa	2	0	1	11580
entrelligués	2	1	entrelligues	2	2	3	11581
entrelligà	2	0	entrelliga	2	34	34	11582
entrelligàrem	2	0	entrelligarem	2	1	1	11583
entrellucà	2	3	entrelluca	2	29	32	11584
entrellucàrem	2	0	entrellucarem	2	2	2	11585
entrelluqués	2	1	entrelluques	2	1	2	11586
entrelluquí	2	0	entrelluqui	2	1	1	11587
entrematés	2	0	entremates	2	2	2	11588
entremesclarà	2	1	entremesclara	2	0	1	11589
entremesclà	2	0	entremescla	2	45	45	11590
entremesclí	2	0	entremescli	2	1	1	11591
entremetré	2	0	entremetre	2	72	72	11592
entremetés	2	3	entremetes	2	0	3	11593
entremetí	2	0	entremeti	2	10	10	11594
entrenarà	2	336	entrenara	2	5	341	11595
entrenà	2	70	entrena	2	2295	2365	11596
entrenàrem	2	0	entrenarem	2	54	54	11597
entrenàreu	2	0	entrenareu	2	5	5	11598
entrenés	2	33	entrenes	2	174	207	11599
entrení	2	0	entreni	2	88	88	11600
entreobrí	2	8	entreobri	2	1	9	11601
entreplantà	2	0	entreplanta	4	29	29	11602
entreplantés	2	0	entreplantes	4	5	5	11603
entreseguirà	2	1	entreseguira	2	0	1	11604
entresquí	2	0	entresqui	2	2	2	11605
entresuà	2	0	entresua	2	2	2	11606
entresòl	4	486	entresol	4	260	746	11607
entresòls	4	14	entresols	4	13	27	11608
entretallà	2	0	entretalla	2	9	9	11609
entretallí	2	0	entretalli	2	4	4	11610
entretancà	2	0	entretanca	2	1	1	11611
entretanqués	2	0	entretanques	2	1	1	11612
entretelà	2	0	entretela	4	48	48	11613
entretelés	2	0	entreteles	4	28	28	11614
entretenguí	2	0	entretengui	2	3	3	11615
entretindré	2	88	entretindre	2	154	242	11616
entretingués	2	34	entretingues	2	1	35	11617
entretinguí	2	0	entretingui	2	121	121	11618
entreveiés	2	1	entreveies	2	1	2	11619
entreveuré	2	0	entreveure	2	3157	3157	11620
entrevindré	2	0	entrevindre	2	1	1	11621
entrevistarà	2	430	entrevistara	2	3	433	11622
entrevistà	2	165	entrevista	2	51438	51603	11623
entrevistàrem	2	13	entrevistarem	2	190	203	11624
entrevistàreu	2	0	entrevistareu	2	1	1	11625
entrevistés	2	43	entrevistes	2	19605	19648	11626
entrevistí	2	3	entrevisti	2	45	48	11627
entrevoré	2	0	entrevore	2	12	12	11628
entrevèiem	2	12	entreveiem	2	55	67	11629
entrevéiem	2	0	entreveiem	2	55	55	11630
entrevéu	2	0	entreveu	2	593	593	11631
entrexocà	2	0	entrexoca	2	1	1	11632
entrexocàrem	2	0	entrexocarem	2	1	1	11633
entrexoqués	2	0	entrexoques	2	2	2	11634
entrexoquí	2	0	entrexoqui	2	1	1	11635
entrigà	2	0	entriga	2	1	1	11636
entristirà	2	12	entristira	2	0	12	11637
entristà	2	0	entrista	2	2	2	11638
entristí	2	18	entristi	2	1	19	11639
entristírem	2	1	entristirem	2	1	2	11640
entristíreu	2	0	entristireu	2	4	4	11641
entristís	2	2	entristis	2	1	3	11642
entrompàreu	2	0	entrompareu	2	1	1	11643
entroncarà	2	1	entroncara	2	0	1	11644
entroncà	2	16	entronca	2	643	659	11645
entronitzarà	2	4	entronitzara	2	1	5	11646
entronitzà	2	18	entronitza	2	49	67	11647
entronitzí	2	0	entronitzi	2	3	3	11648
entronqués	2	3	entronques	2	2	5	11649
entronquí	2	0	entronqui	2	22	22	11650
entropessarà	2	5	entropessara	2	0	5	11651
entropessà	2	3	entropessa	2	22	25	11652
entropessàrem	2	1	entropessarem	2	1	2	11653
entropessàreu	2	0	entropessareu	2	1	1	11654
entropessés	2	0	entropesses	2	7	7	11655
entropessó	4	6	entropesso	2	0	6	11656
entrunyellàrem	2	1	entrunyellarem	2	0	1	11657
entrunyellí	2	0	entrunyelli	2	1	1	11658
entrà	2	4620	entra	2	27824	32444	11659
entràrem	2	185	entrarem	2	1749	1934	11660
entràreu	2	5	entrareu	2	400	405	11661
entrén	2	8	entren	2	12133	12141	11662
entrés	2	1729	entres	2	2682	4411	11663
entrí	2	27	entri	2	5691	5718	11664
entrò	7	8	entro	2	2531	2539	11665
entubà	2	0	entuba	2	5	5	11666
entubí	2	0	entubi	2	1	1	11667
entuixeguí	2	0	entuixegui	2	1	1	11668
enturà	2	0	entura	2	1	1	11669
entusiasmarà	2	82	entusiasmara	2	0	82	11670
entusiasmà	2	65	entusiasma	2	743	808	11671
entusiasmàrem	2	0	entusiasmarem	2	1	1	11672
entusiasmés	2	15	entusiasmes	2	137	152	11673
entusiasmí	2	0	entusiasmi	2	77	77	11674
enumerarà	2	13	enumerara	2	0	13	11675
enumerà	2	21	enumera	2	1006	1027	11676
enumeràrem	2	1	enumerarem	2	51	52	11677
enumerés	2	4	enumeres	2	8	12	11678
enumerí	2	0	enumeri	2	31	31	11679
enunciarà	2	5	enunciara	2	1	6	11680
enuncià	2	44	enuncia	2	256	300	11681
enunciàrem	2	0	enunciarem	2	8	8	11682
enunciés	2	7	enuncies	2	1	8	11683
enutgés	2	1	enutges	2	2	3	11684
enutgí	2	0	enutgi	2	6	6	11685
enutjarà	2	0	enutjara	2	1	1	11686
enutjà	2	8	enutja	2	65	73	11687
enutjós	0	199	enutjos	4	16	215	11688
envasarà	2	4	envasara	2	0	4	11689
envasà	2	0	envasa	2	174	174	11690
envasàrem	2	0	envasarem	2	9	9	11691
envasés	2	1	envases	2	27	28	11692
envasí	2	0	envasi	2	7	7	11693
envaírem	2	0	envairem	2	4	4	11694
envegès	0	0	enveges	4	620	620	11695
envegés	0	3	enveges	4	620	623	11696
envegí	2	0	envegi	2	10	10	11697
envejarà	2	7	envejara	2	1	8	11698
envejà	2	2	enveja	4	5771	5773	11699
envejàrem	2	0	envejarem	2	5	5	11700
envellirà	2	43	envellira	2	0	43	11701
envellutí	2	1	envelluti	2	0	1	11702
envellírem	2	0	envellirem	2	8	8	11703
envellíreu	2	0	envellireu	2	1	1	11704
envelà	2	1	envela	2	4	5	11705
enventàrem	2	1	enventarem	2	0	1	11706
envergà	2	3	enverga	2	7	10	11707
enverinarà	2	15	enverinara	2	0	15	11708
enverinà	2	18	enverina	2	186	204	11709
enverinàrem	2	1	enverinarem	2	0	1	11710
enverinés	2	9	enverines	2	0	9	11711
enveriní	2	0	enverini	2	14	14	11712
envermellirà	2	3	envermellira	2	0	3	11713
envernissà	2	2	envernissa	2	14	16	11714
envernissàrem	2	0	envernissarem	2	10	10	11715
envernissés	2	0	envernisses	2	1	1	11716
envernissí	2	0	envernissi	2	1	1	11717
enverà	2	0	envera	2	2	2	11718
enverés	2	0	enveres	2	1	1	11719
enverí	2	0	enveri	2	1	1	11720
envescà	2	0	envesca	2	2	2	11721
envesquí	2	0	envesqui	2	1	1	11722
envestirà	2	6	envestira	2	0	6	11723
envestírem	2	2	envestirem	2	2	4	11724
envetà	2	0	enveta	2	1	1	11725
enviarà	2	3933	enviara	2	58	3991	11726
envidrià	2	0	envidria	2	1	1	11727
enviduarà	2	1	enviduara	2	0	1	11728
enviduà	2	8	envidua	2	4	12	11729
envidà	2	0	envida	2	10	10	11730
envidés	2	0	envides	2	2	2	11731
envidí	2	0	envidi	2	2	2	11732
envinarà	2	1	envinara	2	0	1	11733
envinà	2	0	envina	2	3	3	11734
envinàreu	2	1	envinareu	2	0	1	11735
envinés	2	0	envines	2	2	2	11736
environà	2	0	environa	2	1	1	11737
enviscà	2	1	envisca	2	1	2	11738
enviscàrem	2	1	enviscarem	2	0	1	11739
envitricollà	2	0	envitricolla	2	1	1	11740
enviudà	2	33	enviuda	2	4	37	11741
enviudés	2	2	enviudes	2	1	3	11742
enviudí	2	0	enviudi	2	1	1	11743
envià	2	2119	envia	2	15999	18118	11744
enviàrem	2	40	enviarem	2	2710	2750	11745
enviàreu	2	8	enviareu	2	53	61	11746
enviés	2	667	envies	2	650	1317	11747
envií	2	63	envii	2	206	269	11748
envolarà	2	5	envolara	2	0	5	11749
envoltarà	2	141	envoltara	2	3	144	11750
envoltà	2	131	envolta	0	18172	18303	11751
envoltàrem	2	1	envoltarem	2	34	35	11752
envoltàreu	2	0	envoltareu	2	3	3	11753
envoltés	2	27	envoltes	0	54	81	11754
envoltí	2	0	envolti	2	116	116	11755
envolupà	2	0	envolupa	2	4	4	11756
envolà	2	8	envola	2	58	66	11757
envolés	2	5	envoles	2	2	7	11758
envolí	2	0	envoli	2	4	4	11759
enxamparà	2	16	enxampara	2	1	17	11760
enxampà	2	11	enxampa	2	218	229	11761
enxampàrem	2	0	enxamparem	2	15	15	11762
enxampàreu	2	0	enxampareu	2	1	1	11763
enxampés	2	48	enxampes	2	17	65	11764
enxampí	2	0	enxampi	2	78	78	11765
enxarxà	2	0	enxarxa	2	84	84	11766
enxarxés	2	0	enxarxes	2	2	2	11767
enxiquirà	2	0	enxiquira	2	1	1	11768
enxisà	2	0	enxisa	2	6	6	11769
enyorarà	2	32	enyorara	2	0	32	11770
enyorà	2	8	enyora	2	544	552	11771
enyoràrem	2	1	enyorarem	2	89	90	11772
enyoràreu	2	1	enyorareu	2	9	10	11773
enyorés	2	14	enyores	2	110	124	11774
enyorí	2	0	enyori	2	40	40	11775
enèmic	0	20	enemic	0	13028	13048	11776
enèmics	0	12	enemics	0	11290	11302	11777
epilogà	2	2	epiloga	2	1	3	11778
epilà	2	0	epila	2	3	3	11779
episodià	2	0	episodia	2	2	2	11780
episodiés	2	0	episodies	2	3	3	11781
epístoma	4	0	epistoma	4	2	2	11782
equalitzà	2	0	equalitza	2	16	16	11783
equalitzés	2	1	equalitzes	2	0	1	11784
equalitzí	2	0	equalitzi	2	1	1	11785
equidistà	2	0	equidista	2	15	15	11786
equilibrarà	2	34	equilibrara	2	1	35	11787
equilibrà	2	7	equilibra	2	676	683	11788
equilibràrem	2	0	equilibrarem	2	5	5	11789
equilibrés	2	18	equilibres	2	14	32	11790
equilibrí	2	2	equilibri	2	34374	34376	11791
equipararà	2	47	equiparara	2	2	49	11792
equiparà	2	78	equipara	2	644	722	11793
equiparàrem	2	0	equipararem	2	8	8	11794
equiparé	2	0	equipare	2	22	22	11795
equiparés	2	17	equipares	2	2	19	11796
equiparí	2	0	equipari	2	131	131	11797
equipà	2	16	equipa	2	435	451	11798
equipàrem	2	1	equiparem	2	41	42	11799
equipàreu	2	0	equipareu	2	3	3	11800
equipés	2	56	equipes	2	7	63	11801
equipí	2	1	equipi	2	36	37	11802
equivaldré	2	0	equivaldre	2	67	67	11803
equivalgués	2	8	equivalgues	2	0	8	11804
equivalguí	2	0	equivalgui	2	82	82	11805
equivocarà	2	56	equivocara	2	2	58	11806
equivocà	2	32	equivoca	2	1512	1544	11807
equivocàrem	2	9	equivocarem	2	96	105	11808
equivocàreu	2	1	equivocareu	2	20	21	11809
equivoqués	2	55	equivoques	2	410	465	11810
equivoquí	2	1	equivoqui	2	487	488	11811
equívoc	0	492	equivoc	4	58	550	11812
equívoca	0	158	equivoca	2	1512	1670	11813
equívocs	0	449	equivocs	4	18	467	11814
equívoques	0	80	equivoques	2	410	490	11815
eregí	2	2	eregi	2	0	2	11816
ererà	2	0	erera	4	9	9	11817
ergotitzí	2	1	ergotitzi	2	0	1	11818
ericés	2	1	erices	2	1	2	11819
ericí	2	0	erici	2	4	4	11820
erigirà	2	54	erigira	2	2	56	11821
erigírem	2	3	erigirem	2	2	5	11822
eriçarà	2	9	eriçara	2	0	9	11823
eriçonà	2	0	eriçona	2	6	6	11824
eriçonés	2	1	eriçones	2	0	1	11825
eriçà	2	3	eriça	2	57	60	11826
eriçàrem	2	0	eriçarem	2	1	1	11827
ermà	2	2	erma	0	315	317	11828
ermés	2	0	ermes	0	262	262	11829
ermí	2	2	ermi	2	7	9	11830
erogarà	2	2	erogara	2	0	2	11831
erogués	2	0	erogues	2	1	1	11832
erogà	2	0	eroga	2	7	7	11833
erolà	2	0	erola	4	350	350	11834
erolés	2	0	eroles	4	372	372	11835
erosionarà	2	12	erosionara	2	0	12	11836
erosionà	2	10	erosiona	2	269	279	11837
erosionàrem	2	0	erosionarem	2	1	1	11838
erosionés	2	1	erosiones	2	1	2	11839
erosioní	2	0	erosioni	2	25	25	11840
erotitzà	2	0	erotitza	2	11	11	11841
erradicarà	2	15	erradicara	2	0	15	11842
erradicà	2	4	erradica	2	18	22	11843
erradicàrem	2	0	erradicarem	2	10	10	11844
erradiqués	2	2	erradiques	2	0	2	11845
erradiquí	2	0	erradiqui	2	27	27	11846
errarà	2	10	errara	2	0	10	11847
errà	2	35	erra	4	1236	1271	11848
erràrem	2	4	errarem	2	9	13	11849
erràreu	2	0	errareu	2	3	3	11850
errés	2	11	erres	4	208	219	11851
errí	2	0	erri	2	184	184	11852
eructà	2	0	eructa	2	8	8	11853
eructés	2	0	eructes	2	25	25	11854
erupcionà	2	1	erupciona	2	17	18	11855
erupcionés	2	1	erupciones	2	2	3	11856
erupcioní	2	0	erupcioni	2	3	3	11857
esbadellà	2	0	esbadella	2	5	5	11858
esbadiní	2	1	esbadini	2	0	1	11859
esbadocà	2	0	esbadoca	2	1	1	11860
esbajocà	2	0	esbajoca	2	1	1	11861
esbajoquí	2	1	esbajoqui	2	0	1	11862
esbaldregà	2	1	esbaldrega	2	3	4	11863
esbaldírem	2	0	esbaldirem	2	1	1	11864
esbalçà	2	1	esbalça	2	5	6	11865
esbandirà	2	3	esbandira	2	0	3	11866
esbandírem	2	0	esbandirem	2	13	13	11867
esbardellà	2	1	esbardella	2	1	2	11868
esbardissí	2	0	esbardissi	2	1	1	11869
esbarjós	0	2	esbarjos	4	59	61	11870
esbarrejà	2	0	esbarreja	2	1	1	11871
esbarrià	2	1	esbarria	2	7	8	11872
esbarrés	2	0	esbarres	2	1	1	11873
esbarzerà	2	0	esbarzera	2	1	1	11874
esbarzerés	2	0	esbarzeres	2	1	1	11875
esbatanà	2	3	esbatana	2	16	19	11876
esbatanés	2	0	esbatanes	2	1	1	11877
esbataní	2	0	esbatani	2	1	1	11878
esbatussà	2	1	esbatussa	2	13	14	11879
esbatussés	2	0	esbatusses	2	1	1	11880
esbatussí	2	0	esbatussi	2	1	1	11881
esbatussó	4	1	esbatusso	2	0	1	11882
esbelegués	2	0	esbelegues	2	1	1	11883
esbellussà	2	0	esbellussa	2	1	1	11884
esberlarà	2	12	esberlara	2	0	12	11885
esberlà	2	10	esberla	4	195	205	11886
esberlàrem	2	0	esberlarem	2	1	1	11887
esberlés	2	10	esberles	4	18	28	11888
esberlí	2	1	esberli	2	17	18	11889
esbiaixarà	2	3	esbiaixara	2	0	3	11890
esbiaixà	2	2	esbiaixa	2	33	35	11891
esbiaixés	2	0	esbiaixes	2	1	1	11892
esbiaixí	2	0	esbiaixi	2	6	6	11893
esbiegà	2	0	esbiega	2	2	2	11894
esblaimà	2	3	esblaima	2	1	4	11895
esblenà	2	0	esblena	2	1	1	11896
esbocinà	2	4	esbocina	2	17	21	11897
esbocinés	2	1	esbocines	2	0	1	11898
esbociní	2	0	esbocini	2	2	2	11899
esboirà	2	0	esboira	2	3	3	11900
esboirés	2	1	esboires	2	0	1	11901
esboldregà	2	0	esboldrega	2	4	4	11902
esbombarà	2	2	esbombara	2	0	2	11903
esbombolí	2	0	esbomboli	2	1	1	11904
esbombà	2	2	esbomba	2	30	32	11905
esbombés	2	5	esbombes	2	1	6	11906
esbombí	2	0	esbombi	2	9	9	11907
esboquí	2	0	esboqui	2	1	1	11908
esbordellà	2	0	esbordella	2	1	1	11909
esbordellàrem	2	1	esbordellarem	2	0	1	11910
esbordellí	2	0	esbordelli	2	1	1	11911
esborrallà	2	0	esborralla	2	3	3	11912
esborrarà	2	376	esborrara	2	9	385	11913
esborrifà	2	0	esborrifa	2	1	1	11914
esborronarà	2	4	esborronara	2	0	4	11915
esborronà	2	1	esborrona	2	104	105	11916
esborronés	2	1	esborrones	2	1	2	11917
esborroní	2	0	esborroni	2	2	2	11918
esborrà	2	43	esborra	2	1877	1920	11919
esborràrem	2	1	esborrarem	2	43	44	11920
esborràreu	2	0	esborrareu	2	10	10	11921
esborrés	2	77	esborres	2	51	128	11922
esborrí	2	0	esborri	2	366	366	11923
esboscassarà	2	0	esboscassara	2	1	1	11924
esbossarà	2	20	esbossara	2	0	20	11925
esbossà	2	49	esbossa	2	392	441	11926
esbossàrem	2	1	esbossarem	2	9	10	11927
esbossàreu	2	1	esbossareu	2	1	2	11928
esbossés	2	6	esbosses	2	6	12	11929
esbossí	2	0	esbossi	2	37	37	11930
esbotifarrí	2	0	esbotifarri	2	1	1	11931
esbotzarà	2	1	esbotzara	2	0	1	11932
esbotzà	2	3	esbotza	2	19	22	11933
esbotzàrem	2	0	esbotzarem	2	2	2	11934
esbotzés	2	1	esbotzes	2	0	1	11935
esbotzí	2	0	esbotzi	2	3	3	11936
esbramegà	2	0	esbramega	2	3	3	11937
esbrancà	2	0	esbranca	2	4	4	11938
esbranquí	2	0	esbranqui	2	1	1	11939
esbraonà	2	0	esbraona	2	2	2	11940
esbravà	2	0	esbrava	2	68	68	11941
esbravés	2	3	esbraves	2	0	3	11942
esbraví	2	0	esbravi	2	12	12	11943
esbrinarà	2	39	esbrinara	2	4	43	11944
esbrinà	2	5	esbrina	2	322	327	11945
esbrinàrem	2	2	esbrinarem	2	143	145	11946
esbrinàreu	2	0	esbrinareu	2	24	24	11947
esbrinés	2	21	esbrines	2	15	36	11948
esbriní	2	0	esbrini	2	110	110	11949
esbrollà	2	0	esbrolla	2	2	2	11950
esbroncarà	2	1	esbroncara	2	0	1	11951
esbroncà	2	0	esbronca	2	59	59	11952
esbronqués	2	8	esbronques	2	3	11	11953
esbronquí	2	0	esbronqui	2	4	4	11954
esbrossà	2	0	esbrossa	2	3	3	11955
esbrossés	2	0	esbrosses	2	4	4	11956
esbrossí	2	0	esbrossi	2	3	3	11957
esbrotonàrem	2	0	esbrotonarem	2	1	1	11958
esbucarà	2	1	esbucara	2	0	1	11959
esbucà	2	7	esbuca	2	19	26	11960
esbucàrem	2	0	esbucarem	2	1	1	11961
esbudellarà	2	6	esbudellara	2	0	6	11962
esbudellà	2	1	esbudella	2	29	30	11963
esbudellàrem	2	0	esbudellarem	2	2	2	11964
esbudellés	2	0	esbudelles	2	1	1	11965
esbudellí	2	0	esbudelli	2	1	1	11966
esbufegués	2	0	esbufegues	2	3	3	11967
esbufegà	2	4	esbufega	2	79	83	11968
esbufegàrem	2	0	esbufegarem	2	1	1	11969
esbullà	2	0	esbulla	2	5	5	11970
esbullés	2	0	esbulles	2	2	2	11971
esbullí	2	0	esbulli	2	1	1	11972
esbuqués	2	2	esbuques	2	1	3	11973
esbuquí	2	0	esbuqui	2	12	12	11974
esbutzà	2	0	esbutza	2	3	3	11975
esbutzàrem	2	2	esbutzarem	2	0	2	11976
escabellà	2	0	escabella	2	5	5	11977
escabetxà	2	0	escabetxa	2	2	2	11978
escabetxés	2	0	escabetxes	2	1	1	11979
escabetxí	2	0	escabetxi	2	1	1	11980
escabridà	2	0	escabrida	2	3	3	11981
escabridés	2	0	escabrides	2	1	1	11982
escabussó	4	2	escabusso	2	0	2	11983
escagarrinarà	2	1	escagarrinara	2	0	1	11984
escagarrinà	2	0	escagarrina	2	1	1	11985
escagarriní	2	0	escagarrini	2	1	1	11986
escagassà	2	0	escagassa	2	1	1	11987
escaigués	2	47	escaigues	2	0	47	11988
escaiguí	2	1	escaigui	2	976	977	11989
escainà	2	0	escaina	2	2	2	11990
escairà	2	0	escaira	2	25	25	11991
escairés	2	0	escaires	2	78	78	11992
escalabornà	2	0	escalaborna	2	3	3	11993
escalaborní	2	0	escalaborni	2	2	2	11994
escalabrà	2	0	escalabra	2	4	4	11995
escalarà	2	65	escalara	2	2	67	11996
escaldarà	2	3	escaldara	2	0	3	11997
escaldufà	2	0	escaldufa	2	1	1	11998
escaldà	2	128	escalda	4	259	387	11999
escaldàrem	2	0	escaldarem	2	46	46	12000
escaldàreu	2	0	escaldareu	2	2	2	12001
escaldés	2	1	escaldes	4	1963	1964	12002
escaldí	2	0	escaldi	2	5	5	12003
escaldó	4	4	escaldo	2	10	14	12004
escalenòedre	4	0	escalenoedre	4	1	1	12005
escalenòedres	4	1	escalenoedres	4	1	2	12006
escalfarà	2	137	escalfara	2	2	139	12007
escalfà	2	19	escalfa	2	2706	2725	12008
escalfàrem	2	1	escalfarem	2	127	128	12009
escalfàreu	2	0	escalfareu	2	10	10	12010
escalfés	2	52	escalfes	2	60	112	12011
escalfí	2	1	escalfi	2	310	311	12012
escalivà	2	0	escaliva	2	15	15	12013
escalivàrem	2	0	escalivarem	2	12	12	12014
escallà	2	0	escalla	2	1	1	12015
escallés	2	0	escalles	2	1	1	12016
escalonarà	2	1	escalonara	2	0	1	12017
escalonà	2	0	escalona	4	260	260	12018
escalonés	2	0	escalones	2	27	27	12019
escaloní	2	0	escaloni	2	4	4	12020
escalopà	2	0	escalopa	4	77	77	12021
escalopés	2	0	escalopes	4	32	32	12022
escalopí	2	1	escalopi	2	0	1	12023
escalà	2	27	escala	4	62434	62461	12024
escalàrem	2	1	escalarem	2	35	36	12025
escalàreu	2	0	escalareu	2	5	5	12026
escalè	0	50	escale	2	71	121	12027
escalé	0	197	escale	2	71	268	12028
escalés	2	20	escales	4	19058	19078	12029
escalí	2	0	escali	2	49	49	12030
escaló	4	466	escalo	2	77	543	12031
escamarlà	2	268	escamarla	2	2	270	12032
escamnà	2	0	escamna	2	2	2	12033
escamotejà	2	1	escamoteja	2	22	23	12034
escamotés	2	1	escamotes	2	0	1	12035
escamparà	2	110	escampara	2	8	118	12036
escampà	2	215	escampa	2	1649	1864	12037
escampàrem	2	3	escamparem	2	57	60	12038
escampàreu	2	0	escampareu	2	2	2	12039
escampés	2	73	escampes	2	28	101	12040
escampí	2	2	escampi	2	314	316	12041
escamà	2	1	escama	4	39	40	12042
escamés	2	0	escames	4	312	312	12043
escandalitzarà	2	23	escandalitzara	2	4	27	12044
escandalitzà	2	32	escandalitza	2	381	413	12045
escandalitzàrem	2	0	escandalitzarem	2	6	6	12046
escandalitzàreu	2	0	escandalitzareu	2	3	3	12047
escandalitzés	2	18	escandalitzes	2	4	22	12048
escandalitzí	2	0	escandalitzi	2	42	42	12049
escandallà	2	0	escandalla	2	3	3	12050
escandirà	2	1	escandira	2	0	1	12051
escandí	2	0	escandi	4	46	46	12052
escandís	2	1	escandis	4	0	1	12053
escanegés	2	1	escaneges	2	12	13	12054
escanegí	2	0	escanegi	2	19	19	12055
escanejarà	2	26	escanejara	2	0	26	12056
escanejà	2	1	escaneja	2	328	329	12057
escanejàrem	2	0	escanejarem	2	14	14	12058
escantellà	2	0	escantella	2	5	5	12059
escantonà	2	0	escantona	2	3	3	12060
escanyarà	2	13	escanyara	2	2	15	12061
escanyussà	2	1	escanyussa	2	1	2	12062
escanyà	2	4	escanya	2	295	299	12063
escanyàrem	2	0	escanyarem	2	1	1	12064
escanyés	2	7	escanyes	2	11	18	12065
escanyí	2	0	escanyi	2	19	19	12066
escanyó	4	0	escanyo	2	8	8	12067
escaparà	2	221	escapara	2	19	240	12068
escapcés	2	5	escapces	4	6	11	12069
escapcí	2	0	escapci	2	17	17	12070
escapolirà	2	2	escapolira	2	0	2	12071
escapollàreu	2	1	escapollareu	2	0	1	12072
escapolà	2	0	escapola	2	1	1	12073
escapolàreu	2	1	escapolareu	2	0	1	12074
escapolí	2	22	escapoli	2	3	25	12075
escapolírem	2	0	escapolirem	2	1	1	12076
escapolís	2	5	escapolis	2	0	5	12077
escapoló	4	4	escapolo	2	0	4	12078
escapà	2	242	escapa	2	5838	6080	12079
escapàrem	2	3	escaparem	2	40	43	12080
escapàreu	2	0	escapareu	2	16	16	12081
escapçarà	2	13	escapçara	2	1	14	12082
escapçà	2	12	escapça	4	257	269	12083
escapçàrem	2	0	escapçarem	2	2	2	12084
escapés	2	256	escapes	2	129	385	12085
escapí	2	1	escapi	2	933	934	12086
escaquegés	2	1	escaqueges	2	1	2	12087
escaquegí	2	0	escaquegi	2	5	5	12088
escaquejà	2	0	escaqueja	2	12	12	12089
escaquejàrem	2	1	escaquejarem	2	0	1	12090
escaramussà	2	0	escaramussa	4	197	197	12091
escaramussés	2	0	escaramusses	4	307	307	12092
escarbotà	2	0	escarbota	2	2	2	12093
escarbà	2	0	escarba	2	6	6	12094
escarbés	2	0	escarbes	2	3	3	12095
escardarà	2	1	escardara	2	0	1	12096
escardà	2	0	escarda	2	6	6	12097
escardés	2	0	escardes	2	3	3	12098
escardí	2	1	escardi	2	1	2	12099
escarificà	2	0	escarifica	2	3	3	12100
escarificàrem	2	0	escarificarem	2	1	1	12101
escarmentarà	2	6	escarmentara	2	0	6	12102
escarmentà	2	1	escarmenta	2	11	12	12103
escarmentàrem	2	0	escarmentarem	2	1	1	12104
escarmentí	2	0	escarmenti	2	3	3	12105
escarmenà	2	0	escarmena	2	16	16	12106
escarní	2	5	escarni	4	945	950	12107
escarnís	2	1	escarnis	4	99	100	12108
escarotà	2	1	escarota	2	2	3	12109
escarotés	2	0	escarotes	2	1	1	12110
escarranxà	2	0	escarranxa	2	1	1	12111
escarranxés	2	1	escarranxes	2	0	1	12112
escarrassarà	2	3	escarrassara	2	0	3	12113
escarrassà	2	3	escarrassa	2	43	46	12114
escarrassés	2	3	escarrasses	2	4	7	12115
escarrassí	2	0	escarrassi	2	15	15	12116
escarrassó	4	1	escarrasso	2	18	19	12117
escarritxà	2	0	escarritxa	2	1	1	12118
escarrufà	2	2	escarrufa	2	44	46	12119
escarrufí	2	0	escarrufi	2	1	1	12120
escarrà	2	68	escarra	2	8	76	12121
escarràssem	2	0	escarrassem	2	32	32	12122
escarràsseu	2	0	escarrasseu	2	9	9	12123
escartejà	2	0	escarteja	2	1	1	12124
escarxofà	2	0	escarxofa	4	79	79	12125
escarxofés	2	0	escarxofes	4	80	80	12126
escarxà	2	0	escarxa	2	2	2	12127
escarà	2	0	escara	2	39	39	12128
escaré	2	1	escare	2	0	1	12129
escarés	2	0	escares	2	9	9	12130
escarí	2	0	escari	2	2	2	12131
escassegés	2	1	escasseges	2	0	1	12132
escassegí	2	0	escassegi	2	18	18	12133
escassejarà	2	5	escassejara	2	0	5	12134
escassejà	2	1	escasseja	2	245	246	12135
escassejàreu	2	0	escassejareu	2	1	1	12136
escatainà	2	0	escataina	2	2	2	12137
escatainí	2	0	escataini	2	1	1	12138
escatarà	2	2	escatara	2	0	2	12139
escatimarà	2	82	escatimara	2	2	84	12140
escatimà	2	10	escatima	2	206	216	12141
escatimàrem	2	0	escatimarem	2	34	34	12142
escatimés	2	3	escatimes	2	3	6	12143
escatimí	2	0	escatimi	2	24	24	12144
escatirà	2	2	escatira	2	0	2	12145
escatxiguí	2	0	escatxigui	2	1	1	12146
escatxigà	2	0	escatxiga	2	2	2	12147
escatà	2	2	escata	4	215	217	12148
escatés	2	0	escates	4	1287	1287	12149
escatí	2	2	escati	2	3	5	12150
escatírem	2	0	escatirem	2	2	2	12151
escatíreu	2	0	escatireu	2	1	1	12152
escatís	2	1	escatis	2	1	2	12153
escauré	2	2	escaure	2	169	171	12154
escenificarà	2	128	escenificara	2	0	128	12155
escenificà	2	25	escenifica	2	639	664	12156
escenificàrem	2	2	escenificarem	2	7	9	12157
escenifiqués	2	7	escenifiques	2	5	12	12158
escenifiquí	2	0	escenifiqui	2	18	18	12159
escindirà	2	9	escindira	2	0	9	12160
escindírem	2	0	escindirem	2	1	1	12161
escintil·làreu	2	0	escintil·lareu	2	2	2	12162
esclafarà	2	22	esclafara	2	0	22	12163
esclafirà	2	0	esclafira	2	1	1	12164
esclafà	2	26	esclafa	2	179	205	12165
esclafàrem	2	0	esclafarem	2	7	7	12166
esclafàreu	2	0	esclafareu	2	1	1	12167
esclafés	2	23	esclafes	2	4	27	12168
esclafí	2	17	esclafi	2	32	49	12169
esclafírem	2	0	esclafirem	2	1	1	12170
esclafís	2	1	esclafis	2	3	4	12171
esclarirà	2	17	esclarira	2	0	17	12172
esclarissà	2	0	esclarissa	2	8	8	12173
esclarírem	2	0	esclarirem	2	3	3	12174
esclatarà	2	247	esclatara	2	15	262	12175
esclatà	2	1219	esclata	2	1970	3189	12176
esclatàrem	2	1	esclatarem	2	1	2	12177
esclatàreu	2	0	esclatareu	2	1	1	12178
esclatés	2	338	esclates	2	12	350	12179
esclatí	2	2	esclati	2	301	303	12180
esclató	4	2	esclato	2	16	18	12181
esclavitzarà	2	6	esclavitzara	2	0	6	12182
esclavitzà	2	8	esclavitza	2	145	153	12183
esclavitzàrem	2	0	esclavitzarem	2	1	1	12184
esclavitzí	2	0	esclavitzi	2	11	11	12185
esclerosà	2	0	esclerosa	2	5	5	12186
esclerosés	2	0	escleroses	2	1	1	12187
esclerosí	2	0	esclerosi	2	4022	4022	12188
esclerotitzà	2	0	esclerotitza	2	2	2	12189
esclofollà	2	0	esclofolla	4	2	2	12190
esclofollàreu	2	2	esclofollareu	2	0	2	12191
esclofollés	2	0	esclofolles	4	2	2	12192
esclovellà	2	1	esclovella	2	3	4	12193
escodrinyarà	2	1	escodrinyara	2	0	1	12194
escodrinyà	2	2	escodrinya	2	33	35	12195
escodrinyés	2	2	escodrinyes	2	2	4	12196
escodrinyí	2	0	escodrinyi	2	2	2	12197
escodà	2	2	escoda	4	848	850	12198
escodés	2	0	escodes	4	4	4	12199
escodí	2	0	escodi	2	220	220	12200
escolaritzarà	2	5	escolaritzara	2	0	5	12201
escolaritzà	2	2	escolaritza	2	104	106	12202
escolaritzés	2	3	escolaritzes	2	2	5	12203
escolaritzí	2	0	escolaritzi	2	13	13	12204
escolarà	2	12	escolara	2	5	17	12205
escolià	2	0	escolia	2	1	1	12206
escoliés	2	0	escolies	2	9	9	12207
escollarés	2	0	escollares	2	1	1	12208
escollirà	2	1210	escollira	2	15	1225	12209
escollà	2	0	escolla	2	8	8	12210
escollés	2	0	escolles	2	3	3	12211
escollí	2	350	escolli	2	58	408	12212
escollírem	2	12	escollirem	2	321	333	12213
escollíreu	2	1	escollireu	2	34	35	12214
escollís	2	202	escollis	2	21	223	12215
escoltarà	2	553	escoltara	2	40	593	12216
escoltà	2	219	escolta	0	17785	18004	12217
escoltàrem	2	73	escoltarem	2	1780	1853	12218
escoltàreu	2	5	escoltareu	2	318	323	12219
escoltés	2	302	escoltes	0	4845	5147	12220
escoltí	2	6	escolti	2	2362	2368	12221
escolàrem	2	0	escolarem	2	2	2	12222
escolés	2	22	escoles	4	95641	95663	12223
escolí	2	0	escoli	2	94	94	12224
escombrarà	2	48	escombrara	2	1	49	12225
escombrà	2	17	escombra	4	1482	1499	12226
escombràrem	2	0	escombrarem	2	8	8	12227
escombrés	2	13	escombres	4	409	422	12228
escombrí	2	0	escombri	2	51	51	12229
escomencés	2	1	escomences	2	3	4	12230
escomencí	2	1	escomenci	2	2	3	12231
escomençarà	2	6	escomençara	2	3	9	12232
escomençà	2	37	escomença	2	66	103	12233
escomençàrem	2	1	escomençarem	2	7	8	12234
escometré	2	1	escometre	2	1336	1337	12235
escometés	2	7	escometes	2	5	12	12236
escometí	2	0	escometi	2	23	23	12237
esconyà	2	0	esconya	2	1	1	12238
esconyí	2	0	esconyi	2	1	1	12239
escopetegés	2	1	escopeteges	2	0	1	12240
escopetejà	2	0	escopeteja	2	1	1	12241
escopetejàrem	2	0	escopetejarem	2	1	1	12242
escopinyà	2	1	escopinya	4	81	82	12243
escopinyés	2	0	escopinyes	4	434	434	12244
escopinyí	2	0	escopinyi	2	1	1	12245
escopinà	2	0	escopina	4	6	6	12246
escopinés	2	0	escopines	4	2	2	12247
escopiní	2	0	escopini	2	1	1	12248
escopirà	2	10	escopira	2	1	11	12249
escopírem	2	0	escopirem	2	2	2	12250
escopíreu	2	0	escopireu	2	1	1	12251
escorarà	2	1	escorara	2	0	1	12252
escorcollarà	2	9	escorcollara	2	0	9	12253
escorcollà	2	22	escorcolla	2	107	129	12254
escorcollàreu	2	0	escorcollareu	2	2	2	12255
escorcollés	2	7	escorcolles	2	2	9	12256
escorcollí	2	0	escorcolli	2	6	6	12257
escorcés	2	2	escorces	4	241	243	12258
escorniflàrem	2	0	escorniflarem	2	1	1	12259
escornà	2	0	escorna	2	41	41	12260
escorpitarà	2	0	escorpitara	2	1	1	12261
escorpità	2	0	escorpita	2	1	1	12262
escorporà	2	0	escorpora	2	21	21	12263
escorporés	2	0	escorpores	2	6	6	12264
escorranqués	2	1	escorranques	2	0	1	12265
escorregués	2	3	escorregues	2	1	4	12266
escorregà	2	0	escorrega	2	1	1	12267
escortarà	2	3	escortara	2	0	3	12268
escortà	2	14	escorta	4	1435	1449	12269
escortàrem	2	0	escortarem	2	3	3	12270
escortés	2	5	escortes	4	303	308	12271
escortí	2	0	escorti	2	2	2	12272
escorxarà	2	4	escorxara	2	0	4	12273
escorxà	2	3	escorxa	4	33	36	12274
escorxàreu	2	0	escorxareu	2	1	1	12275
escorxés	2	3	escorxes	4	4	7	12276
escorà	2	3	escora	4	75	78	12277
escorçarà	2	1	escorçara	2	0	1	12278
escorçà	2	0	escorça	4	4146	4146	12279
escorés	2	1	escores	4	0	1	12280
escorí	2	1	escori	2	23	24	12281
escossés	2	9	escosses	2	3	12	12282
escossí	2	1	escossi	2	2	3	12283
escotxegà	2	0	escotxega	2	1	1	12284
escotà	2	0	escota	4	71	71	12285
escotàrem	2	0	escotarem	2	1	1	12286
escotés	2	0	escotes	4	24	24	12287
escotí	2	0	escoti	2	5	5	12288
escoà	2	0	escoa	2	4	4	12289
escoés	2	0	escoes	2	5	5	12290
escrebantà	2	0	escrebanta	2	1	1	12291
escridassarà	2	1	escridassara	2	0	1	12292
escridassà	2	13	escridassa	2	88	101	12293
escridassàreu	2	0	escridassareu	2	2	2	12294
escridassés	2	4	escridasses	2	2	6	12295
escridassí	2	0	escridassi	2	7	7	12296
escridà	2	0	escrida	2	1	1	12297
escridàssem	2	0	escridassem	2	8	8	12298
escridés	2	0	escrides	2	1	1	12299
escrigués	2	235	escrigues	4	40	275	12300
escriguí	2	37	escrigui	2	1620	1657	12301
escripturà	2	2	escriptura	4	26575	26577	12302
escripturària	0	4	escripturaria	2	1	5	12303
escripturàries	0	5	escripturaries	2	0	5	12304
escripturés	2	2	escriptures	4	2677	2679	12305
escriuré	2	874	escriure	2	98203	99077	12306
escrostonarà	2	1	escrostonara	2	0	1	12307
escrostonà	2	0	escrostona	2	9	9	12308
escrostoní	2	0	escrostoni	2	4	4	12309
escrostà	2	0	escrosta	2	1	1	12310
escruixíreu	2	0	escruixireu	2	1	1	12311
escrutarà	2	8	escrutara	2	0	8	12312
escrutà	2	6	escruta	2	70	76	12313
escrutàrem	2	1	escrutarem	2	3	4	12314
escrutés	2	0	escrutes	2	6	6	12315
escrutí	2	0	escruti	2	2	2	12316
escudarà	2	1	escudara	2	1	2	12317
escudellà	2	2	escudella	4	2010	2012	12318
escudellés	2	0	escudelles	4	207	207	12319
escudà	2	3	escuda	2	144	147	12320
escudàrem	2	0	escudarem	2	1	1	12321
escudés	2	4	escudes	2	1	5	12322
escudí	2	2	escudi	2	24	26	12323
escuixà	2	0	escuixa	2	1	1	12324
escuixàrem	2	0	escuixarem	2	1	1	12325
escullà	2	0	esculla	2	8	8	12326
escullés	2	2	esculles	2	3	5	12327
escullí	2	3	esculli	2	736	739	12328
esculpirà	2	6	esculpira	2	0	6	12329
esculpírem	2	0	esculpirem	2	2	2	12330
esculturà	2	1	escultura	4	17145	17146	12331
esculturés	2	0	escultures	4	9196	9196	12332
esculà	2	0	escula	2	5	5	12333
esculés	2	0	escules	2	1	1	12334
escumejà	2	0	escumeja	2	6	6	12335
escumà	2	0	escuma	4	4748	4748	12336
escumàrem	2	0	escumarem	2	4	4	12337
escumés	2	0	escumes	4	367	367	12338
escumí	2	0	escumi	2	1	1	12339
escuncés	2	1	escunces	2	0	1	12340
escunçà	2	2	escunça	2	3	5	12341
escurarà	2	3	escurara	2	0	3	12342
escurcés	2	22	escurces	2	10	32	12343
escurcí	2	0	escurci	2	53	53	12344
escurà	2	19	escura	2	229	248	12345
escuràrem	2	1	escurarem	2	1	2	12346
escurçarà	2	81	escurçara	2	1	82	12347
escurçà	2	16	escurça	2	600	616	12348
escurçàrem	2	1	escurçarem	2	15	16	12349
escurçàreu	2	0	escurçareu	2	2	2	12350
escurçó	4	466	escurço	2	22	488	12351
escurés	2	2	escures	2	6	8	12352
escurí	2	0	escuri	2	5	5	12353
escuró	4	0	escuro	2	13	13	12354
escutià	2	1	escutia	2	66	67	12355
escuà	2	0	escua	4	3	3	12356
escués	2	0	escues	4	9	9	12357
escà	2	4	esca	4	336	340	12358
escàlem	4	7	escalem	2	136	143	12359
escàpol	0	126	escapol	2	2	128	12360
escàpola	0	14	escapola	2	1	15	12361
escàpoles	0	6	escapoles	2	0	6	12362
escàreu	2	0	escareu	2	2	2	12363
escàrpia	4	2	escarpia	2	5	7	12364
escàrpies	4	4	escarpies	2	8	12	12365
escòlia	4	0	escolia	2	1	1	12366
escòlies	4	0	escolies	2	9	9	12367
escòs	2	10	escos	4	2	12	12368
escó	4	2984	esco	2	125	3109	12369
escórpora	4	175	escorpora	2	21	196	12370
escórpores	4	73	escorpores	2	6	79	12371
escórrega	2	3	escorrega	2	1	4	12372
escórreguen	2	1	escorreguen	2	0	1	12373
escórregues	2	0	escorregues	2	1	1	12374
esdentàrem	2	1	esdentarem	2	0	1	12375
esderneguí	2	0	esdernegui	2	2	2	12376
esdernegà	2	0	esdernega	2	1	1	12377
esdevenguí	2	2	esdevengui	2	87	89	12378
esdevindré	2	32	esdevindre	2	488	520	12379
esdevingués	2	898	esdevingues	2	9	907	12380
esdevinguí	2	12	esdevingui	2	5091	5103	12381
esfarinés	2	0	esfarines	2	1	1	12382
esferificarà	2	2	esferificara	2	0	2	12383
esferificà	2	0	esferifica	2	2	2	12384
esferifiquí	2	0	esferifiqui	2	1	1	12385
esfilagarsarà	2	1	esfilagarsara	2	1	2	12386
esfilagarsà	2	0	esfilagarsa	2	27	27	12387
esfilagarsés	2	3	esfilagarses	2	0	3	12388
esfilagarsí	2	0	esfilagarsi	2	5	5	12389
esfilegassà	2	0	esfilegassa	2	2	2	12390
esfilà	2	0	esfila	2	3	3	12391
esflorà	2	1	esflora	2	2	3	12392
esflorí	2	1	esflori	2	0	1	12393
esfondrarà	2	33	esfondrara	2	1	34	12394
esfondrà	2	71	esfondra	2	220	291	12395
esfondràrem	2	0	esfondrarem	2	3	3	12396
esfondrés	2	36	esfondres	2	0	36	12397
esfondrí	2	0	esfondri	2	54	54	12398
esforcés	2	50	esforces	2	129	179	12399
esforcí	2	2	esforci	2	358	360	12400
esforçarà	2	248	esforçara	2	3	251	12401
esforçà	2	121	esforça	2	2699	2820	12402
esforçàrem	2	7	esforçarem	2	202	209	12403
esforçàreu	2	0	esforçareu	2	4	4	12404
esfreixurà	2	0	esfreixura	2	1	1	12405
esfreixurés	2	1	esfreixures	2	0	1	12406
esfullarà	2	1	esfullara	2	0	1	12407
esfullà	2	0	esfulla	2	10	10	12408
esfumarà	2	18	esfumara	2	1	19	12409
esfumà	2	12	esfuma	2	155	167	12410
esfumés	2	8	esfumes	2	1	9	12411
esfumí	2	2	esfumi	2	16	18	12412
esgalabrés	2	1	esgalabres	2	0	1	12413
esgaldinyà	2	1	esgaldinya	2	0	1	12414
esgallà	2	0	esgalla	2	1	1	12415
esganyés	2	0	esganyes	2	1	1	12416
esgargamellà	2	0	esgargamella	2	21	21	12417
esgargamellí	2	0	esgargamelli	2	2	2	12418
esgaripà	2	2	esgaripa	2	5	7	12419
esgaripés	2	0	esgaripes	2	1	1	12420
esgarraparà	2	7	esgarrapara	2	0	7	12421
esgarrapà	2	4	esgarrapa	2	147	151	12422
esgarrapàrem	2	0	esgarraparem	2	3	3	12423
esgarrapés	2	3	esgarrapes	2	6	9	12424
esgarrapí	2	0	esgarrapi	2	17	17	12425
esgarrarà	2	3	esgarrara	2	0	3	12426
esgarriarà	2	1	esgarriara	2	0	1	12427
esgarrifarà	2	8	esgarrifara	2	0	8	12428
esgarrifà	2	5	esgarrifa	2	251	256	12429
esgarrifàrem	2	0	esgarrifarem	2	1	1	12430
esgarrifàreu	2	0	esgarrifareu	2	4	4	12431
esgarrifés	2	2	esgarrifes	2	7	9	12432
esgarrifí	2	0	esgarrifi	2	11	11	12433
esgarrinxà	2	0	esgarrinxa	2	5	5	12434
esgarrinxàrem	2	0	esgarrinxarem	2	1	1	12435
esgarrinxí	2	0	esgarrinxi	2	1	1	12436
esgarrià	2	0	esgarria	2	18	18	12437
esgarriés	2	6	esgarries	2	1	7	12438
esgarrií	2	0	esgarrii	2	1	1	12439
esgarrà	2	1	esgarra	2	32	33	12440
esgarràrem	2	0	esgarrarem	2	2	2	12441
esgarràreu	2	2	esgarrareu	2	0	2	12442
esgarrés	2	1	esgarres	2	4	5	12443
esgarrí	2	0	esgarri	2	1	1	12444
esgarró	4	1	esgarro	2	4	5	12445
esgavellà	2	0	esgavella	2	4	4	12446
esgavellí	2	0	esgavelli	2	1	1	12447
esglaiarà	2	2	esglaiara	2	0	2	12448
esglaià	2	8	esglaia	2	40	48	12449
esglaiàrem	2	0	esglaiarem	2	1	1	12450
esglaiés	2	0	esglaies	2	1	1	12451
esglaonarà	2	1	esglaonara	2	0	1	12452
esglaonà	2	0	esglaona	2	20	20	12453
esglaí	2	0	esglai	4	633	633	12454
esgolà	2	0	esgola	2	6	6	12455
esgotarà	2	160	esgotara	2	7	167	12456
esgotimí	2	1	esgotimi	2	0	1	12457
esgotà	2	43	esgota	2	1201	1244	12458
esgotàrem	2	2	esgotarem	2	40	42	12459
esgotàreu	2	0	esgotareu	2	5	5	12460
esgotés	2	59	esgotes	2	17	76	12461
esgotí	2	0	esgoti	2	324	324	12462
esgrafià	2	2	esgrafia	2	4	6	12463
esgrafiés	2	0	esgrafies	2	1	1	12464
esgrafií	2	0	esgrafii	2	1	1	12465
esgranà	2	1	esgrana	2	8	9	12466
esgranàrem	2	0	esgranarem	2	1	1	12467
esgraní	2	0	esgrani	2	1	1	12468
esgraonà	2	0	esgraona	2	1	1	12469
esgratinyà	2	0	esgratinya	2	2	2	12470
esgrillà	2	0	esgrilla	2	1	1	12471
esgrimirà	2	7	esgrimira	2	0	7	12472
esgrimírem	2	0	esgrimirem	2	1	1	12473
esgrunà	2	0	esgruna	2	1	1	12474
esguardarà	2	2	esguardara	2	0	2	12475
esguardà	2	23	esguarda	2	106	129	12476
esguardàrem	2	0	esguardarem	2	1	1	12477
esguardés	2	1	esguardes	2	3	4	12478
esguardí	2	1	esguardi	2	3	4	12479
esguerrarà	2	7	esguerrara	2	0	7	12480
esguerrà	2	6	esguerra	2	72	78	12481
esguerràrem	2	0	esguerrarem	2	2	2	12482
esguerràreu	2	0	esguerrareu	2	1	1	12483
esguerrés	2	10	esguerres	2	4	14	12484
esguerrí	2	0	esguerri	2	24	24	12485
esguitarà	2	1	esguitara	2	0	1	12486
esguità	2	3	esguita	2	33	36	12487
esguités	2	0	esguites	2	1	1	12488
esguitó	4	1	esguito	2	0	1	12489
eslingués	2	0	eslingues	4	19	19	12490
eslingà	2	0	eslinga	4	12	12	12491
esllanguirà	2	4	esllanguira	2	0	4	12492
esllavissà	2	2	esllavissa	2	19	21	12493
esllavissés	2	3	esllavisses	2	0	3	12494
esllavissí	2	0	esllavissi	2	4	4	12495
esllemenàrem	2	0	esllemenarem	2	1	1	12496
esllenegà	2	0	esllenega	2	1	1	12497
esllomà	2	0	eslloma	2	1	1	12498
esllomés	2	0	esllomes	2	2	2	12499
esllomí	2	0	esllomi	2	1	1	12500
esmadeixàreu	2	2	esmadeixareu	2	0	2	12501
esmaixà	2	2	esmaixa	2	10	12	12502
esmaixés	2	1	esmaixes	2	1	2	12503
esmaixí	2	0	esmaixi	2	1	1	12504
esmaltà	2	0	esmalta	2	6	6	12505
esmaltàrem	2	0	esmaltarem	2	2	2	12506
esmaltés	2	0	esmaltes	2	7	7	12507
esmaltí	2	0	esmalti	2	1	1	12508
esmarrà	2	0	esmarra	2	1	1	12509
esmarà	2	0	esmara	2	2	2	12510
esmenarà	2	57	esmenara	2	4	61	12511
esmentarà	2	58	esmentara	2	3	61	12512
esmentà	2	107	esmenta	2	7947	8054	12513
esmentàrem	2	4	esmentarem	2	170	174	12514
esmentàreu	2	0	esmentareu	2	1	1	12515
esmentés	2	98	esmentes	2	309	407	12516
esmentí	2	0	esmenti	2	549	549	12517
esmenà	2	20	esmena	4	26827	26847	12518
esmenàrem	2	0	esmenarem	2	26	26	12519
esmenàreu	2	0	esmenareu	2	1	1	12520
esmenés	2	31	esmenes	4	33060	33091	12521
esmení	2	1	esmeni	2	221	222	12522
esmercés	2	10	esmerces	2	9	19	12523
esmercí	2	1	esmerci	2	30	31	12524
esmerilarà	2	1	esmerilara	2	0	1	12525
esmerilà	2	0	esmerila	2	2	2	12526
esmerçarà	2	20	esmerçara	2	1	21	12527
esmerçà	2	46	esmerça	2	140	186	12528
esmerçàrem	2	1	esmerçarem	2	23	24	12529
esmerçàreu	2	0	esmerçareu	2	1	1	12530
esmicolarà	2	13	esmicolara	2	0	13	12531
esmicolà	2	22	esmicola	2	256	278	12532
esmicolàrem	2	0	esmicolarem	2	16	16	12533
esmicolàreu	2	0	esmicolareu	2	1	1	12534
esmicolés	2	8	esmicoles	2	8	16	12535
esmicolí	2	0	esmicoli	2	28	28	12536
esmitjà	2	0	esmitja	2	1	1	12537
esmolarà	2	2	esmolara	2	1	3	12538
esmollarà	2	1	esmollara	2	0	1	12539
esmollà	2	0	esmolla	2	1	1	12540
esmollés	2	0	esmolles	2	1	1	12541
esmollí	2	0	esmolli	2	1	1	12542
esmolsarà	2	1	esmolsara	2	0	1	12543
esmolsà	2	0	esmolsa	2	1	1	12544
esmolà	2	1	esmola	2	79	80	12545
esmolàrem	2	0	esmolarem	2	2	2	12546
esmolés	2	2	esmoles	2	4	6	12547
esmolí	2	0	esmoli	2	5	5	12548
esmonyonés	2	1	esmonyones	2	0	1	12549
esmorcàrem	2	0	esmorcarem	2	1	1	12550
esmorrellàrem	2	0	esmorrellarem	2	1	1	12551
esmorrellàreu	2	0	esmorrellareu	2	1	1	12552
esmorrí	2	0	esmorri	2	1	1	12553
esmorzarà	2	21	esmorzara	2	1	22	12554
esmorzà	2	12	esmorza	2	381	393	12555
esmorzàrem	2	26	esmorzarem	2	348	374	12556
esmorzàreu	2	0	esmorzareu	2	2	2	12557
esmorzés	2	3	esmorzes	2	54	57	12558
esmorzí	2	0	esmorzi	2	22	22	12559
esmotxarà	2	0	esmotxara	2	1	1	12560
esmotxà	2	0	esmotxa	2	1	1	12561
esmunyirà	2	9	esmunyira	2	1	10	12562
esmunyí	2	22	esmunyi	2	10	32	12563
esmunyíreu	2	0	esmunyireu	2	1	1	12564
esmunyís	2	11	esmunyis	2	0	11	12565
esmussarà	2	0	esmussara	2	1	1	12566
esmussà	2	0	esmussa	2	31	31	12567
esmussés	2	2	esmusses	2	2	4	12568
esmussí	2	0	esmussi	2	3	3	12569
esmà	2	2	esma	4	967	969	12570
esmàrem	2	0	esmarem	2	1	1	12571
esmèn	2	3	esmen	2	15	18	12572
esmés	2	2	esmes	4	15	17	12573
esmí	2	0	esmi	2	1	1	12574
esnifà	2	0	esnifa	2	31	31	12575
esnifés	2	1	esnifes	2	2	3	12576
esnifí	2	0	esnifi	2	1	1	12577
esnovà	2	0	esnova	2	1	1	12578
espadellà	2	0	espadella	4	35	35	12579
espadellés	2	0	espadelles	4	6	6	12580
espadés	2	0	espades	2	22	22	12581
espadí	2	2	espadi	2	1	3	12582
espadó	4	2	espado	2	0	2	12583
espaiarà	2	2	espaiara	2	0	2	12584
espaià	2	3	espaia	2	23	26	12585
espaiàrem	2	0	espaiarem	2	2	2	12586
espaiés	2	2	espaies	2	3	5	12587
espallussés	2	0	espallusses	2	1	1	12588
espalmà	2	1	espalma	4	0	1	12589
espalmés	2	0	espalmes	4	1	1	12590
espampolà	2	0	espampola	2	1	1	12591
espanotxàrem	2	0	espanotxarem	2	1	1	12592
espantarà	2	55	espantara	2	4	59	12593
espantà	2	51	espanta	2	2021	2072	12594
espantàrem	2	0	espantarem	2	10	10	12595
espantàreu	2	0	espantareu	2	4	4	12596
espantés	2	44	espantes	2	52	96	12597
espantí	2	2	espanti	2	274	276	12598
espanyarà	2	1	espanyara	2	0	1	12599
espanyolitzarà	2	2	espanyolitzara	2	0	2	12600
espanyolitzà	2	0	espanyolitza	2	21	21	12601
espanyolitzés	2	1	espanyolitzes	2	0	1	12602
espanyolitzí	2	0	espanyolitzi	2	3	3	12603
espanyà	2	6	espanya	4	215953	215959	12604
espanyàrem	2	1	espanyarem	2	0	1	12605
espanyés	2	0	espanyes	4	1174	1174	12606
espanyí	2	0	espanyi	2	1	1	12607
espargirà	2	5	espargira	2	1	6	12608
espargírem	2	0	espargirem	2	3	3	12609
espargíreu	2	0	espargireu	2	1	1	12610
esparpallà	2	0	esparpalla	2	1	1	12611
esparpillés	2	1	esparpilles	2	0	1	12612
esparracarà	2	1	esparracara	2	0	1	12613
esparracà	2	0	esparraca	2	4	4	12614
esparraquí	2	0	esparraqui	2	3	3	12615
espartà	2	262	esparta	4	947	1209	12616
espartí	2	2	esparti	2	0	2	12617
esparverà	2	0	esparvera	2	31	31	12618
esparveràrem	2	0	esparverarem	2	1	1	12619
esparverí	2	0	esparveri	2	2	2	12620
espasmés	2	0	espasmes	2	411	411	12621
espassarà	2	4	espassara	2	0	4	12622
espassà	2	1	espassa	2	105	106	12623
espassàrem	2	0	espassarem	2	1	1	12624
espassàreu	2	1	espassareu	2	0	1	12625
espassés	2	2	espasses	2	34	36	12626
espassí	2	0	espassi	2	4	4	12627
espasà	2	1	espasa	4	7557	7558	12628
espasàreu	2	2	espasareu	2	0	2	12629
espasés	2	0	espases	4	3537	3537	12630
espasí	2	58	espasi	2	12	70	12631
espatarrà	2	0	espatarra	2	11	11	12632
espaterràreu	2	1	espaterrareu	2	0	1	12633
espaterrí	2	0	espaterri	2	1	1	12634
espatlarà	2	1	espatlara	2	0	1	12635
espatllarà	2	36	espatllara	2	3	39	12636
espatllejàrem	2	1	espatllejarem	2	0	1	12637
espatllà	2	6	espatlla	4	4976	4982	12638
espatllàrem	2	0	espatllarem	2	9	9	12639
espatllàreu	2	0	espatllareu	2	1	1	12640
espatllés	2	63	espatlles	4	4348	4411	12641
espatllí	2	0	espatlli	2	249	249	12642
espatlló	4	0	espatllo	2	7	7	12643
espatlà	2	1	espatla	4	54	55	12644
espatlés	2	0	espatles	4	56	56	12645
espatló	4	3	espatlo	2	0	3	12646
espavilarà	2	27	espavilara	2	0	27	12647
espavilà	2	7	espavila	2	392	399	12648
espavilàrem	2	0	espavilarem	2	12	12	12649
espavilàreu	2	0	espavilareu	2	7	7	12650
espavilés	2	20	espaviles	2	25	45	12651
espavilí	2	0	espavili	2	95	95	12652
espaí	2	15	espai	4	336389	336404	12653
espaíem	2	0	espaiem	2	1	1	12654
espaís	2	8	espais	4	138334	138342	12655
especegí	2	0	especegi	2	1	1	12656
especejà	2	0	especeja	2	3	3	12657
especejàrem	2	0	especejarem	2	1	1	12658
especialitzarà	2	51	especialitzara	2	1	52	12659
especialitzà	2	374	especialitza	2	873	1247	12660
especialitzàrem	2	0	especialitzarem	2	9	9	12661
especialitzés	2	15	especialitzes	2	16	31	12662
especialitzí	2	0	especialitzi	2	31	31	12663
especificarà	2	276	especificara	2	6	282	12664
especificà	2	20	especifica	2	6860	6880	12665
especificàrem	2	1	especificarem	2	42	43	12666
especificàreu	2	0	especificareu	2	4	4	12667
especifiqués	2	54	especifiques	2	760	814	12668
especifiquí	2	0	especifiqui	2	1008	1008	12669
especià	2	0	especia	2	83	83	12670
especiàrem	2	0	especiarem	2	2	2	12671
especiés	2	3	especies	2	1242	1245	12672
especií	2	1	especii	2	0	1	12673
especularà	2	8	especulara	2	0	8	12674
especulà	2	35	especula	2	818	853	12675
especulàrem	2	3	especularem	2	15	18	12676
especulàreu	2	1	especulareu	2	0	1	12677
especulés	2	11	especules	2	9	20	12678
especulí	2	0	especuli	2	59	59	12679
específic	0	24456	especific	2	261	24717	12680
específica	0	23850	especifica	2	6860	30710	12681
específiques	0	22817	especifiques	2	760	23577	12682
espedaçà	2	0	espedaça	2	2	2	12683
espellarà	2	1	espellara	2	0	1	12684
espelleringués	2	0	espelleringues	2	1	1	12685
espelletà	2	0	espelleta	2	21	21	12686
espellifarà	2	0	espellifara	2	1	1	12687
espellissí	2	0	espellissi	2	1	1	12688
espellofí	2	0	espellofi	2	1	1	12689
espellotés	2	0	espellotes	2	1	1	12690
espellucà	2	0	espelluca	2	1	1	12691
espellà	2	0	espella	2	4	4	12692
espellí	2	0	espelli	2	2	2	12693
espellís	2	0	espellis	2	1	1	12694
espenjollà	2	0	espenjolla	2	1	1	12695
espentarà	2	5	espentara	2	3	8	12696
espentejarà	2	0	espentejara	2	1	1	12697
espentejà	2	0	espenteja	2	4	4	12698
espentà	2	6	espenta	4	453	459	12699
espentés	2	0	espentes	4	72	72	12700
espentó	4	6	espento	2	1	7	12701
espenyà	2	2	espenya	2	17	19	12702
espenyàrem	2	1	espenyarem	2	0	1	12703
espenyés	2	0	espenyes	2	16	16	12704
espenyí	2	0	espenyi	2	9	9	12705
espenyó	4	0	espenyo	2	1	1	12706
esperancés	2	1	esperances	4	7721	7722	12707
esperançà	2	4	esperança	4	36058	36062	12708
esperarà	2	850	esperara	2	39	889	12709
esperesà	2	0	esperesa	2	1	1	12710
esperità	2	0	esperita	2	1	1	12711
esperití	2	0	esperiti	2	3	3	12712
esperneguí	2	1	espernegui	2	1	2	12713
espernegà	2	0	espernega	2	4	4	12714
esperonarà	2	14	esperonara	2	1	15	12715
esperonegés	2	1	esperoneges	2	0	1	12716
esperonegí	2	0	esperonegi	2	1	1	12717
esperonejà	2	1	esperoneja	2	9	10	12718
esperonejàreu	2	1	esperonejareu	2	0	1	12719
esperonà	2	49	esperona	2	452	501	12720
esperonàrem	2	0	esperonarem	2	1	1	12721
esperonés	2	17	esperones	2	3	20	12722
esperoní	2	0	esperoni	2	56	56	12723
esperà	2	176	espera	4	67878	68054	12724
esperàrem	2	28	esperarem	2	1072	1100	12725
esperàreu	2	1	esperareu	2	34	35	12726
esperès	2	3	esperes	4	3382	3385	12727
esperés	2	379	esperes	4	3382	3761	12728
esperí	2	3	esperi	2	1150	1153	12729
esperó	4	1573	espero	2	51037	52610	12730
espessirà	2	25	espessira	2	0	25	12731
espessírem	2	0	espessirem	2	3	3	12732
espetarregà	2	0	espetarrega	2	2	2	12733
espetegarà	2	2	espetegara	2	0	2	12734
espetegués	2	0	espetegues	2	1	1	12735
espeteguí	2	0	espetegui	2	4	4	12736
espetegà	2	10	espetega	2	70	80	12737
espeternegués	2	0	espeternegues	2	1	1	12738
espeternegà	2	0	espeternega	2	3	3	12739
espiarà	2	6	espiara	2	0	6	12740
espicassà	2	0	espicassa	2	1	1	12741
espicassés	2	1	espicasses	2	0	1	12742
espicossà	2	0	espicossa	2	1	1	12743
espicossés	2	1	espicosses	2	1	2	12744
espifià	2	0	espifia	2	8	8	12745
espifiés	2	0	espifies	2	2	2	12746
espigarà	2	1	espigara	2	0	1	12747
espigolà	2	9	espigola	2	65	74	12748
espigolàrem	2	0	espigolarem	2	2	2	12749
espigolí	2	0	espigoli	2	1	1	12750
espiguegí	2	1	espiguegi	2	0	1	12751
espigués	2	2	espigues	4	872	874	12752
espiguí	2	0	espigui	2	2	2	12753
espigà	2	2	espiga	4	1339	1341	12754
espillà	2	0	espilla	2	4	4	12755
espincés	2	0	espinces	2	1	1	12756
espinyolà	2	0	espinyola	2	3	3	12757
espinyà	2	0	espinya	2	9	9	12758
espinyés	2	0	espinyes	2	1	1	12759
espinzellà	2	0	espinzella	2	28	28	12760
espinzellés	2	0	espinzelles	2	4	4	12761
espinà	2	0	espina	4	2670	2670	12762
espinàrem	2	1	espinarem	2	0	1	12763
espinés	2	0	espines	4	2308	2308	12764
espipellà	2	0	espipella	2	4	4	12765
espipellàrem	2	0	espipellarem	2	2	2	12766
espiritualitzà	2	0	espiritualitza	2	11	11	12767
espiràrem	2	0	espirarem	2	1	1	12768
espirés	2	0	espires	4	98	98	12769
espirí	2	0	espiri	2	16	16	12770
espiròmetres	4	13	espirometres	4	0	13	12771
espitgés	2	1	espitges	2	0	1	12772
espitgí	2	0	espitgi	2	1	1	12773
espitjarà	2	1	espitjara	2	0	1	12774
espitjà	2	1	espitja	2	15	16	12775
espitjàrem	2	0	espitjarem	2	3	3	12776
espitllerà	2	0	espitllera	4	375	375	12777
espitllerés	2	0	espitlleres	4	696	696	12778
espitllà	2	0	espitlla	2	2	2	12779
espitllés	2	0	espitlles	4	10	10	12780
espitllí	2	0	espitlli	2	1	1	12781
espitregà	2	1	espitrega	2	0	1	12782
espitxà	2	0	espitxa	2	8	8	12783
espixorrà	2	0	espixorra	2	1	1	12784
espià	2	6	espia	4	2339	2345	12785
espiàrem	2	0	espiarem	2	3	3	12786
espiés	2	13	espies	4	1690	1703	12787
espií	2	2	espii	2	0	2	12788
espió	4	0	espio	2	21	21	12789
esplaiarà	2	7	esplaiara	2	1	8	12790
esplaià	2	7	esplaia	2	144	151	12791
esplaiàrem	2	0	esplaiarem	2	5	5	12792
esplaiés	2	7	esplaies	2	1	8	12793
esplanarà	2	2	esplanara	2	0	2	12794
esplanà	2	0	esplana	4	16	16	12795
esplanés	2	0	esplanes	4	78	78	12796
esplaí	2	1	esplai	4	10653	10654	12797
espletà	2	0	espleta	2	2	2	12798
espletí	2	0	espleti	2	1	1	12799
esplomissarà	2	1	esplomissara	2	0	1	12800
esplugués	2	0	esplugues	4	7071	7071	12801
espluguí	2	147	esplugui	2	31	178	12802
esplugà	2	0	espluga	4	4208	4208	12803
espoliarà	2	2	espoliara	2	0	2	12804
espolinés	2	0	espolines	2	3	3	12805
espoliní	2	0	espolini	2	1	1	12806
espolià	2	3	espolia	2	117	120	12807
espoliés	2	1	espolies	2	0	1	12808
espolií	2	2	espolii	2	0	2	12809
espollà	2	2	espolla	4	873	875	12810
espollés	2	0	espolles	2	2	2	12811
espolsarà	2	2	espolsara	2	0	2	12812
espolsà	2	14	espolsa	2	191	205	12813
espolsàrem	2	1	espolsarem	2	39	40	12814
espolsàreu	2	0	espolsareu	2	1	1	12815
espolsés	2	7	espolses	2	16	23	12816
espolsí	2	0	espolsi	2	22	22	12817
espolsó	4	3	espolso	2	25	28	12818
espolí	4	61	espoli	4	3909	3970	12819
esponcellàrem	2	1	esponcellarem	2	0	1	12820
espongés	2	1	esponges	4	891	892	12821
espongí	2	0	espongi	2	7	7	12822
esponjarà	2	7	esponjara	2	0	7	12823
esponjà	2	1	esponja	4	1446	1447	12824
esponsoritzarà	2	12	esponsoritzara	2	0	12	12825
esponsoritzà	2	0	esponsoritza	2	36	36	12826
esponsoritzés	2	1	esponsoritzes	2	0	1	12827
esponsoritzí	2	0	esponsoritzi	2	5	5	12828
esporgués	2	1	esporgues	4	26	27	12829
esporguí	2	0	esporgui	2	3	3	12830
esporgà	2	0	esporga	4	272	272	12831
esportellà	2	1	esportella	2	5	6	12832
esportinà	2	0	esportina	2	1	1	12833
esporulà	2	0	esporula	2	1	1	12834
esposarà	2	8	esposara	2	0	8	12835
esposà	2	17	esposa	2	13409	13426	12836
esposàreu	2	1	esposareu	2	0	1	12837
esposés	2	4	esposes	2	1128	1132	12838
esposí	2	0	esposi	2	1	1	12839
espremerà	2	8	espremera	2	2	10	12840
espremérem	2	1	espremerem	2	6	7	12841
espreméreu	2	0	espremereu	2	1	1	12842
espremí	2	0	espremi	2	6	6	12843
esprimatxà	2	0	esprimatxa	2	2	2	12844
esprintà	2	0	esprinta	2	8	8	12845
esprintés	2	1	esprintes	2	0	1	12846
espumegí	2	0	espumegi	2	1	1	12847
espumejà	2	0	espumeja	2	1	1	12848
espumà	2	0	espuma	4	710	710	12849
espumés	2	0	espumes	4	89	89	12850
espumí	2	0	espumi	2	1	1	12851
espunyà	2	0	espunya	4	39	39	12852
espunyés	2	0	espunyes	2	102	102	12853
espurnegés	2	1	espurneges	2	0	1	12854
espurnegí	2	0	espurnegi	2	4	4	12855
espurnejà	2	2	espurneja	2	41	43	12856
espurnà	2	0	espurna	4	2422	2422	12857
espurnés	2	0	espurnes	4	1530	1530	12858
espurní	2	0	espurni	2	1	1	12859
esputà	2	1	esputa	2	1	2	12860
esputí	2	0	esputi	2	1	1	12861
espuà	2	0	espua	2	1	1	12862
espués	2	1	espues	2	0	1	12863
espècia	4	685	especia	2	83	768	12864
espècie	4	39412	especie	2	681	40093	12865
espècies	4	56860	especies	2	1242	58102	12866
espècul	4	26	especul	2	1	27	12867
espòrula	4	0	esporula	2	1	1	12868
espòrules	4	1	esporules	2	0	1	12869
esquarterarà	2	4	esquarterara	2	0	4	12870
esquarterà	2	14	esquartera	2	41	55	12871
esquarteràrem	2	0	esquarterarem	2	4	4	12872
esquarterés	2	1	esquarteres	2	0	1	12873
esquarterí	2	0	esquarteri	2	5	5	12874
esqueixalàreu	2	1	esqueixalareu	2	0	1	12875
esqueixarà	2	4	esqueixara	2	0	4	12876
esqueixà	2	6	esqueixa	2	57	63	12877
esqueixàrem	2	0	esqueixarem	2	6	6	12878
esqueixés	2	1	esqueixes	2	0	1	12879
esqueixí	2	0	esqueixi	2	5	5	12880
esquellà	2	1	esquella	4	697	698	12881
esquellés	2	0	esquelles	4	417	417	12882
esquellí	2	25	esquelli	2	0	25	12883
esquematitzà	2	2	esquematitza	2	22	24	12884
esquematitzàrem	2	0	esquematitzarem	2	1	1	12885
esquematitzí	2	0	esquematitzi	2	1	1	12886
esquenà	2	1	esquena	4	20112	20113	12887
esquenés	2	0	esquenes	4	2470	2470	12888
esquerdarà	2	19	esquerdara	2	0	19	12889
esquerdejàrem	2	1	esquerdejarem	2	0	1	12890
esquerdissà	2	0	esquerdissa	2	2	2	12891
esquerdà	2	7	esquerda	4	2640	2647	12892
esquerdàrem	2	0	esquerdarem	2	2	2	12893
esquerdés	2	9	esquerdes	4	2947	2956	12894
esquerdí	2	0	esquerdi	2	49	49	12895
esquerdís	2	2	esquerdis	2	1	3	12896
esquerrés	2	0	esquerres	0	18273	18273	12897
esquerrí	2	0	esquerri	2	1	1	12898
esquerà	2	2	esquera	2	188	190	12899
esquerés	2	0	esqueres	2	7	7	12900
esquerí	2	0	esqueri	2	1	1	12901
esquiarà	2	5	esquiara	2	0	5	12902
esquilà	2	0	esquila	4	46	46	12903
esquilàrem	2	0	esquilarem	2	1	1	12904
esquilés	2	2	esquiles	2	1	3	12905
esquilí	2	30	esquili	2	4	34	12906
esquincés	2	3	esquinces	2	5	8	12907
esquincí	2	0	esquinci	2	25	25	12908
esquinçarà	2	17	esquinçara	2	2	19	12909
esquinçà	2	47	esquinça	2	177	224	12910
esquinçàrem	2	1	esquinçarem	2	3	4	12911
esquinçàreu	2	0	esquinçareu	2	1	1	12912
esquirolejà	2	0	esquiroleja	2	1	1	12913
esquistós	0	16	esquistos	4	136	152	12914
esquitarà	2	2	esquitara	2	0	2	12915
esquitllà	2	2	esquitlla	2	13	15	12916
esquitllàrem	2	1	esquitllarem	2	0	1	12917
esquitllés	2	2	esquitlles	2	0	2	12918
esquitllí	2	0	esquitlli	2	2	2	12919
esquitxarà	2	27	esquitxara	2	0	27	12920
esquitxotegí	2	0	esquitxotegi	2	1	1	12921
esquitxotejàreu	2	1	esquitxotejareu	2	0	1	12922
esquitxà	2	11	esquitxa	2	410	421	12923
esquitxàrem	2	0	esquitxarem	2	2	2	12924
esquitxés	2	7	esquitxes	2	12	19	12925
esquitxí	2	0	esquitxi	2	75	75	12926
esquitxó	4	0	esquitxo	2	5	5	12927
esquità	2	0	esquita	2	8	8	12928
esquivarà	2	25	esquivara	2	1	26	12929
esquivà	2	19	esquiva	4	520	539	12930
esquivàrem	2	1	esquivarem	2	8	9	12931
esquivés	2	8	esquives	0	71	79	12932
esquiví	2	0	esquivi	2	17	17	12933
esquià	2	0	esquia	2	125	125	12934
esquiàrem	2	1	esquiarem	2	13	14	12935
esquiés	2	1	esquies	2	12	13	12936
esquií	2	0	esquii	2	1	1	12937
esquèn	2	0	esquen	2	2	2	12938
esqués	2	5	esques	4	7	12	12939
esquí	2	19791	esqui	2	552	20343	12940
estabilitzarà	2	55	estabilitzara	2	0	55	12941
estabilitzà	2	79	estabilitza	2	475	554	12942
estabilitzàrem	2	1	estabilitzarem	2	5	6	12943
estabilitzés	2	22	estabilitzes	2	3	25	12944
estabilitzí	2	0	estabilitzi	2	126	126	12945
establirà	2	2749	establira	2	43	2792	12946
establà	2	0	establa	4	12	12	12947
establés	2	0	estables	4	6088	6088	12948
establí	2	3642	establi	2	30	3672	12949
establírem	2	13	establirem	2	442	455	12950
establíreu	2	0	establireu	2	20	20	12951
establís	2	651	establis	2	15	666	12952
estabornirà	2	1	estabornira	2	0	1	12953
estabulà	2	0	estabula	2	3	3	12954
estacarà	2	1	estacara	2	0	1	12955
estacionarà	2	19	estacionara	2	0	19	12956
estacionà	2	9	estaciona	2	91	100	12957
estacionàrem	2	2	estacionarem	2	19	21	12958
estacionàreu	2	0	estacionareu	2	2	2	12959
estacionària	0	210	estacionaria	2	17	227	12960
estacionàries	0	123	estacionaries	2	8	131	12961
estacionés	2	2	estaciones	2	111	113	12962
estacioní	2	0	estacioni	2	20	20	12963
estacà	2	1	estaca	4	1129	1130	12964
estacàrem	2	0	estacarem	2	3	3	12965
estadificà	2	0	estadifica	2	1	1	12966
estafarà	2	4	estafara	2	1	5	12967
estafà	2	4	estafa	4	3739	3743	12968
estafàrem	2	0	estafarem	2	1	1	12969
estafàreu	2	0	estafareu	2	1	1	12970
estafés	2	3	estafes	4	1049	1052	12971
estafí	2	0	estafi	2	46	46	12972
estaià	2	0	estaia	2	3	3	12973
estalonarà	2	3	estalonara	2	0	3	12974
estalonà	2	2	estalona	2	19	21	12975
estalonàrem	2	0	estalonarem	2	4	4	12976
estalonés	2	1	estalones	2	0	1	12977
estaloní	2	0	estaloni	2	4	4	12978
estalviarà	2	638	estalviara	2	8	646	12979
estalvià	2	34	estalvia	2	2658	2692	12980
estalviàrem	2	0	estalviarem	2	419	419	12981
estalviàreu	2	1	estalviareu	2	202	203	12982
estalviés	2	34	estalvies	2	414	448	12983
estalvií	2	9	estalvii	2	306	315	12984
estamenejà	2	0	estameneja	2	3	3	12985
estamparà	2	39	estampara	2	1	40	12986
estampillarà	2	3	estampillara	2	0	3	12987
estampillà	2	0	estampilla	4	12	12	12988
estampillés	2	0	estampilles	4	25	25	12989
estampià	0	1	estampia	2	2	3	12990
estampà	2	42	estampa	4	2124	2166	12991
estampàrem	2	0	estamparem	2	30	30	12992
estampàreu	2	0	estampareu	2	2	2	12993
estampés	2	9	estampes	4	1445	1454	12994
estampí	2	1	estampi	2	15	16	12995
estampís	2	0	estampis	2	3	3	12996
estancarà	2	17	estancara	2	0	17	12997
estancà	2	29	estanca	0	439	468	12998
estancàrem	2	0	estancarem	2	3	3	12999
estandarditzarà	2	3	estandarditzara	2	1	4	13000
estandarditzà	2	3	estandarditza	2	50	53	13001
estandarditzés	2	1	estandarditzes	2	1	2	13002
estandarditzí	2	0	estandarditzi	2	3	3	13003
estanqués	2	10	estanques	0	158	168	13004
estanquí	2	0	estanqui	2	39	39	13005
estantolà	2	1	estantola	2	0	1	13006
estanyadà	2	0	estanyada	4	10	10	13007
estanyadés	2	0	estanyades	4	8	8	13008
estanyà	2	1	estanya	4	61	62	13009
estanyés	2	0	estanyes	2	12	12	13010
estaqués	2	0	estaques	4	634	634	13011
estaquí	2	0	estaqui	2	2	2	13012
estarrufarà	2	1	estarrufara	2	0	1	13013
estarrufà	2	0	estarrufa	2	23	23	13014
estarrufés	2	2	estarrufes	2	0	2	13015
estarrufí	2	0	estarrufi	2	4	4	13016
estassarà	2	1	estassara	2	0	1	13017
estassà	2	0	estassa	2	6	6	13018
estassés	2	1	estasses	2	0	1	13019
estassí	2	0	estassi	2	1	1	13020
estatalitzà	2	0	estatalitza	2	2	2	13021
estatalitzí	2	0	estatalitzi	2	1	1	13022
estatgés	2	0	estatges	4	286	286	13023
estatgí	2	1	estatgi	2	0	1	13024
estatitzà	2	1	estatitza	2	1	2	13025
estatjà	2	3	estatja	4	24	27	13026
estavellarà	2	21	estavellara	2	1	22	13027
estavellà	2	96	estavella	2	396	492	13028
estavellàrem	2	0	estavellarem	2	4	4	13029
estavellés	2	48	estavelles	2	20	68	13030
estavellí	2	0	estavelli	2	44	44	13031
estaí	2	0	estai	4	36	36	13032
estefanià	0	2	estefania	4	744	746	13033
estellarà	2	1	estellara	2	0	1	13034
estellà	2	12	estella	4	1006	1018	13035
estellí	2	0	estelli	2	3	3	13036
estenallà	2	0	estenalla	2	1	1	13037
estenallés	2	0	estenalles	2	352	352	13038
estendré	2	216	estendre	2	14376	14592	13039
estengués	2	326	estengues	2	2	328	13040
estenguí	2	2	estengui	2	1004	1006	13041
estenografià	2	0	estenografia	4	13	13	13042
esteranyinà	2	0	esteranyina	2	1	1	13043
estereotipà	2	0	estereotipa	2	10	10	13044
estereotipés	2	1	estereotipes	2	0	1	13045
estereotipí	2	0	estereotipi	2	4	4	13046
esterificà	2	0	esterifica	2	3	3	13047
esterilitzarà	2	2	esterilitzara	2	0	2	13048
esterilitzà	2	3	esterilitza	2	65	68	13049
esterilitzàrem	2	0	esterilitzarem	2	6	6	13050
esterilitzés	2	0	esterilitzes	2	3	3	13051
esterilitzí	2	0	esterilitzi	2	2	2	13052
esternià	2	0	esternia	2	2	2	13053
esternudà	2	1	esternuda	2	52	53	13054
esternudàreu	2	0	esternudareu	2	2	2	13055
esternudés	2	2	esternudes	2	3	5	13056
esternudí	2	0	esternudi	2	9	9	13057
esterrossà	2	1	esterrossa	2	2	3	13058
estesà	2	0	estesa	2	6455	6455	13059
estesés	2	0	esteses	2	1414	1414	13060
estesí	2	0	estesi	2	4	4	13061
estetitzà	2	0	estetitza	2	2	2	13062
estevà	2	0	esteva	4	1052	1052	13063
estevés	2	1	esteves	4	96	97	13064
esteví	2	0	estevi	2	3	3	13065
estibà	2	1	estiba	4	258	259	13066
estibés	2	0	estibes	4	13	13	13067
estibí	2	0	estibi	2	2	2	13068
estigmatitzarà	2	7	estigmatitzara	2	0	7	13069
estigmatitzà	2	4	estigmatitza	2	138	142	13070
estigmatitzàrem	2	0	estigmatitzarem	2	1	1	13071
estigmatitzés	2	3	estigmatitzes	2	1	4	13072
estigmatitzí	2	0	estigmatitzi	2	36	36	13073
estigués	2	9235	estigues	2	1645	10880	13074
estiguí	2	30	estigui	2	58375	58405	13075
estilarà	2	1	estilara	2	0	1	13076
estilitzà	2	5	estilitza	2	70	75	13077
estilitzés	2	0	estilitzes	2	1	1	13078
estilà	2	0	estila	2	190	190	13079
estilés	2	0	estiles	2	4	4	13080
estilí	2	0	estili	2	3	3	13081
estimarà	2	220	estimara	2	23	243	13082
estimbarà	2	3	estimbara	2	0	3	13083
estimbà	2	8	estimba	2	61	69	13084
estimbàrem	2	0	estimbarem	2	4	4	13085
estimbés	2	11	estimbes	2	2	13	13086
estimbí	2	0	estimbi	2	9	9	13087
estimularà	2	339	estimulara	2	4	343	13088
estimulà	2	107	estimula	2	3811	3918	13089
estimulàrem	2	0	estimularem	2	53	53	13090
estimulàreu	2	0	estimulareu	2	1	1	13091
estimulés	2	40	estimules	2	11	51	13092
estimulí	2	0	estimuli	2	454	454	13093
estimà	2	285	estima	4	24119	24404	13094
estimàrem	2	7	estimarem	2	117	124	13095
estimàreu	2	1	estimareu	2	35	36	13096
estimés	2	248	estimes	4	2371	2619	13097
estimí	2	2	estimi	2	1861	1863	13098
estintolà	2	0	estintola	2	12	12	13099
estintolàrem	2	1	estintolarem	2	0	1	13100
estintolés	2	0	estintoles	2	1	1	13101
estintolí	2	0	estintoli	2	2	2	13102
estipendià	2	1	estipendia	2	1	2	13103
estipendiària	4	3	estipendiaria	2	1	4	13104
estipendiàries	4	2	estipendiaries	2	1	3	13105
estipularà	2	16	estipulara	2	0	16	13106
estipulà	2	29	estipula	2	2070	2099	13107
estipulàrem	2	0	estipularem	2	1	1	13108
estipulés	2	17	estipules	2	6	23	13109
estipulí	2	0	estipuli	2	155	155	13110
estirarà	2	79	estirara	2	8	87	13111
estireganyà	2	2	estireganya	2	1	3	13112
estireganyés	2	1	estireganyes	2	0	1	13113
estiregassà	2	0	estiregassa	2	3	3	13114
estiregassés	2	0	estiregasses	2	1	1	13115
estirà	2	104	estira	4	2433	2537	13116
estiràrem	2	4	estirarem	2	131	135	13117
estiràreu	2	0	estirareu	2	4	4	13118
estirè	4	69	estire	2	27	96	13119
estiré	4	14	estire	2	27	41	13120
estirés	2	63	estires	4	255	318	13121
estirí	2	0	estiri	2	134	134	13122
estiró	4	12	estiro	2	347	359	13123
estisorà	2	0	estisora	2	24	24	13124
estisorés	2	0	estisores	2	170	170	13125
estiuegés	2	1	estiueges	2	5	6	13126
estiuegí	2	0	estiuegi	2	2	2	13127
estiuejarà	2	5	estiuejara	2	1	6	13128
estiuejà	2	9	estiueja	2	173	182	13129
estiuejàrem	2	0	estiuejarem	2	2	2	13130
estiuà	2	0	estiua	2	5	5	13131
estiués	2	3	estiues	2	1	4	13132
estiuí	2	0	estiui	2	4	4	13133
estivà	2	0	estiva	2	24	24	13134
estivés	2	0	estives	2	5	5	13135
estiví	2	0	estivi	2	49	49	13136
estofà	2	0	estofa	4	129	129	13137
estofés	2	0	estofes	4	4	4	13138
estomacarà	2	2	estomacara	2	0	2	13139
estomacà	2	2	estomaca	2	23	25	13140
estomaqués	2	2	estomaques	2	0	2	13141
estomaquí	2	0	estomaqui	2	7	7	13142
estontolà	2	1	estontola	2	2	3	13143
estontolàreu	2	0	estontolareu	2	1	1	13144
estopejà	2	0	estopeja	2	1	1	13145
estorà	2	0	estora	4	675	675	13146
estorés	2	1	estores	4	452	453	13147
estorí	2	3	estori	2	1	4	13148
estossegués	2	1	estossegues	2	1	2	13149
estosseguí	2	0	estossegui	2	4	4	13150
estossegà	2	4	estossega	2	15	19	13151
estossinà	2	0	estossina	2	1	1	13152
estossinés	2	1	estossines	2	0	1	13153
estotjà	2	3	estotja	2	13	16	13154
estotjàreu	2	1	estotjareu	2	0	1	13155
estovarà	2	23	estovara	2	0	23	13156
estovà	2	1	estova	2	203	204	13157
estovàrem	2	0	estovarem	2	7	7	13158
estovés	2	11	estoves	2	2	13	13159
estoví	2	0	estovi	2	142	142	13160
estraféu	2	1	estrafeu	2	1	2	13161
estrallà	2	0	estralla	2	4	4	13162
estrallés	2	1	estralles	2	0	1	13163
estrallí	2	0	estralli	2	2	2	13164
estrangeritzà	2	1	estrangeritza	2	0	1	13165
estrangularà	2	1	estrangulara	2	0	1	13166
estrangulà	2	8	estrangula	2	35	43	13167
estrangulàrem	2	0	estrangularem	2	1	1	13168
estrangulés	2	4	estrangules	2	0	4	13169
estrangulí	2	0	estranguli	2	3	3	13170
estranyarà	2	95	estranyara	2	3	98	13171
estranyà	2	39	estranya	0	12229	12268	13172
estranyàrem	2	0	estranyarem	2	8	8	13173
estranyàreu	2	0	estranyareu	2	4	4	13174
estranyés	2	6	estranyes	0	4202	4208	13175
estranyí	2	0	estranyi	2	236	236	13176
estratificà	2	0	estratifica	2	13	13	13177
estratificàrem	2	0	estratificarem	2	1	1	13178
estratifiquí	2	0	estratifiqui	2	1	1	13179
estrebarà	2	1	estrebara	2	0	1	13180
estrebà	2	1	estreba	2	46	47	13181
estrelà	2	0	estrela	4	754	754	13182
estrelés	2	0	estreles	4	318	318	13183
estremirà	2	4	estremira	2	0	4	13184
estremírem	2	0	estremirem	2	5	5	13185
estremíreu	2	0	estremireu	2	1	1	13186
estrenarà	2	4193	estrenara	2	22	4215	13187
estrenyerà	2	26	estrenyera	2	1	27	13188
estrenyérem	2	1	estrenyerem	2	6	7	13189
estrenyés	2	16	estrenyes	2	4	20	13190
estrenyí	2	1	estrenyi	2	76	77	13191
estrenà	2	1321	estrena	4	28925	30246	13192
estrenàrem	2	32	estrenarem	2	342	374	13193
estrenàreu	2	0	estrenareu	2	6	6	13194
estrenés	2	170	estrenes	4	3404	3574	13195
estrení	2	0	estreni	2	244	244	13196
estrepà	2	2	estrepa	2	0	2	13197
estressarà	2	1	estressara	2	0	1	13198
estressà	2	1	estressa	2	156	157	13199
estressàrem	2	0	estressarem	2	3	3	13200
estressés	2	1	estresses	2	7	8	13201
estressí	2	0	estressi	2	17	17	13202
estretegés	2	2	estreteges	2	11	13	13203
estretirà	2	3	estretira	2	0	3	13204
estretírem	2	0	estretirem	2	1	1	13205
estricà	2	0	estrica	2	11	11	13206
estrijolà	2	0	estrijola	2	1	1	13207
estringués	2	0	estringues	2	1	1	13208
estriparà	2	11	estripara	2	0	11	13209
estripà	2	13	estripa	2	167	180	13210
estripàrem	2	1	estriparem	2	4	5	13211
estripés	2	8	estripes	2	4	12	13212
estripí	2	0	estripi	2	20	20	13213
estritllà	2	0	estritlla	2	1	1	13214
estrià	2	0	estria	4	136	136	13215
estriàrem	2	0	estriarem	2	2	2	13216
estriés	2	0	estries	4	601	601	13217
estrompassà	2	0	estrompassa	2	1	1	13218
estroncarà	2	19	estroncara	2	1	20	13219
estroncà	2	88	estronca	2	119	207	13220
estronqués	2	11	estronques	2	0	11	13221
estronquí	2	0	estronqui	2	29	29	13222
estropellà	2	0	estropella	2	1	1	13223
estropellí	2	0	estropelli	2	2	2	13224
estructurarà	2	305	estructurara	2	1	306	13225
estructurà	2	67	estructura	4	81981	82048	13226
estructuràrem	2	0	estructurarem	2	24	24	13227
estructurés	2	9	estructures	4	33741	33750	13228
estructurí	2	0	estructuri	2	80	80	13229
estrès	2	12116	estres	4	290	12406	13230
estrés	4	1464	estres	4	290	1754	13231
estríjol	4	3	estrijol	2	0	3	13232
estubarà	2	1	estubara	2	0	1	13233
estubà	2	1	estuba	4	12	13	13234
estubés	2	0	estubes	4	2	2	13235
estucà	2	0	estuca	2	2	2	13236
estucàrem	2	0	estucarem	2	1	1	13237
estudiarà	2	2290	estudiara	2	37	2327	13238
estudià	2	4141	estudia	2	12585	16726	13239
estudiàrem	2	20	estudiarem	2	1230	1250	13240
estudiàreu	2	1	estudiareu	2	17	18	13241
estudiés	2	368	estudies	2	398	766	13242
estudií	2	15	estudii	2	58	73	13243
estufà	2	0	estufa	4	1357	1357	13244
estufés	2	0	estufes	4	845	845	13245
estufí	2	0	estufi	2	1	1	13246
estupiditzà	2	0	estupiditza	2	1	1	13247
estuprés	2	0	estupres	2	5	5	13248
estuqués	2	0	estuques	2	1	1	13249
està	2	898367	esta	3	63376	961743	13250
estàlvia	0	97	estalvia	2	2658	2755	13251
estàlvies	0	28	estalvies	2	414	442	13252
estènia	4	2	estenia	2	1759	1761	13253
estès	2	6888	estes	3	10659	17547	13254
estés	2	850	estes	3	10659	11509	13255
estímul	4	5991	estimul	2	103	6094	13256
estípula	4	4	estipula	2	2070	2074	13257
estípules	4	146	estipules	2	6	152	13258
estòs	2	5	estos	3	11221	11226	13259
estómac	4	4357	estomac	4	561	4918	13260
estómacs	4	299	estomacs	4	52	351	13261
esvalotarà	2	3	esvalotara	2	0	3	13262
esvalotà	2	2	esvalota	2	35	37	13263
esvalotàrem	2	0	esvalotarem	2	1	1	13264
esvalotés	2	2	esvalotes	2	1	3	13265
esvalotí	2	0	esvaloti	2	8	8	13266
esvanirà	2	3	esvanira	2	0	3	13267
esvarà	2	1	esvara	2	19	20	13268
esvarés	2	1	esvares	2	3	4	13269
esvaró	4	8	esvaro	2	2	10	13270
esvaírem	2	0	esvairem	2	2	2	13271
esventrà	2	0	esventra	2	8	8	13272
esventrí	2	0	esventri	2	1	1	13273
esventà	2	0	esventa	2	5	5	13274
esventí	2	0	esventi	2	2	2	13275
esverà	2	7	esvera	2	77	84	13276
esverés	2	2	esveres	2	6	8	13277
esverí	2	0	esveri	2	31	31	13278
esvinçà	2	0	esvinça	2	1	1	13279
esvoletegués	2	0	esvoletegues	2	1	1	13280
esvorellà	2	0	esvorella	2	1	1	13281
esvorellàreu	2	2	esvorellareu	2	0	2	13282
esvorà	2	0	esvora	2	1	1	13283
eternitzarà	2	10	eternitzara	2	0	10	13284
eternitzà	2	2	eternitza	2	96	98	13285
eternitzés	2	7	eternitzes	2	1	8	13286
eternitzí	2	0	eternitzi	2	58	58	13287
etilè	4	218	etile	2	1	219	13288
etilé	4	9	etile	2	1	10	13289
etiolàrem	2	1	etiolarem	2	0	1	13290
etiolés	2	0	etioles	2	1	1	13291
etiquetarà	2	25	etiquetara	2	0	25	13292
etiquetà	2	6	etiqueta	4	19601	19607	13293
etiquetàrem	2	0	etiquetarem	2	16	16	13294
etiquetés	2	26	etiquetes	4	25288	25314	13295
etiquetí	2	2	etiqueti	2	77	79	13296
etzibarà	2	4	etzibara	2	0	4	13297
etzibà	2	74	etziba	2	269	343	13298
etzibàreu	2	0	etzibareu	2	1	1	13299
etzibés	2	14	etzibes	2	2	16	13300
etzibí	2	0	etzibi	2	8	8	13301
età	4	148	eta	4	7201	7349	13302
europeïtzarà	2	1	europeïtzara	2	0	1	13303
evacuarà	2	11	evacuara	2	1	12	13304
evacuà	2	33	evacua	2	77	110	13305
evacuàrem	2	0	evacuarem	2	1	1	13306
evacués	2	21	evacues	2	1	22	13307
evaginí	2	1	evagini	2	0	1	13308
evangelitzà	2	8	evangelitza	2	28	36	13309
evangelitzàrem	2	1	evangelitzarem	2	1	2	13310
evangelitzés	2	1	evangelitzes	2	0	1	13311
evangelitzí	2	0	evangelitzi	2	2	2	13312
evaporarà	2	45	evaporara	2	1	46	13313
evaporà	2	5	evapora	2	476	481	13314
evaporés	2	17	evapores	2	1	18	13315
evaporí	2	0	evapori	2	526	526	13316
evidenciarà	2	60	evidenciara	2	2	62	13317
evidencià	2	87	evidencia	2	4770	4857	13318
evidenciàrem	2	1	evidenciarem	2	9	10	13319
evidenciés	2	29	evidencies	2	162	191	13320
evidencií	2	3	evidencii	2	4	7	13321
evidència	4	17247	evidencia	2	4770	22017	13322
evidències	4	5575	evidencies	2	162	5737	13323
eviscerà	2	0	eviscera	2	1	1	13324
evitarà	2	1851	evitara	2	28	1879	13325
evità	2	218	evita	2	8921	9139	13326
evitàrem	2	6	evitarem	2	834	840	13327
evitàreu	2	1	evitareu	2	209	210	13328
evités	2	275	evites	2	175	450	13329
evití	2	1	eviti	2	1946	1947	13330
evocarà	2	88	evocara	2	1	89	13331
evocà	2	55	evoca	2	3907	3962	13332
evocàrem	2	2	evocarem	2	32	34	13333
evocàreu	2	0	evocareu	2	1	1	13334
evolucionarà	2	420	evolucionara	2	6	426	13335
evolucionà	2	433	evoluciona	2	3825	4258	13336
evolucionàrem	2	0	evolucionarem	2	22	22	13337
evolucionàreu	2	0	evolucionareu	2	1	1	13338
evolucionés	2	63	evoluciones	2	42	105	13339
evolucioní	2	0	evolucioni	2	449	449	13340
evoqués	2	31	evoques	2	12	43	13341
evoquí	2	0	evoqui	2	96	96	13342
exacerbarà	2	12	exacerbara	2	0	12	13343
exacerbà	2	10	exacerba	2	75	85	13344
exacerbàrem	2	0	exacerbarem	2	2	2	13345
exacerbés	2	1	exacerbes	2	0	1	13346
exacerbí	2	0	exacerbi	2	3	3	13347
exagerarà	2	4	exagerara	2	1	5	13348
exagerà	2	5	exagera	2	323	328	13349
exageràrem	2	0	exagerarem	2	5	5	13350
exagerés	2	9	exageres	2	29	38	13351
exagerí	2	0	exageri	2	30	30	13352
exalcés	2	2	exalces	2	0	2	13353
exalcí	2	0	exalci	2	3	3	13354
exaltarà	2	15	exaltara	2	1	16	13355
exaltà	2	27	exalta	2	541	568	13356
exaltés	2	8	exaltes	2	8	16	13357
exaltí	2	0	exalti	2	26	26	13358
exalçarà	2	4	exalçara	2	0	4	13359
exalçà	2	5	exalça	2	127	132	13360
exalçàrem	2	0	exalçarem	2	3	3	13361
examinarà	2	721	examinara	2	1	722	13362
examinà	2	77	examina	2	1734	1811	13363
examinàrem	2	1	examinarem	2	484	485	13364
examinàreu	2	0	examinareu	2	10	10	13365
examinés	2	157	examines	2	50	207	13366
examiní	2	2	examini	2	741	743	13367
exasperarà	2	1	exasperara	2	0	1	13368
exasperà	2	8	exaspera	2	65	73	13369
exasperés	2	0	exasperes	2	1	1	13370
exasperí	2	0	exasperi	2	1	1	13371
excarcerà	2	1	excarcera	2	4	5	13372
excarcerí	2	0	excarceri	2	9	9	13373
excavarà	2	41	excavara	2	0	41	13374
excavà	2	64	excava	2	228	292	13375
excavàrem	2	0	excavarem	2	9	9	13376
excavés	2	13	excaves	2	4	17	13377
excaví	2	0	excavi	2	12	12	13378
excedirà	2	102	excedira	2	1	103	13379
excedírem	2	0	excedirem	2	4	4	13380
excel·lirà	2	6	excel·lira	2	0	6	13381
excel·lírem	2	0	excel·lirem	2	4	4	13382
exceptuarà	2	3	exceptuara	2	0	3	13383
exceptuà	2	0	exceptua	2	137	137	13384
exceptués	2	1	exceptues	2	2	3	13385
excitarà	2	7	excitara	2	1	8	13386
excità	2	10	excita	2	428	438	13387
excitàrem	2	0	excitarem	2	1	1	13388
excités	2	3	excites	2	16	19	13389
excití	2	0	exciti	2	27	27	13390
excitó	4	6	excito	2	20	26	13391
exclamarà	2	15	exclamara	2	1	16	13392
exclamà	2	240	exclama	2	774	1014	13393
exclamàrem	2	1	exclamarem	2	8	9	13394
exclamés	2	13	exclames	2	12	25	13395
exclamí	2	0	exclami	2	18	18	13396
exclaustrà	2	1	exclaustra	2	0	1	13397
exclaustrés	2	1	exclaustres	2	0	1	13398
exclogués	2	50	exclogues	2	1	51	13399
excloguí	2	0	exclogui	2	429	429	13400
exclouré	2	8	excloure	2	4357	4365	13401
excogità	2	4	excogita	2	0	4	13402
excomunicarà	2	1	excomunicara	2	0	1	13403
excomunicà	2	43	excomunica	2	19	62	13404
excomuniqués	2	7	excomuniques	2	1	8	13405
excomuniquí	2	0	excomuniqui	2	2	2	13406
excorià	2	0	excoria	2	3	3	13407
excrementà	2	0	excrementa	2	2	2	13408
excrementés	2	0	excrementes	2	1	1	13409
excrementí	2	0	excrementi	2	1	1	13410
excretarà	2	3	excretara	2	0	3	13411
excretà	2	0	excreta	4	72	72	13412
excretés	2	0	excretes	4	14	14	13413
excretí	2	0	excreti	2	5	5	13414
exculparà	2	0	exculpara	2	2	2	13415
exculpà	2	4	exculpa	2	69	73	13416
exculpàrem	2	1	exculparem	2	0	1	13417
exculpés	2	6	exculpes	2	0	6	13418
exculpí	2	0	exculpi	2	4	4	13419
excusarà	2	8	excusara	2	2	10	13420
excusà	2	29	excusa	4	17721	17750	13421
excusàrem	2	0	excusarem	2	2	2	13422
excusàreu	2	0	excusareu	2	7	7	13423
excusés	2	19	excuses	4	4330	4349	13424
excusí	2	0	excusi	2	39	39	13425
execrà	2	0	execra	2	1	1	13426
execrés	2	0	execres	2	1	1	13427
executarà	2	1364	executara	2	20	1384	13428
executà	2	220	executa	2	4667	4887	13429
executàrem	2	3	executarem	2	74	77	13430
executés	2	142	executes	2	37	179	13431
executí	2	0	executi	2	1026	1026	13432
exemplificarà	2	19	exemplificara	2	1	20	13433
exemplificà	2	17	exemplifica	2	1229	1246	13434
exemplificàrem	2	0	exemplificarem	2	7	7	13435
exemplifiqués	2	2	exemplifiques	2	1	3	13436
exemplifiquí	2	0	exemplifiqui	2	20	20	13437
exemptà	2	1	exempta	0	2086	2087	13438
exemptés	2	0	exemptes	0	1500	1500	13439
exercirà	2	1797	exercira	2	22	1819	13440
exercitarà	2	140	exercitara	2	0	140	13441
exercità	2	9	exercita	2	383	392	13442
exercitàrem	2	2	exercitarem	2	17	19	13443
exercitàreu	2	0	exercitareu	2	3	3	13444
exercités	2	12	exercites	2	17	29	13445
exercití	2	0	exerciti	2	122	122	13446
exercírem	2	0	exercirem	2	127	127	13447
exercíreu	2	0	exercireu	2	2	2	13448
exfoliarà	2	1	exfoliara	2	0	1	13449
exfolià	2	0	exfolia	2	41	41	13450
exfoliàrem	2	0	exfoliarem	2	1	1	13451
exhalarà	2	3	exhalara	2	0	3	13452
exhalà	2	9	exhala	2	156	165	13453
exhalàrem	2	0	exhalarem	2	1	1	13454
exhalàreu	2	3	exhalareu	2	0	3	13455
exhalés	2	1	exhales	2	16	17	13456
exhalí	2	0	exhali	2	13	13	13457
exhaurirà	2	17	exhaurira	2	1	18	13458
exhaurírem	2	1	exhaurirem	2	3	4	13459
exhibirà	2	483	exhibira	2	4	487	13460
exhibírem	2	0	exhibirem	2	11	11	13461
exhibíreu	2	0	exhibireu	2	1	1	13462
exhortarà	2	8	exhortara	2	0	8	13463
exhortà	2	45	exhorta	2	385	430	13464
exhortàrem	2	0	exhortarem	2	1	1	13465
exhortés	2	16	exhortes	2	0	16	13466
exhortí	2	0	exhorti	2	7	7	13467
exhumarà	2	11	exhumara	2	1	12	13468
exhumà	2	14	exhuma	2	29	43	13469
exhumàrem	2	0	exhumarem	2	2	2	13470
exhumés	2	2	exhumes	2	1	3	13471
exhumí	2	0	exhumi	2	9	9	13472
exigirà	2	1681	exigira	2	22	1703	13473
exigírem	2	7	exigirem	2	349	356	13474
exigíreu	2	0	exigireu	2	4	4	13475
exiliarà	2	14	exiliara	2	0	14	13476
exilià	2	959	exilia	2	217	1176	13477
exiliàrem	2	0	exiliarem	2	3	3	13478
exiliàreu	2	0	exiliareu	2	1	1	13479
exiliés	2	25	exilies	2	2	27	13480
exilií	2	0	exilii	2	4	4	13481
eximirà	2	70	eximira	2	2	72	13482
eximí	2	14	eximi	0	80	94	13483
eximírem	2	0	eximirem	2	3	3	13484
eximíreu	2	0	eximireu	2	3	3	13485
eximís	2	16	eximis	0	16	32	13486
existirà	2	874	existira	2	149	1023	13487
existírem	2	2	existirem	2	10	12	13488
exonerarà	2	19	exonerara	2	0	19	13489
exonerà	2	16	exonera	2	331	347	13490
exonerés	2	5	exoneres	2	3	8	13491
exonerí	2	0	exoneri	2	18	18	13492
exorcitzarà	2	1	exorcitzara	2	0	1	13493
exorcitzà	2	2	exorcitza	2	10	12	13494
exorcitzí	2	0	exorcitzi	2	1	1	13495
exornà	2	0	exorna	2	2	2	13496
expandirà	2	132	expandira	2	9	141	13497
expandírem	2	0	expandirem	2	7	7	13498
expansionarà	2	3	expansionara	2	0	3	13499
expansionà	2	7	expansiona	2	32	39	13500
expansionés	2	1	expansiones	2	1	2	13501
expansioní	2	0	expansioni	2	4	4	13502
expatrià	2	10	expatria	2	4	14	13503
expatriés	2	1	expatries	2	0	1	13504
expectarà	2	1	expectara	2	0	1	13505
expectorà	2	0	expectora	2	3	3	13506
expectorí	2	0	expectori	2	1	1	13507
expectà	2	0	expecta	2	3	3	13508
expectés	2	0	expectes	2	1	1	13509
expedientarà	2	6	expedientara	2	0	6	13510
expedientà	2	1	expedienta	2	26	27	13511
expedientés	2	2	expedientes	2	41	43	13512
expedientí	2	0	expedienti	2	6	6	13513
expedirà	2	311	expedira	2	0	311	13514
expedírem	2	0	expedirem	2	4	4	13515
expendré	2	0	expendre	2	14	14	13516
expenguí	2	0	expengui	2	1	1	13517
experimentarà	2	531	experimentara	2	7	538	13518
experimentà	2	540	experimenta	2	4488	5028	13519
experimentàrem	2	11	experimentarem	2	401	412	13520
experimentàreu	2	0	experimentareu	2	62	62	13521
experimentés	2	71	experimentes	2	145	216	13522
experimentí	2	0	experimenti	2	388	388	13523
expiarà	2	5	expiara	2	1	6	13524
expilàrem	2	1	expilarem	2	0	1	13525
expirarà	2	109	expirara	2	2	111	13526
expirà	2	39	expira	2	543	582	13527
expiràrem	2	0	expirarem	2	2	2	13528
expiràreu	2	1	expirareu	2	0	1	13529
expirés	2	51	expires	2	16	67	13530
expirí	2	0	expiri	2	180	180	13531
expià	2	4	expia	2	24	28	13532
expiàrem	2	0	expiarem	2	1	1	13533
expiés	2	2	expies	2	0	2	13534
explanarà	2	1	explanara	2	0	1	13535
explantà	2	0	explanta	2	1	1	13536
explanà	2	26	explana	2	34	60	13537
explanés	2	1	explanes	2	0	1	13538
explicarà	2	7004	explicara	2	126	7130	13539
explicitarà	2	49	explicitara	2	1	50	13540
explicità	2	20	explicita	2	1124	1144	13541
explicitàrem	2	0	explicitarem	2	6	6	13542
explicités	2	19	explicites	2	47	66	13543
explicití	2	1	expliciti	2	105	106	13544
explicà	2	2327	explica	2	110924	113251	13545
explicàrem	2	69	explicarem	2	4108	4177	13546
explicàreu	2	1	explicareu	2	254	255	13547
expliqués	2	1511	expliques	2	2171	3682	13548
expliquí	2	9	expliqui	2	4789	4798	13549
explorarà	2	344	explorara	2	5	349	13550
explorà	2	126	explora	2	5623	5749	13551
exploràrem	2	9	explorarem	2	545	554	13552
exploràreu	2	0	explorareu	2	24	24	13553
explorés	2	34	explores	2	45	79	13554
explorí	2	0	explori	2	211	211	13555
explosionà	2	1	explosiona	2	20	21	13556
explosionés	2	0	explosiones	2	2	2	13557
explosioní	2	0	explosioni	2	1	1	13558
explotarà	2	203	explotara	2	5	208	13559
explotà	2	118	explota	2	1949	2067	13560
explotàrem	2	0	explotarem	2	21	21	13561
explotàreu	2	0	explotareu	2	2	2	13562
explotés	2	99	explotes	2	15	114	13563
explotí	2	0	exploti	2	290	290	13564
explícit	0	4197	explicit	2	109	4306	13565
explícita	0	5113	explicita	2	1124	6237	13566
explícites	0	1174	explicites	2	47	1221	13567
exportarà	2	96	exportara	2	2	98	13568
exportà	2	37	exporta	2	2808	2845	13569
exportàrem	2	0	exportarem	2	19	19	13570
exportàveu	2	5	exportaveu	4	208	213	13571
exportés	2	12	exportes	2	17	29	13572
exportí	2	0	exporti	2	91	91	13573
exposarà	2	2163	exposara	2	14	2177	13574
exposà	2	1012	exposa	2	12358	13370	13575
exposàrem	2	17	exposarem	2	484	501	13576
exposàreu	2	2	exposareu	2	7	9	13577
exposés	2	144	exposes	2	281	425	13578
exposí	2	0	exposi	2	612	612	13579
expressarà	2	304	expressara	2	18	322	13580
expressà	2	496	expressa	4	22370	22866	13581
expressàrem	2	7	expressarem	2	78	85	13582
expressàreu	2	0	expressareu	2	3	3	13583
expressés	2	258	expresses	4	445	703	13584
expressí	2	3	expressi	2	1564	1567	13585
exprimirà	2	8	exprimira	2	0	8	13586
exprimírem	2	0	exprimirem	2	15	15	13587
exprimíreu	2	0	exprimireu	2	4	4	13588
expropiarà	2	19	expropiara	2	4	23	13589
expropià	2	27	expropia	2	51	78	13590
expropiàrem	2	0	expropiarem	2	3	3	13591
expropiés	2	12	expropies	2	2	14	13592
expropií	2	3	expropii	2	2	5	13593
expugnà	2	0	expugna	2	2	2	13594
expulsarà	2	122	expulsara	2	9	131	13595
expulsà	2	217	expulsa	2	1002	1219	13596
expulsàrem	2	1	expulsarem	2	14	15	13597
expulsés	2	107	expulses	2	15	122	13598
expulsí	2	0	expulsi	2	165	165	13599
expurgués	2	0	expurgues	2	1	1	13600
expurgà	2	2	expurga	2	0	2	13601
exsecallà	2	0	exsecalla	2	1	1	13602
exsudarà	2	1	exsudara	2	0	1	13603
exsudà	2	0	exsuda	2	10	10	13604
exsudés	2	0	exsudes	2	1	1	13605
extasiarà	2	1	extasiara	2	0	1	13606
extasià	2	2	extasia	2	27	29	13607
extasiàrem	2	0	extasiarem	2	1	1	13608
extasiés	2	1	extasies	2	1	2	13609
extenuà	2	2	extenua	2	3	5	13610
exterioritzarà	2	1	exterioritzara	2	0	1	13611
exterioritzà	2	1	exterioritza	2	91	92	13612
exterioritzàrem	2	1	exterioritzarem	2	0	1	13613
exterioritzés	2	6	exterioritzes	2	3	9	13614
exterioritzí	2	0	exterioritzi	2	13	13	13615
exterminarà	2	10	exterminara	2	1	11	13616
exterminà	2	14	extermina	2	53	67	13617
exterminàrem	2	0	exterminarem	2	1	1	13618
exterminàreu	2	0	exterminareu	2	2	2	13619
exterminés	2	12	extermines	2	0	12	13620
exterminí	2	1	extermini	2	2960	2961	13621
externalitzarà	2	10	externalitzara	2	0	10	13622
externalitzà	2	1	externalitza	2	104	105	13623
externalitzés	2	1	externalitzes	2	1	2	13624
externalitzí	2	0	externalitzi	2	21	21	13625
extingirà	2	116	extingira	2	2	118	13626
extingírem	2	0	extingirem	2	8	8	13627
extirparà	2	6	extirpara	2	1	7	13628
extirpà	2	2	extirpa	2	86	88	13629
extirpàrem	2	0	extirparem	2	1	1	13630
extirpés	2	6	extirpes	2	2	8	13631
extirpí	2	0	extirpi	2	16	16	13632
extorsionà	2	1	extorsiona	2	23	24	13633
extorsionés	2	1	extorsiones	2	3	4	13634
extorsioní	2	0	extorsioni	2	1	1	13635
extractà	2	2	extracta	2	10	12	13636
extractés	2	0	extractes	2	2171	2171	13637
extradirà	2	31	extradira	2	0	31	13638
extradírem	2	0	extradirem	2	1	1	13639
extragués	2	23	extragues	2	1	24	13640
extraguí	2	0	extragui	2	2	2	13641
extralimitarà	2	1	extralimitara	2	1	2	13642
extralimità	2	0	extralimita	2	44	44	13643
extralimités	2	5	extralimites	2	0	5	13644
extralimití	2	0	extralimiti	2	12	12	13645
extrapolarà	2	4	extrapolara	2	0	4	13646
extrapolà	2	5	extrapola	2	97	102	13647
extrapolàrem	2	0	extrapolarem	2	6	6	13648
extrapolés	2	2	extrapoles	2	2	4	13649
extrapolí	2	0	extrapoli	2	6	6	13650
extrauré	2	10	extraure	2	1172	1182	13651
extraviarà	2	2	extraviara	2	1	3	13652
extravià	2	4	extravia	2	52	56	13653
extraviés	2	6	extravies	2	4	10	13654
extravií	2	0	extravii	2	1	1	13655
extremarà	2	9	extremara	2	0	9	13656
extremuncià	2	1	extremuncia	2	0	1	13657
extremunció	4	59	extremuncio	2	0	59	13658
extremà	2	3	extrema	0	17950	17953	13659
extremàrem	2	0	extremarem	2	7	7	13660
extremés	2	3	extremes	0	3578	3581	13661
extremí	2	0	extremi	2	55	55	13662
extrudirà	2	1	extrudira	2	1	2	13663
exultarà	2	3	exultara	2	0	3	13664
exultà	2	3	exulta	2	21	24	13665
exultés	2	1	exultes	2	0	1	13666
exultí	2	0	exulti	2	3	3	13667
exèrcit	4	50707	exercit	2	8335	59042	13668
exèrcits	4	6060	exercits	2	607	6667	13669
exímia	0	21	eximia	2	88	109	13670
exímies	0	2	eximies	2	0	2	13671
eó	4	60	eo	4	223	283	13672
fabricarà	2	174	fabricara	2	5	179	13673
fabricà	2	153	fabrica	2	3705	3858	13674
fabricàrem	2	3	fabricarem	2	82	85	13675
fabricàreu	2	0	fabricareu	2	2	2	13676
fabriqués	2	48	fabriques	2	313	361	13677
fabriquí	2	0	fabriqui	2	135	135	13678
fabulà	2	0	fabula	2	131	131	13679
fabulés	2	0	fabules	2	11	11	13680
fabulí	2	4	fabuli	2	1	5	13681
facetà	2	1	faceta	4	4202	4203	13682
facetés	2	0	facetes	4	3793	3793	13683
facilitarà	2	5817	facilitara	2	53	5870	13684
facilità	2	375	facilita	2	20294	20669	13685
facilitàrem	2	8	facilitarem	2	972	980	13686
facilitàreu	2	0	facilitareu	2	24	24	13687
facilitària	0	1	facilitaria	2	873	874	13688
facilitàries	0	0	facilitaries	2	2	2	13689
facilités	2	401	facilites	2	279	680	13690
facilití	2	0	faciliti	2	5520	5520	13691
factoritzarà	2	1	factoritzara	2	0	1	13692
factoritzà	2	0	factoritza	2	7	7	13693
facturarà	2	178	facturara	2	3	181	13694
facturà	2	14	factura	4	14918	14932	13695
facturàrem	2	2	facturarem	2	20	22	13696
facturàreu	2	0	facturareu	2	1	1	13697
facturés	2	7	factures	4	10354	10361	13698
facturí	2	0	facturi	2	52	52	13699
facultarà	2	112	facultara	2	0	112	13700
facultà	2	8	faculta	2	574	582	13701
facultés	2	11	facultes	2	2	13	13702
facultí	2	0	faculti	2	61	61	13703
fadigués	2	0	fadigues	4	4	4	13704
fadigà	2	2	fadiga	4	48	50	13705
fadà	2	0	fada	4	2477	2477	13706
fadés	2	0	fades	4	3916	3916	13707
fadí	2	1	fadi	2	20	21	13708
fagocitarà	2	2	fagocitara	2	0	2	13709
fagocità	2	3	fagocita	2	48	51	13710
fagocitària	0	14	fagocitaria	2	0	14	13711
fagocitàries	0	4	fagocitaries	2	0	4	13712
fagocití	2	0	fagociti	2	6	6	13713
fagòcit	4	22	fagocit	2	0	22	13714
faixà	2	0	faixa	4	1977	1977	13715
faixés	2	0	faixes	4	584	584	13716
faixí	2	67	faixi	2	47	114	13717
faixó	4	100	faixo	2	6	106	13718
falcà	2	2	falca	4	778	780	13719
faldejà	2	0	faldeja	2	6	6	13720
faldejàrem	2	0	faldejarem	2	2	2	13721
fallarà	2	253	fallara	2	11	264	13722
fallirà	2	0	fallira	2	1	1	13723
fallà	2	94	falla	4	16728	16822	13724
fallàrem	2	4	fallarem	2	90	94	13725
fallàreu	2	0	fallareu	2	12	12	13726
fallés	2	175	falles	4	13063	13238	13727
fallí	2	6	falli	2	383	389	13728
fallís	2	3	fallis	2	51	54	13729
falqués	2	187	falques	4	662	849	13730
falquí	2	3	falqui	2	1	4	13731
falsegés	2	5	falseges	2	1	6	13732
falsegí	2	0	falsegi	2	18	18	13733
falsejarà	2	2	falsejara	2	0	2	13734
falsejà	2	1	falseja	2	130	131	13735
falsificarà	2	3	falsificara	2	0	3	13736
falsificà	2	10	falsifica	2	51	61	13737
falsifiqués	2	5	falsifiques	2	3	8	13738
falsifiquí	2	0	falsifiqui	2	20	20	13739
falsà	2	0	falsa	0	8621	8621	13740
falsària	0	17	falsaria	2	5	22	13741
falsàries	0	35	falsaries	2	1	36	13742
falsés	2	1	falses	0	7784	7785	13743
falsí	2	0	falsi	2	7	7	13744
faltarà	2	1484	faltara	2	66	1550	13745
faltà	2	152	falta	4	101678	101830	13746
faltàrem	2	0	faltarem	2	44	44	13747
faltàreu	2	0	faltareu	2	5	5	13748
faltés	2	348	faltes	4	6287	6635	13749
faltí	2	1	falti	2	1575	1576	13750
famejà	2	0	fameja	2	1	1	13751
familiaritzarà	2	37	familiaritzara	2	4	41	13752
familiaritzà	2	20	familiaritza	2	110	130	13753
familiaritzàrem	2	0	familiaritzarem	2	36	36	13754
familiaritzàreu	2	0	familiaritzareu	2	4	4	13755
familiaritzés	2	13	familiaritzes	2	13	26	13756
familiaritzí	2	1	familiaritzi	2	132	133	13757
fanatitzà	2	0	fanatitza	2	5	5	13758
fanatitzés	2	1	fanatitzes	2	0	1	13759
fanfarronegés	2	0	fanfarroneges	2	1	1	13760
fanfarronegí	2	0	fanfarronegi	2	3	3	13761
fanfarronejà	2	1	fanfarroneja	2	8	9	13762
fanguejà	2	0	fangueja	2	1	1	13763
fangués	2	0	fangues	4	12	12	13764
fanguí	2	0	fangui	2	1	1	13765
fangà	2	1	fanga	4	176	177	13766
fantasiegés	2	0	fantasieges	2	1	1	13767
fantasiegí	2	0	fantasiegi	2	3	3	13768
fantasiejarà	2	1	fantasiejara	2	0	1	13769
fantasiejà	2	2	fantasieja	2	68	70	13770
fantasiejàrem	2	0	fantasiejarem	2	1	1	13771
fantasiejàreu	2	0	fantasiejareu	2	2	2	13772
fantasià	2	1	fantasia	4	10330	10331	13773
fantasiàrem	2	0	fantasiarem	2	2	2	13774
fantasiés	2	1	fantasies	4	2068	2069	13775
fantasmejà	2	0	fantasmeja	2	1	1	13776
farcirà	2	13	farcira	2	2	15	13777
farcírem	2	0	farcirem	2	72	72	13778
farcíreu	2	0	farcireu	2	3	3	13779
fargués	2	1	fargues	4	657	658	13780
farguí	2	0	fargui	2	1	1	13781
fargà	2	0	farga	4	2801	2801	13782
farolejà	2	0	faroleja	2	1	1	13783
faronejà	2	0	faroneja	2	1	1	13784
farratgés	2	0	farratges	4	587	587	13785
farratjà	2	0	farratja	2	3	3	13786
farratjàrem	2	0	farratjarem	2	1	1	13787
farratjó	4	1	farratjo	2	0	1	13788
fartarà	2	2	fartara	2	0	2	13789
fartà	2	7	farta	0	1231	1238	13790
fartàrem	2	0	fartarem	2	2	2	13791
fartés	2	1	fartes	0	393	394	13792
fartí	2	0	farti	2	1	1	13793
fartó	4	11	farto	2	7	18	13794
faró	4	25	faro	4	839	864	13795
fascinarà	2	93	fascinara	2	0	93	13796
fascinà	2	30	fascina	2	1335	1365	13797
fascinàrem	2	0	fascinarem	2	1	1	13798
fascinés	2	6	fascines	2	6	12	13799
fasciní	2	0	fascini	2	34	34	13800
fastiguegí	2	0	fastiguegi	2	9	9	13801
fastiguejarà	2	3	fastiguejara	2	0	3	13802
fastiguejà	2	2	fastigueja	2	83	85	13803
fatigarà	2	2	fatigara	2	1	3	13804
fatigués	2	2	fatigues	4	298	300	13805
fatiguí	2	0	fatigui	2	7	7	13806
fatigà	2	0	fatiga	4	3812	3812	13807
fatxendejà	2	0	fatxendeja	2	3	3	13808
fatxendà	2	0	fatxenda	4	412	412	13809
fatxendés	2	0	fatxendes	4	189	189	13810
febrejà	2	0	febreja	2	4	4	13811
fecundarà	2	5	fecundara	2	0	5	13812
fecundà	2	1	fecunda	0	746	747	13813
fecundàrem	2	1	fecundarem	2	1	2	13814
fecundés	2	3	fecundes	0	140	143	13815
fecundí	2	0	fecundi	2	17	17	13816
federarà	2	4	federara	2	0	4	13817
federà	2	11	federa	2	53	64	13818
federàrem	2	0	federarem	2	4	4	13819
federàreu	2	0	federareu	2	1	1	13820
federés	2	3	federes	2	2	5	13821
federí	2	0	federi	2	21	21	13822
feinegés	2	0	feineges	2	2	2	13823
feinegí	2	0	feinegi	2	1	1	13824
feinejarà	2	1	feinejara	2	0	1	13825
feinejà	2	1	feineja	2	60	61	13826
feinejàrem	2	0	feinejarem	2	1	1	13827
feixà	2	0	feixa	4	1154	1154	13828
feixàreu	2	1	feixareu	2	0	1	13829
feixés	2	1	feixes	4	1649	1650	13830
feixí	2	4	feixi	2	2	6	13831
felicitarà	2	36	felicitara	2	5	41	13832
felicità	2	104	felicita	2	1810	1914	13833
felicitàrem	2	3	felicitarem	2	31	34	13834
felicitàreu	2	0	felicitareu	2	1	1	13835
felicités	2	27	felicites	2	19	46	13836
felicití	2	0	feliciti	2	193	193	13837
feliuà	0	4	feliua	4	7	11	13838
femarà	2	1	femara	2	0	1	13839
feminitzà	2	1	feminitza	2	23	24	13840
feminitzí	2	0	feminitzi	2	3	3	13841
femtà	2	0	femta	4	687	687	13842
femtés	2	0	femtes	4	294	294	13843
femà	2	0	fema	2	38	38	13844
femàreu	2	1	femareu	2	0	1	13845
femés	2	0	femes	2	12	12	13846
femí	2	3	femi	2	33	36	13847
fendirà	2	1	fendira	2	0	1	13848
fendré	2	0	fendre	2	6	6	13849
fendí	2	4	fendi	4	42	46	13850
fenià	4	35	fenia	2	24	59	13851
fenyés	2	0	fenyes	2	1	1	13852
ferejàreu	2	1	ferejareu	2	0	1	13853
ferirà	2	19	ferira	2	1	20	13854
fermarà	2	5	fermara	2	0	5	13855
fermentarà	2	16	fermentara	2	1	17	13856
fermentà	2	3	fermenta	2	354	357	13857
fermentàrem	2	0	fermentarem	2	1	1	13858
fermentés	2	14	fermentes	2	1	15	13859
fermentí	2	0	fermenti	2	85	85	13860
fermà	2	12	ferma	0	14112	14124	13861
fermàrem	2	2	fermarem	2	0	2	13862
fermés	2	11	fermes	0	1979	1990	13863
ferrarà	2	0	ferrara	4	689	689	13864
ferrarès	0	6	ferrares	2	1	7	13865
ferrarés	0	3	ferrares	2	1	4	13866
ferratgés	2	0	ferratges	4	238	238	13867
ferratjà	2	0	ferratja	2	1	1	13868
ferretejà	2	0	ferreteja	2	2	2	13869
ferràrem	2	0	ferrarem	2	1	1	13870
ferrés	2	544	ferres	4	101	645	13871
ferrí	2	2	ferri	4	3502	3504	13872
ferrós	0	67	ferros	4	960	1027	13873
fertilitzarà	2	5	fertilitzara	2	0	5	13874
fertilitzà	2	1	fertilitza	2	75	76	13875
fertilitzàreu	2	0	fertilitzareu	2	1	1	13876
fertilitzés	2	1	fertilitzes	2	1	2	13877
fertilitzí	2	0	fertilitzi	2	3	3	13878
ferí	2	96	feri	2	22	118	13879
ferírem	2	0	ferirem	2	4	4	13880
ferís	2	27	feris	2	3	30	13881
festegés	2	1	festeges	2	10	11	13882
festegí	2	0	festegi	2	10	10	13883
festejarà	2	35	festejara	2	2	37	13884
festejà	2	11	festeja	2	303	314	13885
festejàrem	2	1	festejarem	2	25	26	13886
festivarà	2	1	festivara	2	1	2	13887
festivà	2	0	festiva	0	6770	6770	13888
festivés	2	0	festives	0	2374	2374	13889
festiví	2	0	festivi	2	1	1	13890
fetillà	2	0	fetilla	2	4	4	13891
fetillí	2	1	fetilli	2	0	1	13892
feudalitzà	2	2	feudalitza	2	0	2	13893
fiancés	2	16	fiances	4	560	576	13894
fiançarà	2	1	fiançara	2	0	1	13895
fiançà	2	0	fiança	4	4038	4038	13896
fiarà	2	17	fiara	2	3	20	13897
fiblà	2	5	fibla	4	323	328	13898
fiblés	2	0	fibles	4	5	5	13899
fiblí	2	0	fibli	2	1	1	13900
fibló	4	426	fiblo	2	5	431	13901
fibrosà	2	0	fibrosa	2	186	186	13902
fibrosés	2	0	fibroses	2	115	115	13903
fibrosí	2	0	fibrosi	2	739	739	13904
ficarà	2	177	ficara	2	21	198	13905
ficcionà	2	0	ficciona	2	36	36	13906
ficcionés	2	0	ficciones	2	50	50	13907
ficà	2	150	fica	2	2520	2670	13908
ficàrem	2	14	ficarem	2	325	339	13909
ficàreu	2	0	ficareu	2	19	19	13910
fidelitzarà	2	4	fidelitzara	2	0	4	13911
fidelitzà	2	0	fidelitza	2	252	252	13912
fidelitzàrem	2	0	fidelitzarem	2	7	7	13913
fidelitzàreu	2	0	fidelitzareu	2	1	1	13914
fidelitzés	2	0	fidelitzes	2	1	1	13915
fidelitzí	2	0	fidelitzi	2	18	18	13916
figuerolà	0	0	figuerola	4	1619	1619	13917
figurarà	2	553	figurara	2	13	566	13918
figurà	2	92	figura	4	67744	67836	13919
figuràrem	2	0	figurarem	2	2	2	13920
figuràreu	2	0	figurareu	2	1	1	13921
figurés	2	165	figures	4	30674	30839	13922
figurí	2	126	figuri	2	1042	1168	13923
filarà	2	11	filara	2	1	12	13924
filetegí	2	0	filetegi	2	1	1	13925
filetejà	2	0	fileteja	2	6	6	13926
filetejàrem	2	0	filetejarem	2	2	2	13927
filigranà	2	0	filigrana	4	505	505	13928
filigranés	2	0	filigranes	4	553	553	13929
filià	2	57	filia	2	51	108	13930
filiés	2	0	filies	2	109	109	13931
filií	2	0	filii	2	19	19	13932
fillolà	2	0	fillola	4	259	259	13933
fillolés	2	0	filloles	4	134	134	13934
filmarà	2	36	filmara	2	0	36	13935
filmà	2	42	filma	2	340	382	13936
filmàrem	2	0	filmarem	2	16	16	13937
filmés	2	27	filmes	2	27	54	13938
filmí	2	0	filmi	2	26	26	13939
filosofà	2	1	filosofa	2	98	99	13940
filosofàrem	2	0	filosofarem	2	3	3	13941
filosofés	2	0	filosofes	2	6	6	13942
filosofí	2	0	filosofi	2	14	14	13943
filtrarà	2	55	filtrara	2	1	56	13944
filtrà	2	22	filtra	2	1342	1364	13945
filtràrem	2	0	filtrarem	2	18	18	13946
filtrés	2	48	filtres	2	6931	6979	13947
filtrí	2	0	filtri	2	103	103	13948
filustrà	2	0	filustra	2	4	4	13949
filà	2	2155	fila	4	9946	12101	13950
filàrem	2	1	filarem	2	5	6	13951
filària	4	3	filaria	2	5	8	13952
filàries	4	8	filaries	2	0	8	13953
filés	2	5	files	4	8909	8914	13954
filí	2	5	fili	2	52	57	13955
filòsof	4	9735	filosof	2	56	9791	13956
filòsofa	4	943	filosofa	2	98	1041	13957
filòsofes	4	137	filosofes	2	6	143	13958
fimbrejarà	2	1	fimbrejara	2	0	1	13959
fimbrejà	2	0	fimbreja	2	5	5	13960
fimbrà	2	0	fimbra	2	2	2	13961
fimbrés	2	1	fimbres	2	2	3	13962
finalitzarà	2	5926	finalitzara	2	42	5968	13963
finalitzà	2	1079	finalitza	2	10672	11751	13964
finalitzàrem	2	16	finalitzarem	2	380	396	13965
finalitzàreu	2	0	finalitzareu	2	11	11	13966
finalitzés	2	315	finalitzes	2	51	366	13967
finalitzí	2	0	finalitzi	2	2393	2393	13968
financés	2	87	finances	4	14489	14576	13969
financí	2	1	financi	2	310	311	13970
finançarà	2	981	finançara	2	12	993	13971
finançà	2	130	finança	4	2233	2363	13972
finançàrem	2	1	finançarem	2	65	66	13973
finançàreu	2	0	finançareu	2	1	1	13974
finarà	2	7	finara	2	1	8	13975
finegí	2	0	finegi	2	1	1	13976
finestrejà	2	0	finestreja	2	1	1	13977
fingirà	2	8	fingira	2	0	8	13978
fingírem	2	1	fingirem	2	2	3	13979
finirà	2	31	finira	2	3	34	13980
fintés	2	0	fintes	4	72	72	13981
finà	2	47	fina	4	15481	15528	13982
finès	0	1197	fines	4	4199	5396	13983
finés	2	61	fines	4	4199	4260	13984
finí	2	48	fini	2	183	231	13985
finís	2	5	finis	2	107	112	13986
fiqués	2	122	fiques	2	489	611	13987
fiquí	2	5	fiqui	2	338	343	13988
firarà	2	1	firara	2	0	1	13989
firmarà	2	235	firmara	2	15	250	13990
firmà	2	183	firma	4	9380	9563	13991
firmàrem	2	7	firmarem	2	17	24	13992
firmàreu	2	1	firmareu	2	1	2	13993
firmés	2	99	firmes	4	4832	4931	13994
firmí	2	4	firmi	2	108	112	13995
firà	2	7	fira	4	95358	95365	13996
firàrem	2	0	firarem	2	1	1	13997
firés	2	0	fires	4	15637	15637	13998
firí	2	0	firi	2	3	3	13999
fiscalitzarà	2	19	fiscalitzara	2	2	21	14000
fiscalitzà	2	2	fiscalitza	2	89	91	14001
fiscalitzàrem	2	0	fiscalitzarem	2	6	6	14002
fiscalitzés	2	8	fiscalitzes	2	1	9	14003
fiscalitzí	2	0	fiscalitzi	2	35	35	14004
fissionà	2	0	fissiona	2	7	7	14005
fissioní	2	0	fissioni	2	3	3	14006
fistonejà	2	0	fistoneja	2	2	2	14007
fitarà	2	5	fitara	2	1	6	14008
fitorà	2	0	fitora	4	31	31	14009
fitoràreu	2	0	fitorareu	2	1	1	14010
fitorés	2	0	fitores	4	3	3	14011
fitorí	2	0	fitori	2	1	1	14012
fitxarà	2	89	fitxara	2	6	95	14013
fitxà	2	255	fitxa	4	13882	14137	14014
fitxàrem	2	1	fitxarem	2	23	24	14015
fitxàreu	2	0	fitxareu	2	2	2	14016
fitxés	2	57	fitxes	4	8826	8883	14017
fitxí	2	0	fitxi	2	66	66	14018
fità	2	22	fita	4	15049	15071	14019
fitàrem	2	1	fitarem	2	3	4	14020
fitàreu	2	0	fitareu	2	1	1	14021
fités	2	0	fites	0	10353	10353	14022
fití	2	0	fiti	2	71	71	14023
fixarà	2	811	fixara	2	18	829	14024
fixà	2	417	fixa	0	15645	16062	14025
fixàrem	2	18	fixarem	2	424	442	14026
fixàreu	2	2	fixareu	2	11	13	14027
fixés	2	317	fixes	0	5768	6085	14028
fixí	2	0	fixi	2	1338	1338	14029
fià	2	3	fia	2	1065	1068	14030
fiàrem	2	2	fiarem	2	6	8	14031
fiés	2	11	fies	2	148	159	14032
fií	2	1	fii	2	60	61	14033
flagel·larà	2	1	flagel·lara	2	0	1	14034
flagel·là	2	1	flagel·la	2	10	11	14035
flagel·làrem	2	0	flagel·larem	2	1	1	14036
flagel·lés	2	0	flagel·les	2	2	2	14037
flagel·lí	2	0	flagel·li	2	1	1	14038
flairejarà	2	1	flairejara	2	0	1	14039
flairejà	2	0	flaireja	2	2	2	14040
flairosegí	2	1	flairosegi	2	0	1	14041
flairà	2	6	flaira	2	81	87	14042
flairàrem	2	0	flairarem	2	2	2	14043
flairés	2	2	flaires	2	288	290	14044
flairí	2	0	flairi	2	5	5	14045
flamegés	2	1	flameges	2	0	1	14046
flamegí	2	0	flamegi	2	1	1	14047
flamejarà	2	1	flamejara	2	0	1	14048
flamejà	2	1	flameja	2	35	36	14049
flamejàrem	2	0	flamejarem	2	9	9	14050
flamà	2	0	flama	4	7670	7670	14051
flamés	2	0	flames	4	4549	4549	14052
flamí	2	2	flami	2	2	4	14053
flanquegés	2	0	flanqueges	2	3	3	14054
flanquegí	2	0	flanquegi	2	2	2	14055
flanquejarà	2	1	flanquejara	2	1	2	14056
flanquejà	2	2	flanqueja	2	203	205	14057
flanquejàrem	2	0	flanquejarem	2	22	22	14058
flaquegés	2	3	flaqueges	2	3	6	14059
flaquegí	2	0	flaquegi	2	14	14	14060
flaquejarà	2	3	flaquejara	2	0	3	14061
flaquejà	2	1	flaqueja	2	84	85	14062
flaquejàrem	2	0	flaquejarem	2	4	4	14063
flastomà	2	0	flastoma	2	2	2	14064
flastomés	2	0	flastomes	2	1	1	14065
flastomí	2	0	flastomi	2	1	1	14066
flectà	2	0	flecta	2	3	3	14067
fleixarà	2	1	fleixara	2	0	1	14068
fleixà	2	0	fleixa	4	14	14	14069
fleixés	2	0	fleixes	4	5	5	14070
flexibilitzarà	2	28	flexibilitzara	2	0	28	14071
flexibilitzà	2	2	flexibilitza	2	130	132	14072
flexibilitzàrem	2	0	flexibilitzarem	2	7	7	14073
flexibilitzés	2	5	flexibilitzes	2	1	6	14074
flexibilitzí	2	0	flexibilitzi	2	50	50	14075
flexionarà	2	4	flexionara	2	0	4	14076
flexionà	2	0	flexiona	2	78	78	14077
flexionàrem	2	0	flexionarem	2	5	5	14078
flexionés	2	0	flexiones	2	2	2	14079
flexioní	2	0	flexioni	2	10	10	14080
fliparà	2	27	flipara	2	0	27	14081
flipà	2	0	flipa	2	173	173	14082
flipàrem	2	1	fliparem	2	17	18	14083
flipàreu	2	0	flipareu	2	63	63	14084
flipés	2	2	flipes	2	63	65	14085
flipí	2	1	flipi	2	10	11	14086
flirtegés	2	1	flirteges	2	4	5	14087
flirtegí	2	0	flirtegi	2	10	10	14088
flirtejarà	2	1	flirtejara	2	0	1	14089
flirtejà	2	5	flirteja	2	138	143	14090
flirtà	2	0	flirta	2	5	5	14091
flitarà	2	1	flitara	2	0	1	14092
flità	2	0	flita	2	2	2	14093
flités	2	0	flites	2	1	1	14094
flixà	2	0	flixa	2	2	2	14095
flocà	2	0	floca	4	33	33	14096
floqués	2	0	floques	4	1	1	14097
floquí	2	0	floqui	2	2	2	14098
floregés	2	0	floreges	2	1	1	14099
florejarà	2	1	florejara	2	0	1	14100
florejà	2	1	floreja	2	8	9	14101
florirà	2	65	florira	2	1	66	14102
florírem	2	0	florirem	2	6	6	14103
florís	2	34	floris	4	85	119	14104
flotarà	2	20	flotara	2	0	20	14105
flotà	2	2	flota	4	12053	12055	14106
flotàrem	2	0	flotarem	2	1	1	14107
flotàreu	2	0	flotareu	2	1	1	14108
flotés	2	19	flotes	4	1984	2003	14109
flotí	2	0	floti	2	49	49	14110
flotó	4	1	floto	2	9	10	14111
fluctuarà	2	20	fluctuara	2	0	20	14112
fluctuà	2	5	fluctua	2	303	308	14113
fluctuàrem	2	0	fluctuarem	2	1	1	14114
fluctués	2	4	fluctues	2	0	4	14115
fluixegés	2	1	fluixeges	2	0	1	14116
fluixegí	2	0	fluixegi	2	3	3	14117
fluixejarà	2	1	fluixejara	2	0	1	14118
fluixejà	2	0	fluixeja	2	45	45	14119
fluixejàreu	2	1	fluixejareu	2	0	1	14120
fluorè	4	1	fluore	2	0	1	14121
fluírem	2	0	fluirem	2	2	2	14122
fluïdificà	2	0	fluïdifica	2	19	19	14123
fluïdifiqués	2	1	fluïdifiques	2	0	1	14124
flòcul	4	2	flocul	2	0	2	14125
flòrida	0	2	florida	4	7267	7269	14126
flòridament	6	0	floridament	6	4	4	14127
flòrides	0	1	florides	4	671	672	14128
focalitzarà	2	81	focalitzara	2	1	82	14129
focalitzà	2	8	focalitza	2	831	839	14130
focalitzàrem	2	1	focalitzarem	2	27	28	14131
focalitzàreu	2	0	focalitzareu	2	1	1	14132
focalitzés	2	16	focalitzes	2	9	25	14133
focalitzí	2	0	focalitzi	2	52	52	14134
fogallejà	2	0	fogalleja	2	1	1	14135
fogatgés	2	1	fogatges	4	123	124	14136
foguegés	2	1	fogueges	2	0	1	14137
foguegí	2	0	foguegi	2	1	1	14138
foguejà	2	0	fogueja	2	3	3	14139
fogués	2	10	fogues	2	1	11	14140
foguí	2	0	fogui	2	1	1	14141
fogà	2	0	foga	2	9	9	14142
fogó	4	315	fogo	2	87	402	14143
folgarà	2	1	folgara	2	0	1	14144
folgués	2	0	folgues	4	1	1	14145
folgà	2	0	folga	4	33	33	14146
foliarà	2	1	foliara	2	0	1	14147
folià	2	5	folia	4	100	105	14148
foliés	2	0	folies	4	122	122	14149
folií	2	0	folii	2	3	3	14150
folkloritzà	2	1	folkloritza	2	2	3	14151
folkloritzés	2	1	folkloritzes	2	0	1	14152
follarà	2	2	follara	2	1	3	14153
follà	2	1	folla	0	317	318	14154
follàrem	2	0	follarem	2	11	11	14155
follés	2	13	folles	0	137	150	14156
follí	2	1	folli	2	31	32	14157
folrarà	2	5	folrara	2	0	5	14158
folrà	2	5	folra	2	98	103	14159
folràrem	2	0	folrarem	2	37	37	14160
folràreu	2	0	folrareu	2	1	1	14161
folrés	2	0	folres	2	237	237	14162
folrí	2	0	folri	2	2	2	14163
fomentarà	2	1005	fomentara	2	10	1015	14164
fomentà	2	108	fomenta	2	7433	7541	14165
fomentàrem	2	2	fomentarem	2	300	302	14166
fomentàreu	2	0	fomentareu	2	7	7	14167
fomentés	2	85	fomentes	2	26	111	14168
fomentí	2	0	fomenti	2	1565	1565	14169
fonamentarà	2	90	fonamentara	2	1	91	14170
fonamentà	2	85	fonamenta	2	4581	4666	14171
fonamentàrem	2	2	fonamentarem	2	12	14	14172
fonamentés	2	31	fonamentes	2	9	40	14173
fonamentí	2	0	fonamenti	2	274	274	14174
fondegés	2	1	fondeges	2	8	9	14175
fondegí	2	0	fondegi	2	2	2	14176
fondejarà	2	10	fondejara	2	1	11	14177
fondejà	2	9	fondeja	2	21	30	14178
fondejàrem	2	1	fondejarem	2	14	15	14179
fondré	2	8	fondre	2	2740	2748	14180
fongués	2	45	fongues	2	8	53	14181
fonguí	2	0	fongui	2	318	318	14182
fonyà	2	0	fonya	2	2	2	14183
fonà	2	0	fona	4	352	352	14184
fonés	2	3	fones	4	74	77	14185
foní	2	0	foni	2	10	10	14186
fonó	4	11	fono	2	48	59	14187
foradarà	2	8	foradara	2	0	8	14188
foradà	2	109	forada	4	185	294	14189
foradés	2	5	forades	4	6	11	14190
foradí	2	17	foradi	2	18	35	14191
foragitarà	2	7	foragitara	2	0	7	14192
foragità	2	40	foragita	2	121	161	14193
foragitàrem	2	0	foragitarem	2	3	3	14194
foragitàreu	2	2	foragitareu	2	1	3	14195
foragités	2	7	foragites	2	0	7	14196
foragití	2	0	foragiti	2	18	18	14197
foravià	2	0	foravia	2	2	2	14198
forcallà	0	33	forcalla	4	1	34	14199
forcarà	2	4	forcara	2	0	4	14200
forcejarà	2	1	forcejara	2	0	1	14201
forcejà	2	2	forceja	2	12	14	14202
forcà	2	0	forca	4	1363	1363	14203
forcés	2	98	forces	4	70148	70246	14204
forcí	2	1	forci	2	215	216	14205
forcó	4	1	forco	2	3	4	14206
forfollà	2	0	forfolla	2	1	1	14207
forgés	2	12	forges	4	362	374	14208
forgí	2	0	forgi	2	28	28	14209
forjarà	2	49	forjara	2	2	51	14210
forjà	2	88	forja	4	2550	2638	14211
forjàrem	2	0	forjarem	2	12	12	14212
forjàreu	2	1	forjareu	2	1	2	14213
formalitzarà	2	437	formalitzara	2	2	439	14214
formalitzà	2	63	formalitza	2	818	881	14215
formalitzàrem	2	0	formalitzarem	2	27	27	14216
formalitzàreu	2	0	formalitzareu	2	5	5	14217
formalitzés	2	44	formalitzes	2	15	59	14218
formalitzí	2	0	formalitzi	2	292	292	14219
formarà	2	3539	formara	2	82	3621	14220
formatarà	2	18	formatara	2	0	18	14221
formatgés	2	0	formatges	4	8965	8965	14222
formatgí	2	1	formatgi	2	2	3	14223
formatà	2	0	formata	2	258	258	14224
formatàrem	2	0	formatarem	2	2	2	14225
formatés	2	1	formates	2	4	5	14226
formatí	2	0	formati	2	9	9	14227
formigonarà	2	9	formigonara	2	0	9	14228
formigonà	2	0	formigona	2	3	3	14229
formigoní	2	0	formigoni	2	4	4	14230
formiguejà	2	0	formigueja	2	9	9	14231
formigués	2	0	formigues	4	3392	3392	14232
formigà	2	1	formiga	4	1627	1628	14233
formigó	4	7493	formigo	2	56	7549	14234
formularà	2	307	formulara	2	4	311	14235
formulà	2	216	formula	2	3727	3943	14236
formulàrem	2	7	formularem	2	67	74	14237
formulàreu	2	0	formulareu	2	1	1	14238
formulària	0	9	formularia	2	42	51	14239
formulàries	0	7	formularies	2	1	8	14240
formulés	2	117	formules	2	587	704	14241
formulí	2	1	formuli	2	500	501	14242
formà	2	4894	forma	4	472962	477856	14243
formàrem	2	28	formarem	2	304	332	14244
formàreu	2	1	formareu	2	59	60	14245
formés	2	841	formes	4	80180	81021	14246
formí	2	6	formi	2	2740	2746	14247
formó	4	12	formo	2	1288	1300	14248
fornegés	2	0	forneges	2	2	2	14249
fornegí	2	0	fornegi	2	1	1	14250
fornejarà	2	1	fornejara	2	0	1	14251
fornejà	2	1	forneja	2	58	59	14252
fornejàrem	2	0	fornejarem	2	13	13	14253
fornicà	2	2	fornica	2	18	20	14254
fornicàrem	2	0	fornicarem	2	1	1	14255
fornicàreu	2	0	fornicareu	2	1	1	14256
fornicàries	0	0	fornicaries	2	1	1	14257
fornillà	2	0	fornilla	2	4	4	14258
forniqués	2	1	forniques	2	0	1	14259
fornirà	2	12	fornira	2	0	12	14260
fornírem	2	0	fornirem	2	2	2	14261
forqués	2	9	forques	4	967	976	14262
forquí	2	0	forqui	2	1	1	14263
forrarà	2	3	forrara	2	0	3	14264
forrà	2	0	forra	4	46	46	14265
forràrem	2	0	forrarem	2	9	9	14266
forrés	2	0	forres	4	11	11	14267
forrí	2	0	forri	2	5	5	14268
fortificarà	2	3	fortificara	2	2	5	14269
fortificà	2	72	fortifica	2	75	147	14270
fortificàrem	2	0	fortificarem	2	1	1	14271
fortifiqués	2	10	fortifiques	2	1	11	14272
fortifiquí	2	0	fortifiqui	2	4	4	14273
forà	0	467	fora	6	148881	149348	14274
forçarà	2	186	forçara	2	8	194	14275
forçà	2	266	força	3	201913	202179	14276
forçàrem	2	0	forçarem	2	23	23	14277
fosforejà	2	0	fosforeja	2	1	1	14278
fosforilarà	2	1	fosforilara	2	0	1	14279
fosforilà	2	0	fosforila	2	16	16	14280
fosforàrem	2	1	fosforarem	2	0	1	14281
fosquegí	2	0	fosquegi	2	7	7	14282
fosquejarà	2	1	fosquejara	2	0	1	14283
fosquejà	2	0	fosqueja	2	47	47	14284
fossilitzarà	2	1	fossilitzara	2	1	2	14285
fossilitzà	2	0	fossilitza	2	17	17	14286
fossilitzés	2	1	fossilitzes	2	0	1	14287
fossilitzí	2	0	fossilitzi	2	2	2	14288
fossà	2	6	fossa	4	3344	3350	14289
fossàrem	2	0	fossarem	2	2	2	14290
fossés	2	0	fosses	4	3345	3345	14291
fossí	2	0	fossi	2	91	91	14292
fotgés	2	0	fotges	4	150	150	14293
fotgí	2	0	fotgi	2	1	1	14294
fotjà	2	9	fotja	4	155	164	14295
fotocopià	2	0	fotocopia	2	397	397	14296
fotocopiàrem	2	0	fotocopiarem	2	1	1	14297
fotocopiés	2	1	fotocopies	2	96	97	14298
fotocopií	2	1	fotocopii	2	0	1	14299
fotocòpia	4	5595	fotocopia	2	397	5992	14300
fotocòpies	4	1450	fotocopies	2	96	1546	14301
fotografiarà	2	20	fotografiara	2	4	24	14302
fotografià	2	35	fotografia	4	69094	69129	14303
fotografiàrem	2	3	fotografiarem	2	34	37	14304
fotografiàreu	2	0	fotografiareu	2	2	2	14305
fotografiés	2	43	fotografies	4	64715	64758	14306
fotografií	2	2	fotografii	2	5	7	14307
fotolitografià	2	0	fotolitografia	4	31	31	14308
fotosintetitzà	2	0	fotosintetitza	2	2	2	14309
fotré	2	123	fotre	7	3585	3708	14310
fotés	2	76	fotes	2	14	90	14311
fotó	4	408	foto	4	147910	148318	14312
fracassarà	2	190	fracassara	2	4	194	14313
fracassà	2	409	fracassa	2	773	1182	14314
fracassàrem	2	0	fracassarem	2	46	46	14315
fracassàreu	2	0	fracassareu	2	11	11	14316
fracassés	2	118	fracasses	2	23	141	14317
fracassí	2	0	fracassi	2	220	220	14318
fraccionarà	2	16	fraccionara	2	0	16	14319
fraccionà	2	6	fracciona	2	66	72	14320
fraccionàrem	2	0	fraccionarem	2	3	3	14321
fraccionàreu	2	1	fraccionareu	2	0	1	14322
fraccionària	0	117	fraccionaria	2	14	131	14323
fraccionàries	0	23	fraccionaries	2	0	23	14324
fraccionés	2	0	fracciones	2	17	17	14325
fraccioní	2	0	fraccioni	2	5	5	14326
fracturarà	2	14	fracturara	2	0	14	14327
fracturà	2	15	fractura	4	4654	4669	14328
fracturàrem	2	0	fracturarem	2	1	1	14329
fracturés	2	4	fractures	4	1522	1526	14330
fracturí	2	0	fracturi	2	21	21	14331
fragmentarà	2	11	fragmentara	2	0	11	14332
fragmentà	2	28	fragmenta	2	947	975	14333
fragmentària	0	330	fragmentaria	2	26	356	14334
fragmentàries	0	175	fragmentaries	2	5	180	14335
fragmentés	2	4	fragmentes	2	4	8	14336
fragmentí	2	0	fragmenti	2	30	30	14337
francesitzarà	2	1	francesitzara	2	0	1	14338
francesitzés	2	0	francesitzes	2	1	1	14339
franciscà	0	1155	francisca	4	1469	2624	14340
frangés	2	2	franges	4	4476	4478	14341
frangí	2	2	frangi	2	1	3	14342
franjà	2	0	franja	4	15267	15267	14343
franquegés	2	3	franqueges	2	3	6	14344
franquegí	2	0	franquegi	2	6	6	14345
franquejarà	2	6	franquejara	2	0	6	14346
franquejà	2	1	franqueja	2	95	96	14347
franquejàrem	2	0	franquejarem	2	8	8	14348
frasejà	2	1	fraseja	2	10	11	14349
fraternitzà	2	1	fraternitza	2	2	3	14350
fraternitzí	2	0	fraternitzi	2	1	1	14351
fredorejà	2	1	fredoreja	2	0	1	14352
fregarà	2	44	fregara	2	2	46	14353
fregirà	2	7	fregira	2	2	9	14354
fregués	2	24	fregues	4	196	220	14355
freguí	2	0	fregui	2	80	80	14356
fregà	2	29	frega	4	1333	1362	14357
fregàrem	2	1	fregarem	2	37	38	14358
fregàreu	2	0	fregareu	2	2	2	14359
fregírem	2	1	fregirem	2	240	241	14360
fregíreu	2	0	fregireu	2	5	5	14361
fregó	4	1	frego	2	147	148	14362
freixnedà	0	0	freixneda	4	90	90	14363
frenarà	2	165	frenara	2	4	169	14364
frenà	2	73	frena	2	1350	1423	14365
frenàrem	2	0	frenarem	2	24	24	14366
frenàreu	2	0	frenareu	2	2	2	14367
frenés	2	60	frenes	2	31	91	14368
frení	2	0	freni	2	368	368	14369
freqüentarà	2	20	freqüentara	2	1	21	14370
freqüentà	2	408	freqüenta	2	329	737	14371
freqüentés	2	13	freqüentes	2	25	38	14372
freqüentí	2	0	freqüenti	2	14	14	14373
fresarà	2	1	fresara	2	0	1	14374
frescós	0	1	frescos	0	7287	7288	14375
fresquegí	2	0	fresquegi	2	1	1	14376
fresquejà	2	0	fresqueja	2	7	7	14377
fressarà	2	1	fressara	2	0	1	14378
fressejà	2	0	fresseja	2	2	2	14379
fressà	2	1	fressa	4	537	538	14380
fressés	2	0	fresses	4	86	86	14381
fresà	2	0	fresa	4	400	400	14382
fresés	2	0	freses	4	175	175	14383
fresí	2	1	fresi	2	48	49	14384
freturà	2	0	fretura	4	69	69	14385
freturàrem	2	1	freturarem	2	1	2	14386
freturés	2	0	fretures	4	14	14	14387
freturí	2	0	freturi	2	2	2	14388
friccionà	2	1	fricciona	2	8	9	14389
friccionàrem	2	0	friccionarem	2	1	1	14390
friccionés	2	0	fricciones	2	7	7	14391
friccioní	2	0	friccioni	2	1	1	14392
frisarà	2	1	frisara	2	0	1	14393
frissà	2	0	frissa	2	21	21	14394
frissés	2	0	frisses	2	5	5	14395
frissí	2	0	frissi	2	1	1	14396
frisà	2	0	frisa	2	118	118	14397
frisàreu	2	0	frisareu	2	2	2	14398
frisés	2	2	frises	2	16	18	14399
frisí	2	0	frisi	2	23	23	14400
frisó	0	273	friso	2	169	442	14401
frisós	0	55	frisos	4	392	447	14402
frivolitzà	2	0	frivolitza	2	34	34	14403
frivolitzés	2	2	frivolitzes	2	0	2	14404
frivolitzí	2	0	frivolitzi	2	11	11	14405
fronterejà	2	0	frontereja	2	11	11	14406
fructificarà	2	24	fructificara	2	1	25	14407
fructificà	2	23	fructifica	2	154	177	14408
fructificàreu	2	0	fructificareu	2	2	2	14409
fructifiqués	2	20	fructifiques	2	0	20	14410
fructifiquí	2	0	fructifiqui	2	59	59	14411
fruitarià	0	0	fruitaria	2	2	2	14412
fruitarà	2	5	fruitara	2	0	5	14413
fruità	2	4	fruita	4	27686	27690	14414
fruitàrem	2	0	fruitarem	2	2	2	14415
fruités	2	1	fruites	4	15734	15735	14416
fruití	2	0	fruiti	2	1	1	14417
frustrarà	2	28	frustrara	2	1	29	14418
frustrà	2	26	frustra	2	229	255	14419
frustràrem	2	0	frustrarem	2	6	6	14420
frustràreu	2	0	frustrareu	2	1	1	14421
frustrés	2	16	frustres	2	14	30	14422
frustrí	2	0	frustri	2	26	26	14423
fruírem	2	5	fruirem	2	21	26	14424
fruíreu	2	0	fruireu	2	11	11	14425
frànkfurt	4	10	frankfurt	4	4310	4320	14426
fuetegés	2	2	fueteges	2	1	3	14427
fuetegí	2	0	fuetegi	2	1	1	14428
fuetejarà	2	3	fuetejara	2	0	3	14429
fuetejà	2	3	fueteja	2	70	73	14430
fugarà	2	2	fugara	2	0	2	14431
fugirà	2	120	fugira	2	16	136	14432
fugués	2	3	fugues	4	790	793	14433
fuguí	2	0	fugui	2	3	3	14434
fugà	2	13	fuga	4	3518	3531	14435
fugàrem	2	0	fugarem	2	1	1	14436
fugí	2	710	fugi	2	235	945	14437
fugírem	2	3	fugirem	2	28	31	14438
fugíreu	2	0	fugireu	2	5	5	14439
fugís	2	168	fugis	2	38	206	14440
fulgurà	2	0	fulgura	2	19	19	14441
fulgurés	2	0	fulgures	2	1	1	14442
fullegés	2	7	fulleges	2	33	40	14443
fullegí	2	0	fullegi	2	7	7	14444
fullejà	2	7	fulleja	2	93	100	14445
fullejàrem	2	1	fullejarem	2	1	2	14446
fullés	2	0	fulles	4	25135	25135	14447
fulminarà	2	4	fulminara	2	0	4	14448
fulminà	2	16	fulmina	2	77	93	14449
fulminés	2	7	fulmines	2	0	7	14450
fulminí	2	0	fulmini	2	9	9	14451
fulés	0	0	fules	0	15	15	14452
fumarà	2	18	fumara	2	2	20	14453
fumegí	2	0	fumegi	2	29	29	14454
fumejarà	2	2	fumejara	2	0	2	14455
fumejà	2	0	fumeja	2	97	97	14456
fumerà	2	0	fumera	0	431	431	14457
fumigarà	2	11	fumigara	2	0	11	14458
fumigués	2	1	fumigues	2	1	2	14459
fumiguí	2	0	fumigui	2	1	1	14460
fumigà	2	0	fumiga	2	20	20	14461
fumà	2	5	fuma	2	833	838	14462
fumàrem	2	1	fumarem	2	10	11	14463
fumària	4	11	fumaria	2	43	54	14464
fumàries	4	3	fumaries	2	2	5	14465
fumé	2	26	fume	2	41	67	14466
fuméreu	2	0	fumereu	2	2	2	14467
fumés	2	38	fumes	2	124	162	14468
fumí	2	0	fumi	2	149	149	14469
funcionaritzí	2	0	funcionaritzi	2	1	1	14470
funcionarà	2	2840	funcionara	2	45	2885	14471
funcionà	2	305	funciona	2	35136	35441	14472
funcionàrem	2	0	funcionarem	2	17	17	14473
funcionàreu	2	0	funcionareu	2	1	1	14474
funcionària	4	976	funcionaria	2	809	1785	14475
funcionàries	4	516	funcionaries	2	31	547	14476
funcionés	2	675	funciones	2	328	1003	14477
funcioní	2	2	funcioni	2	6024	6026	14478
fundarà	2	96	fundara	2	12	108	14479
fundà	2	3962	funda	4	4022	7984	14480
fundàrem	2	9	fundarem	2	11	20	14481
fundàreu	2	1	fundareu	2	0	1	14482
fundés	2	108	fundes	4	1188	1296	14483
fundí	2	2	fundi	2	37	39	14484
funestà	2	0	funesta	0	358	358	14485
funestés	2	0	funestes	0	222	222	14486
funestí	2	1	funesti	2	1	2	14487
funyí	2	0	funyi	2	1	1	14488
funyírem	2	0	funyirem	2	3	3	14489
furgarà	2	3	furgara	2	0	3	14490
furgués	2	3	furgues	4	22	25	14491
furguí	2	0	furgui	2	13	13	14492
furgà	2	5	furga	4	211	216	14493
furgàrem	2	0	furgarem	2	4	4	14494
furgó	4	540	furgo	2	1021	1561	14495
furonejà	2	0	furoneja	2	1	1	14496
furonà	2	0	furona	2	2	2	14497
furonés	2	0	furones	2	17	17	14498
furtarà	2	11	furtara	2	2	13	14499
furtà	2	16	furta	2	95	111	14500
furtàrem	2	0	furtarem	2	4	4	14501
furtàreu	2	0	furtareu	2	13	13	14502
furtés	2	5	furtes	2	7	12	14503
furtí	2	0	furti	2	11	11	14504
furà	2	22	fura	4	1534	1556	14505
furés	2	0	fures	4	414	414	14506
furí	2	0	furi	2	42	42	14507
furó	4	9	furo	2	12	21	14508
fusionarà	2	138	fusionara	2	6	144	14509
fusionà	2	198	fusiona	2	1806	2004	14510
fusionàrem	2	0	fusionarem	2	15	15	14511
fusionés	2	33	fusiones	2	14	47	14512
fusioní	2	0	fusioni	2	49	49	14513
fusterejàreu	2	1	fusterejareu	2	0	1	14514
fusterià	0	141	fusteria	4	3942	4083	14515
fustigués	2	3	fustigues	2	2	5	14516
fustiguí	2	0	fustigui	2	5	5	14517
fustigà	2	11	fustiga	2	61	72	14518
fàbrica	4	36103	fabrica	2	3705	39808	14519
fàbriques	4	9265	fabriques	2	313	9578	14520
fària	4	48	faria	2	22034	22082	14521
fàries	4	6	faries	2	1152	1158	14522
fàtic	0	3	fatic	4	6	9	14523
fàtics	0	2	fatics	4	15	17	14524
fèria	4	21	feria	2	1428	1449	14525
fèries	4	17	feries	2	15	32	14526
fé	2	255	fe	4	37836	38091	14527
féu	2	10889	feu	2	47128	58017	14528
fíala	4	1	fiala	4	14	15	14529
fíales	4	0	fiales	4	3	3	14530
fíat	4	1	fiat	4	967	968	14531
fíats	4	0	fiats	2	21	21	14532
fília	4	68	filia	2	51	119	14533
fílies	4	229	filies	2	109	338	14534
fòrbia	4	1	forbia	2	0	1	14535
fòrbies	4	7	forbies	2	0	7	14536
fòrmic	0	82	formic	2	147	229	14537
fòrnix	4	5	fornix	2	10	15	14538
fòsfor	4	1863	fosfor	2	21	1884	14539
fóra	2	6661	fora	6	148881	155542	14540
fórmula	4	23680	formula	2	3727	27407	14541
fórmules	4	8869	formules	2	587	9456	14542
fóssem	2	14	fossem	2	11	25	14543
fósseu	2	2	fosseu	2	3	5	14544
fúlgida	0	4	fulgida	2	2	6	14545
fúmer	2	33	fumer	0	8	41	14546
gabarà	2	0	gabara	2	57	57	14547
gabionarà	2	0	gabionara	2	1	1	14548
gabà	2	16	gaba	2	127	143	14549
gabés	2	2	gabes	2	22	24	14550
gaianès	0	1	gaianes	4	144	145	14551
gaianés	0	0	gaianes	4	144	144	14552
gaitejà	2	1	gaiteja	2	0	1	14553
galegés	2	0	galeges	2	3	3	14554
galejà	2	0	galeja	2	3	3	14555
galerí	4	1	galeri	4	149	150	14556
galgués	2	0	galgues	4	42	42	14557
galgà	2	0	galga	4	64	64	14558
galibí	2	0	galibi	2	7	7	14559
galileà	0	9	galilea	4	1225	1234	14560
galindó	4	48	galindo	4	919	967	14561
gallardegí	2	0	gallardegi	2	1	1	14562
gallardejà	2	0	gallardeja	2	2	2	14563
gallardó	4	11	gallardo	4	2148	2159	14564
gallegés	2	0	galleges	2	10	10	14565
gallegí	2	0	gallegi	2	3	3	14566
gallejà	2	0	galleja	2	12	12	14567
gallifà	0	2	gallifa	4	1230	1232	14568
gallàrdia	4	0	gallardia	4	59	59	14569
galopà	2	1	galopa	4	56	57	14570
galopàreu	2	0	galopareu	2	1	1	14571
galopés	2	0	galopes	2	4	4	14572
galopí	2	1	galopi	2	3	4	14573
galtejà	2	1	galteja	2	2	3	14574
galvanitzà	2	6	galvanitza	2	10	16	14575
galzarà	2	1	galzara	2	0	1	14576
galzés	2	0	galzes	2	8	8	14577
gal·lés	0	20	gal·les	4	3902	3922	14578
galà	0	114	gala	4	16440	16554	14579
gambarà	2	0	gambara	2	11	11	14580
gambà	2	0	gamba	4	2117	2117	14581
gambés	2	3	gambes	4	3755	3758	14582
gambí	2	5	gambi	2	5	10	14583
gambúsia	4	47	gambusia	4	25	72	14584
gambúsies	4	16	gambusies	4	4	20	14585
gamificà	2	0	gamifica	2	7	7	14586
gamifiquí	2	0	gamifiqui	2	1	1	14587
gamà	2	0	gama	2	7249	7249	14588
gamés	2	3	games	2	3419	3422	14589
gamí	2	0	gami	2	10	10	14590
gamó	4	3	gamo	2	49	52	14591
gandesà	0	40	gandesa	4	2541	2581	14592
gandià	0	101	gandia	4	13679	13780	14593
gandulegés	2	2	ganduleges	2	0	2	14594
gandulejà	2	0	ganduleja	2	3	3	14595
ganejà	2	0	ganeja	2	1	1	14596
gangrenarà	2	4	gangrenara	2	0	4	14597
gangrenà	2	0	gangrena	4	170	170	14598
gangrenés	2	1	gangrenes	4	12	13	14599
gangrení	2	0	gangreni	2	1	1	14600
ganivetejà	2	1	ganiveteja	2	2	3	14601
gansallà	2	0	gansalla	4	6	6	14602
gansallí	2	0	gansalli	2	1	1	14603
ganxó	4	543	ganxo	4	2055	2598	14604
ganxós	4	0	ganxos	4	786	786	14605
ganyolà	2	1	ganyola	2	3	4	14606
ganyà	2	4	ganya	4	33	37	14607
ganyàrem	2	0	ganyarem	2	1	1	14608
ganyés	2	0	ganyes	4	62	62	14609
ganyí	2	0	ganyi	2	1	1	14610
ganyó	0	5	ganyo	2	0	5	14611
garantirà	2	2813	garantira	2	45	2858	14612
garantírem	2	0	garantirem	2	346	346	14613
garantíreu	2	0	garantireu	2	5	5	14614
garapinyà	2	0	garapinya	2	1	1	14615
garbejà	2	0	garbeja	2	1	1	14616
garbellà	2	0	garbella	4	33	33	14617
garbellés	2	1	garbelles	4	3	4	14618
garbellí	2	0	garbelli	2	3	3	14619
garberà	2	0	garbera	4	32	32	14620
garberés	2	0	garberes	4	22	22	14621
garberí	2	2	garberi	2	0	2	14622
garbó	4	31	garbo	4	297	328	14623
garbós	0	0	garbos	4	1	1	14624
garcià	0	1	garcia	4	23667	23668	14625
gardenyà	2	0	gardenya	4	5	5	14626
gardenyés	2	0	gardenyes	4	42	42	14627
garfullà	2	0	garfulla	2	1	1	14628
garfí	2	0	garfi	4	114	114	14629
garfís	2	5	garfis	4	46	51	14630
gargallejà	2	0	gargalleja	2	1	1	14631
gargamellejà	2	0	gargamelleja	2	2	2	14632
gargamellejàrem	2	1	gargamellejarem	2	0	1	14633
gargaritzí	2	0	gargaritzi	2	1	1	14634
gargotegí	2	0	gargotegi	2	1	1	14635
gargotejà	2	3	gargoteja	2	4	7	14636
garibaldí	0	18	garibaldi	4	421	439	14637
garlà	2	0	garla	2	19	19	14638
garlés	2	0	garles	2	2	2	14639
garlí	2	1	garli	2	6	7	14640
garolà	2	0	garola	4	21	21	14641
garrigà	0	5	garriga	4	11821	11826	14642
garrinarà	2	1	garrinara	2	0	1	14643
garrinà	2	0	garrina	4	2	2	14644
garrinés	2	0	garrines	4	3	3	14645
garroní	2	0	garroni	2	2	2	14646
garrotà	2	0	garrota	4	15	15	14647
garrotés	2	0	garrotes	2	3	3	14648
garrotí	2	8	garroti	2	0	8	14649
garrulà	2	0	garrula	2	23	23	14650
garrulés	2	0	garrules	2	6	6	14651
garrés	4	6	garres	4	62	68	14652
garsà	2	0	garsa	4	470	470	14653
garsés	2	0	garses	4	326	326	14654
garsó	4	2	garso	2	0	2	14655
gasejarà	2	0	gasejara	2	1	1	14656
gasejà	2	1	gaseja	2	2	3	14657
gasparà	2	0	gaspara	4	12	12	14658
gaspà	2	95	gaspa	2	17	112	14659
gaspí	2	0	gaspi	2	9	9	14660
gastarà	2	274	gastara	2	16	290	14661
gastà	2	55	gasta	2	2638	2693	14662
gastàrem	2	8	gastarem	2	158	166	14663
gastàreu	2	0	gastareu	2	29	29	14664
gastés	2	70	gastes	2	240	310	14665
gasés	2	0	gases	4	195	195	14666
gasí	2	0	gasi	2	15	15	14667
gasós	0	526	gasos	4	11794	12320	14668
gategés	2	0	gateges	2	2	2	14669
gategí	2	0	gategi	2	5	5	14670
gatejarà	2	3	gatejara	2	0	3	14671
gatejà	2	1	gateja	2	42	43	14672
gatejàreu	2	0	gatejareu	2	1	1	14673
gatinà	2	0	gatina	2	19	19	14674
gatinés	2	0	gatines	2	2	2	14675
gatonà	2	0	gatona	2	10	10	14676
gaubí	2	6	gaubi	2	0	6	14677
gaudirà	2	1852	gaudira	2	42	1894	14678
gaudírem	2	137	gaudirem	2	3901	4038	14679
gaudíreu	2	1	gaudireu	2	1588	1589	14680
gaudís	2	277	gaudis	4	85	362	14681
gavanyés	2	1	gavanyes	2	0	1	14682
gavetà	0	0	gaveta	4	49	49	14683
gaó	4	24	gao	4	337	361	14684
gaús	4	1	gaus	4	15	16	14685
gebrà	2	0	gebra	2	24	24	14686
gebrés	2	0	gebres	2	3	3	14687
gebrí	2	0	gebri	2	1	1	14688
gelarà	2	9	gelara	2	3	12	14689
gelatinitzà	2	0	gelatinitza	2	6	6	14690
gelatinitzí	2	0	gelatinitzi	2	1	1	14691
gelificarà	2	1	gelificara	2	0	1	14692
gelificà	2	0	gelifica	2	17	17	14693
gelifiquí	2	0	gelifiqui	2	6	6	14694
gelà	2	11	gela	4	348	359	14695
gelàrem	2	0	gelarem	2	3	3	14696
gelés	2	12	geles	2	34	46	14697
gelí	2	6	geli	4	1601	1607	14698
gemecà	2	0	gemeca	2	2	2	14699
gemegarà	2	1	gemegara	2	0	1	14700
gemegués	2	2	gemegues	2	4	6	14701
gemeguí	2	0	gemegui	2	7	7	14702
gemegà	2	7	gemega	2	173	180	14703
gemegàrem	2	0	gemegarem	2	1	1	14704
geminà	2	0	gemina	2	65	65	14705
geminí	2	0	gemini	2	348	348	14706
gemín	2	0	gemin	0	18	18	14707
generalitzarà	2	36	generalitzara	2	2	38	14708
generalitzà	2	73	generalitza	2	444	517	14709
generalitzàrem	2	0	generalitzarem	2	4	4	14710
generalitzés	2	38	generalitzes	2	15	53	14711
generalitzí	2	0	generalitzi	2	95	95	14712
generarà	2	2504	generara	2	25	2529	14713
generà	2	436	genera	2	28285	28721	14714
generàrem	2	3	generarem	2	166	169	14715
generàreu	2	0	generareu	2	16	16	14716
generí	2	0	generi	2	2829	2829	14717
gentrificarà	2	2	gentrificara	2	0	2	14718
gentrificà	2	0	gentrifica	2	6	6	14719
gentrifiqués	2	2	gentrifiques	2	0	2	14720
geolocalitzarà	2	7	geolocalitzara	2	0	7	14721
geolocalitzà	2	0	geolocalitza	2	51	51	14722
geolocalitzàrem	2	1	geolocalitzarem	2	1	2	14723
geolocalitzés	2	0	geolocalitzes	2	1	1	14724
georeferencià	2	0	georeferencia	2	9	9	14725
germanitzarà	2	11	germanitzara	2	0	11	14726
germanitzàrem	2	0	germanitzarem	2	1	1	14727
germinarà	2	21	germinara	2	3	24	14728
germinà	2	7	germina	2	337	344	14729
germinàrem	2	0	germinarem	2	2	2	14730
germinés	2	4	germines	2	1	5	14731
germiní	2	0	germini	2	40	40	14732
gerró	4	4	gerro	4	1197	1201	14733
gestarà	2	10	gestara	2	1	11	14734
gesticularà	2	1	gesticulara	2	0	1	14735
gesticulà	2	1	gesticula	2	120	121	14736
gesticulàrem	2	0	gesticularem	2	1	1	14737
gesticulés	2	0	gesticules	2	8	8	14738
gesticulí	2	0	gesticuli	2	6	6	14739
gestionarà	2	1512	gestionara	2	20	1532	14740
gestionà	2	75	gestiona	2	14388	14463	14741
gestionàrem	2	4	gestionarem	2	610	614	14742
gestionàreu	2	0	gestionareu	2	7	7	14743
gestionés	2	133	gestiones	2	150	283	14744
gestioní	2	0	gestioni	2	1218	1218	14745
gestà	2	47	gesta	4	2721	2768	14746
gestàrem	2	0	gestarem	2	1	1	14747
gestés	2	3	gestes	4	1590	1593	14748
gicà	2	1	gica	2	62	63	14749
ginebrosà	0	0	ginebrosa	4	33	33	14750
ginyà	2	1	ginya	2	5	6	14751
ginyés	2	0	ginyes	2	12	12	14752
giqués	2	0	giques	2	9	9	14753
giragonsarà	2	1	giragonsara	2	0	1	14754
giragonsejarà	2	0	giragonsejara	2	1	1	14755
giragonsà	2	0	giragonsa	4	121	121	14756
giragonsàrem	2	1	giragonsarem	2	0	1	14757
giragonsés	2	0	giragonses	4	470	470	14758
girarà	2	1414	girara	2	18	1432	14759
giravoltarà	2	3	giravoltara	2	0	3	14760
giravoltà	2	5	giravolta	4	85	90	14761
giravoltés	2	3	giravoltes	4	48	51	14762
giravoltí	2	0	giravolti	2	3	3	14763
girigàrem	2	1	girigarem	2	0	1	14764
giroflé	4	0	girofle	4	4	4	14765
girà	2	437	gira	4	27936	28373	14766
giràrem	2	9	girarem	2	913	922	14767
giràreu	2	0	girareu	2	53	53	14768
girí	2	5	giri	2	768	773	14769
giscà	2	0	gisca	4	9	9	14770
gitarà	2	0	gitara	2	3	3	14771
gità	2	48	gita	4	213	261	14772
gitàrem	2	2	gitarem	2	1	3	14773
gités	2	1	gites	4	44	45	14774
glacegí	2	0	glacegi	2	1	1	14775
glacejà	2	0	glaceja	2	1	1	14776
glacé	4	166	glace	2	67	233	14777
glacés	4	24	glaces	4	24	48	14778
glací	2	0	glaci	2	45	45	14779
glapirà	2	0	glapira	2	1	1	14780
glaçarà	2	23	glaçara	2	0	23	14781
glaçà	2	11	glaça	4	406	417	14782
glaçó	4	146	glaço	2	3	149	14783
globalitzarà	2	5	globalitzara	2	0	5	14784
globalitzà	2	2	globalitza	2	74	76	14785
globalitzàrem	2	0	globalitzarem	2	1	1	14786
globalitzés	2	0	globalitzes	2	1	1	14787
globalitzí	2	0	globalitzi	2	2	2	14788
glopegés	2	0	glopeges	2	1	1	14789
glopegí	2	0	glopegi	2	1	1	14790
glopejà	2	0	glopeja	2	10	10	14791
glorianès	0	0	glorianes	4	18	18	14792
glorianés	0	0	glorianes	4	18	18	14793
gloriarà	2	2	gloriara	2	0	2	14794
gloriegés	2	3	glorieges	2	0	3	14795
gloriejà	2	1	glorieja	2	4	5	14796
glorificarà	2	15	glorificara	2	0	15	14797
glorificà	2	5	glorifica	2	121	126	14798
glorifiqués	2	4	glorifiques	2	1	5	14799
glorifiquí	2	0	glorifiqui	2	11	11	14800
glorià	2	1	gloria	2	2665	2666	14801
gloriés	2	0	glories	2	116	116	14802
glorií	2	1	glorii	2	0	1	14803
glosarà	2	7	glosara	2	0	7	14804
glossarà	2	28	glossara	2	4	32	14805
glossà	2	64	glossa	4	721	785	14806
glossàrem	2	0	glossarem	2	5	5	14807
glossés	2	6	glosses	4	307	313	14808
glossí	2	0	glossi	2	7	7	14809
glosà	2	11	glosa	4	951	962	14810
glosés	2	3	gloses	4	472	475	14811
glosí	2	0	glosi	2	3	3	14812
godallà	2	0	godalla	4	1	1	14813
godelletà	0	0	godelleta	4	225	225	14814
godellà	0	3	godella	4	1701	1704	14815
godinà	2	0	godina	4	45	45	14816
godiní	2	0	godini	2	4	4	14817
gofrarà	2	1	gofrara	2	0	1	14818
gofrà	2	0	gofra	2	14	14	14819
gofrés	2	0	gofres	2	198	198	14820
gogés	2	0	goges	4	317	317	14821
gogí	2	0	gogi	2	11	11	14822
gojarà	2	1	gojara	2	0	1	14823
gojà	2	6	goja	4	77	83	14824
gojàrem	2	2	gojarem	2	2	4	14825
gojàreu	2	0	gojareu	2	2	2	14826
gojós	0	38	gojos	4	142	180	14827
golegés	2	2	goleges	2	0	2	14828
golegí	2	0	golegi	2	1	1	14829
golejà	2	8	goleja	2	108	116	14830
gomboldà	2	0	gombolda	2	3	3	14831
gonà	4	0	gona	4	37	37	14832
googlegés	2	1	googleges	2	2	3	14833
googlegí	2	0	googlegi	2	2	2	14834
googlejà	2	0	googleja	2	5	5	14835
gorrejà	2	0	gorreja	2	1	1	14836
gosarà	2	111	gosara	2	6	117	14837
gosà	2	105	gosa	2	971	1076	14838
gosàrem	2	2	gosarem	2	13	15	14839
gosàreu	2	0	gosareu	2	6	6	14840
gosés	2	106	goses	2	106	212	14841
gosí	2	2	gosi	2	264	266	14842
gotegés	2	1	goteges	2	2	3	14843
gotegí	2	0	gotegi	2	12	12	14844
gotejarà	2	2	gotejara	2	0	2	14845
gotejà	2	2	goteja	2	98	100	14846
gotinyarà	2	0	gotinyara	2	1	1	14847
governarà	2	437	governara	2	28	465	14848
governà	2	421	governa	2	4586	5007	14849
governàrem	2	7	governarem	2	42	49	14850
governàreu	2	0	governareu	2	4	4	14851
governés	2	194	governes	2	40	234	14852
governí	2	1	governi	2	1142	1143	14853
goès	0	0	goes	4	679	679	14854
goés	0	0	goes	4	679	679	14855
graciarà	2	0	graciara	2	1	1	14856
graciés	2	44	gracies	2	7044	7088	14857
graduarà	2	17	graduara	2	0	17	14858
graduà	2	535	gradua	2	305	840	14859
graduàrem	2	0	graduarem	2	1	1	14860
gradués	2	10	gradues	2	7	17	14861
grafiarà	2	3	grafiara	2	0	3	14862
grafià	2	11	grafia	4	1761	1772	14863
grafiés	2	0	grafies	4	698	698	14864
grallà	2	0	gralla	4	1755	1755	14865
grallés	2	0	gralles	4	1546	1546	14866
gramatitzàrem	2	1	gramatitzarem	2	0	1	14867
graminà	2	0	gramina	2	1	1	14868
granallà	2	0	granalla	4	19	19	14869
granallés	2	0	granalles	4	11	11	14870
granarà	2	1	granara	2	0	1	14871
granejà	2	2	graneja	2	1	3	14872
granissarà	2	1	granissara	2	0	1	14873
granissà	2	0	granissa	4	7	7	14874
granissés	2	0	granisses	4	4	4	14875
granulà	2	0	granula	2	4	4	14876
granulàrem	2	1	granularem	2	0	1	14877
granulés	2	0	granules	2	2	2	14878
granà	2	8	grana	0	2443	2451	14879
granés	2	247	granes	4	415	662	14880
graní	2	0	grani	2	11	11	14881
granís	2	76	granis	2	10	86	14882
graníssol	4	0	granissol	4	4	4	14883
graparà	2	2	grapara	2	0	2	14884
grapegés	2	2	grapeges	2	1	3	14885
grapegí	2	0	grapegi	2	3	3	14886
grapejà	2	0	grapeja	2	16	16	14887
grapà	2	0	grapa	4	493	493	14888
grapàrem	2	0	graparem	2	3	3	14889
grapàreu	2	0	grapareu	2	1	1	14890
grapés	2	0	grapes	4	1045	1045	14891
grapí	2	15	grapi	2	0	15	14892
gratarà	2	6	gratara	2	0	6	14893
gratificarà	2	22	gratificara	2	1	23	14894
gratificà	2	2	gratifica	2	69	71	14895
gratificàrem	2	0	gratificarem	2	1	1	14896
gratifiqués	2	0	gratifiques	2	2	2	14897
gratifiquí	2	0	gratifiqui	2	7	7	14898
gratinarà	2	1	gratinara	2	0	1	14899
gratinà	2	0	gratina	2	43	43	14900
gratinàrem	2	0	gratinarem	2	15	15	14901
gratinés	2	1	gratines	2	10	11	14902
gratiní	2	0	gratini	2	9	9	14903
gratà	2	5	grata	4	1810	1815	14904
gratàrem	2	0	gratarem	2	6	6	14905
gratàreu	2	0	gratareu	2	1	1	14906
gratés	2	9	grates	4	273	282	14907
gratí	2	0	grati	2	28	28	14908
gratín	2	0	gratin	2	29	29	14909
gravarà	2	357	gravara	2	17	374	14910
gravitarà	2	11	gravitara	2	1	12	14911
gravità	2	11	gravita	2	124	135	14912
gravités	2	2	gravites	2	2	4	14913
gravití	2	20	graviti	2	4	24	14914
gravitó	4	20	gravito	2	0	20	14915
gravà	2	139	grava	4	3224	3363	14916
gravàrem	2	17	gravarem	2	144	161	14917
gravàreu	2	0	gravareu	2	4	4	14918
gravés	2	94	graves	4	1124	1218	14919
graví	2	6	gravi	2	277	283	14920
grecitzarà	2	1	grecitzara	2	0	1	14921
gredós	0	1	gredos	4	174	175	14922
greixolí	4	1	greixoli	4	0	1	14923
greixà	2	2	greixa	2	32	34	14924
greixàrem	2	0	greixarem	2	1	1	14925
greixàreu	2	0	greixareu	2	1	1	14926
greixés	2	0	greixes	2	6	6	14927
greixí	2	0	greixi	2	2	2	14928
greixó	4	2	greixo	2	3	5	14929
greixós	0	257	greixos	4	6208	6465	14930
gresós	0	4	gresos	4	504	508	14931
greugés	2	1	greuges	4	6428	6429	14932
greujarà	2	1	greujara	2	0	1	14933
greujà	2	0	greuja	2	8	8	14934
grifolà	2	0	grifola	2	2	2	14935
grifolí	2	0	grifoli	2	1	1	14936
grifoní	2	0	grifoni	2	9	9	14937
grifà	2	0	grifa	4	20	20	14938
grifés	2	1	grifes	4	0	1	14939
grifí	2	0	grifi	2	2	2	14940
grifó	4	94	grifo	2	65	159	14941
grillarà	2	2	grillara	2	0	2	14942
grillà	2	1	grilla	2	11	12	14943
grillés	2	3	grilles	2	2	5	14944
grillí	2	0	grilli	2	53	53	14945
grilló	4	39	grillo	2	304	343	14946
grimpà	2	2	grimpa	2	45	47	14947
grimpàrem	2	0	grimparem	2	13	13	14948
grimpés	2	1	grimpes	2	5	6	14949
grimpí	2	0	grimpi	2	4	4	14950
grinyolarà	2	3	grinyolara	2	0	3	14951
grinyolà	2	4	grinyola	2	413	417	14952
grinyolàrem	2	0	grinyolarem	2	1	1	14953
grinyolés	2	4	grinyoles	2	0	4	14954
grinyolí	2	0	grinyoli	2	43	43	14955
grisejà	2	0	griseja	2	6	6	14956
grisós	0	297	grisos	0	3415	3712	14957
groguegí	2	0	groguegi	2	1	1	14958
groguejà	2	0	grogueja	2	17	17	14959
groguís	0	1	groguis	0	10	11	14960
gronsà	2	0	gronsa	4	15	15	14961
gronsés	2	0	gronses	4	3	3	14962
gronxarà	2	5	gronxara	2	0	5	14963
gronxà	2	4	gronxa	2	146	150	14964
gronxàrem	2	0	gronxarem	2	1	1	14965
gronxés	2	1	gronxes	2	6	7	14966
gronxí	2	0	gronxi	2	11	11	14967
gruarà	2	1	gruara	2	0	1	14968
grufà	2	0	grufa	4	9	9	14969
grumejà	2	0	grumeja	2	1	1	14970
grumí	2	0	grumi	2	5	5	14971
grunyí	2	2	grunyi	2	2	4	14972
grunyíreu	2	0	grunyireu	2	1	1	14973
gruà	2	6	grua	4	2939	2945	14974
grués	2	0	grues	4	1685	1685	14975
gràfila	4	3	grafila	2	0	3	14976
gràfiles	4	1	grafiles	2	0	1	14977
grànul	4	47	granul	2	2	49	14978
grúmol	4	3	grumol	4	2	5	14979
grúmols	4	4	grumols	4	5	9	14980
guaitarà	2	6	guaitara	2	0	6	14981
guaità	2	13	guaita	4	2335	2348	14982
guaitàrem	2	5	guaitarem	2	8	13	14983
guaitàreu	2	0	guaitareu	2	2	2	14984
guaités	2	1	guaites	4	140	141	14985
guaití	2	2	guaiti	2	13	15	14986
guaixés	2	0	guaixes	2	2	2	14987
gualterí	0	0	gualteri	4	11	11	14988
guanyarà	2	2611	guanyara	2	118	2729	14989
guanyà	2	4395	guanya	2	19760	24155	14990
guanyàrem	2	50	guanyarem	2	1335	1385	14991
guanyàreu	2	1	guanyareu	2	122	123	14992
guanyés	2	1199	guanyes	2	891	2090	14993
guanyí	2	2	guanyi	2	2882	2884	14994
guardarà	2	559	guardara	2	12	571	14995
guardonarà	2	42	guardonara	2	0	42	14996
guardonà	2	32	guardona	2	205	237	14997
guardonàrem	2	1	guardonarem	2	1	2	14998
guardonés	2	1	guardones	2	10	11	14999
guardoní	2	0	guardoni	2	3	3	15000
guardà	2	124	guarda	4	12549	12673	15001
guardàrem	2	3	guardarem	2	410	413	15002
guardàreu	2	0	guardareu	2	35	35	15003
guardés	2	184	guardes	4	1581	1765	15004
guardó	4	10944	guardo	2	1818	12762	15005
guaretà	2	0	guareta	2	1	1	15006
guaretí	2	0	guareti	2	1	1	15007
guaretó	4	1	guareto	2	0	1	15008
guarirà	2	40	guarira	2	0	40	15009
guarnirà	2	32	guarnira	2	0	32	15010
guarnírem	2	0	guarnirem	2	40	40	15011
guarníreu	2	0	guarnireu	2	1	1	15012
guarírem	2	1	guarirem	2	5	6	15013
guaríreu	2	0	guarireu	2	3	3	15014
guerrejà	2	7	guerreja	2	11	18	15015
guerxà	2	0	guerxa	0	41	41	15016
guerxés	2	0	guerxes	0	19	19	15017
guerxí	2	0	guerxi	2	1	1	15018
guerxós	0	0	guerxos	0	28	28	15019
guiarà	2	1169	guiara	2	10	1179	15020
guillarà	2	0	guillara	2	1	1	15021
guilloixés	2	0	guilloixes	2	1	1	15022
guillotinà	2	1	guillotina	4	609	610	15023
guillotinés	2	0	guillotines	4	76	76	15024
guillotiní	2	0	guillotini	2	2	2	15025
guillà	2	0	guilla	4	506	506	15026
guillàrem	2	0	guillarem	2	1	1	15027
guillés	2	2	guilles	4	112	114	15028
guillí	2	0	guilli	2	7	7	15029
guimbà	2	0	guimba	2	1	1	15030
guindà	2	0	guinda	4	423	423	15031
guindés	2	0	guindes	4	54	54	15032
guindí	2	0	guindi	2	1	1	15033
guineà	0	194	guinea	4	6094	6288	15034
guinguetès	0	0	guinguetes	4	344	344	15035
guinguetés	0	0	guinguetes	4	344	344	15036
guinyolà	2	0	guinyola	2	3	3	15037
guinyolés	2	0	guinyoles	2	1	1	15038
guinyà	2	0	guinya	2	1	1	15039
guinyí	2	0	guinyi	2	1	1	15040
guipà	2	4	guipa	2	11	15	15041
guipés	2	0	guipes	2	2	2	15042
guipí	2	0	guipi	2	2	2	15043
guisarà	2	1	guisara	2	0	1	15044
guiscà	2	0	guisca	2	1	1	15045
guisquí	2	0	guisqui	2	2	2	15046
guisà	2	0	guisa	4	270	270	15047
guisàrem	2	0	guisarem	2	6	6	15048
guisés	2	1	guises	4	2	3	15049
guisí	2	0	guisi	2	3	3	15050
guitarà	2	0	guitara	2	9	9	15051
guità	2	4	guita	0	177	181	15052
guités	2	0	guites	0	97	97	15053
guití	2	0	guiti	2	12	12	15054
guixarà	2	2	guixara	2	0	2	15055
guixerès	0	0	guixeres	4	215	215	15056
guixerés	0	0	guixeres	4	215	215	15057
guixés	2	6	guixes	4	66	72	15058
guixí	2	0	guixi	2	5	5	15059
guixó	4	14	guixo	2	9	23	15060
guià	2	58	guia	4	51886	51944	15061
guiàrem	2	0	guiarem	2	105	105	15062
guiàreu	2	0	guiareu	2	2	2	15063
guiés	2	79	guies	4	15400	15479	15064
guií	2	15	guii	2	25	40	15065
guió	4	17305	guio	2	162	17467	15066
gunitarà	2	1	gunitara	2	0	1	15067
gunità	2	0	gunita	4	3	3	15068
gurú	4	384	guru	4	801	1185	15069
gurús	4	299	gurus	4	457	756	15070
guspiregí	2	0	guspiregi	2	1	1	15071
guspirejarà	2	44	guspirejara	2	0	44	15072
guspirejà	2	0	guspireja	2	14	14	15073
gustarà	2	0	gustara	2	1	1	15074
gustàrem	2	0	gustarem	2	2	2	15075
gustés	2	1	gustes	2	2	3	15076
gustí	2	41	gusti	2	73	114	15077
gustós	0	976	gustos	4	12735	13711	15078
guíndola	4	4	guindola	4	20	24	15079
guíndoles	4	1	guindoles	4	4	5	15080
gàlib	4	108	galib	2	28	136	15081
gàrola	4	0	garola	4	21	21	15082
gèlida	0	360	gelida	4	2223	2583	15083
gèmina	0	12	gemina	2	65	77	15084
gèmini	4	10	gemini	2	348	358	15085
gèminis	4	50	geminis	2	51	101	15086
gènera	4	31	genera	2	28285	28316	15087
gènere	4	86056	genere	2	817	86873	15088
gèneres	4	13121	generes	2	380	13501	15089
gíric	0	0	giric	4	1	1	15090
gònions	4	0	gonions	4	2	2	15091
güellà	2	0	güella	2	5	5	15092
güellés	2	0	güelles	2	4	4	15093
habilitarà	2	1438	habilitara	2	12	1450	15094
habilità	2	98	habilita	2	3539	3637	15095
habilitàrem	2	0	habilitarem	2	101	101	15096
habilitàreu	2	0	habilitareu	2	4	4	15097
habilités	2	42	habilites	2	11	53	15098
habilití	2	0	habiliti	2	409	409	15099
habitarà	2	49	habitara	2	2	51	15100
habituarà	2	6	habituara	2	0	6	15101
habituà	2	5	habitua	2	65	70	15102
habituàrem	2	0	habituarem	2	2	2	15103
habitués	2	7	habitues	2	11	18	15104
habità	2	111	habita	2	3200	3311	15105
habitàrem	2	1	habitarem	2	10	11	15106
habitàreu	2	0	habitareu	2	11	11	15107
habités	2	35	habites	2	28	63	15108
habití	2	1	habiti	2	76	77	15109
hackejà	2	0	hackeja	2	9	9	15110
hackejàrem	2	0	hackejarem	2	1	1	15111
hagués	2	70700	hagues	2	840	71540	15112
haguí	2	69	hagui	2	267	336	15113
hagés	2	98	hages	2	484	582	15114
hagí	2	11	hagi	2	159634	159645	15115
hajà	2	1	haja	2	11344	11345	15116
halà	2	0	hala	7	171	171	15117
halés	2	0	hales	4	45	45	15118
halí	2	1	hali	2	28	29	15119
haló	4	12	halo	2	801	813	15120
handicaparà	2	1	handicapara	2	0	1	15121
handicapés	2	6	handicapes	2	1	7	15122
harmalà	4	1	harmala	4	6	7	15123
harmonitzarà	2	49	harmonitzara	2	2	51	15124
harmonitzà	2	8	harmonitza	2	394	402	15125
harmonitzàrem	2	0	harmonitzarem	2	12	12	15126
harmonitzés	2	15	harmonitzes	2	0	15	15127
harmonitzí	2	0	harmonitzi	2	116	116	15128
hauré	2	5864	haure	2	245	6109	15129
hebraïtzés	2	1	hebraïtzes	2	0	1	15130
hegemonitzà	2	1	hegemonitza	2	16	17	15131
hegemonitzí	2	0	hegemonitzi	2	7	7	15132
hel·lenitzà	2	0	hel·lenitza	2	1	1	15133
hel·lenitzés	2	1	hel·lenitzes	2	2	3	15134
heptàedre	4	2	heptaedre	4	2	4	15135
heptàedres	4	2	heptaedres	4	0	2	15136
herboritzà	2	6	herboritza	2	1	7	15137
heretarà	2	92	heretara	2	3	95	15138
heretà	2	420	hereta	2	653	1073	15139
heretàrem	2	5	heretarem	2	6	11	15140
heretàreu	2	0	heretareu	2	2	2	15141
heretés	2	36	heretes	2	17	53	15142
heretí	2	2	hereti	2	50	52	15143
hernià	2	0	hernia	2	61	61	15144
herniària	0	1	herniaria	2	3	4	15145
herniés	2	0	hernies	2	22	22	15146
hesità	2	1	hesita	2	2	3	15147
heterodinà	2	0	heterodina	2	1	1	15148
hexaoctàedres	4	0	hexaoctaedres	4	1	1	15149
hexàedre	4	12	hexaedre	4	9	21	15150
hexàedres	4	0	hexaedres	4	1	1	15151
hibernarà	2	2	hibernara	2	0	2	15152
hibernà	2	1	hiberna	2	59	60	15153
hibernés	2	1	hibernes	2	0	1	15154
hiberní	2	0	hiberni	2	4	4	15155
hibridarà	2	3	hibridara	2	0	3	15156
hibridà	2	0	hibrida	2	96	96	15157
hibridés	2	0	hibrides	2	21	21	15158
hibridí	2	0	hibridi	2	5	5	15159
hidratarà	2	26	hidratara	2	1	27	15160
hidratà	2	1	hidrata	2	556	557	15161
hidratàrem	2	2	hidratarem	2	14	16	15162
hidratés	2	2	hidrates	2	14	16	15163
hidratí	2	0	hidrati	2	42	42	15164
hidrogenarà	2	2	hidrogenara	2	0	2	15165
hidrogenà	2	0	hidrogena	2	3	3	15166
hidrogenés	2	0	hidrogenes	2	1	1	15167
hidrogèn	2	0	hidrogen	4	5416	5416	15168
hidrolitzarà	2	2	hidrolitzara	2	0	2	15169
hidrolitzà	2	0	hidrolitza	2	58	58	15170
hidromètria	4	0	hidrometria	4	1	1	15171
higienitzà	2	0	higienitza	2	18	18	15172
higienitzí	2	0	higienitzi	2	2	2	15173
hiperbolitzà	2	1	hiperbolitza	2	4	5	15174
hiperestesià	2	0	hiperestesia	2	1	1	15175
hiperestèsia	4	13	hiperestesia	2	1	14	15176
hiperestèsies	4	1	hiperestesies	2	0	1	15177
hipertrofià	2	0	hipertrofia	2	34	34	15178
hipertrofiés	2	1	hipertrofies	2	2	3	15179
hipertròfia	4	283	hipertrofia	2	34	317	15180
hipertròfies	4	8	hipertrofies	2	2	10	15181
hipnotitzarà	2	6	hipnotitzara	2	0	6	15182
hipnotitzà	2	1	hipnotitza	2	138	139	15183
hipnotitzés	2	2	hipnotitzes	2	0	2	15184
hipnotitzí	2	0	hipnotitzi	2	3	3	15185
hipotecarà	2	40	hipotecara	2	0	40	15186
hipotecà	2	8	hipoteca	4	6029	6037	15187
hipotecàrem	2	0	hipotecarem	2	5	5	15188
hipotecària	0	1624	hipotecaria	2	151	1775	15189
hipotecàries	0	754	hipotecaries	2	30	784	15190
hipotequés	2	5	hipoteques	4	4387	4392	15191
hipotequí	2	0	hipotequi	2	45	45	15192
hipotetitzà	2	3	hipotetitza	2	7	10	15193
hipotetitzàrem	2	0	hipotetitzarem	2	1	1	15194
hispanitzí	2	0	hispanitzi	2	1	1	15195
hissarà	2	50	hissara	2	1	51	15196
hissà	2	20	hissa	2	74	94	15197
hissàrem	2	1	hissarem	2	7	8	15198
hissés	2	8	hisses	2	4	12	15199
hissí	2	0	hissi	2	54	54	15200
historiarà	2	3	historiara	2	0	3	15201
historià	2	10	historia	2	14708	14718	15202
historiàreu	2	2	historiareu	2	0	2	15203
historiés	2	0	histories	2	1193	1193	15204
historií	2	0	historii	2	11	11	15205
història	4	343395	historia	2	14708	358103	15206
històries	4	49495	histories	2	1193	50688	15207
hivernarà	2	2	hivernara	2	0	2	15208
hivernà	2	3	hiverna	2	134	137	15209
hivernàrem	2	0	hivernarem	2	1	1	15210
hivernés	2	1	hivernes	2	1	2	15211
hiverní	2	0	hiverni	2	8	8	15212
holandès	0	4464	holandes	4	115	4579	15213
holandés	0	258	holandes	4	115	373	15214
holografià	2	0	holografia	4	85	85	15215
holografiés	2	0	holografies	4	14	14	15216
homenatgés	2	18	homenatges	4	2572	2590	15217
homenatgí	2	0	homenatgi	2	16	16	15218
homenatjarà	2	368	homenatjara	2	0	368	15219
homenatjà	2	35	homenatja	2	1066	1101	15220
homenatjàrem	2	0	homenatjarem	2	39	39	15221
homenejarà	2	1	homenejara	2	0	1	15222
homogeneïtzarà	2	9	homogeneïtzara	2	0	9	15223
homogeneïtzà	2	0	homogeneïtza	2	65	65	15224
homogeneïtzàrem	2	0	homogeneïtzarem	2	5	5	15225
homogeneïtzés	2	2	homogeneïtzes	2	0	2	15226
homogeneïtzí	2	0	homogeneïtzi	2	14	14	15227
homologarà	2	21	homologara	2	0	21	15228
homologués	2	4	homologues	2	5	9	15229
homologuí	2	0	homologui	2	24	24	15230
homologà	2	2	homologa	2	145	147	15231
homologàrem	2	1	homologarem	2	0	1	15232
homòloga	0	339	homologa	2	145	484	15233
homòlogues	0	210	homologues	2	5	215	15234
honorarà	2	31	honorara	2	0	31	15235
honorificà	2	0	honorifica	2	31	31	15236
honorifiqués	2	0	honorifiques	2	4	4	15237
honorifiquí	2	0	honorifiqui	2	1	1	15238
honorà	2	36	honora	2	919	955	15239
honoràrem	2	3	honorarem	2	11	14	15240
honorària	0	165	honoraria	2	42	207	15241
honoràries	0	8	honoraries	2	1	9	15242
honorés	2	10	honores	2	18	28	15243
honorí	2	1	honori	4	377	378	15244
honorífic	0	1806	honorific	2	26	1832	15245
honorífica	0	791	honorifica	2	31	822	15246
honorífiques	0	225	honorifiques	2	4	229	15247
honrarà	2	39	honrara	2	1	40	15248
honrà	2	13	honra	4	813	826	15249
honràrem	2	1	honrarem	2	14	15	15250
honràreu	2	0	honrareu	2	1	1	15251
honrés	2	3	honres	4	44	47	15252
honrí	2	0	honri	2	16	16	15253
hormonarà	2	1	hormonara	2	0	1	15254
hormonà	2	0	hormona	4	2100	2100	15255
hormonés	2	0	hormones	4	3228	3228	15256
hormoní	2	0	hormoni	2	1	1	15257
horripilà	2	1	horripila	2	2	3	15258
horroritzarà	2	3	horroritzara	2	1	4	15259
horroritzà	2	8	horroritza	2	162	170	15260
horroritzés	2	2	horroritzes	2	2	4	15261
horroritzí	2	0	horroritzi	2	6	6	15262
hospitalitzà	2	0	hospitalitza	2	3	3	15263
hospitalitzés	2	2	hospitalitzes	2	0	2	15264
hospitalitzí	2	0	hospitalitzi	2	1	1	15265
hostatgés	2	3	hostatges	4	248	251	15266
hostatgí	2	0	hostatgi	2	3	3	15267
hostatjarà	2	17	hostatjara	2	1	18	15268
hostatjà	2	51	hostatja	2	205	256	15269
hostatjàrem	2	1	hostatjarem	2	8	9	15270
hostegés	2	0	hosteges	2	1	1	15271
hostejarà	2	1	hostejara	2	0	1	15272
hostejà	2	4	hosteja	2	4	8	15273
hostilitzà	2	3	hostilitza	2	4	7	15274
hostilitzés	2	3	hostilitzes	2	0	3	15275
huitanta-quatrè	0	0	huitanta-quatre	3	3	3	15276
huitanta-quatré	0	0	huitanta-quatre	3	3	3	15277
humanitzarà	2	5	humanitzara	2	0	5	15278
humanitzà	2	4	humanitza	2	277	281	15279
humanitzàrem	2	0	humanitzarem	2	3	3	15280
humanitzés	2	0	humanitzes	2	2	2	15281
humanitzí	2	0	humanitzi	2	18	18	15282
humectà	2	0	humecta	2	9	9	15283
humidificarà	2	1	humidificara	2	0	1	15284
humidificà	2	0	humidifica	2	12	12	15285
humidificàrem	2	0	humidificarem	2	1	1	15286
humidifiqués	2	1	humidifiques	2	1	2	15287
humidifiquí	2	0	humidifiqui	2	2	2	15288
humiliarà	2	13	humiliara	2	2	15	15289
humiliàrem	2	0	humiliarem	2	3	3	15290
humiliés	2	8	humilies	2	5	13	15291
humilií	2	1	humilii	2	3	4	15292
humitegés	2	2	humiteges	2	4	6	15293
humitegí	2	0	humitegi	2	29	29	15294
humitejarà	2	9	humitejara	2	0	9	15295
humitejà	2	3	humiteja	2	104	107	15296
humitejàrem	2	0	humitejarem	2	13	13	15297
hàbit	4	6219	habit	2	135	6354	15298
hàbitat	4	8491	habitat	2	3616	12107	15299
hàbitats	4	6067	habitats	2	1378	7445	15300
hàgem	2	299	hagem	2	159	458	15301
hàgeu	2	108	hageu	2	171	279	15302
hàndicap	4	189	handicap	2	1414	1603	15303
hèrnia	4	417	hernia	2	61	478	15304
hèrnies	4	237	hernies	2	22	259	15305
híbrid	0	2461	hibrid	2	51	2512	15306
híbrida	0	1025	hibrida	2	96	1121	15307
híbrides	0	497	hibrides	2	21	518	15308
iconificà	2	0	iconifica	2	7	7	15309
icositetràedre	4	11	icositetraedre	4	1	12	15310
icosàedre	4	58	icosaedre	4	59	117	15311
icosàedres	4	2	icosaedres	4	4	6	15312
idealitzarà	2	1	idealitzara	2	1	2	15313
idealitzà	2	1	idealitza	2	114	115	15314
idealitzàrem	2	0	idealitzarem	2	2	2	15315
idealitzés	2	2	idealitzes	2	7	9	15316
idealitzí	2	0	idealitzi	2	5	5	15317
idearà	2	16	ideara	2	1	17	15318
identificarà	2	506	identificara	2	24	530	15319
identificà	2	254	identifica	2	9243	9497	15320
identificàrem	2	9	identificarem	2	260	269	15321
identificàreu	2	0	identificareu	2	35	35	15322
identifiqués	2	241	identifiques	2	235	476	15323
identifiquí	2	1	identifiqui	2	1420	1421	15324
ideologitzà	2	0	ideologitza	2	2	2	15325
ideologitzés	2	0	ideologitzes	2	1	1	15326
ideà	2	191	idea	4	130127	130318	15327
ideàrem	2	1	idearem	2	8	9	15328
ideés	2	23	idees	4	83382	83405	15329
ideí	2	0	idei	2	7	7	15330
idiotitzà	2	0	idiotitza	2	14	14	15331
idiotitzí	2	0	idiotitzi	2	1	1	15332
idolatrarà	2	0	idolatrara	2	1	1	15333
idolatrà	2	1	idolatra	2	70	71	15334
idolatrés	2	0	idolatres	2	5	5	15335
idolatrí	2	0	idolatri	2	2	2	15336
idòlatra	0	21	idolatra	2	70	91	15337
idòlatres	0	50	idolatres	2	5	55	15338
iessà	0	1	iessa	4	7	8	15339
ignifugués	2	0	ignifugues	2	17	17	15340
ignifugà	2	0	ignifuga	2	9	9	15341
ignorarà	2	199	ignorara	2	4	203	15342
ignorà	2	59	ignora	2	3446	3505	15343
ignoràrem	2	0	ignorarem	2	25	25	15344
ignorés	2	79	ignores	2	85	164	15345
ignorí	2	0	ignori	2	327	327	15346
ignífug	0	153	ignifug	2	3	156	15347
ignífuga	0	115	ignifuga	2	9	124	15348
ignífugues	0	70	ignifugues	2	17	87	15349
igualarà	2	74	igualara	2	5	79	15350
igualà	2	42	iguala	4	968	1010	15351
igualàrem	2	0	igualarem	2	15	15	15352
igualés	2	51	iguales	4	255	306	15353
igualí	2	0	iguali	2	119	119	15354
il·legalitzarà	2	6	il·legalitzara	2	1	7	15355
il·legalitzà	2	8	il·legalitza	2	35	43	15356
il·legalitzàrem	2	0	il·legalitzarem	2	1	1	15357
il·legalitzés	2	6	il·legalitzes	2	2	8	15358
il·legalitzí	2	0	il·legalitzi	2	25	25	15359
il·luminarà	2	343	il·luminara	2	4	347	15360
il·luminà	2	81	il·lumina	2	2439	2520	15361
il·luminàrem	2	0	il·luminarem	2	13	13	15362
il·luminàreu	2	0	il·luminareu	2	3	3	15363
il·luminés	2	61	il·lumines	2	29	90	15364
il·luminí	2	0	il·lumini	2	287	287	15365
il·lusionarà	2	8	il·lusionara	2	1	9	15366
il·lusionà	2	3	il·lusiona	2	588	591	15367
il·lusionàrem	2	1	il·lusionarem	2	1	2	15368
il·lusionàreu	2	0	il·lusionareu	2	4	4	15369
il·lusionés	2	5	il·lusiones	2	18	23	15370
il·lusioní	2	0	il·lusioni	2	88	88	15371
il·lustrarà	2	192	il·lustrara	2	3	195	15372
il·lustrà	2	149	il·lustra	2	4272	4421	15373
il·lustràrem	2	1	il·lustrarem	2	43	44	15374
il·lustrés	2	44	il·lustres	2	3188	3232	15375
il·lustrí	2	0	il·lustri	2	89	89	15376
imaginarà	2	27	imaginara	2	5	32	15377
imaginà	2	75	imagina	2	5288	5363	15378
imaginàrem	2	4	imaginarem	2	65	69	15379
imaginàreu	2	0	imaginareu	2	60	60	15380
imaginària	0	1468	imaginaria	2	253	1721	15381
imaginàries	0	633	imaginaries	2	76	709	15382
imaginés	2	39	imagines	2	1551	1590	15383
imaginí	2	1	imagini	2	486	487	15384
imantà	2	0	imanta	2	19	19	15385
imbricarà	2	1	imbricara	2	1	2	15386
imbricà	2	0	imbrica	2	37	37	15387
imbriqués	2	2	imbriques	2	0	2	15388
imbècil	0	1258	imbecil	0	50	1308	15389
imbècilment	6	2	imbecilment	6	0	2	15390
imbècils	0	709	imbecils	0	25	734	15391
imitarà	2	32	imitara	2	11	43	15392
imità	2	31	imita	2	1189	1220	15393
imitàrem	2	1	imitarem	2	20	21	15394
imitàreu	2	0	imitareu	2	3	3	15395
imités	2	36	imites	2	9	45	15396
imití	2	0	imiti	2	83	83	15397
immatriculà	2	1	immatricula	2	0	1	15398
immatriculés	2	0	immatricules	2	1	1	15399
immatriculí	2	0	immatriculi	2	1	1	15400
immergirà	2	4	immergira	2	0	4	15401
immergírem	2	0	immergirem	2	1	1	15402
immigrà	2	2	immigra	2	9	11	15403
immigrés	2	4	immigres	2	0	4	15404
immiscirà	2	6	immiscira	2	0	6	15405
immiscírem	2	0	immiscirem	2	2	2	15406
immobilitzarà	2	9	immobilitzara	2	0	9	15407
immobilitzà	2	12	immobilitza	2	131	143	15408
immobilitzàrem	2	0	immobilitzarem	2	2	2	15409
immobilitzés	2	6	immobilitzes	2	1	7	15410
immobilitzí	2	0	immobilitzi	2	10	10	15411
immolarà	2	5	immolara	2	2	7	15412
immolà	2	5	immola	2	35	40	15413
immolàrem	2	1	immolarem	2	2	3	15414
immolés	2	5	immoles	2	1	6	15415
immolí	2	0	immoli	2	10	10	15416
immortalitzarà	2	20	immortalitzara	2	1	21	15417
immortalitzà	2	38	immortalitza	2	136	174	15418
immortalitzàrem	2	0	immortalitzarem	2	4	4	15419
immortalitzés	2	6	immortalitzes	2	3	9	15420
immortalitzí	2	0	immortalitzi	2	12	12	15421
immunitzà	2	1	immunitza	2	39	40	15422
immunitzés	2	0	immunitzes	2	3	3	15423
immunitzí	2	0	immunitzi	2	5	5	15424
immutarà	2	1	immutara	2	1	2	15425
immutà	2	4	immuta	2	72	76	15426
immutés	2	5	immutes	2	3	8	15427
immutí	2	0	immuti	2	4	4	15428
impacientarà	2	1	impacientara	2	1	2	15429
impacientà	2	1	impacienta	2	32	33	15430
impacientés	2	2	impacientes	2	3	5	15431
impacientí	2	0	impacienti	2	8	8	15432
impactarà	2	148	impactara	2	2	150	15433
impactà	2	105	impacta	2	1183	1288	15434
impactàrem	2	0	impactarem	2	4	4	15435
impactés	2	56	impactes	2	8044	8100	15436
impactí	2	0	impacti	2	144	144	15437
impartirà	2	3421	impartira	2	20	3441	15438
impartírem	2	2	impartirem	2	102	104	15439
impartíreu	2	0	impartireu	2	2	2	15440
impedirà	2	1211	impedira	2	28	1239	15441
impedírem	2	1	impedirem	2	61	62	15442
impedíreu	2	0	impedireu	2	9	9	15443
impel·lirà	2	1	impel·lira	2	1	2	15444
imperarà	2	18	imperara	2	0	18	15445
impermeabilitzarà	2	8	impermeabilitzara	2	0	8	15446
impermeabilitzà	2	2	impermeabilitza	2	50	52	15447
impermeabilitzí	2	0	impermeabilitzi	2	4	4	15448
impersonalitzà	2	0	impersonalitza	2	2	2	15449
imperà	2	23	impera	2	1273	1296	15450
imperàrem	2	0	imperarem	2	1	1	15451
imperés	2	15	imperes	2	0	15	15452
imperí	2	4	imperi	2	30226	30230	15453
impetràreu	2	0	impetrareu	2	1	1	15454
implantarà	2	539	implantara	2	6	545	15455
implantà	2	189	implanta	2	844	1033	15456
implantàrem	2	1	implantarem	2	56	57	15457
implantàreu	2	0	implantareu	2	2	2	15458
implantés	2	68	implantes	2	18	86	15459
implantí	2	0	implanti	2	286	286	15460
implementarà	2	419	implementara	2	1	420	15461
implementà	2	37	implementa	2	1334	1371	15462
implementàrem	2	2	implementarem	2	76	78	15463
implementàreu	2	0	implementareu	2	1	1	15464
implementés	2	61	implementes	2	10	71	15465
implementí	2	0	implementi	2	313	313	15466
implicarà	2	2544	implicara	2	23	2567	15467
implicà	2	337	implica	2	37911	38248	15468
implicàrem	2	3	implicarem	2	54	57	15469
implicàreu	2	0	implicareu	2	2	2	15470
impliqués	2	299	impliques	2	70	369	15471
impliquí	2	0	impliqui	2	2825	2825	15472
implorarà	2	3	implorara	2	0	3	15473
implorà	2	16	implora	2	128	144	15474
imploràreu	2	0	implorareu	2	1	1	15475
implorés	2	2	implores	2	0	2	15476
implorí	2	0	implori	2	10	10	15477
importarà	2	299	importara	2	31	330	15478
importunà	2	1	importuna	2	21	22	15479
importunés	2	1	importunes	2	3	4	15480
importuní	2	0	importuni	2	7	7	15481
importà	2	62	importa	2	16977	17039	15482
importàrem	2	2	importarem	2	29	31	15483
importàreu	2	0	importareu	2	2	2	15484
importés	2	178	importes	2	91	269	15485
importí	2	11	importi	2	644	655	15486
imposarà	2	760	imposara	2	14	774	15487
impossibilitarà	2	82	impossibilitara	2	2	84	15488
impossibilità	2	30	impossibilita	2	782	812	15489
impossibilités	2	9	impossibilites	2	3	12	15490
impossibilití	2	0	impossibiliti	2	154	154	15491
impostà	2	1	imposta	4	464	465	15492
impostés	2	1	impostes	4	594	595	15493
impostí	2	0	imposti	2	4	4	15494
imposà	2	1142	imposa	2	10097	11239	15495
imposàrem	2	2	imposarem	2	38	40	15496
imposàreu	2	0	imposareu	2	4	4	15497
imposés	2	335	imposes	2	41	376	15498
imposí	2	0	imposi	2	1354	1354	15499
imprecà	2	0	impreca	2	1	1	15500
impregnarà	2	91	impregnara	2	4	95	15501
impregnà	2	48	impregna	2	1684	1732	15502
impregnàrem	2	0	impregnarem	2	11	11	15503
impregnàreu	2	0	impregnareu	2	1	1	15504
impregnés	2	26	impregnes	2	13	39	15505
impregní	2	0	impregni	2	225	225	15506
impremtà	2	0	impremta	4	5204	5204	15507
impremtés	2	0	impremtes	4	658	658	15508
impressionarà	2	58	impressionara	2	2	60	15509
impressionà	2	90	impressiona	2	1464	1554	15510
impressionàrem	2	0	impressionarem	2	1	1	15511
impressionàreu	2	0	impressionareu	2	4	4	15512
impressionés	2	11	impressiones	2	17	28	15513
impressioní	2	0	impressioni	2	32	32	15514
imprimirà	2	231	imprimira	2	4	235	15515
imprimírem	2	3	imprimirem	2	67	70	15516
imprimíreu	2	0	imprimireu	2	3	3	15517
improperí	2	0	improperi	2	46	46	15518
improvisarà	2	26	improvisara	2	0	26	15519
improvisà	2	26	improvisa	2	364	390	15520
improvisàrem	2	3	improvisarem	2	22	25	15521
improvisàreu	2	0	improvisareu	2	1	1	15522
improvisés	2	11	improvises	2	23	34	15523
improvisí	2	0	improvisi	2	21	21	15524
improvà	2	0	improva	2	2	2	15525
improvés	2	0	improves	2	9	9	15526
improví	2	0	improvi	2	2	2	15527
improvís	2	127	improvis	2	1	128	15528
impugnarà	2	88	impugnara	2	2	90	15529
impugnà	2	19	impugna	2	229	248	15530
impugnàrem	2	0	impugnarem	2	1	1	15531
impugnàreu	2	0	impugnareu	2	1	1	15532
impugnés	2	25	impugnes	2	4	29	15533
impugní	2	0	impugni	2	64	64	15534
impulsarà	2	1640	impulsara	2	15	1655	15535
impulsà	2	967	impulsa	2	12716	13683	15536
impulsàrem	2	16	impulsarem	2	549	565	15537
impulsàreu	2	0	impulsareu	2	1	1	15538
impulsés	2	127	impulses	2	18	145	15539
impulsí	2	1	impulsi	2	1049	1050	15540
impurificà	2	0	impurifica	2	1	1	15541
imputarà	2	52	imputara	2	0	52	15542
imputà	2	14	imputa	2	721	735	15543
imputàrem	2	0	imputarem	2	3	3	15544
imputés	2	19	imputes	2	3	22	15545
imputí	2	0	imputi	2	62	62	15546
inactivarà	2	2	inactivara	2	0	2	15547
inactivà	2	1	inactiva	0	776	777	15548
inactivàreu	2	0	inactivareu	2	1	1	15549
inactivés	2	0	inactives	0	2695	2695	15550
inactiví	2	0	inactivi	2	5	5	15551
inadmetré	2	0	inadmetre	2	39	39	15552
inadmetí	2	0	inadmeti	2	1	1	15553
inaugurarà	2	4241	inaugurara	2	28	4269	15554
inaugurà	2	1595	inaugura	2	7874	9469	15555
inauguràrem	2	21	inaugurarem	2	268	289	15556
inauguràreu	2	1	inaugurareu	2	1	2	15557
inaugurés	2	127	inaugures	2	7	134	15558
inaugurí	2	0	inauguri	2	220	220	15559
incapacitarà	2	2	incapacitara	2	1	3	15560
incapacità	2	5	incapacita	2	147	152	15561
incapacití	2	0	incapaciti	2	18	18	15562
incardinarà	2	1	incardinara	2	0	1	15563
incardinà	2	4	incardina	2	54	58	15564
incardinàrem	2	0	incardinarem	2	1	1	15565
incautarà	2	1	incautara	2	1	2	15566
incautà	2	11	incauta	0	48	59	15567
incautàrem	2	1	incautarem	2	0	1	15568
incautés	2	0	incautes	0	27	27	15569
incautí	2	0	incauti	2	1	1	15570
incendiarà	2	10	incendiara	2	2	12	15571
incendià	2	60	incendia	2	125	185	15572
incendiàrem	2	0	incendiarem	2	3	3	15573
incendiària	0	168	incendiaria	2	24	192	15574
incendiàries	0	254	incendiaries	2	19	273	15575
incendiés	2	19	incendies	2	56	75	15576
incendií	2	1	incendii	2	3	4	15577
incentivarà	2	146	incentivara	2	2	148	15578
incentivà	2	13	incentiva	2	854	867	15579
incentivàrem	2	0	incentivarem	2	34	34	15580
incentivés	2	14	incentives	2	61	75	15581
incentiví	2	0	incentivi	2	204	204	15582
incidirà	2	456	incidira	2	2	458	15583
incidírem	2	0	incidirem	2	81	81	15584
incidíreu	2	0	incidireu	2	2	2	15585
incinerarà	2	4	incinerara	2	0	4	15586
incinerà	2	1	incinera	2	36	37	15587
incineràrem	2	0	incinerarem	2	2	2	15588
incinerés	2	5	incineres	2	0	5	15589
incinerí	2	0	incineri	2	10	10	15590
incitarà	2	30	incitara	2	2	32	15591
incità	2	55	incita	2	930	985	15592
incitàrem	2	0	incitarem	2	5	5	15593
incités	2	39	incites	2	16	55	15594
incití	2	0	inciti	2	238	238	15595
inclinarà	2	38	inclinara	2	0	38	15596
inclinà	2	115	inclina	2	933	1048	15597
inclinàrem	2	0	inclinarem	2	5	5	15598
inclinàreu	2	0	inclinareu	2	1	1	15599
inclinés	2	29	inclines	2	15	44	15600
incliní	2	0	inclini	2	95	95	15601
inclogués	2	838	inclogues	2	7	845	15602
incloguí	2	1	inclogui	2	5971	5972	15603
inclouré	2	99	incloure	2	39216	39315	15604
incoarà	2	17	incoara	2	1	18	15605
incomodarà	2	14	incomodara	2	2	16	15606
incomodà	2	3	incomoda	2	718	721	15607
incomodàrem	2	0	incomodarem	2	1	1	15608
incomodés	2	7	incomodes	2	121	128	15609
incomodí	2	0	incomodi	2	58	58	15610
incomplirà	2	38	incomplira	2	9	47	15611
incomplírem	2	0	incomplirem	2	11	11	15612
incomunicarà	2	1	incomunicara	2	0	1	15613
incomunicà	2	0	incomunica	2	13	13	15614
incomuniqués	2	1	incomuniques	2	0	1	15615
incomuniquí	2	0	incomuniqui	2	1	1	15616
incorporarà	2	2579	incorporara	2	34	2613	15617
incorporà	2	1420	incorpora	2	19504	20924	15618
incorporàrem	2	13	incorporarem	2	420	433	15619
incorporàreu	2	1	incorporareu	2	17	18	15620
incorporés	2	346	incorpores	2	104	450	15621
incorporí	2	2	incorpori	2	2073	2075	15622
incoà	2	5	incoa	2	74	79	15623
incoàrem	2	0	incoarem	2	2	2	15624
incoés	2	12	incoes	2	0	12	15625
incrementarà	2	1673	incrementara	2	14	1687	15626
incrementà	2	357	incrementa	2	6404	6761	15627
incrementàrem	2	3	incrementarem	2	136	139	15628
incrementàreu	2	0	incrementareu	2	4	4	15629
incrementés	2	144	incrementes	2	12	156	15630
incrementí	2	0	incrementi	2	933	933	15631
increparà	2	1	increpara	2	0	1	15632
increpà	2	19	increpa	2	197	216	15633
increpàrem	2	0	increparem	2	1	1	15634
increpés	2	7	increpes	2	0	7	15635
increpí	2	0	increpi	2	8	8	15636
incriminà	2	5	incrimina	2	24	29	15637
incriminés	2	5	incrimines	2	0	5	15638
incriminí	2	0	incrimini	2	14	14	15639
incrustarà	2	15	incrustara	2	1	16	15640
incrustà	2	3	incrusta	2	207	210	15641
incrustàrem	2	0	incrustarem	2	3	3	15642
incrustés	2	2	incrustes	2	5	7	15643
incrustí	2	0	incrusti	2	9	9	15644
incubarà	2	6	incubara	2	0	6	15645
incubà	2	1	incuba	2	146	147	15646
incubí	2	0	incubi	2	6	6	15647
inculcarà	2	6	inculcara	2	1	7	15648
inculcà	2	31	inculca	2	187	218	15649
inculcàrem	2	1	inculcarem	2	3	4	15650
inculparà	2	0	inculpara	2	1	1	15651
inculpà	2	6	inculpa	2	28	34	15652
inculpés	2	2	inculpes	2	0	2	15653
inculpí	2	0	inculpi	2	4	4	15654
inculqués	2	9	inculques	2	2	11	15655
inculquí	2	0	inculqui	2	5	5	15656
incumbirà	2	14	incumbira	2	0	14	15657
incòmoda	0	1693	incomoda	2	718	2411	15658
incòmode	0	2968	incomode	2	111	3079	15659
incòmodes	0	1944	incomodes	2	121	2065	15660
indagarà	2	35	indagara	2	1	36	15661
indagués	2	8	indagues	2	8	16	15662
indaguí	2	0	indagui	2	31	31	15663
indagà	2	4	indaga	2	646	650	15664
indagàrem	2	1	indagarem	2	30	31	15665
indemnitzarà	2	126	indemnitzara	2	0	126	15666
indemnitzà	2	1	indemnitza	2	70	71	15667
indemnitzàrem	2	0	indemnitzarem	2	3	3	15668
indemnitzés	2	18	indemnitzes	2	0	18	15669
indemnitzí	2	0	indemnitzi	2	136	136	15670
independitzarà	2	24	independitzara	2	5	29	15671
independitzà	2	109	independitza	2	258	367	15672
independitzàrem	2	0	independitzarem	2	4	4	15673
independitzés	2	58	independitzes	2	7	65	15674
independitzí	2	0	independitzi	2	81	81	15675
indexarà	2	17	indexara	2	0	17	15676
indexà	2	1	indexa	2	171	172	15677
indexés	2	0	indexes	2	14	14	15678
indexí	2	0	indexi	2	40	40	15679
indicarà	2	1983	indicara	2	15	1998	15680
indicià	2	0	indicia	2	9	9	15681
indiciària	0	35	indiciaria	2	2	37	15682
indiciàries	0	11	indiciaries	2	1	12	15683
indiciés	2	0	indicies	2	2	2	15684
indicà	2	333	indica	2	37064	37397	15685
indicàrem	2	3	indicarem	2	367	370	15686
indicàreu	2	0	indicareu	2	14	14	15687
indigestarà	2	1	indigestara	2	0	1	15688
indigestà	2	1	indigesta	0	91	92	15689
indigestés	2	0	indigestes	0	27	27	15690
indigestí	2	0	indigesti	2	3	3	15691
indignarà	2	14	indignara	2	1	15	15692
indignà	2	54	indigna	2	1330	1384	15693
indignàrem	2	0	indignarem	2	5	5	15694
indignàreu	2	0	indignareu	2	2	2	15695
indignés	2	12	indignes	2	667	679	15696
indigní	2	0	indigni	2	51	51	15697
indiqués	2	251	indiques	2	192	443	15698
indiquí	2	1	indiqui	2	3664	3665	15699
indisciplinà	2	0	indisciplina	4	292	292	15700
indisciplinés	2	0	indisciplines	4	26	26	15701
indisposà	2	2	indisposa	2	4	6	15702
indisposí	2	0	indisposi	2	1	1	15703
individualitzarà	2	6	individualitzara	2	0	6	15704
individualitzà	2	3	individualitza	2	108	111	15705
individualitzàrem	2	0	individualitzarem	2	2	2	15706
individualitzés	2	1	individualitzes	2	2	3	15707
individualitzí	2	0	individualitzi	2	5	5	15708
individuarà	2	0	individuara	2	1	1	15709
individuà	2	0	individua	2	28	28	15710
individués	2	0	individues	2	9	9	15711
indivídua	0	15	individua	2	28	43	15712
indivídues	0	8	individues	2	9	17	15713
indulgencià	2	0	indulgencia	2	13	13	15714
indulgenciés	2	0	indulgencies	2	6	6	15715
indulgència	4	581	indulgencia	2	13	594	15716
indulgències	4	273	indulgencies	2	6	279	15717
indultarà	2	16	indultara	2	1	17	15718
indultà	2	13	indulta	2	39	52	15719
indultàrem	2	0	indultarem	2	2	2	15720
indultés	2	17	indultes	2	2	19	15721
indultí	2	0	indulti	2	12	12	15722
industrialitzà	2	9	industrialitza	2	22	31	15723
industrialitzés	2	0	industrialitzes	2	1	1	15724
industrialitzí	2	1	industrialitzi	2	5	6	15725
industrià	2	1	industria	2	4372	4373	15726
industriés	2	0	industries	2	1270	1270	15727
industrií	2	0	industrii	2	1	1	15728
induírem	2	0	induirem	2	5	5	15729
indústria	4	71099	industria	2	4372	75471	15730
indústries	4	13328	industries	2	1270	14598	15731
inebriarà	2	0	inebriara	2	1	1	15732
inebrià	2	0	inebria	2	1	1	15733
inertitzà	2	0	inertitza	2	1	1	15734
infamà	2	0	infama	2	4	4	15735
infamés	2	0	infames	2	338	338	15736
infantarà	2	5	infantara	2	0	5	15737
infantilitzà	2	0	infantilitza	2	37	37	15738
infantilitzí	2	0	infantilitzi	2	5	5	15739
infantà	2	46	infanta	4	2083	2129	15740
infantés	2	2	infantes	4	197	199	15741
infantí	2	1	infanti	2	67	68	15742
infantó	4	72	infanto	2	60	132	15743
infeccionà	2	0	infecciona	2	1	1	15744
infeccionés	2	0	infecciones	2	52	52	15745
infectarà	2	14	infectara	2	0	14	15746
infectà	2	10	infecta	2	384	394	15747
infectàrem	2	0	infectarem	2	1	1	15748
infectàreu	2	0	infectareu	2	2	2	15749
infectés	2	12	infectes	2	131	143	15750
infectí	2	0	infecti	2	72	72	15751
inferirà	2	3	inferira	2	0	3	15752
inferíreu	2	0	inferireu	2	2	2	15753
infestarà	2	1	infestara	2	0	1	15754
infestà	2	0	infesta	0	34	34	15755
infestàreu	2	1	infestareu	2	0	1	15756
infestés	2	0	infestes	0	1	1	15757
infestí	2	0	infesti	2	3	3	15758
infeudà	2	42	infeuda	2	8	50	15759
infiltrarà	2	8	infiltrara	2	1	9	15760
infiltrà	2	22	infiltra	2	234	256	15761
infiltràrem	2	0	infiltrarem	2	4	4	15762
infiltrés	2	7	infiltres	2	2	9	15763
infiltrí	2	0	infiltri	2	44	44	15764
infirmà	2	0	infirma	2	2	2	15765
infirmés	2	0	infirmes	2	1	1	15766
infirmí	2	0	infirmi	2	2	2	15767
inflamarà	2	8	inflamara	2	0	8	15768
inflamà	2	8	inflama	2	158	166	15769
inflamés	2	5	inflames	2	1	6	15770
inflamí	2	0	inflami	2	24	24	15771
inflarà	2	42	inflara	2	0	42	15772
inflexionà	2	0	inflexiona	2	8	8	15773
inflexionés	2	1	inflexiones	2	1	2	15774
infligirà	2	1	infligira	2	1	2	15775
influenciarà	2	38	influenciara	2	0	38	15776
influencià	2	84	influencia	2	1150	1234	15777
influenciés	2	10	influencies	2	231	241	15778
influencií	2	1	influencii	2	2	3	15779
influència	4	38709	influencia	2	1150	39859	15780
influències	4	9168	influencies	2	231	9399	15781
influírem	2	0	influirem	2	6	6	15782
influíreu	2	0	influireu	2	1	1	15783
inflà	2	12	infla	2	444	456	15784
inflàrem	2	1	inflarem	2	13	14	15785
inflàreu	2	0	inflareu	2	1	1	15786
inflés	2	20	infles	2	21	41	15787
inflí	2	0	infli	2	107	107	15788
infondré	2	6	infondre	2	523	529	15789
infongués	2	7	infongues	2	0	7	15790
infonguí	2	0	infongui	2	41	41	15791
informarà	2	4316	informara	2	52	4368	15792
informatitzarà	2	6	informatitzara	2	0	6	15793
informatitzà	2	0	informatitza	2	14	14	15794
informatitzàrem	2	0	informatitzarem	2	2	2	15795
informatitzí	2	0	informatitzi	2	2	2	15796
informà	2	835	informa	2	29595	30430	15797
informàrem	2	42	informarem	2	2969	3011	15798
informàreu	2	2	informareu	2	13	15	15799
informés	2	772	informes	2	33529	34301	15800
informí	2	7	informi	2	2090	2097	15801
infradiagnòstic	4	19	infradiagnostic	2	0	19	15802
infraestimà	2	0	infraestima	2	1	1	15803
infrafinançà	2	0	infrafinança	2	2	2	15804
inframón	4	388	inframon	4	65	453	15805
infrautilitzà	2	1	infrautilitza	2	8	9	15806
infrautilitzí	2	0	infrautilitzi	2	1	1	15807
infravalorarà	2	2	infravalorara	2	0	2	15808
infravalorà	2	3	infravalora	2	93	96	15809
infravalorés	2	2	infravalores	2	5	7	15810
infravalorí	2	0	infravalori	2	8	8	15811
infringirà	2	22	infringira	2	2	24	15812
infringírem	2	0	infringirem	2	2	2	15813
infusionà	2	0	infusiona	2	23	23	15814
infusionàrem	2	0	infusionarem	2	4	4	15815
infusionés	2	0	infusiones	2	8	8	15816
infusioní	2	0	infusioni	2	26	26	15817
ingerirà	2	10	ingerira	2	0	10	15818
ingerírem	2	0	ingerirem	2	7	7	15819
ingeríreu	2	0	ingerireu	2	1	1	15820
ingressarà	2	298	ingressara	2	5	303	15821
ingressà	2	1479	ingressa	2	1436	2915	15822
ingressàrem	2	2	ingressarem	2	30	32	15823
ingressàreu	2	0	ingressareu	2	4	4	15824
ingressés	2	98	ingresses	2	32	130	15825
ingressí	2	0	ingressi	2	235	235	15826
inhabilitarà	2	61	inhabilitara	2	1	62	15827
inhabilità	2	6	inhabilita	2	849	855	15828
inhabilités	2	11	inhabilites	2	0	11	15829
inhabilití	2	0	inhabiliti	2	81	81	15830
inhalà	2	4	inhala	2	190	194	15831
inhalàrem	2	0	inhalarem	2	2	2	15832
inhalés	2	1	inhales	2	7	8	15833
inhalí	2	0	inhali	2	11	11	15834
inhibirà	2	16	inhibira	2	2	18	15835
inhumarà	2	1	inhumara	2	0	1	15836
inhumà	2	775	inhuma	2	11	786	15837
inicialitzarà	2	13	inicialitzara	2	0	13	15838
inicialitzà	2	0	inicialitza	2	105	105	15839
inicialitzàrem	2	0	inicialitzarem	2	2	2	15840
inicialitzí	2	0	inicialitzi	2	5	5	15841
iniciarà	2	8690	iniciara	2	102	8792	15842
inicià	2	6585	inicia	2	27786	34371	15843
iniciàrem	2	177	iniciarem	2	1624	1801	15844
iniciàreu	2	4	iniciareu	2	33	37	15845
iniciés	2	586	inicies	2	175	761	15846
inicií	2	48	inicii	2	76	124	15847
injectarà	2	73	injectara	2	4	77	15848
injectà	2	10	injecta	2	534	544	15849
injectàrem	2	0	injectarem	2	3	3	15850
injectés	2	10	injectes	2	12	22	15851
injectí	2	0	injecti	2	34	34	15852
injurià	2	1	injuria	2	42	43	15853
injuriés	2	0	injuries	2	110	110	15854
injúria	4	185	injuria	2	42	227	15855
injúries	4	1303	injuries	2	110	1413	15856
innervà	2	0	innerva	2	27	27	15857
innovarà	2	18	innovara	2	1	19	15858
innovà	2	12	innova	2	3285	3297	15859
innovàrem	2	0	innovarem	2	10	10	15860
innovàreu	2	0	innovareu	2	3	3	15861
innovés	2	3	innoves	2	9	12	15862
innoví	2	2	innovi	2	213	215	15863
inocularà	2	2	inoculara	2	0	2	15864
inoculà	2	6	inocula	2	80	86	15865
inoculàrem	2	0	inocularem	2	1	1	15866
inoculí	2	0	inoculi	2	12	12	15867
inquietarà	2	11	inquietara	2	0	11	15868
inquietà	2	17	inquieta	0	2308	2325	15869
inquietés	2	10	inquietes	0	454	464	15870
inquietí	2	0	inquieti	2	37	37	15871
inquirirà	2	2	inquirira	2	0	2	15872
insaculà	2	0	insacula	2	1	1	15873
inscrigués	2	12	inscrigues	2	4	16	15874
inscriguí	2	0	inscrigui	2	310	310	15875
inscriuré	2	4	inscriure	2	16028	16032	15876
inseminarà	2	1	inseminara	2	0	1	15877
inseminà	2	0	insemina	2	11	11	15878
inseminés	2	0	insemines	2	1	1	15879
insensibilitzà	2	0	insensibilitza	2	21	21	15880
insensibilitzés	2	1	insensibilitzes	2	1	2	15881
insensibilitzí	2	0	insensibilitzi	2	2	2	15882
inserirà	2	202	inserira	2	3	205	15883
inserírem	2	0	inserirem	2	24	24	15884
inseríreu	2	0	inserireu	2	7	7	15885
insidià	2	0	insidia	2	12	12	15886
insidiés	2	0	insidies	2	16	16	15887
insinuarà	2	6	insinuara	2	1	7	15888
insinuà	2	38	insinua	2	968	1006	15889
insinuàrem	2	0	insinuarem	2	2	2	15890
insinués	2	26	insinues	2	38	64	15891
insistirà	2	231	insistira	2	5	236	15892
insistírem	2	14	insistirem	2	248	262	15893
insolentà	2	0	insolenta	2	2	2	15894
insolentés	2	0	insolentes	2	1	1	15895
insolà	2	0	insola	2	5	5	15896
insolàrem	2	0	insolarem	2	1	1	15897
insolés	2	0	insoles	2	10	10	15898
insolí	2	0	insoli	2	1	1	15899
insonoritzarà	2	5	insonoritzara	2	0	5	15900
insonoritzà	2	1	insonoritza	2	8	9	15901
insonoritzés	2	2	insonoritzes	2	0	2	15902
inspeccionarà	2	50	inspeccionara	2	1	51	15903
inspeccionà	2	11	inspecciona	2	165	176	15904
inspeccionàrem	2	0	inspeccionarem	2	11	11	15905
inspeccionés	2	13	inspecciones	2	17	30	15906
inspeccioní	2	0	inspeccioni	2	36	36	15907
inspirarà	2	188	inspirara	2	4	192	15908
inspirà	2	603	inspira	2	5288	5891	15909
inspiràrem	2	6	inspirarem	2	47	53	15910
inspiràreu	2	2	inspirareu	2	5	7	15911
inspirés	2	81	inspires	2	105	186	15912
inspirí	2	0	inspiri	2	362	362	15913
instal·larà	2	3160	instal·lara	2	28	3188	15914
instal·là	2	2475	instal·la	2	5038	7513	15915
instal·làrem	2	9	instal·larem	2	306	315	15916
instal·làreu	2	0	instal·lareu	2	11	11	15917
instal·lés	2	203	instal·les	2	132	335	15918
instal·lí	2	2	instal·li	2	776	778	15919
instancià	2	1	instancia	2	251	252	15920
instanciés	2	0	instancies	2	133	133	15921
instarà	2	316	instara	2	16	332	15922
instaurarà	2	79	instaurara	2	7	86	15923
instaurà	2	334	instaura	2	471	805	15924
instauràrem	2	1	instaurarem	2	20	21	15925
instaurés	2	54	instaures	2	1	55	15926
instaurí	2	0	instauri	2	144	144	15927
instigarà	2	3	instigara	2	0	3	15928
instigués	2	3	instigues	2	0	3	15929
instiguí	2	0	instigui	2	6	6	15930
instigà	2	20	instiga	2	39	59	15931
instigàrem	2	1	instigarem	2	0	1	15932
instil·là	2	0	instil·la	2	7	7	15933
instil·lí	2	1	instil·li	2	1	2	15934
institucionalitzarà	2	10	institucionalitzara	2	0	10	15935
institucionalitzà	2	25	institucionalitza	2	89	114	15936
institucionalitzés	2	6	institucionalitzes	2	1	7	15937
institucionalitzí	2	0	institucionalitzi	2	18	18	15938
instituírem	2	0	instituirem	2	3	3	15939
instrumentalitzarà	2	2	instrumentalitzara	2	0	2	15940
instrumentalitzà	2	2	instrumentalitza	2	72	74	15941
instrumentalitzés	2	2	instrumentalitzes	2	0	2	15942
instrumentalitzí	2	0	instrumentalitzi	2	21	21	15943
instrumentarà	2	8	instrumentara	2	0	8	15944
instrumentà	2	3	instrumenta	2	67	70	15945
instrumentàrem	2	0	instrumentarem	2	1	1	15946
instrumentària	0	0	instrumentaria	2	1	1	15947
instrumentés	2	0	instrumentes	2	9	9	15948
instrumentí	2	0	instrumenti	2	12	12	15949
instruírem	2	0	instruirem	2	3	3	15950
instruíreu	2	0	instruireu	2	2	2	15951
instà	2	125	insta	2	6738	6863	15952
instància	4	14721	instancia	2	251	14972	15953
instàncies	4	7736	instancies	2	133	7869	15954
instàrem	2	2	instarem	2	70	72	15955
instés	2	114	instes	2	6	120	15956
instí	2	4	insti	2	770	774	15957
insubordinà	2	0	insubordina	2	3	3	15958
insuflarà	2	9	insuflara	2	0	9	15959
insuflà	2	7	insufla	2	96	103	15960
insuflàrem	2	0	insuflarem	2	2	2	15961
insuflés	2	2	insufles	2	0	2	15962
insuflí	2	0	insufli	2	13	13	15963
insultarà	2	6	insultara	2	6	12	15964
insultà	2	16	insulta	2	678	694	15965
insultàrem	2	0	insultarem	2	8	8	15966
insultàreu	2	0	insultareu	2	2	2	15967
insultés	2	24	insultes	2	43	67	15968
insultí	2	0	insulti	2	122	122	15969
insurreccionà	2	2	insurrecciona	2	1	3	15970
insídia	4	55	insidia	2	12	67	15971
insídies	4	69	insidies	2	16	85	15972
integrarà	2	778	integrara	2	10	788	15973
integrà	2	908	integra	2	8111	9019	15974
integràrem	2	4	integrarem	2	71	75	15975
integràreu	2	0	integrareu	2	4	4	15976
integrés	2	175	integres	2	90	265	15977
integrí	2	0	integri	2	1330	1330	15978
intel·lectualitzà	2	0	intel·lectualitza	2	4	4	15979
intensificarà	2	457	intensificara	2	2	459	15980
intensificà	2	193	intensifica	2	1131	1324	15981
intensificàrem	2	1	intensificarem	2	63	64	15982
intensifiqués	2	28	intensifiques	2	4	32	15983
intensifiquí	2	0	intensifiqui	2	234	234	15984
intentarà	2	4864	intentara	2	58	4922	15985
intentà	2	2501	intenta	2	24897	27398	15986
intentàrem	2	49	intentarem	2	4713	4762	15987
intentàreu	2	4	intentareu	2	16	20	15988
intentés	2	704	intentes	2	1096	1800	15989
intentí	2	10	intenti	2	2187	2197	15990
interaccionarà	2	14	interaccionara	2	2	16	15991
interaccionà	2	4	interacciona	2	462	466	15992
interaccionàrem	2	0	interaccionarem	2	4	4	15993
interaccionés	2	6	interacciones	2	55	61	15994
interaccioní	2	0	interaccioni	2	53	53	15995
interactuarà	2	83	interactuara	2	2	85	15996
interactuà	2	4	interactua	2	1006	1010	15997
interactuàrem	2	1	interactuarem	2	35	36	15998
interactuàreu	2	0	interactuareu	2	4	4	15999
interactués	2	8	interactues	2	60	68	16000
intercalarà	2	26	intercalara	2	0	26	16001
intercalà	2	7	intercala	2	265	272	16002
intercalàrem	2	0	intercalarem	2	11	11	16003
intercalés	2	2	intercales	2	5	7	16004
intercalí	2	0	intercali	2	7	7	16005
intercanviarà	2	64	intercanviara	2	0	64	16006
intercanvià	2	34	intercanvia	2	604	638	16007
intercanviàrem	2	9	intercanviarem	2	75	84	16008
intercanviàreu	2	2	intercanviareu	2	2	4	16009
intercanviés	2	2	intercanvies	2	36	38	16010
intercanvií	2	5	intercanvii	2	4	9	16011
intercedirà	2	23	intercedira	2	4	27	16012
intercedírem	2	1	intercedirem	2	1	2	16013
interceptarà	2	4	interceptara	2	0	4	16014
interceptà	2	22	intercepta	2	139	161	16015
interceptés	2	16	interceptes	2	0	16	16016
interceptí	2	0	intercepti	2	14	14	16017
intercomunicà	2	0	intercomunica	2	5	5	16018
interconnectarà	2	11	interconnectara	2	0	11	16019
interconnectà	2	0	interconnecta	2	62	62	16020
interconnectés	2	3	interconnectes	2	2	5	16021
interconnectí	2	0	interconnecti	2	12	12	16022
interessarà	2	613	interessara	2	19	632	16023
interessà	2	558	interessa	2	23219	23777	16024
interessàrem	2	9	interessarem	2	33	42	16025
interessàreu	2	0	interessareu	2	1	1	16026
interessés	2	313	interesses	2	98	411	16027
interessí	2	1	interessi	2	2570	2571	16028
interferirà	2	67	interferira	2	1	68	16029
interferírem	2	0	interferirem	2	7	7	16030
interferíreu	2	0	interferireu	2	1	1	16031
interfoliés	2	1	interfolies	2	0	1	16032
interioritzarà	2	4	interioritzara	2	0	4	16033
interioritzà	2	4	interioritza	2	136	140	16034
interioritzàrem	2	0	interioritzarem	2	1	1	16035
interioritzés	2	3	interioritzes	2	12	15	16036
interioritzí	2	0	interioritzi	2	53	53	16037
interlineà	2	0	interlinea	2	2	2	16038
intermediarà	2	4	intermediara	2	0	4	16039
intermedià	2	1	intermedia	2	343	344	16040
intermediària	0	305	intermediaria	2	6	311	16041
intermediàries	0	183	intermediaries	2	7	190	16042
intermediés	2	1	intermedies	2	4	5	16043
intermèdia	0	3296	intermedia	2	343	3639	16044
intermèdies	0	1104	intermedies	2	4	1108	16045
internacionalitzarà	2	13	internacionalitzara	2	1	14	16046
internacionalitzà	2	7	internacionalitza	2	101	108	16047
internacionalitzàrem	2	0	internacionalitzarem	2	6	6	16048
internacionalitzàreu	2	1	internacionalitzareu	2	0	1	16049
internacionalitzés	2	2	internacionalitzes	2	2	4	16050
internacionalitzí	2	0	internacionalitzi	2	11	11	16051
internalitzarà	2	2	internalitzara	2	0	2	16052
internalitzà	2	0	internalitza	2	22	22	16053
internalitzés	2	1	internalitzes	2	2	3	16054
internalitzí	2	0	internalitzi	2	12	12	16055
internarà	2	3	internara	2	0	3	16056
internà	2	31	interna	0	24889	24920	16057
internàrem	2	0	internarem	2	3	3	16058
internàreu	2	0	internareu	2	2	2	16059
internés	2	14	internes	0	9763	9777	16060
interní	2	1	interni	2	24	25	16061
interpel·larà	2	71	interpel·lara	2	1	72	16062
interpel·là	2	17	interpel·la	2	960	977	16063
interpel·làrem	2	0	interpel·larem	2	3	3	16064
interpel·lés	2	10	interpel·les	2	3	13	16065
interpel·lí	2	0	interpel·li	2	73	73	16066
interpenetrà	2	0	interpenetra	2	3	3	16067
interpolarà	2	2	interpolara	2	0	2	16068
interpolà	2	0	interpola	2	42	42	16069
interpolí	2	0	interpoli	2	2	2	16070
interposarà	2	127	interposara	2	7	134	16071
interposà	2	82	interposa	2	433	515	16072
interposàrem	2	0	interposarem	2	15	15	16073
interposàreu	2	1	interposareu	2	0	1	16074
interposés	2	68	interposes	2	9	77	16075
interposí	2	0	interposi	2	186	186	16076
interpretarà	2	3076	interpretara	2	20	3096	16077
interpretà	2	743	interpreta	2	7801	8544	16078
interpretàrem	2	24	interpretarem	2	201	225	16079
interpretàreu	2	0	interpretareu	2	6	6	16080
interpretés	2	206	interpretes	2	133	339	16081
interpretí	2	1	interpreti	2	589	590	16082
interrelacionarà	2	5	interrelacionara	2	0	5	16083
interrelacionà	2	0	interrelaciona	2	143	143	16084
interrelacionàrem	2	0	interrelacionarem	2	2	2	16085
interrelacionés	2	1	interrelaciones	2	5	6	16086
interrelacioní	2	0	interrelacioni	2	13	13	16087
interrogarà	2	34	interrogara	2	0	34	16088
interrogués	2	8	interrogues	2	10	18	16089
interroguí	2	1	interrogui	2	39	40	16090
interrogà	2	51	interroga	2	649	700	16091
interrogàrem	2	0	interrogarem	2	18	18	16092
interrompré	2	15	interrompre	2	4046	4061	16093
interrompés	2	61	interrompes	2	2	63	16094
interrompí	2	17	interrompi	2	254	271	16095
intersecarà	2	1	intersecara	2	1	2	16096
intersecà	2	0	interseca	2	103	103	16097
intersequés	2	0	interseques	2	1	1	16098
intersequí	2	0	intersequi	2	5	5	16099
intervenguí	2	0	intervengui	2	17	17	16100
intervindré	2	111	intervindre	2	708	819	16101
intervingués	2	276	intervingues	2	1	277	16102
intervinguí	2	1	intervingui	2	1089	1090	16103
interviuà	2	0	interviua	2	1	1	16104
intimarà	2	2	intimara	2	0	2	16105
intimidarà	2	3	intimidara	2	1	4	16106
intimidà	2	5	intimida	2	160	165	16107
intimidés	2	4	intimides	2	1	5	16108
intimidí	2	0	intimidi	2	20	20	16109
intimà	2	10	intima	4	243	253	16110
intimàrem	2	0	intimarem	2	2	2	16111
intimés	2	1	intimes	4	118	119	16112
intimí	2	0	intimi	2	1	1	16113
intitularà	2	2	intitulara	2	0	2	16114
intitulà	2	37	intitula	2	73	110	16115
intitulés	2	2	intitules	2	0	2	16116
intitulí	2	0	intituli	2	1	1	16117
intoxicà	2	2	intoxica	2	81	83	16118
intoxicàrem	2	1	intoxicarem	2	1	2	16119
intoxiqués	2	6	intoxiques	2	2	8	16120
intoxiquí	2	0	intoxiqui	2	9	9	16121
intranquil·litzà	2	2	intranquil·litza	2	20	22	16122
intranquil·litzàreu	2	0	intranquil·litzareu	2	1	1	16123
intranquil·litzí	2	0	intranquil·litzi	2	2	2	16124
intricà	2	0	intrica	2	1	1	16125
intrigarà	2	3	intrigara	2	0	3	16126
intrigués	2	0	intrigues	4	1354	1354	16127
intriguí	2	0	intrigui	2	6	6	16128
intrigà	2	9	intriga	4	3460	3469	16129
intriqués	2	0	intriques	2	1	1	16130
introduírem	2	9	introduirem	2	530	539	16131
introduíreu	2	1	introduireu	2	29	30	16132
introjectés	2	0	introjectes	2	5	5	16133
intubà	2	0	intuba	2	1	1	16134
intuírem	2	0	intuirem	2	14	14	16135
intuíreu	2	0	intuireu	2	9	9	16136
intèrpret	4	7209	interpret	2	126	7335	16137
inundarà	2	138	inundara	2	2	140	16138
inundà	2	68	inunda	2	886	954	16139
inundàrem	2	0	inundarem	2	10	10	16140
inundés	2	36	inundes	2	2	38	16141
inundí	2	0	inundi	2	88	88	16142
inutilitzarà	2	25	inutilitzara	2	0	25	16143
inutilitzà	2	9	inutilitza	2	37	46	16144
inutilitzàrem	2	0	inutilitzarem	2	1	1	16145
inutilitzés	2	2	inutilitzes	2	0	2	16146
inutilitzí	2	0	inutilitzi	2	51	51	16147
invadirà	2	2	invadira	2	3	5	16148
invadírem	2	0	invadirem	2	1	1	16149
invaginà	2	0	invagina	2	6	6	16150
invaginí	2	0	invagini	2	1	1	16151
invalidarà	2	26	invalidara	2	1	27	16152
invalidà	2	9	invalida	2	448	457	16153
invalidàrem	2	0	invalidarem	2	1	1	16154
invalidàreu	2	0	invalidareu	2	1	1	16155
invalidés	2	18	invalides	2	43	61	16156
invalidí	2	0	invalidi	2	48	48	16157
invectivà	2	0	invectiva	4	80	80	16158
invectivés	2	0	invectives	4	140	140	16159
inventariarà	2	3	inventariara	2	0	3	16160
inventarià	2	8	inventaria	2	86	94	16161
inventariàrem	2	0	inventariarem	2	1	1	16162
inventariés	2	2	inventaries	2	3	5	16163
inventarà	2	76	inventara	2	11	87	16164
inventaríem	2	12	inventariem	2	8	20	16165
inventà	2	409	inventa	2	1616	2025	16166
inventàrem	2	5	inventarem	2	94	99	16167
inventàreu	2	1	inventareu	2	2	3	16168
inventés	2	132	inventes	2	77	209	16169
inventí	2	0	inventi	2	123	123	16170
invertirà	2	1734	invertira	2	24	1758	16171
invertírem	2	3	invertirem	2	126	129	16172
invertíreu	2	2	invertireu	2	9	11	16173
investigarà	2	469	investigara	2	21	490	16174
investigués	2	202	investigues	2	70	272	16175
investiguí	2	1	investigui	2	1062	1063	16176
investigà	2	189	investiga	2	5946	6135	16177
investigàrem	2	5	investigarem	2	178	183	16178
investigàreu	2	0	investigareu	2	5	5	16179
investirà	2	86	investira	2	1	87	16180
investírem	2	0	investirem	2	14	14	16181
investíreu	2	0	investireu	2	1	1	16182
inveterí	2	0	inveteri	2	1	1	16183
invisibilitzà	2	0	invisibilitza	2	164	164	16184
invisibilitzí	2	0	invisibilitzi	2	9	9	16185
invitarà	2	49	invitara	2	6	55	16186
invità	2	84	invita	2	1451	1535	16187
invitàrem	2	1	invitarem	2	25	26	16188
invités	2	30	invites	2	27	57	16189
invití	2	0	inviti	2	35	35	16190
invocarà	2	40	invocara	2	0	40	16191
invocà	2	32	invoca	2	867	899	16192
invocàrem	2	1	invocarem	2	9	10	16193
invocàreu	2	0	invocareu	2	1	1	16194
involucionarà	2	1	involucionara	2	0	1	16195
involucionà	2	0	involuciona	2	17	17	16196
involucionàrem	2	0	involucionarem	2	1	1	16197
involucioní	2	0	involucioni	2	1	1	16198
involucrarà	2	80	involucrara	2	2	82	16199
involucrà	2	84	involucra	2	1221	1305	16200
involucràrem	2	0	involucrarem	2	14	14	16201
involucràreu	2	0	involucrareu	2	2	2	16202
involucrés	2	50	involucres	2	34	84	16203
involucrí	2	0	involucri	2	332	332	16204
invoqués	2	21	invoques	2	13	34	16205
invoquí	2	0	invoqui	2	201	201	16206
invàlid	0	571	invalid	2	81	652	16207
invàlida	0	328	invalida	2	448	776	16208
invàlides	0	98	invalides	2	43	141	16209
inòcul	4	28	inocul	2	1	29	16210
ioditzà	2	0	ioditza	2	2	2	16211
iodà	2	0	ioda	2	11	11	16212
iodàreu	2	0	iodareu	2	1	1	16213
iodés	2	0	iodes	2	4	4	16214
iodí	2	0	iodi	2	2	2	16215
ionitzà	2	0	ionitza	2	39	39	16216
ionitzí	2	0	ionitzi	2	3	3	16217
irarà	2	0	irara	2	1	1	16218
irisà	2	3	irisa	2	7	10	16219
irisí	2	0	irisi	2	3	3	16220
ironitzarà	2	1	ironitzara	2	0	1	16221
ironitzà	2	6	ironitza	2	293	299	16222
ironitzés	2	0	ironitzes	2	4	4	16223
irradiarà	2	13	irradiara	2	0	13	16224
irradià	2	11	irradia	2	487	498	16225
irradiàreu	2	0	irradiareu	2	1	1	16226
irradiés	2	9	irradies	2	9	18	16227
irradií	2	1	irradii	2	2	3	16228
irrigarà	2	2	irrigara	2	1	3	16229
irriguí	2	0	irrigui	2	1	1	16230
irrigà	2	0	irriga	2	29	29	16231
irritarà	2	11	irritara	2	0	11	16232
irrità	2	23	irrita	2	486	509	16233
irritàrem	2	0	irritarem	2	2	2	16234
irritàreu	2	0	irritareu	2	1	1	16235
irrités	2	2	irrites	2	5	7	16236
irrití	2	0	irriti	2	37	37	16237
irroguí	2	0	irrogui	2	4	4	16238
irrogà	2	0	irroga	2	1	1	16239
irrompré	2	0	irrompre	2	1272	1272	16240
irrompés	2	17	irrompes	2	0	17	16241
irrompí	2	2	irrompi	2	25	27	16242
irà	2	22	ira	4	4523	4545	16243
iré	2	26	ire	2	95	121	16244
irés	2	0	ires	4	758	758	16245
irí	2	0	iri	2	133	133	16246
irís	2	0	iris	2	3100	3100	16247
islamitzarà	2	1	islamitzara	2	0	1	16248
islamitzà	2	2	islamitza	2	2	4	16249
islamitzés	2	1	islamitzes	2	0	1	16250
isolà	2	8	isola	2	248	256	16251
isolàrem	2	1	isolarem	2	0	1	16252
isolés	2	8	isoles	2	14	22	16253
isomeritzà	2	0	isomeritza	2	4	4	16254
isqués	2	2	isques	2	17	19	16255
isquí	2	2	isqui	4	25	27	16256
italianitzà	2	0	italianitza	2	3	3	16257
italianitzés	2	1	italianitzes	2	0	1	16258
iterà	2	0	itera	2	26	26	16259
iteràrem	2	0	iterarem	2	2	2	16260
iterés	2	16	iteres	2	0	16	16261
iterí	2	0	iteri	2	3	3	16262
jacobí	0	247	jacobi	4	184	431	16263
jactà	2	4	jacta	2	88	92	16264
jactés	2	1	jactes	2	0	1	16265
jactí	2	0	jacti	2	2	2	16266
jagués	2	2	jagues	2	2	4	16267
jalonarà	2	1	jalonara	2	0	1	16268
jalonà	2	0	jalona	2	3	3	16269
jalonés	2	0	jalones	2	2	2	16270
jamaicà	0	406	jamaica	4	1519	1925	16271
jaquès	0	7	jaques	4	239	246	16272
jaqués	0	21	jaques	4	239	260	16273
jaquíreu	2	0	jaquireu	2	1	1	16274
jaumetà	2	0	jaumeta	2	48	48	16275
jaumetàreu	2	1	jaumetareu	2	0	1	16276
jaumetés	2	0	jaumetes	2	2	2	16277
jaupà	2	0	jaupa	2	1	1	16278
jauré	2	3	jaure	2	111	114	16279
jerarquitzà	2	1	jerarquitza	2	50	51	16280
jerarquitzí	2	0	jerarquitzi	2	3	3	16281
joguinegí	2	0	joguinegi	2	2	2	16282
joguinejà	2	0	joguineja	2	10	10	16283
jovençà	0	29	jovença	4	1	30	16284
jubilarà	2	76	jubilara	2	5	81	16285
jubilà	2	108	jubila	2	446	554	16286
jubilàrem	2	1	jubilarem	2	13	14	16287
jubilàreu	2	0	jubilareu	2	1	1	16288
jubilés	2	39	jubiles	2	27	66	16289
jubilí	2	0	jubili	2	142	142	16290
judicarà	2	14	judicara	2	0	14	16291
judicialitzarà	2	3	judicialitzara	2	0	3	16292
judicialitzà	2	0	judicialitza	2	20	20	16293
judicialitzí	2	0	judicialitzi	2	9	9	16294
judicà	2	6	judica	2	40	46	16295
judiqués	2	3	judiques	2	2	5	16296
judiquí	2	0	judiqui	2	9	9	16297
jugarà	2	7145	jugara	2	131	7276	16298
jugulà	2	0	jugula	2	1	1	16299
jugués	2	510	jugues	2	1472	1982	16300
juguí	2	1	jugui	2	1819	1820	16301
jugà	2	1105	juga	2	25436	26541	16302
jugàrem	2	64	jugarem	2	909	973	16303
jugàreu	2	1	jugareu	2	35	36	16304
juncosà	0	1	juncosa	4	1037	1038	16305
junyí	2	0	junyi	2	11	11	16306
juramentà	2	0	juramenta	2	2	2	16307
juramentàrem	2	1	juramentarem	2	0	1	16308
juramentés	2	1	juramentes	2	0	1	16309
jurarà	2	22	jurara	2	5	27	16310
jurcà	2	1	jurca	2	3	4	16311
jurqués	2	0	jurques	2	3	3	16312
jurà	2	166	jura	4	971	1137	16313
juràrem	2	1	jurarem	2	3	4	16314
juràreu	2	1	jurareu	2	4	5	16315
jurés	2	42	jures	4	37	79	16316
jurí	2	2	juri	2	103	105	16317
justejà	2	0	justeja	2	19	19	16318
justificarà	2	178	justificara	2	18	196	16319
justificà	2	131	justifica	2	7251	7382	16320
justificàrem	2	0	justificarem	2	23	23	16321
justificàreu	2	0	justificareu	2	1	1	16322
justifiqués	2	200	justifiques	2	45	245	16323
justifiquí	2	0	justifiqui	2	1635	1635	16324
justà	2	0	justa	4	15398	15398	16325
justés	2	0	justes	4	3896	3896	16326
jutgés	2	65	jutges	4	12914	12979	16327
jutgí	2	0	jutgi	2	390	390	16328
jutjarà	2	578	jutjara	2	7	585	16329
jutjà	2	49	jutja	2	1245	1294	16330
jutjàrem	2	1	jutjarem	2	101	102	16331
jutjàreu	2	0	jutjareu	2	20	20	16332
juxtaposarà	2	0	juxtaposara	2	1	1	16333
juxtaposà	2	0	juxtaposa	2	70	70	16334
juxtaposàrem	2	0	juxtaposarem	2	1	1	16335
jòquer	4	93	joquer	4	31	124	16336
jòquers	4	9	joquers	4	1	10	16337
jócs	4	8	jocs	4	132613	132621	16338
júnior	0	5963	junior	0	4457	10420	16339
júniors	0	915	juniors	0	915	1830	16340
júnyer	2	3	junyer	4	58	61	16341
kenyà	0	245	kenya	4	2605	2850	16342
laborarà	2	7	laborara	2	0	7	16343
laborà	2	16	labora	2	335	351	16344
laboràrem	2	1	laborarem	2	4	5	16345
laborés	2	1	labores	2	88	89	16346
laborí	2	0	labori	2	24	24	16347
lacarà	2	0	lacara	2	3	3	16348
lacerà	2	0	lacera	2	17	17	16349
lacerés	2	0	laceres	2	1	1	16350
lacrà	2	0	lacra	2	285	285	16351
lacràrem	2	1	lacrarem	2	0	1	16352
lacrés	2	0	lacres	2	55	55	16353
lacrí	2	0	lacri	2	1	1	16354
lactà	2	1	lacta	2	18	19	16355
lactés	2	0	lactes	2	1	1	16356
lactí	2	0	lacti	2	606	606	16357
lacà	2	0	laca	4	617	617	16358
lamentarà	2	45	lamentara	2	2	47	16359
lamentà	2	149	lamenta	2	6619	6768	16360
lamentàrem	2	3	lamentarem	2	63	66	16361
lamentàreu	2	2	lamentareu	2	3	5	16362
lamentés	2	21	lamentes	2	23	44	16363
lamentí	2	0	lamenti	2	76	76	16364
laminarà	2	3	laminara	2	1	4	16365
laminà	2	0	lamina	2	158	158	16366
laminàrem	2	0	laminarem	2	12	12	16367
laminària	4	5	laminaria	2	23	28	16368
laminàries	4	18	laminaries	2	0	18	16369
laminés	2	1	lamines	2	148	149	16370
laminí	2	0	lamini	2	7	7	16371
lamés	4	9	lames	4	460	469	16372
lapidà	2	1	lapida	2	32	33	16373
lapidària	0	195	lapidaria	2	33	228	16374
lapidàries	0	128	lapidaries	2	7	135	16375
lapidés	2	0	lapides	2	10	10	16376
lapidí	2	0	lapidi	2	5	5	16377
laqués	2	0	laques	4	200	200	16378
laquí	2	1	laqui	2	1	2	16379
lasarà	2	0	lasara	2	2	2	16380
lascà	2	0	lasca	2	8	8	16381
laserés	2	0	laseres	2	1	1	16382
lasqués	2	0	lasques	2	8	8	16383
lassà	2	0	lassa	0	1455	1455	16384
lassés	2	0	lasses	0	4	4	16385
lassí	2	0	lassi	2	30	30	16386
lasà	2	0	lasa	2	192	192	16387
lasí	2	0	lasi	2	9	9	16388
lateralitzà	2	0	lateralitza	2	4	4	16389
lateralitzí	2	0	lateralitzi	2	1	1	16390
laudà	2	1	lauda	4	213	214	16391
laudés	2	0	laudes	4	373	373	16392
laudí	2	0	laudi	2	6	6	16393
laxà	2	0	laxa	0	379	379	16394
laxés	2	0	laxes	0	220	220	16395
laxí	2	0	laxi	2	1	1	16396
laïcitzarà	2	0	laïcitzara	2	1	1	16397
laïcitzà	2	1	laïcitza	2	1	2	16398
legalitzarà	2	24	legalitzara	2	2	26	16399
legalitzà	2	38	legalitza	2	219	257	16400
legalitzàrem	2	0	legalitzarem	2	1	1	16401
legalitzés	2	20	legalitzes	2	0	20	16402
legalitzí	2	0	legalitzi	2	52	52	16403
legislarà	2	22	legislara	2	1	23	16404
legislà	2	14	legisla	2	317	331	16405
legislàrem	2	0	legislarem	2	6	6	16406
legislés	2	37	legisles	2	2	39	16407
legislí	2	0	legisli	2	163	163	16408
legitimarà	2	33	legitimara	2	1	34	16409
legitimà	2	24	legitima	2	1020	1044	16410
legitimàrem	2	0	legitimarem	2	9	9	16411
legitimàreu	2	0	legitimareu	2	1	1	16412
legitimària	4	4	legitimaria	2	68	72	16413
legitimés	2	28	legitimes	2	79	107	16414
legitimí	2	0	legitimi	2	137	137	16415
legítim	0	7359	legitim	2	108	7467	16416
legítima	0	3801	legitima	2	1020	4821	16417
legítimes	0	2242	legitimes	2	79	2321	16418
lematitzés	2	0	lematitzes	2	1	1	16419
lenificà	2	0	lenifica	2	1	1	16420
lenifiqués	2	1	lenifiques	2	0	1	16421
lesionarà	2	9	lesionara	2	3	12	16422
lesionà	2	22	lesiona	2	321	343	16423
lesionés	2	22	lesiones	2	56	78	16424
lesioní	2	0	lesioni	2	71	71	16425
levità	2	2	levita	0	204	206	16426
levités	2	1	levites	0	81	82	16427
levití	2	0	leviti	2	5	5	16428
lexicalitzà	2	0	lexicalitza	2	4	4	16429
lexicalitzí	2	0	lexicalitzi	2	1	1	16430
liberalitzarà	2	22	liberalitzara	2	0	22	16431
liberalitzà	2	13	liberalitza	2	73	86	16432
liberalitzàrem	2	0	liberalitzarem	2	5	5	16433
liberalitzés	2	8	liberalitzes	2	0	8	16434
liberalitzí	2	0	liberalitzi	2	30	30	16435
libà	2	0	liba	2	48	48	16436
libí	2	0	libi	2	497	497	16437
licitarà	2	256	licitara	2	2	258	16438
licità	2	8	licita	2	361	369	16439
licitàrem	2	0	licitarem	2	19	19	16440
licités	2	10	licites	2	10	20	16441
licití	2	0	liciti	2	81	81	16442
liderarà	2	483	liderara	2	8	491	16443
liderà	2	190	lidera	2	4898	5088	16444
lideràrem	2	0	liderarem	2	24	24	16445
liderés	2	98	lideres	2	32	130	16446
liderí	2	1	lideri	2	497	498	16447
lidiarà	2	5	lidiara	2	0	5	16448
lidià	2	1	lidia	2	1223	1224	16449
lidiés	2	0	lidies	2	1	1	16450
lilà	4	73	lila	4	3306	3379	16451
limitarà	2	869	limitara	2	18	887	16452
limità	2	239	limita	2	13902	14141	16453
limitàrem	2	5	limitarem	2	216	221	16454
limitàreu	2	0	limitareu	2	5	5	16455
limités	2	210	limites	2	108	318	16456
limití	2	0	limiti	2	1270	1270	16457
linealitzà	2	0	linealitza	2	3	3	16458
linxà	2	0	linxa	2	11	11	16459
linxés	2	1	linxes	2	0	1	16460
linxí	2	0	linxi	2	3	3	16461
liofilitzà	2	0	liofilitza	2	2	2	16462
liquidarà	2	139	liquidara	2	1	140	16463
liquidà	2	47	liquida	2	468	515	16464
liquidàrem	2	2	liquidarem	2	11	13	16465
liquidés	2	36	liquides	2	27	63	16466
liquidí	2	0	liquidi	2	82	82	16467
liquà	2	2	liqua	2	43	45	16468
liquàrem	2	0	liquarem	2	1	1	16469
liqüés	2	1	liqües	2	0	1	16470
liqüí	2	0	liqüi	2	2	2	16471
lisà	2	0	lisa	2	1813	1813	16472
lisí	2	1	lisi	2	362	363	16473
literaturitzà	2	1	literaturitza	2	5	6	16474
literaturitzés	2	1	literaturitzes	2	0	1	16475
litigarà	2	3	litigara	2	0	3	16476
litigués	2	2	litigues	2	2	4	16477
litiguí	2	0	litigui	2	1	1	16478
litigà	2	1	litiga	2	9	10	16479
litografià	2	0	litografia	4	757	757	16480
litografiés	2	0	litografies	4	516	516	16481
litosòl	4	1	litosol	4	0	1	16482
litosòls	4	1	litosols	4	3	4	16483
lixivià	2	0	lixivia	2	5	5	16484
lixivií	2	0	lixivii	2	1	1	16485
llacés	2	0	llaces	2	4	4	16486
llací	2	0	llaci	2	3	3	16487
lladrarà	2	3	lladrara	2	0	3	16488
lladrà	2	5	lladra	2	82	87	16489
lladràrem	2	0	lladrarem	2	1	1	16490
lladrés	2	0	lladres	2	5820	5820	16491
lladrí	2	0	lladri	2	2	2	16492
llagotejà	2	0	llagoteja	2	1	1	16493
llagrimegí	2	0	llagrimegi	2	2	2	16494
llagrimejà	2	0	llagrimeja	2	5	5	16495
llagués	2	1	llagues	4	284	285	16496
llagà	2	0	llaga	4	243	243	16497
llambregà	2	2	llambrega	4	8	10	16498
llambrejà	2	0	llambreja	2	3	3	16499
llambroixàreu	2	1	llambroixareu	2	0	1	16500
llaminegés	2	0	llamineges	2	1	1	16501
llaminejà	2	1	llamineja	2	2	3	16502
llamparà	2	0	llampara	2	6	6	16503
llampeguejà	2	0	llampegueja	2	5	5	16504
llampeguí	2	0	llampegui	2	5	5	16505
llampegà	2	0	llampega	2	35	35	16506
llampugués	2	0	llampugues	4	29	29	16507
llampugà	2	2	llampuga	4	134	136	16508
llampurnà	2	0	llampurna	2	1	1	16509
llampà	2	0	llampa	2	9	9	16510
llampí	2	2	llampi	2	1	3	16511
llampó	4	0	llampo	2	1	1	16512
llancés	2	261	llances	4	812	1073	16513
llancí	2	2	llanci	2	371	373	16514
llandà	2	0	llanda	4	315	315	16515
llandés	2	0	llandes	4	763	763	16516
llanegés	2	0	llaneges	2	2	2	16517
llanejà	2	0	llaneja	2	1	1	16518
llanguirà	2	2	llanguira	2	1	3	16519
llanguíreu	2	0	llanguireu	2	1	1	16520
llançarà	2	711	llançara	2	23	734	16521
llançàrem	2	18	llançarem	2	144	162	16522
llançàreu	2	2	llançareu	2	9	11	16523
llarguejà	2	1	llargueja	2	0	1	16524
llassés	2	0	llasses	0	2	2	16525
llastarà	2	3	llastara	2	0	3	16526
llastimà	2	1	llastima	2	621	622	16527
llastimés	2	0	llastimes	2	2	2	16528
llastrarà	2	2	llastrara	2	0	2	16529
llastrà	2	3	llastra	2	239	242	16530
llastrés	2	0	llastres	2	192	192	16531
llastrí	2	0	llastri	2	2	2	16532
llastà	2	3	llasta	2	55	58	16533
llastí	2	1	llasti	2	2	3	16534
llatarà	2	1	llatara	2	0	1	16535
llatinitzà	2	3	llatinitza	2	1	4	16536
llatinitzí	2	0	llatinitzi	2	1	1	16537
llatà	2	0	llata	4	351	351	16538
llatés	2	0	llates	4	169	169	16539
llatí	2	19366	llati	2	155	19521	16540
llaunà	2	0	llauna	4	3919	3919	16541
llaunés	2	0	llaunes	4	2535	2535	16542
llaurarà	2	6	llaurara	2	1	7	16543
llaurà	2	26	llaura	4	202	228	16544
llauràrem	2	0	llaurarem	2	9	9	16545
llauràreu	2	1	llaurareu	2	0	1	16546
llaurés	2	0	llaures	4	111	111	16547
llavarà	2	2	llavara	2	0	2	16548
llaviejà	2	1	llavieja	2	0	1	16549
llavorà	2	1	llavora	4	11	12	16550
llavoràreu	2	1	llavorareu	2	0	1	16551
llavorés	2	0	llavores	4	106	106	16552
llavorí	2	0	llavori	2	6	6	16553
llavà	2	4	llava	2	26	30	16554
llavàrem	2	1	llavarem	2	2	3	16555
llavés	2	0	llaves	2	40	40	16556
llaví	2	33	llavi	2	1293	1326	16557
llaçarà	2	2	llaçara	2	0	2	16558
llaçà	2	3	llaça	2	16	19	16559
llegarà	2	15	llegara	2	4	19	16560
llegirà	2	1893	llegira	2	61	1954	16561
llegué	2	24	llegue	2	43	67	16562
llegués	2	3	llegues	0	74	77	16563
lleguí	2	1	llegui	2	16	17	16564
llegà	2	221	llega	0	397	618	16565
llegàrem	2	0	llegarem	2	16	16	16566
llegírem	2	34	llegirem	2	889	923	16567
llegíreu	2	3	llegireu	2	337	340	16568
llegó	4	115	llego	2	60	175	16569
lleixarà	2	1	lleixara	2	0	1	16570
lleixàrem	2	1	lleixarem	2	0	1	16571
lleixés	2	0	lleixes	4	629	629	16572
lleixí	2	1	lleixi	2	3	4	16573
llencés	2	62	llences	4	167	229	16574
llencí	2	2	llenci	2	280	282	16575
llenegarà	2	2	llenegara	2	0	2	16576
llenegués	2	1	llenegues	4	186	187	16577
lleneguí	2	0	llenegui	2	3	3	16578
llenegà	2	3	llenega	4	193	196	16579
llengotejà	2	0	llengoteja	2	3	3	16580
llenyà	2	1	llenya	4	6081	6082	16581
llenyés	2	0	llenyes	4	181	181	16582
llenyí	2	0	llenyi	2	1	1	16583
llençarà	2	135	llençara	2	2	137	16584
llençà	2	254	llença	4	2451	2705	16585
llençàrem	2	4	llençarem	2	65	69	16586
llençàreu	2	0	llençareu	2	17	17	16587
lleonès	0	196	lleones	4	251	447	16588
lleonés	0	31	lleones	4	251	282	16589
lleparà	2	14	llepara	2	0	14	16590
llepolejà	2	0	llepoleja	2	1	1	16591
llepà	2	8	llepa	4	291	299	16592
llepàrem	2	0	lleparem	2	17	17	16593
llepàreu	2	0	llepareu	2	75	75	16594
llepés	2	15	llepes	4	54	69	16595
llepí	2	0	llepi	2	54	54	16596
llepó	0	24	llepo	2	117	141	16597
llescarà	2	2	llescara	2	0	2	16598
llescà	2	1	llesca	4	1052	1053	16599
llescàrem	2	0	llescarem	2	2	2	16600
llescàreu	2	0	llescareu	2	1	1	16601
llesqués	2	0	llesques	4	1399	1399	16602
llesquí	2	0	llesqui	2	2	2	16603
lletregés	2	0	lletreges	2	2	2	16604
lletregí	2	0	lletregi	2	1	1	16605
lletrejà	2	0	lletreja	2	25	25	16606
lleudarà	2	0	lleudara	2	1	1	16607
lleudà	2	1	lleuda	4	55	56	16608
lleudés	2	0	lleudes	4	14	14	16609
llevarà	2	136	llevara	2	37	173	16610
llevà	2	178	lleva	4	2760	2938	16611
llevàrem	2	17	llevarem	2	126	143	16612
llevàreu	2	0	llevareu	2	10	10	16613
llevés	2	54	lleves	4	789	843	16614
lleví	2	3	llevi	2	259	262	16615
llibertà	2	1	lliberta	4	96	97	16616
llibertària	0	2187	llibertaria	2	98	2285	16617
llibertàries	0	1627	llibertaries	2	45	1672	16618
llibertés	2	0	llibertes	4	30	30	16619
llibertí	2	202	lliberti	2	3	205	16620
llicenciarà	2	16	llicenciara	2	1	17	16621
llicencià	2	739	llicencia	2	1130	1869	16622
llicenciàrem	2	1	llicenciarem	2	0	1	16623
llicenciés	2	6	llicencies	2	364	370	16624
llicencií	2	1	llicencii	2	2	3	16625
llicència	4	31277	llicencia	2	1130	32407	16626
llicències	4	13205	llicencies	2	364	13569	16627
lligarà	2	141	lligara	2	3	144	16628
lligués	2	69	lligues	4	3537	3606	16629
lliguí	2	0	lligui	2	318	318	16630
lligà	2	111	lliga	4	66550	66661	16631
lligàrem	2	4	lligarem	2	61	65	16632
lligàreu	2	0	lligareu	2	7	7	16633
lligó	4	6	lligo	2	109	115	16634
llimarà	2	1	llimara	2	0	1	16635
llimutgés	2	0	llimutges	4	1	1	16636
llimà	2	2	llima	4	1672	1674	16637
llimàrem	2	0	llimarem	2	5	5	16638
llimés	2	1	llimes	4	257	258	16639
llimí	2	0	llimi	2	16	16	16640
llimó	4	142	llimo	2	5	147	16641
lliscarà	2	26	lliscara	2	1	27	16642
lliscà	2	20	llisca	2	819	839	16643
lliscàrem	2	0	lliscarem	2	6	6	16644
lliscàreu	2	0	lliscareu	2	2	2	16645
llisonà	2	0	llisona	4	4	4	16646
llisonàrem	2	3	llisonarem	2	0	3	16647
llisonés	2	0	llisones	4	1	1	16648
llisqués	2	35	llisques	2	24	59	16649
llisquí	2	0	llisqui	2	157	157	16650
llistarà	2	47	llistara	2	0	47	16651
llistà	2	14	llista	4	112478	112492	16652
llistàrem	2	0	llistarem	2	15	15	16653
llistés	2	1	llistes	4	21955	21956	16654
llistí	2	18	llisti	2	10	28	16655
llistó	4	1958	llisto	2	66	2024	16656
llità	2	0	llita	2	11	11	16657
llitàrem	2	0	llitarem	2	1	1	16658
llités	2	0	llites	2	3	3	16659
llití	2	1	lliti	2	1	2	16660
lliurarà	2	3412	lliurara	2	22	3434	16661
lliurà	2	800	lliura	4	5605	6405	16662
lliuràrem	2	10	lliurarem	2	338	348	16663
lliuràreu	2	1	lliurareu	2	22	23	16664
lliurés	2	232	lliures	4	38208	38440	16665
lliurí	2	1	lliuri	2	612	613	16666
lloarà	2	12	lloara	2	1	13	16667
llodrigués	2	0	llodrigues	4	1	1	16668
llodrigó	4	6	llodrigo	2	0	6	16669
llofrà	2	1	llofra	2	2	3	16670
llogarà	2	106	llogara	2	7	113	16671
llogués	2	23	llogues	4	100	123	16672
lloguí	2	0	llogui	2	101	101	16673
llogà	2	91	lloga	4	1518	1609	16674
llogàrem	2	11	llogarem	2	54	65	16675
llogàreu	2	0	llogareu	2	2	2	16676
llombaí	0	2	llombai	4	372	374	16677
llorejà	2	0	lloreja	2	2	2	16678
llorigués	2	0	llorigues	4	1	1	16679
llorigà	2	0	lloriga	4	4	4	16680
llorigó	4	10	llorigo	2	1	11	16681
llossés	2	0	llosses	4	313	313	16682
llostrejà	2	2	llostreja	2	4	6	16683
lloà	2	91	lloa	4	674	765	16684
lloàrem	2	1	lloarem	2	6	7	16685
lloàreu	2	2	lloareu	2	0	2	16686
lloés	2	7	lloes	4	93	100	16687
llucà	2	19	lluca	2	24	43	16688
llucàrem	2	0	llucarem	2	1	1	16689
lluentà	2	0	lluenta	2	118	118	16690
lluentés	2	0	lluentes	2	97	97	16691
lluentó	4	26	lluento	2	1	27	16692
lluertegí	2	0	lluertegi	2	1	1	16693
lluertejarà	2	1	lluertejara	2	0	1	16694
llufarà	2	1	llufara	2	0	1	16695
llufà	2	1	llufa	4	430	431	16696
llufés	2	0	llufes	4	177	177	16697
lluitarà	2	1041	lluitara	2	8	1049	16698
lluità	2	1205	lluita	4	107854	109059	16699
lluitàrem	2	18	lluitarem	2	769	787	16700
lluitàreu	2	0	lluitareu	2	12	12	16701
lluités	2	120	lluites	4	12714	12834	16702
lluití	2	1	lluiti	2	536	537	16703
llumejà	2	0	llumeja	2	1	1	16704
llunyejarà	2	1	llunyejara	2	0	1	16705
llunyà	0	7470	llunya	0	154	7624	16706
lluquí	2	3	lluqui	2	25	28	16707
llussià	2	2	llussia	2	1	3	16708
llussiàreu	2	1	llussiareu	2	0	1	16709
llustrejà	2	0	llustreja	2	2	2	16710
llustrà	2	0	llustra	2	3	3	16711
llustrés	2	0	llustres	2	25	25	16712
llustrí	2	2	llustri	2	0	2	16713
lluírem	2	4	lluirem	2	47	51	16714
lluíreu	2	2	lluireu	2	8	10	16715
llàstima	4	13587	llastima	2	621	14208	16716
llàstimes	4	8	llastimes	2	2	10	16717
llúcera	4	2	llucera	4	5	7	16718
llúceres	4	0	lluceres	4	1	1	16719
localitzarà	2	64	localitzara	2	4	68	16720
localitzà	2	97	localitza	2	2458	2555	16721
localitzàrem	2	6	localitzarem	2	71	77	16722
localitzàreu	2	0	localitzareu	2	25	25	16723
localitzés	2	39	localitzes	2	18	57	16724
localitzí	2	1	localitzi	2	116	117	16725
locutarà	2	1	locutara	2	0	1	16726
locutà	2	1	locuta	2	22	23	16727
locutàrem	2	0	locutarem	2	2	2	16728
locutés	2	1	locutes	2	0	1	16729
loriguillà	0	0	loriguilla	4	253	253	16730
loxodròmia	4	1	loxodromia	4	1	2	16731
loxodròmies	4	1	loxodromies	4	0	1	16732
lubricà	2	0	lubrica	2	51	51	16733
lubrificà	2	0	lubrifica	2	20	20	16734
lubrifiqués	2	1	lubrifiques	2	0	1	16735
lubrifiquí	2	0	lubrifiqui	2	1	1	16736
lubriqués	2	1	lubriques	2	4	5	16737
lubriquí	2	0	lubriqui	2	2	2	16738
lucrarà	2	3	lucrara	2	0	3	16739
lucrà	2	3	lucra	2	41	44	16740
lucrés	2	0	lucres	2	25	25	16741
lucrí	2	4	lucri	2	16	20	16742
ludificà	2	0	ludifica	2	1	1	16743
luxà	2	0	luxa	2	10	10	16744
luxés	2	4	luxes	2	913	917	16745
luxí	2	0	luxi	2	14	14	16746
luxó	4	2	luxo	2	17	19	16747
làban	4	0	laban	4	122	122	16748
làmina	4	3248	lamina	2	158	3406	16749
làmines	4	5066	lamines	2	148	5214	16750
làpida	4	1369	lapida	2	32	1401	16751
làpides	4	825	lapides	2	10	835	16752
làser	0	6234	laser	2	1101	7335	16753
lícit	0	1451	licit	2	41	1492	16754
lícita	0	853	licita	2	361	1214	16755
lícites	0	192	licites	2	10	202	16756
líder	0	43280	lider	2	1054	44334	16757
límit	0	36669	limit	2	1159	37828	16758
líquid	0	11287	liquid	2	576	11863	16759
líquida	0	3390	liquida	2	468	3858	16760
líquides	0	508	liquides	2	27	535	16761
lític	0	109	litic	2	0	109	16762
lúbric	0	29	lubric	2	0	29	16763
lúbrica	0	23	lubrica	2	51	74	16764
lúbriques	0	16	lubriques	2	4	20	16765
macarà	2	0	macara	2	3	3	16766
macerarà	2	3	macerara	2	0	3	16767
macerà	2	0	macera	2	77	77	16768
maceràrem	2	0	macerarem	2	3	3	16769
macerés	2	1	maceres	2	1	2	16770
macerí	2	0	maceri	2	20	20	16771
maculà	2	0	macula	2	207	207	16772
maculí	2	20	maculi	2	6	26	16773
macà	2	0	maca	2	6089	6089	16774
madrigalegés	2	1	madrigaleges	2	0	1	16775
maduixà	2	0	maduixa	4	2721	2721	16776
maduixàrem	2	1	maduixarem	2	0	1	16777
maduixés	2	0	maduixes	4	3688	3688	16778
madurarà	2	50	madurara	2	4	54	16779
madurà	2	18	madura	4	5076	5094	16780
maduràrem	2	1	madurarem	2	5	6	16781
madurès	0	4	madures	0	1667	1671	16782
madurés	2	19	madures	0	1667	1686	16783
madurí	2	0	maduri	2	129	129	16784
maellà	0	11	maella	4	195	206	16785
maganyà	2	1	maganya	4	6	7	16786
maganyés	2	0	maganyes	4	3	3	16787
maganyí	2	1	maganyi	2	0	1	16788
magencarà	2	1	magencara	2	0	1	16789
magencà	2	0	magenca	0	4	4	16790
magnetitzà	2	0	magnetitza	2	29	29	16791
magnetó	4	16	magneto	4	104	120	16792
magnificarà	2	3	magnificara	2	1	4	16793
magnificà	2	9	magnifica	2	1525	1534	16794
magnifiqués	2	6	magnifiques	2	718	724	16795
magnifiquí	2	0	magnifiqui	2	10	10	16796
magnífic	0	18260	magnific	2	598	18858	16797
magnífica	0	17194	magnifica	2	1525	18719	16798
magníficat	4	68	magnificat	2	354	422	16799
magníficats	4	9	magnificats	2	43	52	16800
magnífiques	0	5841	magnifiques	2	718	6559	16801
magolés	2	0	magoles	2	1	1	16802
magregés	2	1	magreges	2	0	1	16803
magregí	2	0	magregi	2	3	3	16804
magrejà	2	0	magreja	2	11	11	16805
mahometitzés	2	1	mahometitzes	2	0	1	16806
majorà	2	0	majora	4	210	210	16807
majorés	2	0	majores	4	12	12	16808
majorí	2	1	majori	2	35	36	16809
malacostumarà	2	1	malacostumara	2	0	1	16810
malacostumà	2	0	malacostuma	2	6	6	16811
malacostumés	2	0	malacostumes	2	1	1	16812
malacostumí	2	0	malacostumi	2	1	1	16813
malaguanyà	2	0	malaguanya	2	1	1	16814
malaltegí	2	2	malaltegi	2	0	2	16815
malaltejà	2	0	malalteja	2	2	2	16816
malavegí	2	0	malavegi	2	1	1	16817
malavejà	2	0	malaveja	2	4	4	16818
malavejàrem	2	0	malavejarem	2	1	1	16819
malaxà	2	0	malaxa	2	4	4	16820
malbaratarà	2	8	malbaratara	2	0	8	16821
malbaratà	2	14	malbarata	2	238	252	16822
malbaratàrem	2	0	malbaratarem	2	9	9	16823
malbaratàreu	2	0	malbaratareu	2	2	2	16824
malbaratés	2	14	malbarates	2	11	25	16825
malbaratí	2	0	malbarati	2	45	45	16826
malcasà	2	0	malcasa	2	1	1	16827
malcontentà	2	0	malcontenta	0	36	36	16828
malcontentés	2	0	malcontentes	0	1	1	16829
malcriarà	2	1	malcriara	2	0	1	16830
malcrià	2	4	malcria	2	9	13	16831
malcriés	2	0	malcries	2	2	2	16832
maldarà	2	29	maldara	2	1	30	16833
maldiguí	2	0	maldigui	2	2	2	16834
maldàrem	2	2	maldarem	2	14	16	16835
maldés	2	9	maldes	2	4	13	16836
maldí	2	0	maldi	2	57	57	16837
maldís	2	0	maldis	2	1	1	16838
maleducà	2	0	maleduca	2	2	2	16839
maleficià	2	0	maleficia	2	2	2	16840
malejà	2	0	maleja	2	1	1	16841
malejàrem	2	0	malejarem	2	1	1	16842
malejàreu	2	1	malejareu	2	0	1	16843
malencertà	2	0	malencerta	2	1	1	16844
malentendré	2	0	malentendre	2	24	24	16845
malentenguí	2	0	malentengui	2	4	4	16846
maleírem	2	0	maleirem	2	8	8	16847
maleíreu	2	0	maleireu	2	2	2	16848
malferí	2	2	malferi	2	1	3	16849
malferís	2	2	malferis	2	0	2	16850
malfià	2	2	malfia	2	67	69	16851
malfiés	2	3	malfies	2	1	4	16852
malgastarà	2	18	malgastara	2	0	18	16853
malgastà	2	3	malgasta	2	208	211	16854
malgastàrem	2	1	malgastarem	2	13	14	16855
malgastàreu	2	0	malgastareu	2	1	1	16856
malgastés	2	6	malgastes	2	7	13	16857
malgastí	2	0	malgasti	2	70	70	16858
malhumorà	2	0	malhumora	2	1	1	16859
malicià	2	0	malicia	2	76	76	16860
maliciés	2	0	malicies	2	1	1	16861
malignà	2	0	maligna	2	408	408	16862
malignés	2	0	malignes	2	1231	1231	16863
malinterpretarà	2	2	malinterpretara	2	1	3	16864
malinterpretà	2	5	malinterpreta	2	52	57	16865
malinterpretàreu	2	0	malinterpretareu	2	1	1	16866
malinterpretés	2	7	malinterpretes	2	4	11	16867
malinterpretí	2	0	malinterpreti	2	78	78	16868
mallarà	2	1	mallara	2	0	1	16869
mallorquinitzà	2	0	mallorquinitza	2	1	1	16870
mallà	2	29	malla	4	3915	3944	16871
mallàrem	2	0	mallarem	2	1	1	16872
mallés	2	0	malles	4	1067	1067	16873
mallí	2	1	malli	2	11	12	16874
malló	4	28	mallo	2	270	298	16875
malmenarà	2	2	malmenara	2	0	2	16876
malmenà	2	6	malmena	2	18	24	16877
malmení	2	0	malmeni	2	7	7	16878
malmetré	2	2	malmetre	2	2142	2144	16879
malmetés	2	47	malmetes	2	1	48	16880
malmetí	2	0	malmeti	2	218	218	16881
malmirí	2	0	malmiri	2	1	1	16882
malparlarà	2	1	malparlara	2	0	1	16883
malparlà	2	1	malparla	2	48	49	16884
malparlés	2	1	malparles	2	4	5	16885
malparlí	2	0	malparli	2	10	10	16886
malpensà	2	0	malpensa	2	56	56	16887
malpensés	2	0	malpenses	2	4	4	16888
malpensí	2	0	malpensi	2	9	9	16889
malprendré	2	0	malprendre	2	1	1	16890
maltractarà	2	11	maltractara	2	2	13	16891
maltractà	2	4	maltracta	2	542	546	16892
maltractàreu	2	0	maltractareu	2	1	1	16893
maltractés	2	13	maltractes	2	213	226	16894
maltractí	2	0	maltracti	2	64	64	16895
maltès	0	572	maltes	4	337	909	16896
malvendré	2	0	malvendre	2	153	153	16897
malvengués	2	2	malvengues	2	0	2	16898
malvenguí	2	0	malvengui	2	2	2	16899
malversarà	2	3	malversara	2	0	3	16900
malversà	2	0	malversa	2	12	12	16901
malversés	2	1	malverses	2	0	1	16902
malversí	2	0	malversi	2	3	3	16903
malveuré	2	0	malveure	4	11	11	16904
malvisqués	2	0	malvisques	2	1	1	16905
malvisquí	2	0	malvisqui	2	3	3	16906
malviuré	2	0	malviure	4	264	264	16907
malvèiem	2	0	malveiem	2	1	1	16908
malvèieu	2	0	malveieu	2	1	1	16909
malvéiem	2	0	malveiem	2	1	1	16910
malvéieu	2	0	malveieu	2	1	1	16911
malvés	2	0	malves	4	257	257	16912
malvéu	2	0	malveu	2	1	1	16913
mal·leabilitzàrem	2	2	mal·leabilitzarem	2	0	2	16914
malícia	4	723	malicia	2	76	799	16915
malícies	4	29	malicies	2	1	30	16916
mamarà	2	11	mamara	2	2	13	16917
mamprendré	2	3	mamprendre	2	168	171	16918
mamprengués	2	0	mamprengues	2	1	1	16919
mamprenguí	2	2	mamprengui	2	0	2	16920
mamussàrem	2	0	mamussarem	2	1	1	16921
mamà	2	990	mama	4	9741	10731	16922
mamàrem	2	0	mamarem	2	1	1	16923
mamària	0	544	mamaria	2	40	584	16924
mamàries	0	217	mamaries	2	5	222	16925
mamí	2	4	mami	2	448	452	16926
mamó	4	27	mamo	2	18	45	16927
manarà	2	95	manara	2	75	170	16928
mancarà	2	199	mancara	2	5	204	16929
mancomunarà	2	1	mancomunara	2	0	1	16930
mancomunà	2	0	mancomuna	2	11	11	16931
mancomunàrem	2	0	mancomunarem	2	1	1	16932
mancomunés	2	1	mancomunes	2	0	1	16933
mancomuní	2	0	mancomuni	2	7	7	16934
mancà	2	68	manca	0	57592	57660	16935
mancàrem	2	1	mancarem	2	10	11	16936
mandregés	2	1	mandreges	2	1	2	16937
mandregí	2	1	mandregi	2	0	1	16938
mandrejà	2	1	mandreja	2	14	15	16939
mandrinà	2	0	mandrina	2	2	2	16940
manducà	2	0	manduca	4	170	170	16941
manduqués	2	0	manduques	4	8	8	16942
maneflejà	2	0	manefleja	2	1	1	16943
maneflejàrem	2	1	maneflejarem	2	0	1	16944
manegarà	2	4	manegara	2	0	4	16945
manegués	2	5	manegues	2	87	92	16946
maneguí	2	8	manegui	2	11	19	16947
manegà	2	7	manega	2	256	263	16948
manegàrem	2	0	manegarem	2	5	5	16949
manegés	2	6	maneges	2	45	51	16950
manegí	2	0	manegi	2	51	51	16951
manejarà	2	23	manejara	2	0	23	16952
manejà	2	8	maneja	2	745	753	16953
manejàrem	2	0	manejarem	2	13	13	16954
manejàreu	2	1	manejareu	2	0	1	16955
mangarà	2	0	mangara	2	5	5	16956
mangostà	4	12	mangosta	4	246	258	16957
mangués	2	1	mangues	4	284	285	16958
manguí	2	0	mangui	2	13	13	16959
mangà	2	1	manga	4	6355	6356	16960
mangàreu	2	0	mangareu	2	1	1	16961
manifassejà	2	0	manifasseja	2	1	1	16962
manifassejàrem	2	1	manifassejarem	2	0	1	16963
manifestarà	2	348	manifestara	2	23	371	16964
manifestà	2	902	manifesta	0	14434	15336	16965
manifestàrem	2	32	manifestarem	2	113	145	16966
manifestàreu	2	3	manifestareu	2	1	4	16967
manifestés	2	214	manifestes	0	313	527	16968
manifestí	2	1	manifesti	2	1241	1242	16969
maniobrarà	2	5	maniobrara	2	0	5	16970
maniobrà	2	20	maniobra	4	5750	5770	16971
maniobrés	2	8	maniobres	4	4845	4853	16972
maniobrí	2	0	maniobri	2	9	9	16973
manipularà	2	44	manipulara	2	0	44	16974
manipulà	2	13	manipula	2	1013	1026	16975
manipulàrem	2	1	manipularem	2	25	26	16976
manipulàreu	2	0	manipulareu	2	3	3	16977
manipulés	2	15	manipules	2	29	44	16978
manipulí	2	0	manipuli	2	160	160	16979
manlleutà	2	0	manlleuta	4	2	2	16980
manlleutés	2	0	manlleutes	4	3	3	16981
manllevarà	2	9	manllevara	2	0	9	16982
manllevà	2	18	manlleva	2	155	173	16983
manllevàrem	2	0	manllevarem	2	3	3	16984
manllevés	2	6	manlleves	2	0	6	16985
manlleví	2	1	manllevi	2	15	16	16986
manotejà	2	0	manoteja	2	2	2	16987
manquegí	2	0	manquegi	2	1	1	16988
manqués	2	78	manques	0	956	1034	16989
manquí	2	1	manqui	2	358	359	16990
manresà	0	2239	manresa	4	37563	39802	16991
mansònia	4	2	mansonia	4	1	3	16992
mantegés	2	0	manteges	2	3	3	16993
mantejà	2	0	manteja	2	1	1	16994
mantenguí	2	0	mantengui	2	154	154	16995
mantindré	2	391	mantindre	2	4348	4739	16996
mantingués	2	1054	mantingues	2	297	1351	16997
mantinguí	2	5	mantingui	2	6862	6867	16998
mantornà	2	0	mantorna	2	1	1	16999
mantornés	2	2	mantornes	2	0	2	17000
mantó	4	170	manto	4	136	306	17001
manufacturà	2	1	manufactura	4	1237	1238	17002
manufacturàrem	2	0	manufacturarem	2	1	1	17003
manufacturés	2	2	manufactures	4	632	634	17004
manufacturí	2	0	manufacturi	2	2	2	17005
manumetré	2	0	manumetre	2	3	3	17006
manxarà	2	2	manxara	2	0	2	17007
manxà	2	1	manxa	4	2641	2642	17008
manxés	2	1	manxes	4	85	86	17009
manxó	4	3	manxo	2	10	13	17010
manyegà	2	0	manyega	2	1	1	17011
manà	2	612	mana	4	5523	6135	17012
manàrem	2	2	manarem	2	18	20	17013
manàreu	2	0	manareu	2	6	6	17014
manés	2	104	manes	4	211	315	17015
maní	2	39	mani	4	1774	1813	17016
manípul	4	28	manipul	2	4	32	17017
maparà	2	1	mapara	2	0	1	17018
mapà	2	0	mapa	4	154088	154088	17019
mapàrem	2	0	maparem	2	1	1	17020
mapés	2	0	mapes	4	15310	15310	17021
mapí	2	0	mapi	2	127	127	17022
mapó	4	0	mapo	2	4	4	17023
maquetarà	2	4	maquetara	2	0	4	17024
maquetà	2	2	maqueta	4	3985	3987	17025
maquetàrem	2	0	maquetarem	2	6	6	17026
maquetés	2	1	maquetes	4	3305	3306	17027
maquetí	2	0	maqueti	2	5	5	17028
maquillarà	2	13	maquillara	2	1	14	17029
maquillà	2	1	maquilla	2	139	140	17030
maquillàrem	2	1	maquillarem	2	15	16	17031
maquillés	2	3	maquilles	2	11	14	17032
maquillí	2	0	maquilli	2	9	9	17033
maquinarà	2	3	maquinara	2	2	5	17034
maquinà	2	3	maquina	2	915	918	17035
maquinàrem	2	0	maquinarem	2	1	1	17036
maquinària	4	16183	maquinaria	2	1368	17551	17037
maquinàries	4	360	maquinaries	2	25	385	17038
maquinés	2	0	maquines	2	498	498	17039
maquiní	2	1	maquini	2	3	4	17040
maqués	2	7	maques	2	2564	2571	17041
maquí	2	2	maqui	2	346	348	17042
maquín	2	0	maquin	2	8	8	17043
maquís	4	3	maquis	2	1470	1473	17044
marbrà	2	2	marbra	2	2	4	17045
marbrés	2	0	marbres	2	743	743	17046
marcarà	2	3003	marcara	2	38	3041	17047
marcegí	2	0	marcegi	2	2	2	17048
marcejà	2	0	marceja	2	29	29	17049
marcirà	2	17	marcira	2	0	17	17050
marcà	2	1142	marca	4	85717	86859	17051
marcàrem	2	29	marcarem	2	187	216	17052
marcàreu	2	2	marcareu	2	12	14	17053
marcí	2	0	marci	4	102	102	17054
marededéu	4	603	marededeu	4	53	656	17055
marededéus	4	182	marededeus	4	27	209	17056
maregés	2	5	mareges	2	15	20	17057
maregí	2	0	maregi	2	24	24	17058
marejarà	2	3	marejara	2	1	4	17059
marejà	2	3	mareja	2	211	214	17060
marejàrem	2	0	marejarem	2	3	3	17061
marejàreu	2	0	marejareu	2	1	1	17062
marfondré	2	0	marfondre	2	1	1	17063
margalidà	0	20	margalida	4	3184	3204	17064
margenés	2	0	margenes	2	1	1	17065
marginalitzà	2	2	marginalitza	2	5	7	17066
marginarà	2	15	marginara	2	0	15	17067
marginà	2	8	margina	2	311	319	17068
marginàrem	2	0	marginarem	2	3	3	17069
marginàreu	2	0	marginareu	2	2	2	17070
marginés	2	9	margines	2	0	9	17071
marginí	2	0	margini	2	36	36	17072
margués	2	0	margues	4	441	441	17073
margà	2	0	marga	4	2203	2203	17074
maridarà	2	68	maridara	2	1	69	17075
maridà	2	27	marida	2	361	388	17076
maridàrem	2	0	maridarem	2	100	100	17077
maridàreu	2	0	maridareu	2	2	2	17078
maridés	2	9	marides	2	5	14	17079
maridí	2	0	maridi	2	21	21	17080
marinarà	2	0	marinara	2	13	13	17081
marinà	2	0	marina	4	35964	35964	17082
marinàrem	2	1	marinarem	2	8	9	17083
marinés	2	7	marines	4	6061	6068	17084
mariní	2	2	marini	2	161	163	17085
marinís	0	1	marinis	2	25	26	17086
mariscà	2	1	marisca	2	1	2	17087
marmolés	2	0	marmoles	2	4	4	17088
marmoló	0	2	marmolo	2	0	2	17089
marquí	2	2	marqui	2	2122	2124	17090
marradejà	2	0	marradeja	2	1	1	17091
marranejà	2	0	marraneja	2	6	6	17092
marrarà	2	1	marrara	2	1	2	17093
marroquinà	2	0	marroquina	4	1936	1936	17094
marroquinés	2	0	marroquines	4	855	855	17095
marrucà	2	0	marruca	2	1	1	17096
marruquí	2	1	marruqui	2	0	1	17097
marrà	2	139	marra	4	44	183	17098
marrés	2	0	marres	2	104	104	17099
marrí	2	0	marri	2	7	7	17100
martellejà	2	2	martelleja	2	29	31	17101
martiritzarà	2	0	martiritzara	2	1	1	17102
martiritzà	2	3	martiritza	2	41	44	17103
martiritzàrem	2	0	martiritzarem	2	3	3	17104
martiritzí	2	0	martiritzi	2	6	6	17105
marxarà	2	783	marxara	2	17	800	17106
marxà	2	1852	marxa	4	110780	112632	17107
marxàrem	2	36	marxarem	2	572	608	17108
marxàreu	2	0	marxareu	2	30	30	17109
marxés	2	748	marxes	4	4857	5605	17110
marxí	2	2	marxi	2	1151	1153	17111
marés	4	303	mares	4	41301	41604	17112
mascarà	2	1	mascara	4	167	168	17113
mascarés	2	0	mascares	4	125	125	17114
mascarí	2	0	mascari	2	1	1	17115
masculinitzarà	2	2	masculinitzara	2	0	2	17116
masculinitzà	2	0	masculinitza	2	3	3	17117
masegués	2	3	masegues	4	0	3	17118
maseguí	2	0	masegui	2	2	2	17119
masegà	2	0	masega	4	16	16	17120
massacrarà	2	3	massacrara	2	0	3	17121
massacrà	2	7	massacra	2	86	93	17122
massacràreu	2	0	massacrareu	2	1	1	17123
massacrés	2	5	massacres	2	885	890	17124
massacrí	2	0	massacri	2	8	8	17125
massificarà	2	1	massificara	2	0	1	17126
massificà	2	0	massifica	2	40	40	17127
massifiqués	2	1	massifiques	2	0	1	17128
massifiquí	2	0	massifiqui	2	8	8	17129
massillà	2	0	massilla	4	153	153	17130
massillés	2	0	massilles	4	49	49	17131
massissà	2	0	massissa	2	851	851	17132
massissés	2	0	massisses	2	186	186	17133
massissí	2	0	massissi	2	1	1	17134
mastegarà	2	8	mastegara	2	0	8	17135
mastegués	2	8	mastegues	2	21	29	17136
masteguí	2	0	mastegui	2	24	24	17137
mastegà	2	5	mastega	2	157	162	17138
mastegàrem	2	0	mastegarem	2	6	6	17139
mastegàreu	2	0	mastegareu	2	1	1	17140
mastegó	4	0	mastego	2	24	24	17141
masteritzà	2	1	masteritza	2	5	6	17142
masteritzàrem	2	0	masteritzarem	2	1	1	17143
masticà	2	0	mastica	2	1	1	17144
masturbarà	2	1	masturbara	2	2	3	17145
masturbà	2	0	masturba	2	82	82	17146
masturbés	2	7	masturbes	2	11	18	17147
masturbí	2	0	masturbi	2	12	12	17148
matamalès	0	0	matamales	4	41	41	17149
matamalés	0	0	matamales	4	41	41	17150
matamón	4	4	matamon	4	8	12	17151
matarà	2	435	matara	4	70	505	17152
matematitzà	2	0	matematitza	2	2	2	17153
materialitzarà	2	295	materialitzara	2	5	300	17154
materialitzà	2	115	materialitza	2	1313	1428	17155
materialitzàrem	2	0	materialitzarem	2	9	9	17156
materialitzés	2	71	materialitzes	2	6	77	17157
materialitzí	2	0	materialitzi	2	254	254	17158
mateuà	0	0	mateua	4	86	86	17159
matinarà	2	2	matinara	2	0	2	17160
matinejà	2	0	matineja	2	4	4	17161
matinà	2	3	matina	2	81	84	17162
matinàrem	2	1	matinarem	2	16	17	17163
matiné	4	14	matine	2	21	35	17164
matinés	2	7	matines	2	347	354	17165
matiní	2	0	matini	2	2	2	17166
matisarà	2	11	matisara	2	0	11	17167
matisà	2	29	matisa	2	898	927	17168
matisàrem	2	0	matisarem	2	7	7	17169
matisàreu	2	0	matisareu	2	1	1	17170
matisés	2	10	matises	2	8	18	17171
matisí	2	0	matisi	2	23	23	17172
matricularà	2	38	matriculara	2	3	41	17173
matriculà	2	149	matricula	2	1128	1277	17174
matriculàrem	2	1	matricularem	2	11	12	17175
matriculàreu	2	0	matriculareu	2	2	2	17176
matriculés	2	12	matricules	2	227	239	17177
matriculí	2	0	matriculi	2	105	105	17178
matrícula	4	16036	matricula	2	1128	17164	17179
matrícules	4	2027	matricules	2	227	2254	17180
matxucarà	2	1	matxucara	2	0	1	17181
matxucà	2	0	matxuca	2	19	19	17182
matxucàrem	2	0	matxucarem	2	1	1	17183
matxuqués	2	0	matxuques	2	1	1	17184
matxuquí	2	0	matxuqui	2	1	1	17185
matxó	4	13	matxo	4	232	245	17186
matà	2	479	mata	4	12642	13121	17187
matàrem	2	1	matarem	2	152	153	17188
matàreu	2	1	matareu	2	33	34	17189
matés	2	285	mates	4	2615	2900	17190
matí	2	149534	mati	2	4522	154056	17191
matín	2	11	matin	2	488	499	17192
matís	2	1881	matis	2	213	2094	17193
maulà	2	0	maula	4	78	78	17194
maulés	2	0	maules	4	11	11	17195
maulí	2	2	mauli	2	0	2	17196
maurà	2	9	maura	4	1045	1054	17197
maurés	2	0	maures	4	48	48	17198
maximitzarà	2	16	maximitzara	2	0	16	17199
maximitzà	2	1	maximitza	2	348	349	17200
maximitzàrem	2	0	maximitzarem	2	7	7	17201
maximitzàreu	2	0	maximitzareu	2	1	1	17202
maximitzés	2	8	maximitzes	2	2	10	17203
maximitzí	2	0	maximitzi	2	87	87	17204
maçolà	2	0	maçola	4	4	4	17205
maçolés	2	1	maçoles	4	8	9	17206
maçonà	2	0	maçona	2	26	26	17207
maçonés	2	0	maçones	2	16	16	17208
mecanitzarà	2	2	mecanitzara	2	1	3	17209
mecanitzà	2	45	mecanitza	2	33	78	17210
mecanitzés	2	2	mecanitzes	2	0	2	17211
mecanitzí	2	0	mecanitzi	2	6	6	17212
mecanografià	2	0	mecanografia	4	433	433	17213
mecanografiés	2	2	mecanografies	4	4	6	17214
mediarà	2	19	mediara	2	4	23	17215
mediatitzarà	2	2	mediatitzara	2	0	2	17216
mediatitzà	2	0	mediatitza	2	27	27	17217
mediatitzí	2	0	mediatitzi	2	2	2	17218
medicalitzà	2	0	medicalitza	2	14	14	17219
medicà	2	1	medica	2	296	297	17220
medinès	0	1	medines	4	48	49	17221
medinés	0	0	medines	4	48	48	17222
mediqués	2	0	mediques	2	115	115	17223
mediquí	2	0	mediqui	2	5	5	17224
meditarà	2	2	meditara	2	1	3	17225
medità	2	10	medita	2	254	264	17226
meditàrem	2	0	meditarem	2	12	12	17227
medités	2	5	medites	2	16	21	17228
medití	2	0	mediti	2	27	27	17229
medià	2	42	media	2	7659	7701	17230
mediàrem	2	0	mediarem	2	4	4	17231
mediàs	2	0	medias	4	76	76	17232
mediés	2	13	medies	2	4	17	17233
medií	2	3	medii	2	29	32	17234
medrarà	2	1	medrara	2	0	1	17235
medrí	2	0	medri	2	2	2	17236
medís	4	20	medis	4	3617	3637	17237
melarà	2	0	melara	2	4	4	17238
melindrejarà	2	1	melindrejara	2	0	1	17239
melindrós	0	21	melindros	4	610	631	17240
mel·lificà	2	0	mel·lifica	2	1	1	17241
mel·lífic	0	1	mel·lific	2	0	1	17242
mel·lífica	0	0	mel·lifica	2	1	1	17243
melà	2	8	mela	2	218	226	17244
melé	4	545	mele	2	31	576	17245
melés	2	75	meles	2	124	199	17246
melí	2	1	meli	2	96	97	17247
meló	4	2138	melo	2	426	2564	17248
membrà	2	1	membra	2	47	48	17249
membrés	2	2	membres	2	238797	238799	17250
membrí	2	0	membri	2	3	3	17251
memorarà	2	2	memorara	2	0	2	17252
memoritzarà	2	4	memoritzara	2	0	4	17253
memoritzà	2	4	memoritza	2	244	248	17254
memoritzàreu	2	0	memoritzareu	2	1	1	17255
memoritzés	2	2	memoritzes	2	13	15	17256
memoritzí	2	0	memoritzi	2	22	22	17257
memorà	2	0	memora	2	34	34	17258
memorés	2	0	memores	2	3	3	17259
memorí	2	0	memori	2	53	53	17260
menarà	2	169	menara	2	65	234	17261
mencionarà	2	11	mencionara	2	4	15	17262
mencionà	2	67	menciona	2	1575	1642	17263
mencionàrem	2	2	mencionarem	2	30	32	17264
mencionés	2	21	menciones	2	130	151	17265
mencioní	2	4	mencioni	2	79	83	17266
mendicà	2	0	mendica	2	2	2	17267
menegés	2	0	meneges	2	3	3	17268
menejarà	2	1	menejara	2	4	5	17269
menejà	2	1	meneja	2	35	36	17270
menejàrem	2	0	menejarem	2	2	2	17271
menejó	4	0	menejo	2	1	1	17272
mengés	2	245	menges	4	1908	2153	17273
mengí	2	3	mengi	2	934	937	17274
menjarà	2	400	menjara	2	23	423	17275
menjotejà	2	0	menjoteja	2	1	1	17276
menjucà	2	0	menjuca	2	4	4	17277
menjucàrem	2	0	menjucarem	2	1	1	17278
menjussà	2	0	menjussa	4	4	4	17279
menjussés	2	0	menjusses	4	1	1	17280
menjà	2	116	menja	4	8999	9115	17281
menjàrem	2	46	menjarem	2	746	792	17282
menjàreu	2	0	menjareu	2	192	192	17283
menstruà	2	0	menstrua	2	10	10	17284
menstruàrem	2	0	menstruarem	2	1	1	17285
menstrués	2	1	menstrues	2	1	2	17286
mentalitzà	2	0	mentalitza	2	32	32	17287
mentalitzés	2	1	mentalitzes	2	3	4	17288
mentalitzí	2	0	mentalitzi	2	7	7	17289
mentirà	2	21	mentira	2	429	450	17290
mentoritzarà	2	2	mentoritzara	2	0	2	17291
mentoritzà	2	0	mentoritza	2	3	3	17292
mentorà	2	0	mentora	4	251	251	17293
mentorés	2	0	mentores	4	197	197	17294
mentà	4	0	menta	4	3027	3027	17295
mentí	2	12	menti	2	9	21	17296
mentírem	2	0	mentirem	2	11	11	17297
mentíreu	2	0	mentireu	2	1	1	17298
mentís	2	37	mentis	2	25	62	17299
mentó	4	272	mento	2	24	296	17300
menyscabarà	2	12	menyscabara	2	0	12	17301
menyscabà	2	0	menyscaba	2	107	107	17302
menyscabàrem	2	0	menyscabarem	2	1	1	17303
menyscabés	2	5	menyscabes	2	0	5	17304
menyscabí	2	1	menyscabi	2	42	43	17305
menyscreuré	2	0	menyscreure	2	4	4	17306
menysprearà	2	17	menyspreara	2	2	19	17307
menyspreà	2	21	menysprea	2	1086	1107	17308
menyspreàrem	2	1	menysprearem	2	4	5	17309
menyspreàreu	2	1	menyspreareu	2	4	5	17310
menyspreés	2	19	menysprees	2	25	44	17311
menyspreí	2	0	menysprei	2	14	14	17312
menystindré	2	5	menystindre	2	15	20	17313
menystingués	2	13	menystingues	2	4	17	17314
menystinguí	2	0	menystingui	2	86	86	17315
menysvalorà	2	1	menysvalora	2	19	20	17316
menysvaloràrem	2	0	menysvalorarem	2	1	1	17317
menysvalorés	2	1	menysvalores	2	4	5	17318
menysvalorí	2	0	menysvalori	2	3	3	17319
menà	2	175	mena	4	96327	96502	17320
menàrem	2	2	menarem	2	1	3	17321
menàreu	2	0	menareu	2	1	1	17322
menés	2	12	menes	4	1134	1146	17323
mení	2	3	meni	2	125	128	17324
mequinensà	0	36	mequinensa	4	1017	1053	17325
meravellarà	2	46	meravellara	2	0	46	17326
meravellà	2	25	meravella	4	6550	6575	17327
meravellàrem	2	1	meravellarem	2	11	12	17328
meravellàreu	2	0	meravellareu	2	6	6	17329
meravellés	2	3	meravelles	4	5516	5519	17330
meravellí	2	0	meravelli	2	14	14	17331
mercadegés	2	2	mercadeges	2	0	2	17332
mercadegí	2	0	mercadegi	2	3	3	17333
mercadejà	2	2	mercadeja	2	31	33	17334
mercadejàrem	2	1	mercadejarem	2	2	3	17335
mercantilitzà	2	0	mercantilitza	2	62	62	17336
mercantilitzí	2	0	mercantilitzi	2	2	2	17337
mereixérem	2	1	mereixerem	2	24	25	17338
mereixéreu	2	0	mereixereu	2	3	3	17339
mereixés	2	48	mereixes	2	808	856	17340
mereixí	2	1	mereixi	2	658	659	17341
meresqués	2	15	meresques	2	0	15	17342
meresquí	2	0	meresqui	2	8	8	17343
meritarà	2	40	meritara	2	0	40	17344
merità	2	0	merita	4	138	138	17345
meritàrem	2	0	meritarem	2	1	1	17346
meritàreu	2	1	meritareu	2	0	1	17347
merités	2	2	merites	4	4	6	17348
merití	2	0	meriti	2	30	30	17349
merletés	2	0	merletes	4	3	3	17350
mesarà	2	1	mesara	2	2	3	17351
mesclarà	2	37	mesclara	2	1	38	17352
mesclà	2	9	mescla	4	9536	9545	17353
mesclàrem	2	0	mesclarem	2	126	126	17354
mesclàreu	2	0	mesclareu	2	1	1	17355
mesclés	2	4	mescles	4	1583	1587	17356
mesclí	2	0	mescli	2	31	31	17357
mesquinejàrem	2	0	mesquinejarem	2	1	1	17358
mestallà	2	0	mestalla	4	2257	2257	17359
mestissà	2	0	mestissa	4	457	457	17360
mestissés	2	0	mestisses	4	98	98	17361
mestrejà	2	0	mestreja	2	4	4	17362
mesturà	2	0	mestura	4	73	73	17363
mesturàreu	2	0	mesturareu	2	1	1	17364
mesturés	2	0	mestures	4	1	1	17365
mesurarà	2	348	mesurara	2	4	352	17366
mesurà	2	69	mesura	4	103758	103827	17367
mesuràrem	2	5	mesurarem	2	80	85	17368
mesurés	2	35	mesures	4	141988	142023	17369
mesurí	2	0	mesuri	2	170	170	17370
mesuró	4	8	mesuro	2	59	67	17371
mesà	2	0	mesa	4	17527	17527	17372
mesè	0	0	mese	2	46	46	17373
mesé	0	0	mese	2	46	46	17374
mesés	2	1	meses	4	2968	2969	17375
mesí	2	1	mesi	2	60	61	17376
mesó	4	93	meso	2	89	182	17377
metabolitzarà	2	2	metabolitzara	2	0	2	17378
metabolitzà	2	0	metabolitza	2	104	104	17379
metabolitzàrem	2	0	metabolitzarem	2	1	1	17380
metabolitzés	2	1	metabolitzes	2	0	1	17381
metabolitzí	2	0	metabolitzi	2	8	8	17382
metaforitzà	2	0	metaforitza	2	7	7	17383
metaforitzàrem	2	0	metaforitzarem	2	1	1	17384
metaforitzí	2	0	metaforitzi	2	2	2	17385
metal·litzàreu	2	1	metal·litzareu	2	0	1	17386
metamorfitzà	2	1	metamorfitza	2	1	2	17387
metamorfosegí	2	0	metamorfosegi	2	1	1	17388
metamorfosejà	2	1	metamorfoseja	2	5	6	17389
metamorfosà	2	6	metamorfosa	2	29	35	17390
metamorfosí	2	0	metamorfosi	2	1538	1538	17391
metastatitzà	2	0	metastatitza	2	1	1	17392
meteoritzà	2	0	meteoritza	2	2	2	17393
meteoritzí	2	0	meteoritzi	2	1	1	17394
metgés	2	0	metges	4	24000	24000	17395
metilà	2	0	metila	2	4	4	17396
metilàrem	2	1	metilarem	2	0	1	17397
metilè	4	66	metile	2	0	66	17398
metilé	4	3	metile	2	0	3	17399
metjà	2	1	metja	2	8	9	17400
metoditzà	2	0	metoditza	2	3	3	17401
metrallà	2	4	metralla	4	574	578	17402
metrallés	2	0	metralles	4	2	2	17403
metropolità	0	6284	metropolita	4	74	6358	17404
metré	2	0	metre	4	9677	9677	17405
metà	4	1474	meta	4	11062	12536	17406
metés	2	2	metes	4	2765	2767	17407
metí	2	8	meti	2	23	31	17408
mexicà	0	4103	mexica	0	69	4172	17409
micorrizà	2	0	micorriza	4	13	13	17410
micorrizés	2	0	micorrizes	4	24	24	17411
microcirurgià	4	2	microcirurgia	4	191	193	17412
microfilmarà	2	0	microfilmara	2	1	1	17413
microfilmàrem	2	0	microfilmarem	2	1	1	17414
microinjectà	2	0	microinjecta	2	2	2	17415
micronitzà	2	0	micronitza	2	1	1	17416
micró	4	29	micro	4	4005	4034	17417
micètoma	4	0	micetoma	4	2	2	17418
micètomes	4	0	micetomes	4	2	2	17419
midarà	2	1	midara	2	0	1	17420
midà	2	0	mida	4	55441	55441	17421
midés	2	0	mides	4	11752	11752	17422
midí	2	17	midi	4	1577	1594	17423
midó	4	1548	mido	2	46	1594	17424
migpartirà	2	1	migpartira	2	0	1	17425
migpartírem	2	1	migpartirem	2	0	1	17426
migrarà	2	11	migrara	2	1	12	17427
migrà	2	13	migra	2	445	458	17428
migràrem	2	0	migrarem	2	6	6	17429
migràreu	2	0	migrareu	2	1	1	17430
migrés	2	2	migres	2	24	26	17431
migrí	2	0	migri	2	13	13	17432
milanès	0	239	milanes	4	106	345	17433
milanés	0	105	milanes	4	106	211	17434
militaritzarà	2	6	militaritzara	2	0	6	17435
militaritzà	2	3	militaritza	2	15	18	17436
militaritzés	2	1	militaritzes	2	0	1	17437
militaritzí	2	0	militaritzi	2	4	4	17438
militarà	2	177	militara	2	7	184	17439
milità	2	1443	milita	2	1063	2506	17440
militàrem	2	2	militarem	2	3	5	17441
militàreu	2	1	militareu	2	0	1	17442
milités	2	25	milites	2	44	69	17443
milití	2	0	militi	2	33	33	17444
millarès	4	3	millares	4	137	140	17445
millarés	4	0	millares	4	137	137	17446
millorarà	2	3481	millorara	2	40	3521	17447
millorà	2	305	millora	4	108830	109135	17448
milloràrem	2	8	millorarem	2	612	620	17449
milloràreu	2	0	millorareu	2	27	27	17450
millorés	2	275	millores	4	27783	28058	17451
millorí	2	1	millori	2	2877	2878	17452
mimarà	2	6	mimara	2	1	7	17453
mimetitzarà	2	2	mimetitzara	2	0	2	17454
mimetitzà	2	0	mimetitza	2	97	97	17455
mimetitzés	2	0	mimetitzes	2	1	1	17456
mimetitzí	2	0	mimetitzi	2	10	10	17457
mimà	2	0	mima	2	414	414	17458
mimàrem	2	0	mimarem	2	9	9	17459
mimàreu	2	0	mimareu	2	1	1	17460
mimés	2	2	mimes	2	22	24	17461
mimí	2	167	mimi	2	359	526	17462
minarà	2	32	minara	2	0	32	17463
mineralitzà	2	0	mineralitza	2	11	11	17464
mineralitzés	2	1	mineralitzes	2	0	1	17465
mineralitzí	2	0	mineralitzi	2	1	1	17466
miniarà	2	0	miniara	2	1	1	17467
miniaturarà	2	1	miniaturara	2	0	1	17468
miniaturitzarà	2	2	miniaturitzara	2	0	2	17469
miniaturitzà	2	0	miniaturitza	2	1	1	17470
miniaturitzés	2	0	miniaturitzes	2	1	1	17471
miniaturà	2	0	miniatura	4	2880	2880	17472
miniaturés	2	0	miniatures	4	2146	2146	17473
minimitzarà	2	74	minimitzara	2	1	75	17474
minimitzà	2	2	minimitza	2	986	988	17475
minimitzàrem	2	0	minimitzarem	2	22	22	17476
minimitzàreu	2	0	minimitzareu	2	2	2	17477
minimitzés	2	16	minimitzes	2	13	29	17478
minimitzí	2	0	minimitzi	2	199	199	17479
ministrà	2	0	ministra	2	10520	10520	17480
ministrés	2	0	ministres	2	18455	18455	17481
ministrí	2	0	ministri	2	5	5	17482
minià	2	0	minia	2	25	25	17483
miniés	2	0	minies	2	5	5	17484
minorarà	2	15	minorara	2	1	16	17485
minoritzà	2	0	minoritza	2	13	13	17486
minoritzés	2	1	minoritzes	2	0	1	17487
minorà	2	0	minora	2	50	50	17488
minorés	2	2	minores	2	15	17	17489
minorí	2	0	minori	2	38	38	17490
minutarà	2	2	minutara	2	0	2	17491
minutà	2	0	minuta	4	328	328	17492
minutés	2	0	minutes	4	1144	1144	17493
minutí	2	0	minuti	2	20	20	17494
minvarà	2	110	minvara	2	2	112	17495
minvà	2	113	minva	4	1465	1578	17496
minvàrem	2	0	minvarem	2	4	4	17497
minvés	2	40	minves	4	170	210	17498
minví	2	0	minvi	2	109	109	17499
minyonejà	2	0	minyoneja	2	2	2	17500
minà	2	17	mina	4	10404	10421	17501
minàrem	2	0	minarem	2	2	2	17502
minés	2	10	mines	4	10182	10192	17503
miní	2	14	mini	2	10054	10068	17504
miolà	2	1	miola	2	48	49	17505
miolàreu	2	0	miolareu	2	1	1	17506
miolés	2	1	mioles	2	0	1	17507
miolí	2	0	mioli	2	5	5	17508
mirarà	2	872	mirara	2	45	917	17509
mirmídons	0	11	mirmidons	4	10	21	17510
mirotejà	2	1	miroteja	2	0	1	17511
mirotejàreu	2	1	mirotejareu	2	0	1	17512
mirrà	2	0	mirra	4	359	359	17513
mirràrem	2	0	mirrarem	2	1	1	17514
mirrés	2	0	mirres	4	1	1	17515
mirrí	2	0	mirri	2	41	41	17516
mirà	2	621	mira	4	38423	39044	17517
miràrem	2	42	mirarem	2	1683	1725	17518
miràreu	2	2	mirareu	2	72	74	17519
mirés	2	460	mires	4	4808	5268	17520
mirí	2	3	miri	2	3931	3934	17521
missionà	2	0	missiona	2	1	1	17522
missionés	2	0	missiones	2	7	7	17523
missioní	2	0	missioni	2	1	1	17524
missà	2	0	missa	4	18712	18712	17525
missés	2	0	misses	4	2510	2510	17526
missí	2	0	missi	2	45	45	17527
mistificà	2	0	mistifica	2	10	10	17528
mistifiquí	2	0	mistifiqui	2	1	1	17529
misàntrop	0	33	misantrop	0	151	184	17530
misàntropa	0	2	misantropa	0	10	12	17531
misàntropes	0	1	misantropes	0	0	1	17532
misàntrops	0	2	misantrops	0	10	12	17533
mitificarà	2	4	mitificara	2	0	4	17534
mitificà	2	3	mitifica	2	48	51	17535
mitificàrem	2	0	mitificarem	2	2	2	17536
mitifiqués	2	1	mitifiques	2	4	5	17537
mitifiquí	2	0	mitifiqui	2	3	3	17538
mitigarà	2	20	mitigara	2	0	20	17539
mitigués	2	5	mitigues	2	1	6	17540
mitiguí	2	0	mitigui	2	27	27	17541
mitigà	2	8	mitiga	2	113	121	17542
mitigàrem	2	0	mitigarem	2	1	1	17543
mitjancés	2	3	mitjances	2	0	3	17544
mitjancí	2	0	mitjanci	2	3	3	17545
mitjanà	2	1	mitjana	4	76848	76849	17546
mitjançarà	2	3	mitjançara	2	1	4	17547
mitjançà	2	70	mitjança	2	51	121	17548
mitjanés	2	0	mitjanes	4	14290	14290	17549
mitjaní	2	0	mitjani	2	1	1	17550
mitrà	2	0	mitra	4	548	548	17551
mitrés	2	0	mitres	4	24	24	17552
mitrí	2	0	mitri	2	2	2	17553
miulà	2	0	miula	4	7	7	17554
miulés	2	0	miules	4	5	5	17555
mixturà	2	1	mixtura	4	262	263	17556
mixturés	2	0	mixtures	4	60	60	17557
mobilitzarà	2	266	mobilitzara	2	2	268	17558
mobilitzà	2	86	mobilitza	2	1226	1312	17559
mobilitzàrem	2	1	mobilitzarem	2	78	79	17560
mobilitzàreu	2	1	mobilitzareu	2	0	1	17561
mobilitzés	2	44	mobilitzes	2	17	61	17562
mobilitzí	2	1	mobilitzi	2	291	292	17563
moblarà	2	1	moblara	2	0	1	17564
moblà	2	0	mobla	2	12	12	17565
moblés	2	0	mobles	2	14288	14288	17566
moblí	2	0	mobli	2	2	2	17567
mocarà	2	3	mocara	2	1	4	17568
mocà	2	1	moca	4	136	137	17569
mocàrem	2	0	mocarem	2	1	1	17570
modalitzà	2	0	modalitza	2	1	1	17571
modelarà	2	30	modelara	2	0	30	17572
modelitzarà	2	2	modelitzara	2	0	2	17573
modelitzà	2	1	modelitza	2	28	29	17574
modelitzàreu	2	1	modelitzareu	2	0	1	17575
modelitzí	2	0	modelitzi	2	3	3	17576
modelà	2	28	modela	2	532	560	17577
modelàrem	2	0	modelarem	2	20	20	17578
modelàreu	2	0	modelareu	2	2	2	17579
modelés	2	6	modeles	2	10	16	17580
modelí	2	0	modeli	2	28	28	17581
moderarà	2	487	moderara	2	1	488	17582
modernitzarà	2	61	modernitzara	2	1	62	17583
modernitzà	2	35	modernitza	2	275	310	17584
modernitzàrem	2	0	modernitzarem	2	12	12	17585
modernitzés	2	10	modernitzes	2	7	17	17586
modernitzí	2	0	modernitzi	2	35	35	17587
moderà	2	24	modera	2	798	822	17588
moderàrem	2	0	moderarem	2	2	2	17589
moderés	2	27	moderes	2	5	32	17590
moderí	2	0	moderi	2	68	68	17591
modificarà	2	1077	modificara	2	17	1094	17592
modificà	2	304	modifica	2	9943	10247	17593
modificàrem	2	3	modificarem	2	141	144	17594
modificàreu	2	0	modificareu	2	6	6	17595
modifiqués	2	230	modifiques	2	81	311	17596
modifiquí	2	0	modifiqui	2	1236	1236	17597
modularà	2	14	modulara	2	0	14	17598
modulà	2	3	modula	2	292	295	17599
modulàrem	2	0	modularem	2	4	4	17600
modulés	2	2	modules	2	64	66	17601
modulí	2	0	moduli	2	20	20	17602
mofà	2	1	mofa	4	586	587	17603
mofés	2	5	mofes	4	85	90	17604
mofí	2	0	mofi	2	4	4	17605
mogués	2	293	mogues	4	17	310	17606
moguí	2	0	mogui	2	1343	1343	17607
moianés	0	29	moianes	4	41	70	17608
molarà	2	22	molara	2	5	27	17609
moldré	2	3	moldre	2	988	991	17610
molestarà	2	134	molestara	2	18	152	17611
molestà	2	30	molesta	0	4606	4636	17612
molestàrem	2	0	molestarem	2	16	16	17613
molestàreu	2	0	molestareu	2	3	3	17614
molestés	2	114	molestes	0	746	860	17615
molestí	2	0	molesti	2	650	650	17616
molestós	0	6	molestos	0	1003	1009	17617
molgués	2	3	molgues	2	0	3	17618
molinarà	2	1	molinara	2	1	2	17619
molinà	2	8	molina	4	8823	8831	17620
molinés	2	2	molines	4	374	376	17621
moliní	2	11	molini	2	6	17	17622
mollegés	2	0	molleges	2	1	1	17623
mollejà	2	0	molleja	2	6	6	17624
molletà	0	246	molleta	4	19	265	17625
moltonejà	2	0	moltoneja	2	1	1	17626
molturà	2	3	moltura	4	43	46	17627
molturés	2	2	moltures	4	5	7	17628
molturí	2	0	molturi	2	1	1	17629
mol·lificà	2	0	mol·lifica	2	1	1	17630
mol·lifiquí	2	0	mol·lifiqui	2	1	1	17631
mol·lisòl	4	0	mol·lisol	4	1	1	17632
mol·lisòls	4	3	mol·lisols	4	0	3	17633
molà	2	9	mola	4	6861	6870	17634
molàreu	2	1	molareu	2	0	1	17635
molés	2	125	moles	4	2127	2252	17636
molín	2	2	molin	2	40	42	17637
moló	4	12	molo	2	56	68	17638
momificarà	2	1	momificara	2	0	1	17639
momificà	2	0	momifica	2	5	5	17640
momificàrem	2	0	momificarem	2	1	1	17641
momifiquí	2	0	momifiqui	2	1	1	17642
monedà	2	0	moneda	4	20107	20107	17643
monedés	2	0	monedes	4	9511	9511	17644
monedí	2	0	monedi	2	1	1	17645
monetaritzà	2	0	monetaritza	2	3	3	17646
monetitzà	2	0	monetitza	2	16	16	17647
monetitzàreu	2	0	monetitzareu	2	1	1	17648
monetitzés	2	1	monetitzes	2	0	1	17649
monetitzí	2	0	monetitzi	2	2	2	17650
monitorarà	2	11	monitorara	2	0	11	17651
monitorà	2	1	monitora	4	1899	1900	17652
monitoràrem	2	0	monitorarem	2	1	1	17653
monitorés	2	0	monitores	4	2347	2347	17654
monitorí	2	0	monitori	2	110	110	17655
monjoià	2	0	monjoia	4	31	31	17656
monjoiés	2	0	monjoies	4	21	21	17657
monjoí	2	0	monjoi	2	8	8	17658
monoftongà	2	0	monoftonga	2	2	2	17659
monologués	2	0	monologues	2	6	6	17660
monologà	2	0	monologa	2	10	10	17661
monopolitzarà	2	3	monopolitzara	2	0	3	17662
monopolitzà	2	12	monopolitza	2	141	153	17663
monopolitzés	2	11	monopolitzes	2	0	11	17664
monopolitzí	2	0	monopolitzi	2	42	42	17665
monotonitzà	2	0	monotonitza	2	1	1	17666
montgaí	0	0	montgai	4	859	859	17667
monumentalitzà	2	1	monumentalitza	2	6	7	17668
monumentalitzí	2	0	monumentalitzi	2	1	1	17669
monyó	4	60	monyo	4	429	489	17670
moquejà	2	0	moqueja	2	3	3	17671
moqués	2	3	moques	4	14	17	17672
moquí	2	0	moqui	2	14	14	17673
moquís	4	0	moquis	2	1	1	17674
moragués	2	0	moragues	4	1667	1667	17675
moragà	2	0	moraga	4	57	57	17676
moralitzà	2	0	moralitza	2	19	19	17677
moralitzés	2	1	moralitzes	2	0	1	17678
moralitzí	2	0	moralitzi	2	1	1	17679
morbós	0	238	morbos	4	15	253	17680
morcà	2	0	morca	4	35	35	17681
morcàreu	2	1	morcareu	2	0	1	17682
morellanès	0	0	morellanes	0	106	106	17683
morellanés	0	0	morellanes	0	106	106	17684
morfinà	2	0	morfina	4	437	437	17685
morfinés	2	0	morfines	4	3	3	17686
morfíreu	2	0	morfireu	2	1	1	17687
morfó	4	0	morfo	4	23	23	17688
morirà	2	1274	morira	2	64	1338	17689
mormolà	2	7	mormola	2	21	28	17690
mormolés	2	0	mormoles	2	2	2	17691
mormà	2	0	morma	4	8	8	17692
mormés	2	0	mormes	4	1	1	17693
mormó	0	160	mormo	2	3	163	17694
morqués	2	0	morques	4	21	21	17695
morquí	2	9	morqui	4	1	10	17696
morregí	2	0	morregi	2	2	2	17697
morrejarà	2	0	morrejara	2	1	1	17698
morrejà	2	0	morreja	2	4	4	17699
morró	4	26	morro	4	2331	2357	17700
mortificarà	2	2	mortificara	2	0	2	17701
mortificà	2	1	mortifica	2	30	31	17702
mortificàrem	2	0	mortificarem	2	1	1	17703
mortifiqués	2	1	mortifiques	2	0	1	17704
mortifiquí	2	0	mortifiqui	2	5	5	17705
morí	2	5991	mori	4	2257	8248	17706
morírem	2	1	morirem	2	402	403	17707
moríreu	2	2	morireu	2	63	65	17708
morís	2	976	moris	2	206	1182	17709
morós	0	149	moros	0	6764	6913	17710
moscà	2	1	mosca	4	2776	2777	17711
mosquejà	2	0	mosqueja	2	20	20	17712
mosqués	2	0	mosques	4	2426	2426	17713
mosquí	2	0	mosqui	2	16	16	17714
mossegarà	2	40	mossegara	2	1	41	17715
mossegués	2	31	mossegues	4	41	72	17716
mosseguí	2	3	mossegui	2	115	118	17717
mossegà	2	25	mossega	4	929	954	17718
mossegàrem	2	0	mossegarem	2	3	3	17719
mossó	0	5	mosso	4	1858	1863	17720
mostassà	4	8	mostassa	4	1719	1727	17721
mostatxó	4	1	mostatxo	4	55	56	17722
mostrarà	2	6881	mostrara	2	64	6945	17723
mostrejarà	2	4	mostrejara	2	0	4	17724
mostrejà	2	1	mostreja	2	17	18	17725
mostrejàrem	2	0	mostrejarem	2	1	1	17726
mostrà	2	1952	mostra	4	168765	170717	17727
mostràrem	2	25	mostrarem	2	1013	1038	17728
mostràreu	2	3	mostrareu	2	18	21	17729
mostrés	2	651	mostres	4	21954	22605	17730
mostrí	2	4	mostri	2	2911	2915	17731
mostós	0	8	mostos	4	176	184	17732
motegí	2	0	motegi	2	94	94	17733
motivarà	2	193	motivara	2	5	198	17734
motivà	2	405	motiva	0	3092	3497	17735
motivàrem	2	0	motivarem	2	23	23	17736
motivàreu	2	1	motivareu	2	1	2	17737
motivés	2	67	motives	0	29	96	17738
motiví	2	0	motivi	2	454	454	17739
motllurà	2	0	motllura	4	1202	1202	17740
motllurés	2	0	motllures	4	1285	1285	17741
motlurarà	2	1	motlurara	2	0	1	17742
motlurà	2	0	motlura	4	14	14	17743
motlurés	2	0	motlures	4	30	30	17744
motoritzà	2	1	motoritza	2	4	5	17745
mouré	2	62	moure	2	28757	28819	17746
mudarà	2	25	mudara	2	1	26	17747
mudà	2	94	muda	2	2052	2146	17748
mudàrem	2	8	mudarem	2	8	16	17749
mudés	2	20	mudes	2	640	660	17750
mudí	2	0	mudi	2	29	29	17751
mufà	2	0	mufa	2	4	4	17752
mugíreu	2	0	mugireu	2	1	1	17753
mullarà	2	40	mullara	2	2	42	17754
mullerà	2	1	mullera	2	79	80	17755
mullerés	2	0	mulleres	2	193	193	17756
mullà	2	21	mulla	4	1426	1447	17757
mullàrem	2	0	mullarem	2	75	75	17758
mullàreu	2	0	mullareu	2	10	10	17759
mullés	2	36	mulles	4	54	90	17760
mullí	2	0	mulli	2	188	188	17761
multarà	2	82	multara	2	0	82	17762
multicopià	2	1	multicopia	2	0	1	17763
multicopiàreu	2	0	multicopiareu	2	1	1	17764
multicòpia	4	6	multicopia	2	0	6	17765
multicòpies	4	2	multicopies	2	0	2	17766
multiplexà	2	0	multiplexa	2	6	6	17767
multiplexés	2	0	multiplexes	2	2	2	17768
multiplicarà	2	233	multiplicara	2	6	239	17769
multiplicà	2	64	multiplica	2	2162	2226	17770
multiplicàrem	2	0	multiplicarem	2	18	18	17771
multiplicàreu	2	0	multiplicareu	2	2	2	17772
multipliqués	2	25	multipliques	2	34	59	17773
multipliquí	2	0	multipliqui	2	139	139	17774
multà	2	9	multa	4	7068	7077	17775
multàrem	2	0	multarem	2	2	2	17776
multés	2	13	multes	4	5358	5371	17777
multí	2	1	multi	2	1433	1434	17778
mundà	2	241	munda	2	96	337	17779
mundés	2	0	mundes	2	7	7	17780
mundí	2	2	mundi	2	903	905	17781
municionà	2	0	municiona	2	1	1	17782
municionés	2	0	municiones	2	5	5	17783
municipalitzarà	2	2	municipalitzara	2	0	2	17784
municipalitzà	2	0	municipalitza	2	11	11	17785
municipalitzàrem	2	0	municipalitzarem	2	2	2	17786
municipalitzés	2	3	municipalitzes	2	1	4	17787
municipalitzí	2	0	municipalitzi	2	14	14	17788
munirà	2	0	munira	2	3	3	17789
muntanyejà	2	0	muntanyeja	2	1	1	17790
muntanyejàrem	2	0	muntanyejarem	2	1	1	17791
muntanyejàreu	2	0	muntanyejareu	2	1	1	17792
muntanyès	0	61	muntanyes	4	32779	32840	17793
muntanyés	0	12	muntanyes	4	32779	32791	17794
muntarà	2	557	muntara	2	7	564	17795
muntà	2	328	munta	4	2227	2555	17796
muntàrem	2	34	muntarem	2	536	570	17797
muntàreu	2	0	muntareu	2	13	13	17798
muntès	0	1	muntes	4	128	129	17799
muntés	2	76	muntes	4	128	204	17800
muntí	2	1	munti	2	151	152	17801
munyirà	2	0	munyira	2	1	1	17802
munyí	2	0	munyi	2	1	1	17803
munyírem	2	0	munyirem	2	3	3	17804
munyís	2	2	munyis	2	1	3	17805
muní	2	12	muni	4	152	164	17806
murallà	2	0	muralla	4	10841	10841	17807
murallés	2	0	muralles	4	7624	7624	17808
murarà	2	0	murara	2	5	5	17809
murgonà	2	1	murgona	2	0	1	17810
murmurarà	2	5	murmurara	2	0	5	17811
murmurejà	2	1	murmureja	2	1	2	17812
murmurà	2	46	murmura	2	131	177	17813
murmuràreu	2	0	murmurareu	2	1	1	17814
murmurés	2	4	murmures	2	13	17	17815
murmurí	2	1	murmuri	2	540	541	17816
murrí	0	0	murri	0	678	678	17817
murà	2	55	mura	4	1292	1347	17818
murés	2	0	mures	4	28	28	17819
murí	2	31	muri	2	40	71	17820
muró	4	12	muro	4	3274	3286	17821
musarà	2	0	musara	2	10	10	17822
musclejà	2	1	muscleja	2	1	2	17823
museïtzarà	2	4	museïtzara	2	0	4	17824
museïtzà	2	1	museïtza	2	3	4	17825
museïtzés	2	1	museïtzes	2	0	1	17826
museïtzí	2	0	museïtzi	2	3	3	17827
musicarà	2	7	musicara	2	2	9	17828
musicà	2	53	musica	2	4120	4173	17829
musicàrem	2	1	musicarem	2	3	4	17830
musiqués	2	5	musiques	2	159	164	17831
musiquí	2	0	musiqui	2	4	4	17832
mussità	2	4	mussita	2	10	14	17833
mussitàrem	2	0	mussitarem	2	1	1	17834
mussitàreu	2	1	mussitareu	2	0	1	17835
mustigà	2	1	mustiga	2	0	1	17836
mustià	2	0	mustia	2	6	6	17837
mustiés	2	0	musties	2	5	5	17838
musà	2	13	musa	4	2625	2638	17839
musés	2	0	muses	4	1194	1194	17840
musí	2	3	musi	2	49	52	17841
mutarà	2	16	mutara	2	21	37	17842
mutilarà	2	3	mutilara	2	0	3	17843
mutilà	2	13	mutila	2	59	72	17844
mutilàreu	2	0	mutilareu	2	1	1	17845
mutilés	2	1	mutiles	2	3	4	17846
mutilí	2	0	mutili	2	5	5	17847
mutualitzà	2	0	mutualitza	2	1	1	17848
mutualitzí	2	0	mutualitzi	2	1	1	17849
mutà	2	4	muta	2	192	196	17850
mutés	2	5	mutes	2	7	12	17851
mutí	2	0	muti	2	173	173	17852
mutó	4	0	muto	2	23	23	17853
mà	4	130473	ma	3	18196	148669	17854
màcula	4	464	macula	2	207	671	17855
màcules	4	70	macules	2	0	70	17856
mànegues	4	1053	manegues	2	87	1140	17857
màquina	4	28948	maquina	2	915	29863	17858
màquines	4	23118	maquines	2	498	23616	17859
màscara	4	5267	mascara	4	167	5434	17860
màscares	4	3630	mascares	4	125	3755	17861
màser	4	27	maser	4	13	40	17862
màsers	4	10	masers	4	6	16	17863
màssic	0	60	massic	4	2	62	17864
màstec	4	7	mastec	4	0	7	17865
màstecs	4	3	mastecs	4	0	3	17866
màstic	4	48	mastic	2	2	50	17867
màx	7	245	max	4	9722	9967	17868
mèdic	0	13927	medic	2	132	14059	17869
mèdica	0	16307	medica	2	296	16603	17870
mèdicament	6	225	medicament	4	4443	4668	17871
mèdiques	0	10490	mediques	2	115	10605	17872
mèlic	0	15	melic	4	1601	1616	17873
mèlics	0	2	melics	4	56	58	17874
mènada	4	8	menada	2	87	95	17875
mènades	4	48	menades	2	31	79	17876
mèrit	4	11942	merit	2	564	12506	17877
mèu	4	34	meu	4	243518	243552	17878
mèus	4	2	meus	4	71364	71366	17879
més	4	4419168	mes	1	278085	4697253	17880
mín	7	114	min	2	5774	5888	17881
mínvol	0	4	minvol	0	0	4	17882
míster	4	623	mister	4	734	1357	17883
místers	4	25	misters	4	17	42	17884
mític	0	7298	mitic	2	85	7383	17885
mòdica	0	119	modica	4	28	147	17886
mòdul	4	15261	modul	2	169	15430	17887
mòllera	4	23	mollera	4	222	245	17888
mòlleres	4	14	molleres	4	212	226	17889
mòlt	2	515	molt	2	1640550	1641065	17890
mòlta	2	706	molta	2	148257	148963	17891
mòltes	2	140	moltes	2	306837	306977	17892
mòlts	2	83	molts	2	378667	378750	17893
mònada	4	32	monada	4	410	442	17894
mònades	4	34	monades	4	26	60	17895
mòria	4	42	moria	2	2565	2607	17896
mòries	4	4	mories	2	30	34	17897
món	4	478756	mon	3	20387	499143	17898
móres	4	491	mores	4	1070	1561	17899
mújol	0	12	mujol	4	0	12	17900
mújols	0	3	mujols	4	0	3	17901
múltiplex	0	445	multiplex	2	85	530	17902
músic	0	19192	music	2	9326	28518	17903
música	0	264183	musica	2	4120	268303	17904
músiques	0	8582	musiques	2	159	8741	17905
mústia	0	12	mustia	2	6	18	17906
mústic	0	6	mustic	2	0	6	17907
músties	0	15	musties	2	5	20	17908
mústiga	0	3	mustiga	2	0	3	17909
mústigues	0	3	mustigues	2	0	3	17910
nacionalitzarà	2	4	nacionalitzara	2	0	4	17911
nacionalitzà	2	62	nacionalitza	2	41	103	17912
nacionalitzàrem	2	0	nacionalitzarem	2	3	3	17913
nacionalitzés	2	5	nacionalitzes	2	1	6	17914
nacionalitzí	2	0	nacionalitzi	2	8	8	17915
nadarà	2	6	nadara	2	0	6	17916
nadà	2	1	nada	2	1857	1858	17917
nadàrem	2	1	nadarem	2	4	5	17918
nadàreu	2	0	nadareu	2	1	1	17919
nadés	2	4	nades	2	46	50	17920
nadí	2	0	nadi	2	48	48	17921
nadís	4	21	nadis	2	50	71	17922
nadó	4	10073	nado	2	99	10172	17923
nafrà	2	4	nafra	4	544	548	17924
nafràreu	2	0	nafrareu	2	1	1	17925
nafrés	2	1	nafres	4	474	475	17926
nafrí	2	0	nafri	2	4	4	17927
naixérem	2	0	naixerem	2	4	4	17928
naixéreu	2	0	naixereu	2	2	2	17929
naixés	2	138	naixes	2	28	166	17930
naixí	2	1	naixi	2	16	17	17931
naixó	4	3	naixo	2	1	4	17932
nannà	2	0	nanna	2	77	77	17933
nanní	2	0	nanni	2	105	105	17934
napejarà	2	1	napejara	2	0	1	17935
napà	2	0	napa	4	354	354	17936
napàrem	2	0	naparem	2	6	6	17937
napés	2	0	napes	4	13	13	17938
napí	2	0	napi	2	53	53	17939
napís	4	0	napis	2	3	3	17940
naquerà	0	0	naquera	4	17	17	17941
narcotitzarà	2	4	narcotitzara	2	0	4	17942
narcotitzà	2	0	narcotitza	2	8	8	17943
narcotitzés	2	1	narcotitzes	2	0	1	17944
narcotitzí	2	0	narcotitzi	2	1	1	17945
narrarà	2	151	narrara	2	5	156	17946
narrà	2	58	narra	2	9046	9104	17947
narràrem	2	2	narrarem	2	32	34	17948
narrés	2	10	narres	2	20	30	17949
narrí	2	0	narri	2	76	76	17950
nasalitzà	2	0	nasalitza	2	1	1	17951
nasprarà	2	0	nasprara	2	1	1	17952
naspràrem	2	0	nasprarem	2	2	2	17953
nasqués	2	237	nasques	2	3	240	17954
natgés	2	0	natges	4	646	646	17955
naturalitzarà	2	5	naturalitzara	2	0	5	17956
naturalitzà	2	26	naturalitza	2	63	89	17957
naturalitzàrem	2	0	naturalitzarem	2	1	1	17958
naturalitzés	2	3	naturalitzes	2	0	3	17959
naturalitzí	2	0	naturalitzi	2	6	6	17960
naufragarà	2	10	naufragara	2	1	11	17961
naufragués	2	14	naufragues	2	5	19	17962
naufraguí	2	0	naufragui	2	15	15	17963
naufragà	2	34	naufraga	2	160	194	17964
naufragàrem	2	0	naufragarem	2	1	1	17965
navegarà	2	97	navegara	2	1	98	17966
navegués	2	26	navegues	2	247	273	17967
naveguí	2	0	navegui	2	378	378	17968
navegà	2	100	navega	2	2579	2679	17969
navegàrem	2	3	navegarem	2	212	215	17970
navegàreu	2	0	navegareu	2	27	27	17971
nebulitzà	2	0	nebulitza	2	1	1	17972
necessitarà	2	3289	necessitara	2	33	3322	17973
necessità	2	111	necessita	2	56524	56635	17974
necessitàrem	2	12	necessitarem	2	2347	2359	17975
necessitàreu	2	1	necessitareu	2	969	970	17976
necessités	2	383	necessites	2	12403	12786	17977
necessití	2	0	necessiti	2	3966	3966	17978
necrosarà	2	0	necrosara	2	1	1	17979
necrosà	2	0	necrosa	2	2	2	17980
necrosí	2	0	necrosi	2	295	295	17981
nedarà	2	67	nedara	2	0	67	17982
nedà	2	10	neda	2	1009	1019	17983
nedàrem	2	2	nedarem	2	24	26	17984
nedàreu	2	0	nedareu	2	6	6	17985
nedés	2	15	nedes	2	37	52	17986
nedí	2	1	nedi	2	41	42	17987
nefrectomitzarà	2	1	nefrectomitzara	2	0	1	17988
negarà	2	338	negara	2	72	410	17989
negativitzarà	2	1	negativitzara	2	0	1	17990
negativitzà	2	0	negativitza	2	1	1	17991
negativitzés	2	0	negativitzes	2	1	1	17992
negativà	2	0	negativa	0	16622	16622	17993
negativàreu	2	2	negativareu	2	0	2	17994
negativés	2	0	negatives	0	7800	7800	17995
negligirà	2	1	negligira	2	0	1	17996
negociarà	2	347	negociara	2	7	354	17997
negocià	2	137	negocia	2	1190	1327	17998
negociàrem	2	9	negociarem	2	127	136	17999
negociàreu	2	0	negociareu	2	2	2	18000
negociés	2	91	negocies	2	45	136	18001
negocií	2	8	negocii	2	16	24	18002
negregés	2	1	negreges	2	0	1	18003
negrejà	2	0	negreja	2	2	2	18004
negrejàrem	2	0	negrejarem	2	1	1	18005
negrellí	2	0	negrelli	2	1	1	18006
negrelló	0	3	negrello	2	0	3	18007
neguitegés	2	1	neguiteges	2	2	3	18008
neguitegí	2	1	neguitegi	2	14	15	18009
neguitejarà	2	1	neguitejara	2	0	1	18010
neguitejà	2	4	neguiteja	2	257	261	18011
neguitejàrem	2	0	neguitejarem	2	1	1	18012
negués	2	345	negues	2	122	467	18013
neguí	2	3	negui	2	854	857	18014
negà	2	834	nega	2	8841	9675	18015
negàrem	2	5	negarem	2	171	176	18016
negàreu	2	1	negareu	2	187	188	18017
nerví	0	0	nervi	4	2543	2543	18018
nespró	4	0	nespro	4	44	44	18019
netegés	2	59	neteges	4	1231	1290	18020
netegí	2	0	netegi	2	233	233	18021
netejarà	2	190	netejara	2	8	198	18022
netejà	2	37	neteja	4	39114	39151	18023
netejàrem	2	7	netejarem	2	231	238	18024
netejàreu	2	0	netejareu	2	6	6	18025
neulà	2	0	neula	0	230	230	18026
neulés	2	1	neules	0	992	993	18027
neurocirurgià	4	156	neurocirurgia	4	248	404	18028
neurotitzà	2	0	neurotitza	2	1	1	18029
neurotitzés	2	1	neurotitzes	2	0	1	18030
neutralitzarà	2	13	neutralitzara	2	0	13	18031
neutralitzà	2	10	neutralitza	2	328	338	18032
neutralitzàrem	2	0	neutralitzarem	2	3	3	18033
neutralitzés	2	10	neutralitzes	2	5	15	18034
neutralitzí	2	0	neutralitzi	2	31	31	18035
nevarà	2	107	nevara	2	13	120	18036
neviscà	2	0	nevisca	2	1	1	18037
nevés	2	42	neves	4	309	351	18038
neví	2	0	nevi	2	309	309	18039
niarà	2	4	niara	2	10	14	18040
nidificà	2	0	nidifica	2	196	196	18041
nidifiquí	2	0	nidifiqui	2	2	2	18042
niellà	2	0	niella	4	33	33	18043
niellés	2	0	nielles	4	2	2	18044
nimbà	2	0	nimba	4	43	43	18045
nimbés	2	0	nimbes	2	16	16	18046
ninó	4	5	nino	4	1077	1082	18047
niquelà	2	0	niquela	2	1	1	18048
nitratà	2	0	nitrata	2	1	1	18049
nitratés	2	0	nitrates	2	3	3	18050
nitrificà	2	0	nitrifica	2	1	1	18051
nitrogení	2	0	nitrogeni	2	1	1	18052
nitrogèn	2	0	nitrogen	4	4177	4177	18053
nitrà	2	0	nitra	4	66	66	18054
nitrés	2	0	nitres	2	1	1	18055
nitrí	2	0	nitri	2	1	1	18056
nitrós	0	181	nitros	4	9	190	18057
niuà	2	0	niua	2	11	11	18058
nià	2	6	nia	2	457	463	18059
niàs	2	0	nias	4	18	18	18060
niés	2	25	nies	2	26	51	18061
nií	2	0	nii	2	258	258	18062
nocà	2	0	noca	2	19	19	18063
nodrirà	2	125	nodrira	2	1	126	18064
nodrírem	2	0	nodrirem	2	11	11	18065
nodríreu	2	0	nodrireu	2	1	1	18066
noedès	0	0	noedes	4	114	114	18067
noedés	0	0	noedes	4	114	114	18068
noliegí	2	0	noliegi	2	1	1	18069
noliejarà	2	7	noliejara	2	0	7	18070
noliejà	2	3	nolieja	2	8	11	18071
nombrarà	2	16	nombrara	2	0	16	18072
nombrà	2	15	nombra	4	102	117	18073
nombràrem	2	0	nombrarem	2	10	10	18074
nombràreu	2	1	nombrareu	2	0	1	18075
nombrés	2	15	nombres	4	11103	11118	18076
nombrí	2	0	nombri	2	8	8	18077
nomenarà	2	496	nomenara	2	12	508	18078
nomenà	2	1137	nomena	2	1802	2939	18079
nomenàrem	2	7	nomenarem	2	26	33	18080
nomenés	2	165	nomenes	2	22	187	18081
nomení	2	1	nomeni	2	351	352	18082
nominalitzà	2	0	nominalitza	2	2	2	18083
nominalitzés	2	0	nominalitzes	2	1	1	18084
nominarà	2	4	nominara	2	0	4	18085
nominà	2	6	nomina	2	169	175	18086
nominàrem	2	0	nominarem	2	3	3	18087
nominés	2	5	nomines	2	54	59	18088
nominí	2	0	nomini	2	7	7	18089
nomèn	2	1	nomen	2	481	482	18090
només	6	712322	nomes	4	6640	718962	18091
nomí	2	0	nomi	2	49	49	18092
nomín	2	0	nomin	2	3	3	18093
nonà	4	4	nona	4	338	342	18094
noquegí	2	0	noquegi	2	1	1	18095
noquejà	2	1	noqueja	2	10	11	18096
noranta-quatrè	0	3	noranta-quatre	3	64	67	18097
noranta-quatré	0	0	noranta-quatre	3	64	64	18098
nordejà	2	0	nordeja	2	1	1	18099
normalitzarà	2	51	normalitzara	2	3	54	18100
normalitzà	2	16	normalitza	2	382	398	18101
normalitzàrem	2	0	normalitzarem	2	25	25	18102
normalitzés	2	16	normalitzes	2	6	22	18103
normalitzí	2	0	normalitzi	2	197	197	18104
normativitzà	2	1	normativitza	2	17	18	18105
normativitzés	2	2	normativitzes	2	0	2	18106
normativitzí	2	0	normativitzi	2	3	3	18107
normà	2	0	norma	4	25396	25396	18108
normés	2	9	normes	4	70886	70895	18109
normí	2	1	normi	2	0	1	18110
notarà	2	571	notara	2	25	596	18111
noticià	2	0	noticia	2	6011	6011	18112
noticiés	2	5	noticies	2	7729	7734	18113
notificarà	2	780	notificara	2	5	785	18114
notificà	2	42	notifica	2	816	858	18115
notificàrem	2	0	notificarem	2	141	141	18116
notificàreu	2	0	notificareu	2	3	3	18117
notifiqués	2	30	notifiques	2	7	37	18118
notifiquí	2	0	notifiqui	2	518	518	18119
notà	2	145	nota	4	61102	61247	18120
notàrem	2	18	notarem	2	387	405	18121
notàreu	2	1	notareu	2	347	348	18122
notària	4	100	notaria	2	666	766	18123
notàries	4	9	notaries	2	176	185	18124
notés	2	226	notes	4	32434	32660	18125
notí	2	10	noti	2	1095	1105	18126
notícia	4	48380	noticia	2	6011	54391	18127
notícies	4	75481	noticies	2	7729	83210	18128
nouré	2	0	noure	2	17	17	18129
novel·larà	2	1	novel·lara	2	0	1	18130
novel·là	2	5	novel·la	4	77084	77089	18131
novel·lés	2	1	novel·les	4	17715	17716	18132
novel·lí	2	0	novel·li	2	1	1	18133
nuarà	2	1	nuara	2	22	23	18134
nugarà	2	1	nugara	2	0	1	18135
nugués	2	0	nugues	2	1	1	18136
nugà	2	6	nuga	2	34	40	18137
numerarà	2	3	numerara	2	0	3	18138
numerà	2	2	numera	2	57	59	18139
numeràrem	2	0	numerarem	2	4	4	18140
numerària	0	117	numeraria	2	21	138	18141
numeràries	0	5	numeraries	2	1	6	18142
numerés	2	3	numeres	2	7	10	18143
numerí	2	0	numeri	2	22	22	18144
nuà	2	19	nua	0	2369	2388	18145
nuàrem	2	0	nuarem	2	1	1	18146
nués	2	1	nues	0	892	893	18147
nyacarà	2	0	nyacara	2	1	1	18148
nyacà	2	0	nyaca	2	19	19	18149
nyagués	2	0	nyagues	2	2	2	18150
nyagà	2	0	nyaga	2	1	1	18151
nyaufarà	2	0	nyaufara	2	1	1	18152
nyaufà	2	0	nyaufa	2	1	1	18153
nàufrag	0	413	naufrag	2	17	430	18154
nàufraga	0	19	naufraga	2	160	179	18155
nàufragues	0	9	naufragues	2	5	14	18156
néta	4	2035	neta	0	11366	13401	18157
nétes	4	387	netes	0	4642	5029	18158
néts	4	3924	nets	0	7237	11161	18159
níquel	4	1005	niquel	2	14	1019	18160
nòmina	4	3674	nomina	2	169	3843	18161
nòmines	4	1938	nomines	2	54	1992	18162
nòvia	4	759	novia	4	937	1696	18163
nòvies	4	78	novies	4	83	161	18164
nós	5	322	nos	4	6446	6768	18165
nóvia	4	93	novia	4	937	1030	18166
nóvies	4	12	novies	4	83	95	18167
número	4	98086	numero	2	2362	100448	18168
obcecà	2	1	obceca	2	8	9	18169
obcequés	2	2	obceques	2	1	3	18170
obcequí	2	0	obcequi	2	1	1	18171
obeírem	2	2	obeirem	2	14	16	18172
obeíreu	2	0	obeireu	2	1	1	18173
objectarà	2	25	objectara	2	0	25	18174
objectivarà	2	1	objectivara	2	0	1	18175
objectivà	2	2	objectiva	0	5123	5125	18176
objectivés	2	0	objectives	0	2144	2144	18177
objectiví	2	0	objectivi	2	1	1	18178
objectà	2	16	objecta	2	82	98	18179
objectàrem	2	2	objectarem	2	0	2	18180
objectàreu	2	0	objectareu	2	2	2	18181
objectés	2	2	objectes	2	51703	51705	18182
objectí	2	1	objecti	2	30	31	18183
oblidarà	2	573	oblidara	2	30	603	18184
oblidà	2	169	oblida	2	4869	5038	18185
oblidàrem	2	18	oblidarem	2	1120	1138	18186
oblidàreu	2	0	oblidareu	2	147	147	18187
oblidés	2	277	oblides	2	699	976	18188
oblidí	2	3	oblidi	2	1654	1657	18189
obligarà	2	2078	obligara	2	37	2115	18190
obligués	2	386	obligues	2	92	478	18191
obliguí	2	0	obligui	2	1560	1560	18192
obligà	2	1246	obliga	2	19393	20639	18193
obligàrem	2	0	obligarem	2	54	54	18194
obligàreu	2	0	obligareu	2	10	10	18195
obliquà	2	0	obliqua	0	349	349	18196
obliqüés	2	0	obliqües	0	132	132	18197
obliterà	2	0	oblitera	2	5	5	18198
obliteràrem	2	1	obliterarem	2	0	1	18199
obliterés	2	1	obliteres	2	0	1	18200
obnubilarà	2	2	obnubilara	2	0	2	18201
obnubilà	2	2	obnubila	2	19	21	18202
obnubilí	2	0	obnubili	2	1	1	18203
obrarà	2	32	obrara	2	1	33	18204
obrirà	2	12443	obrira	2	125	12568	18205
obrà	2	53	obra	4	278464	278517	18206
obràrem	2	2	obrarem	2	5	7	18207
obràreu	2	0	obrareu	2	2	2	18208
obrés	2	26	obres	4	218730	218756	18209
obrí	2	2142	obri	2	7651	9793	18210
obrírem	2	33	obrirem	2	1406	1439	18211
obríreu	2	2	obrireu	2	52	54	18212
obrís	2	993	obris	2	389	1382	18213
obsedirà	2	2	obsedira	2	0	2	18214
obsedíreu	2	0	obsedireu	2	1	1	18215
obsequiarà	2	508	obsequiara	2	3	511	18216
obsequià	2	115	obsequia	2	623	738	18217
obsequiàrem	2	1	obsequiarem	2	131	132	18218
obsequiés	2	13	obsequies	2	7	20	18219
obsequií	2	0	obsequii	2	1	1	18220
observarà	2	279	observara	2	12	291	18221
observà	2	485	observa	2	11301	11786	18222
observàrem	2	62	observarem	2	955	1017	18223
observàreu	2	0	observareu	2	242	242	18224
observés	2	103	observes	2	406	509	18225
observí	2	3	observi	2	497	500	18226
obsessionarà	2	34	obsessionara	2	1	35	18227
obsessionà	2	18	obsessiona	2	350	368	18228
obsessionàrem	2	0	obsessionarem	2	1	1	18229
obsessionés	2	4	obsessiones	2	15	19	18230
obsessioní	2	0	obsessioni	2	19	19	18231
obstaculitzarà	2	52	obstaculitzara	2	1	53	18232
obstaculitzà	2	21	obstaculitza	2	377	398	18233
obstaculitzàrem	2	1	obstaculitzarem	2	2	3	18234
obstaculitzàreu	2	0	obstaculitzareu	2	1	1	18235
obstaculitzés	2	19	obstaculitzes	2	1	20	18236
obstaculitzí	2	0	obstaculitzi	2	125	125	18237
obstarà	2	4	obstara	2	0	4	18238
obstinarà	2	7	obstinara	2	1	8	18239
obstinà	2	8	obstina	2	207	215	18240
obstinàrem	2	0	obstinarem	2	1	1	18241
obstinés	2	7	obstines	2	5	12	18242
obstiní	2	0	obstini	2	30	30	18243
obstruírem	2	0	obstruirem	2	1	1	18244
obstà	2	7	obsta	2	149	156	18245
obstín	2	0	obstin	2	1	1	18246
obtenguí	2	0	obtengui	2	59	59	18247
obtindré	2	129	obtindre	2	3650	3779	18248
obtingués	2	504	obtingues	2	222	726	18249
obtinguí	2	1	obtingui	2	2309	2310	18250
obturarà	2	1	obturara	2	0	1	18251
obturà	2	0	obtura	2	35	35	18252
obturés	2	1	obtures	2	1	2	18253
obturí	2	0	obturi	2	6	6	18254
obviarà	2	14	obviara	2	1	15	18255
obvià	2	12	obvia	2	898	910	18256
obviàrem	2	0	obviarem	2	92	92	18257
obviàreu	2	0	obviareu	2	2	2	18258
obviés	2	20	obvies	2	246	266	18259
obvií	2	2	obvii	2	6	8	18260
ocasionarà	2	196	ocasionara	2	4	200	18261
ocasionà	2	210	ocasiona	2	1347	1557	18262
ocasionàrem	2	0	ocasionarem	2	3	3	18263
ocasionés	2	22	ocasiones	2	158	180	18264
ocasioní	2	0	ocasioni	2	246	246	18265
occidentalitzà	2	1	occidentalitza	2	1	2	18266
occidentalitzí	2	0	occidentalitzi	2	1	1	18267
occirà	2	3	occira	2	0	3	18268
oclouré	2	0	ocloure	2	5	5	18269
octaví	4	3	octavi	4	2220	2223	18270
octubrà	2	0	octubra	2	1	1	18271
octubrés	2	0	octubres	2	49	49	18272
octubrí	2	2	octubri	2	0	2	18273
octà	4	36	octa	4	45	81	18274
octàedre	4	51	octaedre	4	62	113	18275
octàedres	4	19	octaedres	4	11	30	18276
ocultarà	2	88	ocultara	2	2	90	18277
ocultà	2	36	oculta	0	145503	145539	18278
ocultàrem	2	0	ocultarem	2	4	4	18279
ocultés	2	38	ocultes	0	1938	1976	18280
ocultí	2	1	oculti	2	107	108	18281
ocuparà	2	3440	ocupara	2	58	3498	18282
ocupà	2	2387	ocupa	2	29591	31978	18283
ocupàrem	2	9	ocuparem	2	393	402	18284
ocupàreu	2	0	ocupareu	2	12	12	18285
ocupés	2	551	ocupes	2	386	937	18286
ocupí	2	1	ocupi	2	2235	2236	18287
odiarà	2	30	odiara	2	2	32	18288
odià	2	5	odia	2	1095	1100	18289
odiàrem	2	0	odiarem	2	6	6	18290
odiàreu	2	0	odiareu	2	3	3	18291
odiés	2	22	odies	2	182	204	18292
odií	2	1	odii	2	39	40	18293
odorí	2	0	odori	2	12	12	18294
ofegarà	2	44	ofegara	2	3	47	18295
ofegués	2	32	ofegues	2	36	68	18296
ofeguí	2	0	ofegui	2	120	120	18297
ofegà	2	43	ofega	2	1145	1188	18298
ofegàrem	2	2	ofegarem	2	28	30	18299
ofegàreu	2	0	ofegareu	2	5	5	18300
ofendré	2	6	ofendre	2	1600	1606	18301
ofengués	2	28	ofengues	2	2	30	18302
ofenguí	2	1	ofengui	2	155	156	18303
oferirà	2	18989	oferira	2	82	19071	18304
oferírem	2	16	oferirem	2	2195	2211	18305
oferíreu	2	2	oferireu	2	16	18	18306
oficialitzarà	2	65	oficialitzara	2	4	69	18307
oficialitzà	2	26	oficialitza	2	134	160	18308
oficialitzàrem	2	0	oficialitzarem	2	1	1	18309
oficialitzés	2	12	oficialitzes	2	0	12	18310
oficialitzí	2	0	oficialitzi	2	25	25	18311
oficiarà	2	119	oficiara	2	1	120	18312
oficià	2	30	oficia	2	133	163	18313
oficiàrem	2	0	oficiarem	2	1	1	18314
oficiés	2	15	oficies	2	15	30	18315
oficií	2	2	oficii	2	1	3	18316
ofrenarà	2	1	ofrenara	2	1	2	18317
ofrenà	2	11	ofrena	4	5892	5903	18318
ofrenàrem	2	0	ofrenarem	2	3	3	18319
ofrenàreu	2	1	ofrenareu	2	0	1	18320
ofrenés	2	0	ofrenes	4	1821	1821	18321
ofrení	2	0	ofreni	2	3	3	18322
oftàlmia	4	6	oftalmia	4	4	10	18323
oftàlmies	4	0	oftalmies	4	1	1	18324
ofuscà	2	0	ofusca	2	42	42	18325
ofuscàrem	2	1	ofuscarem	2	0	1	18326
ofusqués	2	1	ofusques	2	5	6	18327
ofusquí	2	0	ofusqui	2	8	8	18328
oià	2	0	oia	2	67	67	18329
oiés	2	0	oies	2	6	6	18330
oldré	2	0	oldre	2	11	11	18331
olesà	0	207	olesa	4	5234	5441	18332
olgués	2	1	olgues	4	9	10	18333
olguí	2	0	olgui	2	6	6	18334
olianès	0	25	olianes	4	0	25	18335
olivarà	2	1	olivara	2	4	5	18336
olivetà	0	1	oliveta	4	45	46	18337
olivà	2	14	oliva	4	23591	23605	18338
olivària	0	1	olivaria	2	4	5	18339
olivés	2	15	olives	4	6271	6286	18340
oliví	2	5	olivi	2	10	15	18341
oliés	2	0	olies	2	2	2	18342
olií	2	0	olii	2	5	5	18343
ollerià	0	10	olleria	4	848	858	18344
olorarà	2	6	olorara	2	3	9	18345
olorà	2	8	olora	2	370	378	18346
oloràrem	2	1	olorarem	2	20	21	18347
oloràreu	2	0	olorareu	2	4	4	18348
olorés	2	13	olores	2	82	95	18349
olorí	2	0	olori	2	55	55	18350
olíem	2	0	oliem	2	3	3	18351
olíeu	2	0	olieu	2	25	25	18352
ombregés	2	1	ombreges	2	0	1	18353
ombregí	2	0	ombregi	2	1	1	18354
ombrejarà	2	3	ombrejara	2	0	3	18355
ombrejà	2	0	ombreja	2	37	37	18356
ombrejàreu	2	0	ombrejareu	2	1	1	18357
ombrà	2	1	ombra	4	19429	19430	18358
ombrés	2	0	ombres	4	9878	9878	18359
ombrí	2	3	ombri	2	2	5	18360
ometré	2	17	ometre	2	1087	1104	18361
ometés	2	15	ometes	2	1	16	18362
ometí	2	1	ometi	2	53	54	18363
omplirà	2	2501	omplira	2	33	2534	18364
omplí	2	376	ompli	2	2387	2763	18365
omplírem	2	18	omplirem	2	499	517	18366
omplíreu	2	3	omplireu	2	33	36	18367
omplís	2	255	omplis	2	295	550	18368
omès	2	392	omes	4	21	413	18369
omés	2	44	omes	4	21	65	18370
oncogèn	4	15	oncogen	0	27	42	18371
oncogén	4	0	oncogen	0	27	27	18372
oncògens	0	14	oncogens	4	43	57	18373
ondarà	2	4	ondara	4	4798	4802	18374
ondegí	2	0	ondegi	2	3	3	18375
ondejarà	2	6	ondejara	2	1	7	18376
ondejà	2	0	ondeja	2	13	13	18377
ondulà	2	1	ondula	2	27	28	18378
ondulàrem	2	0	ondularem	2	1	1	18379
ondulí	2	0	onduli	2	2	2	18380
ondà	2	0	onda	4	3280	3280	18381
ondés	2	0	ondes	4	217	217	18382
onegés	2	38	oneges	2	1	39	18383
onegí	2	0	onegi	2	102	102	18384
onejarà	2	86	onejara	2	5	91	18385
onejà	2	9	oneja	2	379	388	18386
onejàrem	2	0	onejarem	2	1	1	18387
onzè	0	1288	onze	3	27843	29131	18388
onzé	0	71	onze	3	27843	27914	18389
operacionalitzà	2	0	operacionalitza	2	1	1	18390
operarà	2	258	operara	2	3	261	18391
operativitzà	2	0	operativitza	2	3	3	18392
operà	2	78	opera	2	7608	7686	18393
operàrem	2	0	operarem	2	17	17	18394
operària	4	52	operaria	2	55	107	18395
operàries	4	59	operaries	2	7	66	18396
operés	2	50	operes	2	110	160	18397
operí	2	0	operi	2	279	279	18398
operó	4	67	opero	2	25	92	18399
opilí	2	0	opili	2	2	2	18400
opinarà	2	42	opinara	2	6	48	18401
opinà	2	53	opina	2	4778	4831	18402
opinàrem	2	2	opinarem	2	19	21	18403
opinàreu	2	0	opinareu	2	8	8	18404
opinés	2	34	opines	2	330	364	18405
opiní	2	0	opini	2	283	283	18406
oposarà	2	267	oposara	2	10	277	18407
opositarà	2	1	opositara	2	0	1	18408
oposità	2	1	oposita	2	32	33	18409
oposà	2	673	oposa	2	3825	4498	18410
oposàrem	2	14	oposarem	2	186	200	18411
oposàreu	2	0	oposareu	2	1	1	18412
oposés	2	110	oposes	2	25	135	18413
oposí	2	2	oposi	2	617	619	18414
oprimirà	2	4	oprimira	2	0	4	18415
optarà	2	493	optara	2	20	513	18416
optimitzarà	2	78	optimitzara	2	2	80	18417
optimitzà	2	0	optimitza	2	732	732	18418
optimitzàrem	2	0	optimitzarem	2	33	33	18419
optimitzàreu	2	0	optimitzareu	2	2	2	18420
optimitzés	2	4	optimitzes	2	12	16	18421
optimitzí	2	0	optimitzi	2	119	119	18422
optimà	2	0	optima	2	258	258	18423
optimés	2	1	optimes	2	71	72	18424
optimí	2	0	optimi	2	9	9	18425
optà	2	391	opta	2	4077	4468	18426
optàrem	2	63	optarem	2	117	180	18427
optàreu	2	0	optareu	2	22	22	18428
optés	2	266	optes	2	178	444	18429
optí	2	0	opti	2	701	701	18430
opugní	2	1	opugni	2	0	1	18431
opòsit	4	1	oposit	2	1	2	18432
orbarà	2	0	orbara	2	3	3	18433
orbetà	0	0	orbeta	4	3	3	18434
orbitarà	2	14	orbitara	2	0	14	18435
orbità	2	7	orbita	2	560	567	18436
orbitàrem	2	0	orbitarem	2	2	2	18437
orbitària	0	45	orbitaria	2	14	59	18438
orbitàries	0	15	orbitaries	2	0	15	18439
orbités	2	5	orbites	2	36	41	18440
orbití	2	0	orbiti	2	20	20	18441
orbà	2	2	orba	4	472	474	18442
orbés	2	1	orbes	0	69	70	18443
ordenarà	2	338	ordenara	2	20	358	18444
ordenà	2	1801	ordena	2	4668	6469	18445
ordenàrem	2	3	ordenarem	2	33	36	18446
ordenàreu	2	0	ordenareu	2	3	3	18447
ordenés	2	234	ordenes	2	57	291	18448
ordení	2	1	ordeni	2	379	380	18449
ordinès	0	0	ordines	4	114	114	18450
ordinés	0	0	ordines	4	114	114	18451
ordirà	2	10	ordira	2	0	10	18452
ordià	2	0	ordia	2	16	16	18453
ordí	2	25	ordi	4	2478	2503	18454
ordís	2	6	ordis	4	352	358	18455
oregí	2	0	oregi	2	16	16	18456
orejà	2	0	oreja	2	416	416	18457
orellés	2	0	orelles	4	7020	7020	18458
orellí	2	0	orelli	2	2	2	18459
orelló	4	5	orello	2	0	5	18460
organitzarà	2	3949	organitzara	2	44	3993	18461
organitzà	2	2358	organitza	2	64653	67011	18462
organitzàrem	2	91	organitzarem	2	1133	1224	18463
organitzàreu	2	2	organitzareu	2	12	14	18464
organitzés	2	307	organitzes	2	186	493	18465
organitzí	2	0	organitzi	2	1148	1148	18466
orgullà	2	0	orgulla	2	1	1	18467
orgullí	2	1	orgulli	2	1	2	18468
orientarà	2	458	orientara	2	11	469	18469
orientà	2	172	orienta	2	2918	3090	18470
orientàrem	2	1	orientarem	2	117	118	18471
orientàreu	2	0	orientareu	2	1	1	18472
orientés	2	71	orientes	2	15	86	18473
orientí	2	0	orienti	2	453	453	18474
originarà	2	148	originara	2	2	150	18475
originà	2	586	origina	2	2600	3186	18476
originàrem	2	1	originarem	2	3	4	18477
originària	0	3482	originaria	2	399	3881	18478
originàries	0	1008	originaries	2	55	1063	18479
originés	2	28	origines	2	55	83	18480
originí	2	1	origini	2	215	216	18481
orinarà	2	1	orinara	2	0	1	18482
orinà	2	6	orina	4	2486	2492	18483
orinés	2	0	orines	4	39	39	18484
oriní	2	0	orini	2	18	18	18485
oriolà	0	76	oriola	4	1702	1778	18486
oripellés	2	0	oripelles	2	1	1	18487
orlà	2	2	orla	4	764	766	18488
orlés	2	0	orles	4	609	609	18489
orlí	2	0	orli	2	5	5	18490
orló	4	1	orlo	2	2	3	18491
ornamentarà	2	6	ornamentara	2	0	6	18492
ornamentà	2	5	ornamenta	2	55	60	18493
ornamentàrem	2	0	ornamentarem	2	1	1	18494
ornamentés	2	0	ornamentes	2	3	3	18495
ornamentí	2	0	ornamenti	2	2	2	18496
ornarà	2	3	ornara	2	0	3	18497
ornà	2	3	orna	2	66	69	18498
ornàrem	2	0	ornarem	2	1	1	18499
ornés	2	0	ornes	2	7	7	18500
orní	2	1	orni	2	254	255	18501
oronejà	2	0	oroneja	2	1	1	18502
orquestrarà	2	5	orquestrara	2	0	5	18503
orquestrà	2	26	orquestra	4	33179	33205	18504
orquestrés	2	4	orquestres	4	3538	3542	18505
orsarà	2	0	orsara	2	1	1	18506
orsà	2	20	orsa	4	78	98	18507
orsés	2	1	orses	4	8	9	18508
orsí	2	0	orsi	2	22	22	18509
ortigués	2	0	ortigues	4	404	404	18510
ortigà	2	0	ortiga	4	430	430	18511
ortografià	2	0	ortografia	4	5212	5212	18512
ortografiés	2	0	ortografies	4	98	98	18513
ortòedre	4	3	ortoedre	4	19	22	18514
ortòedres	4	0	ortoedres	4	2	2	18515
orxegà	2	1	orxega	2	0	1	18516
orxetà	0	1	orxeta	4	67	68	18517
orxà	0	0	orxa	4	254	254	18518
orés	2	2	ores	4	64	66	18519
orí	2	13	ori	2	173	186	18520
orín	2	7	orin	2	28	35	18521
oscil·larà	2	249	oscil·lara	2	3	252	18522
oscil·là	2	31	oscil·la	2	2230	2261	18523
oscil·lés	2	9	oscil·les	2	2	11	18524
oscil·lí	2	0	oscil·li	2	48	48	18525
oscà	2	8	osca	4	4098	4106	18526
osqués	2	0	osques	0	219	219	18527
osquí	2	0	osqui	2	2	2	18528
ossificà	2	0	ossifica	2	5	5	18529
ossífica	0	0	ossifica	2	5	5	18530
ossós	0	6	ossos	4	9616	9622	18531
ostentarà	2	190	ostentara	2	5	195	18532
ostentà	2	138	ostenta	2	2491	2629	18533
ostentés	2	24	ostentes	2	11	35	18534
ostentí	2	1	ostenti	2	223	224	18535
ovacionarà	2	1	ovacionara	2	0	1	18536
ovacionà	2	8	ovaciona	2	25	33	18537
ovacionés	2	2	ovaciones	2	0	2	18538
ovacioní	2	0	ovacioni	2	1	1	18539
ovalà	2	0	ovala	2	2	2	18540
ovalés	2	0	ovales	2	2	2	18541
ovalí	2	0	ovali	2	1	1	18542
ovulà	2	0	ovula	2	25	25	18543
ovulés	2	1	ovules	2	14	15	18544
ovulí	2	0	ovuli	2	2	2	18545
oxidarà	2	9	oxidara	2	0	9	18546
oxidà	2	3	oxida	2	318	321	18547
oxidés	2	5	oxides	2	2	7	18548
oxidí	2	0	oxidi	2	84	84	18549
oxigenarà	2	10	oxigenara	2	0	10	18550
oxigenà	2	1	oxigena	2	148	149	18551
oxigenàrem	2	0	oxigenarem	2	1	1	18552
oxigenés	2	0	oxigenes	2	1	1	18553
oxigení	2	0	oxigeni	2	14	14	18554
oxigèn	2	1	oxigen	4	8678	8679	18555
oí	2	38	oi	7	15461	15499	18556
oíem	2	2	oiem	2	0	2	18557
oíeu	2	0	oieu	2	1	1	18558
oírem	2	2	oirem	2	4	6	18559
oíreu	2	1	oireu	2	5	6	18560
oís	2	4	ois	4	55	59	18561
pacificarà	2	18	pacificara	2	0	18	18562
pacificà	2	16	pacifica	2	386	402	18563
pacificàrem	2	0	pacificarem	2	1	1	18564
pacifiqués	2	5	pacifiques	2	51	56	18565
pacifiquí	2	0	pacifiqui	2	19	19	18566
pactarà	2	235	pactara	2	3	238	18567
pactejarà	2	1	pactejara	2	0	1	18568
pactejàrem	2	1	pactejarem	2	0	1	18569
pactà	2	167	pacta	2	721	888	18570
pactàrem	2	7	pactarem	2	92	99	18571
pactàreu	2	0	pactareu	2	6	6	18572
pactés	2	62	pactes	2	6578	6640	18573
pactí	2	1	pacti	2	225	226	18574
pacífica	0	9043	pacifica	2	386	9429	18575
pacífiques	0	1682	pacifiques	2	51	1733	18576
padrinejà	2	1	padrineja	2	1	2	18577
paganitzà	2	1	paganitza	2	0	1	18578
pagarà	2	2966	pagara	2	105	3071	18579
pagarés	4	174	pagares	2	14	188	18580
paginà	2	2	pagina	2	1841	1843	18581
paginàrem	2	0	paginarem	2	1	1	18582
paginés	2	2	pagines	2	997	999	18583
paginí	2	0	pagini	2	3	3	18584
pagués	2	521	pagues	4	2669	3190	18585
paguí	2	28	pagui	2	2515	2543	18586
pagàrem	2	29	pagarem	2	946	975	18587
pagàreu	2	0	pagareu	2	140	140	18588
pairé	2	5	paire	2	54	59	18589
pairés	2	0	paires	2	3	3	18590
pairí	2	0	pairi	2	1	1	18591
paixés	2	0	paixes	2	8	8	18592
paladegés	2	1	paladeges	2	3	4	18593
paladegí	2	0	paladegi	2	1	1	18594
paladejà	2	0	paladeja	2	22	22	18595
paladejàreu	2	0	paladejareu	2	1	1	18596
palafangués	2	0	palafangues	4	8	8	18597
palafangà	2	0	palafanga	4	7	7	18598
palanquejarà	2	1	palanquejara	2	0	1	18599
palanquí	0	25	palanqui	4	2	27	18600
palatalitzà	2	0	palatalitza	2	4	4	18601
palegés	2	1	paleges	2	1	2	18602
palegí	2	0	palegi	2	6	6	18603
palejà	2	0	paleja	2	9	9	18604
palejàrem	2	0	palejarem	2	16	16	18605
paleosòl	4	2	paleosol	4	0	2	18606
paleosòls	4	8	paleosols	4	2	10	18607
palesarà	2	21	palesara	2	2	23	18608
palesà	2	88	palesa	2	4638	4726	18609
palesés	2	5	paleses	2	422	427	18610
palesí	2	1	palesi	2	13	14	18611
paletitzà	2	0	paletitza	2	2	2	18612
pallarés	0	920	pallares	2	161	1081	18613
pallà	2	11	palla	4	6661	6672	18614
pallés	2	49	palles	4	301	350	18615
palló	4	6	pallo	2	9	15	18616
palmejà	2	1	palmeja	2	1	2	18617
palparà	2	4	palpara	2	0	4	18618
palpitarà	2	2	palpitara	2	0	2	18619
palpità	2	0	palpita	2	84	84	18620
palpités	2	0	palpites	2	1	1	18621
palpití	2	0	palpiti	2	13	13	18622
palplantà	2	3	palplanta	2	7	10	18623
palplantàrem	2	0	palplantarem	2	1	1	18624
palpunyà	2	1	palpunya	2	2	3	18625
palpà	2	15	palpa	2	383	398	18626
palpàrem	2	0	palparem	2	8	8	18627
palpés	2	2	palpes	2	27	29	18628
palpí	2	0	palpi	2	9	9	18629
palpís	4	29	palpis	2	3	32	18630
paltejà	2	0	palteja	2	1	1	18631
pal·liarà	2	20	pal·liara	2	1	21	18632
pal·lià	2	0	pal·lia	2	56	56	18633
pal·liàrem	2	0	pal·liarem	2	2	2	18634
pal·liés	2	3	pal·lies	2	0	3	18635
pal·lií	2	0	pal·lii	2	2	2	18636
palès	2	4958	pales	4	1988	6946	18637
palés	0	410	pales	4	1988	2398	18638
paló	4	8	palo	4	1071	1079	18639
pampalluguegí	2	0	pampalluguegi	2	1	1	18640
pampalluguejà	2	0	pampallugueja	2	10	10	18641
pampallugués	2	0	pampallugues	2	242	242	18642
pampallugà	2	0	pampalluga	2	55	55	18643
pansificà	2	0	pansifica	2	2	2	18644
pansirà	2	6	pansira	2	0	6	18645
pantaixós	0	0	pantaixos	4	2	2	18646
panteixà	2	1	panteixa	2	18	19	18647
panteixàreu	2	1	panteixareu	2	0	1	18648
panteixés	2	0	panteixes	2	2	2	18649
panyà	2	0	panya	2	21	21	18650
panyés	2	0	panyes	2	9	9	18651
panyí	2	0	panyi	2	3	3	18652
papallonegés	2	0	papalloneges	2	1	1	18653
papallonegí	2	0	papallonegi	2	1	1	18654
papallonejà	2	0	papalloneja	2	2	2	18655
paparà	2	0	papara	2	5	5	18656
papissotejarà	2	1	papissotejara	2	0	1	18657
papà	2	798	papa	4	26374	27172	18658
papàrem	2	1	paparem	2	1	2	18659
papés	2	3	papes	4	1952	1955	18660
papí	2	9	papi	2	303	312	18661
papú	0	16	papu	4	127	143	18662
papús	0	25	papus	4	255	280	18663
parafinà	2	0	parafina	4	212	212	18664
parafinés	2	0	parafines	4	44	44	18665
parafrasegí	2	0	parafrasegi	2	4	4	18666
parafrasejarà	2	0	parafrasejara	2	1	1	18667
parafrasejà	2	4	parafraseja	2	47	51	18668
parafrasejàrem	2	0	parafrasejarem	2	2	2	18669
paralitzarà	2	72	paralitzara	2	13	85	18670
paralitzà	2	68	paralitza	2	740	808	18671
paralitzàrem	2	2	paralitzarem	2	12	14	18672
paralitzés	2	43	paralitzes	2	7	50	18673
paralitzí	2	0	paralitzi	2	223	223	18674
paral·lelitzà	2	1	paral·lelitza	2	1	2	18675
paramentà	2	0	paramenta	2	2	2	18676
paramentés	2	0	paramentes	2	1	1	18677
parametritzà	2	0	parametritza	2	19	19	18678
parametritzàrem	2	0	parametritzarem	2	1	1	18679
parametritzí	2	0	parametritzi	2	1	1	18680
parangonà	2	0	parangona	4	3	3	18681
parapetà	2	2	parapeta	2	25	27	18682
parapetés	2	1	parapetes	2	2	3	18683
parapetí	2	0	parapeti	2	1	1	18684
pararà	2	711	parara	2	43	754	18685
parasitarà	2	2	parasitara	2	0	2	18686
parasità	2	0	parasita	2	80	80	18687
parasitàrem	2	0	parasitarem	2	1	1	18688
parasitària	0	197	parasitaria	2	17	214	18689
parasitàries	0	179	parasitaries	2	4	183	18690
parasités	2	2	parasites	2	7	9	18691
parasití	2	0	parasiti	2	1	1	18692
paraulegí	2	1	paraulegi	2	0	1	18693
paraulejà	2	0	parauleja	2	1	1	18694
parcel·larà	2	1	parcel·lara	2	0	1	18695
parcel·là	2	12	parcel·la	4	7140	7152	18696
parcel·lària	0	173	parcel·laria	2	20	193	18697
parcel·làries	0	23	parcel·laries	2	8	31	18698
parcel·lés	2	5	parcel·les	4	6110	6115	18699
pardinès	0	0	pardines	4	790	790	18700
pardinés	0	0	pardines	4	790	790	18701
paredà	2	12	pareda	2	3	15	18702
paredés	2	0	paredes	2	1001	1001	18703
paregués	2	10	paregues	2	0	10	18704
pareguí	2	0	paregui	2	21	21	18705
paretó	4	26	pareto	4	173	199	18706
parificà	2	0	parifica	2	1	1	18707
parionà	2	0	pariona	2	6	6	18708
parirà	2	18	parira	2	0	18	18709
parlamentà	2	0	parlamenta	2	9	9	18710
parlamentària	0	13430	parlamentaria	2	582	14012	18711
parlamentàries	0	4093	parlamentaries	2	123	4216	18712
parlamentés	2	0	parlamentes	2	4	4	18713
parlamentí	2	1	parlamenti	2	6	7	18714
parlarà	2	7866	parlara	2	187	8053	18715
parlotejà	2	1	parloteja	2	6	7	18716
parlà	2	1485	parla	4	87866	89351	18717
parlàrem	2	260	parlarem	2	9400	9660	18718
parlàreu	2	6	parlareu	2	56	62	18719
parlés	2	1693	parles	4	3699	5392	18720
parlí	2	26	parli	2	6052	6078	18721
parodiarà	2	1	parodiara	2	0	1	18722
parodià	2	3	parodia	2	355	358	18723
parodiàrem	2	0	parodiarem	2	1	1	18724
parodiés	2	1	parodies	2	27	28	18725
parpellegés	2	2	parpelleges	2	5	7	18726
parpellegí	2	0	parpellegi	2	23	23	18727
parpellejarà	2	18	parpellejara	2	0	18	18728
parpellejà	2	3	parpelleja	2	95	98	18729
parrupà	2	0	parrupa	2	1	1	18730
parteregí	2	1	parteregi	2	0	1	18731
parterejàrem	2	1	parterejarem	2	0	1	18732
participarà	2	8412	participara	2	112	8524	18733
participà	2	7346	participa	2	28341	35687	18734
participàrem	2	122	participarem	2	1444	1566	18735
participàreu	2	13	participareu	2	152	165	18736
participés	2	573	participes	2	523	1096	18737
participí	2	4	participi	2	3659	3663	18738
particularitzà	2	1	particularitza	2	46	47	18739
particularitzàrem	2	0	particularitzarem	2	1	1	18740
particularitzàreu	2	1	particularitzareu	2	0	1	18741
particularitzés	2	1	particularitzes	2	0	1	18742
partionà	2	0	partiona	2	3	3	18743
partioní	2	0	partioni	2	1	1	18744
partirà	2	691	partira	2	8	699	18745
partícip	0	1764	particip	2	89	1853	18746
partírem	2	57	partirem	2	479	536	18747
partíreu	2	0	partireu	2	11	11	18748
parà	2	185	para	4	29825	30010	18749
paràrem	2	29	pararem	2	771	800	18750
paràreu	2	1	parareu	2	36	37	18751
paràsit	0	1229	parasit	2	8	1237	18752
paràsita	0	114	parasita	2	80	194	18753
paràsites	0	99	parasites	2	7	106	18754
parí	2	26	pari	2	1242	1268	18755
parírem	2	0	parirem	2	2	2	18756
paríreu	2	0	parireu	2	4	4	18757
paròdia	4	2082	parodia	2	355	2437	18758
paròdies	4	429	parodies	2	27	456	18759
pasqués	2	0	pasques	2	62	62	18760
passamaní	2	0	passamani	2	1	1	18761
passarà	2	19517	passara	2	516	20033	18762
passegés	2	60	passeges	2	267	327	18763
passegí	2	0	passegi	2	232	232	18764
passejarà	2	216	passejara	2	8	224	18765
passejà	2	217	passeja	2	3085	3302	18766
passejàrem	2	26	passejarem	2	751	777	18767
passejàreu	2	0	passejareu	2	40	40	18768
passivarà	2	1	passivara	2	0	1	18769
passivà	2	1	passiva	0	3841	3842	18770
passivés	2	0	passives	0	952	952	18771
passà	2	10129	passa	4	144748	154877	18772
passàrem	2	403	passarem	2	6381	6784	18773
passàreu	2	11	passareu	2	1482	1493	18774
passés	2	4021	passes	4	12161	16182	18775
passí	2	46	passi	2	19062	19108	18776
passó	4	12	passo	2	6826	6838	18777
pastellà	2	0	pastella	2	3	3	18778
pastellés	2	0	pastelles	2	5	5	18779
pastellí	2	0	pastelli	2	1	1	18780
pasteuritzarà	2	1	pasteuritzara	2	0	1	18781
pasteuritzà	2	0	pasteuritza	2	27	27	18782
pasteuritzàrem	2	0	pasteuritzarem	2	1	1	18783
pasteuritzés	2	0	pasteuritzes	2	1	1	18784
pasturarà	2	30	pasturara	2	0	30	18785
pasturà	2	1	pastura	4	1965	1966	18786
pasturàrem	2	0	pasturarem	2	2	2	18787
pasturés	2	4	pastures	4	3034	3038	18788
pasturí	2	0	pasturi	2	14	14	18789
pastà	2	7	pasta	4	21561	21568	18790
pastàrem	2	1	pastarem	2	17	18	18791
pastés	2	5	pastes	4	2937	2942	18792
pastí	2	10	pasti	2	23	33	18793
pastís	4	15752	pastis	2	821	16573	18794
pastós	0	93	pastos	4	47	140	18795
patentarà	2	2	patentara	2	1	3	18796
patentitzà	2	1	patentitza	2	9	10	18797
patentà	2	49	patenta	4	98	147	18798
patentàrem	2	0	patentarem	2	1	1	18799
patentés	2	9	patentes	4	52	61	18800
patentí	2	0	patenti	2	26	26	18801
patinarà	2	6	patinara	2	0	6	18802
patinà	2	1	patina	2	313	314	18803
patinàrem	2	1	patinarem	2	2	3	18804
patinàreu	2	0	patinareu	2	1	1	18805
patinés	2	6	patines	2	33	39	18806
patiní	2	0	patini	2	13	13	18807
patirà	2	1110	patira	2	45	1155	18808
patollà	2	0	patolla	4	1	1	18809
patologitzà	2	0	patologitza	2	11	11	18810
patologitzí	2	0	patologitzi	2	1	1	18811
patrimonialitzarà	2	1	patrimonialitzara	2	0	1	18812
patrimonialitzà	2	0	patrimonialitza	2	2	2	18813
patrimonialitzí	2	0	patrimonialitzi	2	2	2	18814
patrocinarà	2	113	patrocinara	2	3	116	18815
patrocinà	2	74	patrocina	2	1240	1314	18816
patrocinàrem	2	0	patrocinarem	2	4	4	18817
patrocinés	2	13	patrocines	2	0	13	18818
patrociní	2	1	patrocini	4	6862	6863	18819
patronejà	2	1	patroneja	2	3	4	18820
patrullarà	2	12	patrullara	2	0	12	18821
patrullà	2	7	patrulla	4	3449	3456	18822
patrullàrem	2	0	patrullarem	2	1	1	18823
patrullés	2	4	patrulles	4	2647	2651	18824
patrullí	2	0	patrulli	2	8	8	18825
patí	2	4590	pati	4	34800	39390	18826
patírem	2	36	patirem	2	466	502	18827
patíreu	2	10	patireu	2	56	66	18828
patís	2	498	patis	4	5080	5578	18829
pauperitzà	2	0	pauperitza	2	1	1	18830
pautarà	2	12	pautara	2	0	12	18831
pautà	2	0	pauta	4	2494	2494	18832
pautàrem	2	0	pautarem	2	3	3	18833
pautés	2	0	pautes	4	10888	10888	18834
pautí	2	0	pauti	2	5	5	18835
pavimentarà	2	57	pavimentara	2	0	57	18836
pavimentà	2	13	pavimenta	2	27	40	18837
pavimentàrem	2	0	pavimentarem	2	2	2	18838
pavimentés	2	1	pavimentes	2	0	1	18839
pavimentí	2	0	pavimenti	2	5	5	18840
pavonà	2	0	pavona	2	13	13	18841
pavonés	2	0	pavones	2	9	9	18842
pavoní	2	0	pavoni	2	7	7	18843
paírem	2	0	pairem	2	7	7	18844
pecarà	2	5	pecara	2	0	5	18845
pecà	2	11	peca	2	512	523	18846
pecàrem	2	1	pecarem	2	5	6	18847
pedalarà	2	18	pedalara	2	2	20	18848
pedalegés	2	1	pedaleges	2	15	16	18849
pedalegí	2	0	pedalegi	2	4	4	18850
pedalejarà	2	3	pedalejara	2	0	3	18851
pedalejà	2	0	pedaleja	2	65	65	18852
pedalejàrem	2	0	pedalejarem	2	9	9	18853
pedalejàreu	2	0	pedalejareu	2	5	5	18854
pedalà	2	2	pedala	2	318	320	18855
pedalàrem	2	1	pedalarem	2	75	76	18856
pedalàreu	2	0	pedalareu	2	22	22	18857
pedalés	2	1	pedales	2	138	139	18858
pedalí	2	3	pedali	2	16	19	18859
pedregarà	2	1	pedregara	2	1	2	18860
pedreguí	2	2	pedregui	2	5	7	18861
pedregà	2	9	pedrega	4	15	24	18862
pedregés	2	0	pedreges	2	1	1	18863
pedregí	2	1	pedregi	2	0	1	18864
pedània	0	53	pedania	4	535	588	18865
pedànies	0	1	pedanies	4	386	387	18866
pegarà	2	42	pegara	2	18	60	18867
pegués	2	27	pegues	0	642	669	18868
peguí	2	0	pegui	2	77	77	18869
pegà	2	99	pega	0	2644	2743	18870
pegàrem	2	16	pegarem	2	41	57	18871
pegàreu	2	0	pegareu	2	3	3	18872
peixarà	2	1	peixara	2	1	2	18873
peixà	2	0	peixa	2	8	8	18874
peixés	2	3	peixes	2	7	10	18875
peixí	2	0	peixi	2	5	5	18876
pelarà	2	6	pelara	2	1	7	18877
pelaí	4	0	pelai	4	725	725	18878
pelegrinarà	2	2	pelegrinara	2	0	2	18879
pelegrinà	2	4	pelegrina	4	317	321	18880
pelegrinàrem	2	1	pelegrinarem	2	0	1	18881
pelegrinàreu	2	1	pelegrinareu	2	0	1	18882
pelegrinés	2	2	pelegrines	4	43	45	18883
pelegriní	2	0	pelegrini	2	4	4	18884
pelfà	2	0	pelfa	4	106	106	18885
pelfés	2	0	pelfes	4	9	9	18886
pellejà	2	45	pelleja	2	1	46	18887
pellicà	2	0	pellica	2	1	1	18888
pellucà	2	0	pelluca	2	1	1	18889
pelluqués	2	0	pelluques	2	1	1	18890
pellà	2	1	pella	4	292	293	18891
pellés	2	1	pelles	4	9	10	18892
pellí	2	0	pelli	2	28	28	18893
pelà	2	19	pela	4	2159	2178	18894
pelàrem	2	2	pelarem	2	187	189	18895
pelàreu	2	0	pelareu	2	6	6	18896
pelés	2	9	peles	4	633	642	18897
pelí	2	15	peli	2	4275	4290	18898
penalitzarà	2	177	penalitzara	2	0	177	18899
penalitzà	2	3	penalitza	2	848	851	18900
penalitzàrem	2	0	penalitzarem	2	4	4	18901
penalitzés	2	16	penalitzes	2	4	20	18902
penalitzí	2	0	penalitzi	2	173	173	18903
penarà	2	5	penara	2	0	5	18904
pencarà	2	1	pencara	2	1	2	18905
pencà	2	0	penca	4	109	109	18906
pencàrem	2	1	pencarem	2	4	5	18907
pendolà	2	0	pendola	2	1	1	18908
pendulà	2	0	pendula	2	38	38	18909
pendulés	2	0	pendules	2	3	3	18910
pendulí	2	0	penduli	2	2	2	18911
penedirà	2	68	penedira	2	1	69	18912
penedí	2	32	penedi	2	0	32	18913
penedírem	2	1	penedirem	2	33	34	18914
penedíreu	2	0	penedireu	2	198	198	18915
penedís	2	20	penedis	2	0	20	18916
penetrarà	2	52	penetrara	2	5	57	18917
penetrà	2	137	penetra	2	1462	1599	18918
penetràrem	2	0	penetrarem	2	12	12	18919
penetràreu	2	0	penetrareu	2	3	3	18920
penetrés	2	74	penetres	2	16	90	18921
penetrí	2	0	penetri	2	281	281	18922
pengés	2	129	penges	2	204	333	18923
pengí	2	1	pengi	2	447	448	18924
penitenciarà	2	1	penitenciara	2	0	1	18925
penitencià	2	0	penitencia	2	66	66	18926
penitenciària	0	882	penitenciaria	2	222	1104	18927
penitenciàries	0	642	penitenciaries	2	64	706	18928
penitenciés	2	0	penitencies	2	4	4	18929
penitència	4	1494	penitencia	2	66	1560	18930
penitències	4	85	penitencies	2	4	89	18931
penjarà	2	650	penjara	2	18	668	18932
penjà	2	93	penja	2	3749	3842	18933
penjàrem	2	10	penjarem	2	1322	1332	18934
penjàreu	2	1	penjareu	2	18	19	18935
penqués	2	0	penques	4	283	283	18936
penquí	2	0	penqui	2	3	3	18937
pensarà	2	901	pensara	2	88	989	18938
pensionà	2	2	pensiona	2	1	3	18939
pensionària	4	1	pensionaria	2	1	2	18940
pensionés	2	1	pensiones	2	177	178	18941
pensioní	2	0	pensioni	2	2	2	18942
pensà	2	689	pensa	4	31187	31876	18943
pensàrem	2	112	pensarem	2	405	517	18944
pensàreu	2	6	pensareu	2	639	645	18945
pensés	2	769	penses	4	7289	8058	18946
pensí	2	47	pensi	2	4231	4278	18947
pentadodecàedre	4	0	pentadodecaedre	4	1	1	18948
pentinarà	2	11	pentinara	2	2	13	18949
pentinà	2	4	pentina	2	394	398	18950
pentinàrem	2	0	pentinarem	2	10	10	18951
pentinés	2	8	pentines	2	19	27	18952
pentiní	2	0	pentini	2	9	9	18953
pentosà	4	0	pentosa	4	36	36	18954
pentà	4	22	penta	4	182	204	18955
pentàedre	4	0	pentaedre	4	2	2	18956
penyorà	2	1	penyora	4	829	830	18957
penyorés	2	0	penyores	4	101	101	18958
penà	2	8	pena	4	53773	53781	18959
penés	2	0	penes	4	12925	12925	18960
penó	4	615	peno	2	22	637	18961
peonà	2	0	peona	4	240	240	18962
peonés	2	0	peones	4	24	24	18963
peoní	2	0	peoni	2	3	3	18964
pequés	2	3	peques	2	763	766	18965
pequí	2	3	pequi	2	23	26	18966
peraltà	2	0	peralta	4	893	893	18967
peraltés	2	0	peraltes	4	21	21	18968
peraltí	2	0	peralti	2	1	1	18969
perbocà	2	0	perboca	2	13	13	18970
perboquí	2	0	perboqui	2	1	1	18971
percacés	2	1	percaces	4	1	2	18972
percací	2	0	percaci	2	2	2	18973
percaçarà	2	1	percaçara	2	0	1	18974
percaçà	2	2	percaça	4	50	52	18975
percebré	2	3	percebre	2	8087	8090	18976
percebé	2	29	percebe	4	94	123	18977
percebés	2	58	percebes	4	74	132	18978
percebí	2	2	percebi	2	549	551	18979
percolà	2	0	percola	2	10	10	18980
percolí	2	1	percoli	2	0	1	18981
percudirà	2	1	percudira	2	0	1	18982
percudí	2	4	percudi	2	0	4	18983
perdonarà	2	272	perdonara	2	5	277	18984
perdonà	2	84	perdona	2	2883	2967	18985
perdonàrem	2	1	perdonarem	2	58	59	18986
perdonàreu	2	0	perdonareu	2	490	490	18987
perdonés	2	65	perdones	2	93	158	18988
perdoní	2	0	perdoni	2	871	871	18989
perdré	2	339	perdre	2	86160	86499	18990
perdurarà	2	516	perdurara	2	8	524	18991
perdurà	2	304	perdura	2	1836	2140	18992
perduràrem	2	0	perdurarem	2	2	2	18993
perdurés	2	50	perdures	2	6	56	18994
perdurí	2	0	perduri	2	477	477	18995
perdés	2	1390	perdes	2	166	1556	18996
perdí	2	27	perdi	2	4463	4490	18997
perdó	4	9149	perdo	2	1709	10858	18998
peregrinarà	2	3	peregrinara	2	0	3	18999
peregrinà	2	7	peregrina	2	288	295	19000
peregrinàrem	2	0	peregrinarem	2	3	3	19001
peregrinés	2	1	peregrines	2	74	75	19002
peregriní	2	0	peregrini	2	21	21	19003
perfeccionarà	2	35	perfeccionara	2	0	35	19004
perfeccionà	2	130	perfecciona	2	321	451	19005
perfeccionàrem	2	0	perfeccionarem	2	20	20	19006
perfeccionés	2	12	perfecciones	2	7	19	19007
perfeccioní	2	0	perfeccioni	2	37	37	19008
perfilarà	2	31	perfilara	2	0	31	19009
perfilà	2	11	perfila	2	1006	1017	19010
perfilàrem	2	0	perfilarem	2	10	10	19011
perfilés	2	4	perfiles	2	103	107	19012
perfilí	2	0	perfili	2	33	33	19013
perfondré	2	0	perfondre	2	2	2	19014
perforarà	2	16	perforara	2	1	17	19015
perforà	2	9	perfora	2	169	178	19016
perforàrem	2	0	perforarem	2	3	3	19017
perforés	2	8	perfores	2	2	10	19018
perforí	2	0	perfori	2	18	18	19019
perfumarà	2	6	perfumara	2	0	6	19020
perfumà	2	5	perfuma	2	107	112	19021
perfumàrem	2	0	perfumarem	2	6	6	19022
perfumés	2	1	perfumes	2	29	30	19023
perfumí	2	0	perfumi	2	6	6	19024
perféu	2	0	perfeu	2	1	1	19025
pergelisòl	4	9	pergelisol	4	4	13	19026
periclità	2	0	periclita	2	1	1	19027
periclití	2	0	pericliti	2	1	1	19028
perifrasí	2	0	perifrasi	2	3	3	19029
perillarà	2	16	perillara	2	1	17	19030
perillà	2	14	perilla	2	695	709	19031
perillàrem	2	0	perillarem	2	2	2	19032
perillàreu	2	0	perillareu	2	1	1	19033
perillés	2	27	perilles	2	18	45	19034
perillí	2	0	perilli	2	70	70	19035
periodificà	2	1	periodifica	2	3	4	19036
perioditzà	2	0	perioditza	2	1	1	19037
perioditzí	2	0	perioditzi	2	1	1	19038
perirà	2	9	perira	2	1	10	19039
perità	2	0	perita	0	19	19	19040
perités	2	1	perites	0	6	7	19041
perití	2	0	periti	2	1	1	19042
perjudicarà	2	434	perjudicara	2	10	444	19043
perjudicà	2	43	perjudica	2	3457	3500	19044
perjudicàrem	2	0	perjudicarem	2	21	21	19045
perjudicàreu	2	0	perjudicareu	2	3	3	19046
perjudiqués	2	83	perjudiques	2	24	107	19047
perjudiquí	2	0	perjudiqui	2	672	672	19048
perjurà	2	2	perjura	0	20	22	19049
perjurés	2	1	perjures	0	1	2	19050
perjurí	2	0	perjuri	2	78	78	19051
perlejà	2	0	perleja	2	2	2	19052
perllongarà	2	563	perllongara	2	5	568	19053
perllongués	2	27	perllongues	4	10	37	19054
perllonguí	2	0	perllongui	2	85	85	19055
perllongà	2	193	perllonga	4	719	912	19056
perllongàrem	2	0	perllongarem	2	3	3	19057
perlés	0	11	perles	4	3932	3943	19058
permeabilitzà	2	0	permeabilitza	2	6	6	19059
permeabilitzàrem	2	0	permeabilitzarem	2	1	1	19060
permeabilitzí	2	0	permeabilitzi	2	1	1	19061
permetré	2	368	permetre	2	68509	68877	19062
permetés	2	3354	permetes	2	28	3382	19063
permetí	2	20	permeti	2	28892	28912	19064
permutarà	2	3	permutara	2	0	3	19065
permutà	2	27	permuta	4	777	804	19066
permutés	2	1	permutes	4	194	195	19067
permutí	2	0	permuti	2	2	2	19068
pernabatré	2	0	pernabatre	2	1	1	19069
pernoctarà	2	13	pernoctara	2	0	13	19070
pernoctà	2	10	pernocta	2	285	295	19071
pernoctàrem	2	1	pernoctarem	2	30	31	19072
pernoctàreu	2	0	pernoctareu	2	1	1	19073
pernoctés	2	0	pernoctes	2	63	63	19074
pernoctí	2	0	pernocti	2	17	17	19075
pernolií	2	1	pernolii	2	0	1	19076
perorà	2	0	perora	2	1	1	19077
peroxidà	2	0	peroxida	2	1	1	19078
perpetrarà	2	8	perpetrara	2	0	8	19079
perpetrà	2	36	perpetra	2	156	192	19080
perpetràrem	2	0	perpetrarem	2	2	2	19081
perpetrés	2	17	perpetres	2	1	18	19082
perpetrí	2	0	perpetri	2	18	18	19083
perpetuarà	2	67	perpetuara	2	0	67	19084
perpetuà	2	15	perpetua	2	1170	1185	19085
perpetuàrem	2	0	perpetuarem	2	5	5	19086
perpetués	2	18	perpetues	2	17	35	19087
perquès	4	538	perques	4	35	573	19088
perseguirà	2	515	perseguira	2	14	529	19089
perseguírem	2	0	perseguirem	2	47	47	19090
perseguíreu	2	0	perseguireu	2	1	1	19091
perseverarà	2	11	perseverara	2	1	12	19092
perseverà	2	11	persevera	2	123	134	19093
perseveràrem	2	0	perseverarem	2	11	11	19094
perseverés	2	8	perseveres	2	11	19	19095
perseverí	2	0	perseveri	2	38	38	19096
persignà	2	2	persigna	2	4	6	19097
persignés	2	1	persignes	2	0	1	19098
persistirà	2	150	persistira	2	8	158	19099
persistírem	2	0	persistirem	2	64	64	19100
personalitzarà	2	26	personalitzara	2	4	30	19101
personalitzà	2	4	personalitza	2	914	918	19102
personalitzàrem	2	0	personalitzarem	2	41	41	19103
personalitzàreu	2	0	personalitzareu	2	2	2	19104
personalitzés	2	10	personalitzes	2	18	28	19105
personalitzí	2	0	personalitzi	2	84	84	19106
personarà	2	158	personara	2	7	165	19107
personificarà	2	7	personificara	2	0	7	19108
personificà	2	8	personifica	2	299	307	19109
personificàrem	2	0	personificarem	2	3	3	19110
personifiqués	2	3	personifiques	2	3	6	19111
personifiquí	2	0	personifiqui	2	6	6	19112
personà	2	27	persona	4	223355	223382	19113
personàrem	2	3	personarem	2	5	8	19114
personés	2	38	persones	4	743328	743366	19115
personí	2	0	personi	2	105	105	19116
persuadirà	2	5	persuadira	2	1	6	19117
persuadírem	2	0	persuadirem	2	2	2	19118
persà	0	1	persa	0	3330	3331	19119
pertangués	2	6	pertangues	2	2	8	19120
pertanguí	2	1	pertangui	2	1	2	19121
pertanyerà	2	53	pertanyera	2	2	55	19122
pertanyérem	2	0	pertanyerem	2	1	1	19123
pertanyés	2	106	pertanyes	2	10	116	19124
pertanyí	2	3	pertanyi	2	754	757	19125
pertocarà	2	58	pertocara	2	1	59	19126
pertocà	2	9	pertoca	2	3613	3622	19127
pertoqués	2	14	pertoques	2	0	14	19128
pertoquí	2	0	pertoqui	2	529	529	19129
pertorbarà	2	25	pertorbara	2	0	25	19130
pertorbà	2	10	pertorba	2	274	284	19131
pertorbés	2	17	pertorbes	2	3	20	19132
pertorbí	2	0	pertorbi	2	109	109	19133
pervertirà	2	1	pervertira	2	0	1	19134
pervertírem	2	0	pervertirem	2	1	1	19135
pervindré	2	2	pervindre	2	71	73	19136
pervingués	2	5	pervingues	2	0	5	19137
pervinguí	2	0	pervingui	2	8	8	19138
pervisqués	2	2	pervisques	2	0	2	19139
pervisquí	2	0	pervisqui	2	17	17	19140
perviuré	2	0	perviure	2	263	263	19141
perxà	2	0	perxa	4	1511	1511	19142
perxés	2	50	perxes	4	489	539	19143
perxí	2	0	perxi	2	2	2	19144
perífrasi	4	160	perifrasi	2	3	163	19145
perífrasis	4	121	perifrasis	2	8	129	19146
perírem	2	0	perirem	2	1	1	19147
perís	2	21	peris	4	3555	3576	19148
peròxid	4	390	peroxid	2	0	390	19149
pesarà	2	167	pesara	2	10	177	19150
pescallà	2	1	pescalla	2	0	1	19151
pescarà	2	16	pescara	4	154	170	19152
pescà	2	3	pesca	4	33092	33095	19153
pescàrem	2	0	pescarem	2	8	8	19154
pescàreu	2	0	pescareu	2	7	7	19155
pesqués	2	11	pesques	4	91	102	19156
pesquí	2	0	pesqui	2	42	42	19157
pessigarà	2	2	pessigara	2	0	2	19158
pessigollejarà	2	1	pessigollejara	2	0	1	19159
pessigollejà	2	0	pessigolleja	2	14	14	19160
pessigués	2	4	pessigues	2	12	16	19161
pessiguí	2	0	pessigui	2	12	12	19162
pessigà	2	3	pessiga	2	84	87	19163
pessigàrem	2	0	pessigarem	2	3	3	19164
pestanyegés	2	1	pestanyeges	2	0	1	19165
pestanyejà	2	1	pestanyeja	2	3	4	19166
pesà	2	31	pesa	2	4336	4367	19167
pesàrem	2	1	pesarem	2	42	43	19168
pesàreu	2	0	pesareu	2	2	2	19169
pesés	2	65	peses	2	648	713	19170
pesí	2	0	pesi	2	1000	1000	19171
petardejarà	2	1	petardejara	2	0	1	19172
petardejà	2	0	petardeja	2	2	2	19173
petardejàrem	2	0	petardejarem	2	1	1	19174
petarrellejà	2	0	petarrelleja	2	2	2	19175
petarà	2	92	petara	2	0	92	19176
petaré	2	9	petare	4	2	11	19177
petgés	2	0	petges	4	211	211	19178
petgí	2	0	petgi	2	2	2	19179
peticionà	2	3	peticiona	2	4	7	19180
peticionària	0	45	peticionaria	2	2	47	19181
peticionàries	0	20	peticionaries	2	1	21	19182
peticionés	2	0	peticiones	2	25	25	19183
petjà	2	1	petja	4	1124	1125	19184
petonegés	2	1	petoneges	2	2	3	19185
petonegí	2	0	petonegi	2	4	4	19186
petonejà	2	5	petoneja	2	42	47	19187
petonejàrem	2	0	petonejarem	2	1	1	19188
petrificarà	2	1	petrificara	2	1	2	19189
petrificà	2	2	petrifica	2	26	28	19190
petrifiqués	2	0	petrifiques	2	1	1	19191
petrifiquí	2	0	petrifiqui	2	4	4	19192
petà	2	10	peta	2	517	527	19193
petàrem	2	1	petarem	2	26	27	19194
petàreu	2	0	petareu	2	3	3	19195
petés	2	36	petes	2	41	77	19196
petí	2	2	peti	2	736	738	19197
petó	4	5992	peto	2	486	6478	19198
peüllà	2	0	peülla	4	131	131	19199
peüllés	2	0	peülles	4	212	212	19200
picarà	2	62	picara	2	11	73	19201
picolà	2	0	picola	4	103	103	19202
picolàrem	2	0	picolarem	2	1	1	19203
picolés	2	0	picoles	4	11	11	19204
picolí	2	2	picoli	2	2	4	19205
piconarà	2	1	piconara	2	0	1	19206
piconà	2	0	picona	4	2	2	19207
piconàreu	2	0	piconareu	2	1	1	19208
piconés	2	0	picones	4	5	5	19209
picossejà	2	0	picosseja	2	1	1	19210
picotegí	2	0	picotegi	2	1	1	19211
picotejarà	2	1	picotejara	2	0	1	19212
picotejà	2	0	picoteja	2	38	38	19213
picà	2	45	pica	4	7602	7647	19214
picàrem	2	0	picarem	2	147	147	19215
picàreu	2	0	picareu	2	5	5	19216
pidolà	2	3	pidola	2	26	29	19217
pidolàreu	2	0	pidolareu	2	1	1	19218
pidolés	2	0	pidoles	2	1	1	19219
pidolí	2	0	pidoli	2	2	2	19220
pidoló	0	0	pidolo	2	1	1	19221
pifià	2	0	pifia	2	31	31	19222
pifiés	2	0	pifies	2	16	16	19223
pigmentà	2	0	pigmenta	2	12	12	19224
pigmentàreu	2	0	pigmentareu	2	1	1	19225
pigmentària	0	133	pigmentaria	2	14	147	19226
pigmentàries	0	50	pigmentaries	2	1	51	19227
pigmentí	2	3	pigmenti	2	4	7	19228
pignorarà	2	1	pignorara	2	0	1	19229
pignorà	2	0	pignora	2	3	3	19230
pillardegí	2	1	pillardegi	2	0	1	19231
pillarà	2	15	pillara	2	10	25	19232
pillà	2	9	pilla	4	235	244	19233
pillàrem	2	1	pillarem	2	9	10	19234
pillàreu	2	0	pillareu	2	6	6	19235
pillés	2	6	pilles	4	52	58	19236
pillí	2	0	pilli	2	23	23	19237
pilonà	2	0	pilona	4	267	267	19238
pilonés	2	0	pilones	4	698	698	19239
piloní	2	0	piloni	2	2	2	19240
pilotarà	2	60	pilotara	2	0	60	19241
pilotegí	2	1	pilotegi	2	0	1	19242
pilotejà	2	0	piloteja	2	1	1	19243
pilotà	2	28	pilota	4	30137	30165	19244
pilotàrem	2	1	pilotarem	2	2	3	19245
pilotés	2	6	pilotes	4	6156	6162	19246
pilotí	2	5	piloti	2	21	26	19247
pincés	2	2	pinces	4	1757	1759	19248
pincí	2	0	pinci	2	5	5	19249
pinellà	0	0	pinella	4	23	23	19250
pintarà	2	272	pintara	2	17	289	19251
pinterià	0	4	pinteria	4	0	4	19252
pintà	2	544	pinta	4	11249	11793	19253
pintàrem	2	13	pintarem	2	326	339	19254
pintàreu	2	0	pintareu	2	20	20	19255
pintés	2	133	pintes	4	833	966	19256
pintí	2	1	pinti	2	177	178	19257
pinxà	2	1	pinxa	2	35	36	19258
pinxés	2	0	pinxes	2	40	40	19259
pinyolà	2	2	pinyola	4	14	16	19260
pinyolés	2	0	pinyoles	4	4	4	19261
pinyolí	2	3	pinyoli	2	0	3	19262
pinzellà	2	0	pinzella	2	15	15	19263
pinzellàrem	2	0	pinzellarem	2	1	1	19264
pinzellés	2	0	pinzelles	2	2	2	19265
pinà	4	2	pina	4	1515	1517	19266
pinçarà	2	1	pinçara	2	0	1	19267
pinçà	2	8	pinça	4	1185	1193	19268
pinçàrem	2	0	pinçarem	2	1	1	19269
pipellejà	2	0	pipelleja	2	2	2	19270
pipetegí	2	0	pipetegi	2	1	1	19271
pipà	2	0	pipa	4	2562	2562	19272
pipés	2	0	pipes	4	1268	1268	19273
pipí	2	1169	pipi	2	533	1702	19274
pipó	4	21	pipo	2	229	250	19275
piqué	4	4518	pique	2	236	4754	19276
piqués	2	75	piques	4	1221	1296	19277
piquí	2	0	piqui	2	204	204	19278
pirarà	2	0	pirara	2	1	1	19279
pirategés	2	0	pirateges	2	4	4	19280
pirategí	2	0	pirategi	2	4	4	19281
piratejarà	2	2	piratejara	2	0	2	19282
piratejà	2	1	pirateja	2	21	22	19283
piratejàrem	2	0	piratejarem	2	1	1	19284
piritòedre	4	0	piritoedre	4	1	1	19285
pirogravà	2	0	pirograva	2	3	3	19286
pirà	2	3	pira	4	605	608	19287
piràrem	2	0	pirarem	2	2	2	19288
pirè	4	18	pire	2	21	39	19289
piré	4	2	pire	2	21	23	19290
pirés	2	2	pires	4	363	365	19291
pirí	2	2	piri	2	182	184	19292
pisarà	2	0	pisara	2	1	1	19293
piscà	2	0	pisca	2	70	70	19294
piscàrem	2	0	piscarem	2	2	2	19295
pisparà	2	6	pispara	2	0	6	19296
pispà	2	1	pispa	2	105	106	19297
pispàrem	2	1	pisparem	2	2	3	19298
pispés	2	6	pispes	2	75	81	19299
pispí	2	0	pispi	2	2	2	19300
pisés	2	0	pises	4	14	14	19301
pisí	2	0	pisi	2	9	9	19302
pitejà	2	0	piteja	2	2	2	19303
pitgés	2	7	pitges	4	17	24	19304
pitgí	2	3	pitgi	2	20	23	19305
pitjarà	2	5	pitjara	2	0	5	19306
pitjorarà	2	1	pitjorara	2	0	1	19307
pitjorà	2	0	pitjora	4	2	2	19308
pitjorés	2	0	pitjores	4	2	2	19309
pitjà	2	4	pitja	4	138	142	19310
pitjàrem	2	0	pitjarem	2	10	10	19311
pitjàreu	2	0	pitjareu	2	1	1	19312
piularà	2	9	piulara	2	1	10	19313
piulà	2	3	piula	4	300	303	19314
piulàrem	2	0	piularem	2	6	6	19315
piulés	2	7	piules	4	84	91	19316
piulí	2	1	piuli	2	18	19	19317
piuló	4	3	piulo	2	21	24	19318
piuà	2	6	piua	2	5	11	19319
pivotarà	2	77	pivotara	2	0	77	19320
pivotà	2	1	pivota	2	356	357	19321
pivotés	2	5	pivotes	2	1	6	19322
pivotí	2	0	pivoti	2	33	33	19323
pixarà	2	2	pixara	2	0	2	19324
pixelà	2	0	pixela	2	20	20	19325
pixelés	2	0	pixeles	2	12	12	19326
pixelí	2	0	pixeli	2	3	3	19327
pixà	2	6	pixa	4	319	325	19328
pixàrem	2	1	pixarem	2	4	5	19329
pixàreu	2	0	pixareu	2	5	5	19330
pixés	2	6	pixes	4	62	68	19331
pixí	2	1	pixi	2	69	70	19332
placà	2	2	placa	4	15253	15255	19333
placés	2	5	places	4	60446	60451	19334
plací	2	0	placi	2	7	7	19335
plagarà	2	0	plagara	2	1	1	19336
plagià	2	4	plagia	2	36	40	19337
plagiària	0	2	plagiaria	2	0	2	19338
plagiés	2	2	plagies	2	1	3	19339
plaguejà	2	0	plagueja	2	2	2	19340
plagué	2	19	plague	2	36	55	19341
plagués	2	46	plagues	4	4446	4492	19342
plaguí	2	1	plagui	2	441	442	19343
plagà	2	0	plaga	4	4585	4585	19344
planarà	2	29	planara	2	3	32	19345
planegés	2	15	planeges	2	49	64	19346
planegí	2	0	planegi	2	39	39	19347
planejarà	2	21	planejara	2	4	25	19348
planejà	2	132	planeja	2	1802	1934	19349
planejàrem	2	1	planejarem	2	36	37	19350
plangués	2	1	plangues	2	0	1	19351
planificarà	2	116	planificara	2	1	117	19352
planificà	2	40	planifica	2	1272	1312	19353
planificàrem	2	2	planificarem	2	82	84	19354
planificàreu	2	0	planificareu	2	5	5	19355
planifiqués	2	19	planifiques	2	56	75	19356
planifiquí	2	1	planifiqui	2	181	182	19357
plantarà	2	300	plantara	2	16	316	19358
plantegés	2	406	planteges	2	576	982	19359
plantegí	2	2	plantegi	2	1720	1722	19360
plantejarà	2	1334	plantejara	2	25	1359	19361
plantejà	2	532	planteja	2	28342	28874	19362
plantejàrem	2	82	plantejarem	2	463	545	19363
plantejàreu	2	0	plantejareu	2	12	12	19364
plantificarà	2	1	plantificara	2	0	1	19365
plantificà	2	1	plantifica	2	22	23	19366
plantifiqués	2	0	plantifiques	2	3	3	19367
plantifiquí	2	0	plantifiqui	2	2	2	19368
plantà	2	690	planta	4	81170	81860	19369
plantàrem	2	21	plantarem	2	311	332	19370
plantàreu	2	0	plantareu	2	11	11	19371
plantés	2	91	plantes	4	54657	54748	19372
plantí	2	5	planti	2	210	215	19373
plantó	4	21	planto	2	218	239	19374
planxarà	2	1	planxara	2	0	1	19375
planxà	2	1	planxa	4	6099	6100	19376
planxàrem	2	0	planxarem	2	1	1	19377
planxàreu	2	1	planxareu	2	0	1	19378
planxés	2	3	planxes	4	1872	1875	19379
planxí	2	0	planxi	2	9	9	19380
planyerà	2	3	planyera	2	0	3	19381
planyérem	2	0	planyerem	2	2	2	19382
planyés	2	3	planyes	2	3	6	19383
planyí	2	1	planyi	2	12	13	19384
planà	2	13	plana	4	38256	38269	19385
planàrem	2	1	planarem	2	1	2	19386
planària	0	21	planaria	2	11	32	19387
planàries	0	70	planaries	2	3	73	19388
planés	2	18	planes	4	12576	12594	19389
planí	2	0	plani	2	37	37	19390
planó	4	0	plano	2	377	377	19391
plaqué	4	2	plaque	2	39	41	19392
plaqués	2	1	plaques	4	11532	11533	19393
plaquí	2	0	plaqui	2	1	1	19394
plasmarà	2	166	plasmara	2	5	171	19395
plasmà	2	122	plasma	4	7120	7242	19396
plasmàrem	2	0	plasmarem	2	32	32	19397
plasmés	2	27	plasmes	4	114	141	19398
plasmí	2	0	plasmi	2	116	116	19399
plasmó	4	9	plasmo	2	25	34	19400
plastificarà	2	1	plastificara	2	0	1	19401
plastificà	2	0	plastifica	2	9	9	19402
plastificàrem	2	0	plastificarem	2	6	6	19403
plastifiqués	2	0	plastifiques	2	4	4	19404
plategés	2	3	plateges	2	4	7	19405
plategí	2	0	plategi	2	3	3	19406
platejarà	2	8	platejara	2	0	8	19407
platejà	2	2	plateja	2	45	47	19408
platejàrem	2	1	platejarem	2	2	3	19409
platinà	2	0	platina	4	165	165	19410
platinés	2	0	platines	4	100	100	19411
platiní	2	0	platini	2	96	96	19412
platonàreu	2	1	platonareu	2	0	1	19413
plauré	2	1	plaure	2	405	406	19414
plaçà	2	8	plaça	4	201866	201874	19415
plebiscità	2	0	plebiscita	2	1	1	19416
plebiscitària	0	138	plebiscitaria	2	3	141	19417
plebiscitàries	0	1299	plebiscitaries	2	6	1305	19418
plebiscití	2	0	plebisciti	2	1	1	19419
pledegés	2	1	pledeges	2	0	1	19420
pledegí	2	0	pledegi	2	1	1	19421
pledejà	2	20	pledeja	2	13	33	19422
pledejàrem	2	1	pledejarem	2	0	1	19423
plegarà	2	95	plegara	2	1	96	19424
plegués	2	85	plegues	4	61	146	19425
pleguí	2	0	plegui	2	279	279	19426
plegà	2	37	plega	4	1061	1098	19427
plegàrem	2	3	plegarem	2	40	43	19428
plegàreu	2	0	plegareu	2	1	1	19429
plegó	4	1	plego	2	206	207	19430
plisà	2	0	plisa	2	1	1	19431
plisí	2	0	plisi	2	1	1	19432
plomarà	2	2	plomara	2	0	2	19433
plomegí	2	1	plomegi	2	0	1	19434
plomà	2	1	ploma	4	4945	4946	19435
plomés	2	0	plomes	4	3658	3658	19436
plomí	2	134	plomi	2	4	138	19437
plomís	0	20	plomis	2	1	21	19438
plorarà	2	89	plorara	2	9	98	19439
ploricà	2	0	plorica	2	1	1	19440
ploricó	0	56	plorico	2	0	56	19441
plorinyà	2	0	plorinya	2	1	1	19442
ploriquegés	2	1	ploriqueges	2	0	1	19443
ploriquegí	2	0	ploriquegi	2	1	1	19444
ploriquejarà	2	1	ploriquejara	2	0	1	19445
ploriquejà	2	0	ploriqueja	2	19	19	19446
ploriquejàrem	2	1	ploriquejarem	2	0	1	19447
plorà	2	82	plora	2	2114	2196	19448
ploràrem	2	9	plorarem	2	64	73	19449
ploràreu	2	2	plorareu	2	32	34	19450
plorés	2	58	plores	2	229	287	19451
plorí	2	5	plori	2	190	195	19452
ploró	0	6	ploro	2	456	462	19453
plotejà	2	0	ploteja	2	8	8	19454
plovinejà	2	0	plovineja	2	8	8	19455
ploviscà	2	0	plovisca	2	1	1	19456
ploviscàreu	2	1	ploviscareu	2	0	1	19457
ploviscó	4	3	plovisco	2	0	3	19458
plovisquegés	2	1	plovisqueges	2	1	2	19459
plovisquejarà	2	29	plovisquejara	2	0	29	19460
plovisquejà	2	1	plovisqueja	2	56	57	19461
plujà	0	52	pluja	4	34849	34901	19462
plujós	0	1721	plujos	0	31	1752	19463
pluralitzà	2	0	pluralitza	2	7	7	19464
plàtera	4	176	platera	4	47	223	19465
plàteres	4	15	plateres	4	1	16	19466
plèroma	4	2	pleroma	4	16	18	19467
poarà	2	1	poara	2	2	3	19468
poblarà	2	9	poblara	2	2	11	19469
poblejà	2	0	pobleja	2	1	1	19470
poblà	2	40	pobla	4	14964	15004	19471
poblàreu	2	1	poblareu	2	1	2	19472
poblés	2	6	pobles	4	76165	76171	19473
poblí	2	0	pobli	2	8	8	19474
poboledà	0	1	poboleda	4	569	570	19475
pobrejà	2	0	pobreja	2	1	1	19476
podarà	2	8	podara	2	1	9	19477
poderegés	2	0	podereges	2	1	1	19478
poderejà	2	0	podereja	2	1	1	19479
poderejàreu	2	1	poderejareu	2	0	1	19480
podrirà	2	27	podrira	2	1	28	19481
podrírem	2	2	podrirem	2	10	12	19482
podríreu	2	0	podrireu	2	1	1	19483
podà	2	10	poda	4	2339	2349	19484
podàrem	2	0	podarem	2	9	9	19485
podària	4	5	podaria	2	4	9	19486
podés	2	234	podes	4	416	650	19487
podí	2	21	podi	2	8049	8070	19488
poetitzarà	2	1	poetitzara	2	0	1	19489
poetitzà	2	3	poetitza	2	46	49	19490
poetitzàrem	2	0	poetitzarem	2	3	3	19491
poetitzés	2	0	poetitzes	2	2	2	19492
poetà	2	1	poeta	4	39360	39361	19493
poetés	2	0	poetes	4	15170	15170	19494
poetí	2	0	poeti	2	41	41	19495
polaritzarà	2	5	polaritzara	2	0	5	19496
polaritzà	2	9	polaritza	2	109	118	19497
polaritzés	2	0	polaritzes	2	2	2	19498
polaritzí	2	0	polaritzi	2	11	11	19499
polemitzarà	2	2	polemitzara	2	0	2	19500
polemitzà	2	52	polemitza	2	46	98	19501
polemitzàrem	2	0	polemitzarem	2	1	1	19502
polemitzí	2	2	polemitzi	2	6	8	19503
policromà	2	3	policroma	0	100	103	19504
policromés	2	0	policromes	0	60	60	19505
policromí	2	0	policromi	2	6	6	19506
polimeritzarà	2	1	polimeritzara	2	0	1	19507
polimeritzà	2	1	polimeritza	2	20	21	19508
polimeritzí	2	0	polimeritzi	2	2	2	19509
polirà	2	15	polira	2	1	16	19510
politiquegí	2	0	politiquegi	2	1	1	19511
politiquejà	2	0	politiqueja	2	1	1	19512
polititzarà	2	2	polititzara	2	0	2	19513
polititzà	2	6	polititza	2	63	69	19514
polititzés	2	3	polititzes	2	1	4	19515
polititzí	2	0	polititzi	2	42	42	19516
pollinà	2	0	pollina	4	24	24	19517
pollinés	2	0	pollines	4	4	4	19518
polliní	2	0	pollini	2	36	36	19519
pollà	2	1	polla	4	994	995	19520
pollés	2	19	polles	4	292	311	19521
pollí	2	108	polli	2	9	117	19522
pollín	2	22	pollin	2	13	35	19523
pollís	4	1	pollis	2	1	2	19524
polpà	2	0	polpa	4	2054	2054	19525
polpés	2	0	polpes	4	32	32	19526
polpí	2	1	polpi	2	0	1	19527
polsarà	2	0	polsara	2	1	1	19528
polsejà	2	0	polseja	2	2	2	19529
polsinà	2	0	polsina	4	32	32	19530
polsinés	2	0	polsines	4	1	1	19531
polsà	2	1	polsa	2	97	98	19532
polsàrem	2	0	polsarem	2	13	13	19533
polsés	2	1	polses	2	13	14	19534
polsí	2	6	polsi	2	16	22	19535
polsín	2	0	polsin	2	4	4	19536
polsós	0	132	polsos	4	449	581	19537
polvoritzà	2	4	polvoritza	2	60	64	19538
polvoritzàrem	2	0	polvoritzarem	2	1	1	19539
polvoritzés	2	0	polvoritzes	2	1	1	19540
polvoritzí	2	0	polvoritzi	2	4	4	19541
polzejàrem	2	1	polzejarem	2	0	1	19542
pol·linitzarà	2	1	pol·linitzara	2	0	1	19543
pol·linitzà	2	0	pol·linitza	2	21	21	19544
pol·linitzí	2	0	pol·linitzi	2	1	1	19545
políedre	4	229	poliedre	4	126	355	19546
políedres	4	175	poliedres	4	143	318	19547
polígens	4	0	poligens	4	3	3	19548
polírem	2	0	polirem	2	16	16	19549
polís	2	8	polis	4	1130	1138	19550
pompeià	0	77	pompeia	4	848	925	19551
pompejà	2	0	pompeja	2	4	4	19552
pompejàreu	2	0	pompejareu	2	1	1	19553
poncellà	2	0	poncella	0	108	108	19554
poncellés	2	0	poncelles	0	92	92	19555
ponderarà	2	37	ponderara	2	0	37	19556
ponderà	2	4	pondera	2	155	159	19557
ponderàrem	2	0	ponderarem	2	2	2	19558
ponderàreu	2	0	ponderareu	2	1	1	19559
ponderí	2	0	ponderi	2	27	27	19560
pondré	2	5	pondre	2	680	685	19561
pongués	2	23	pongues	2	0	23	19562
ponguí	2	0	pongui	2	114	114	19563
pontificà	2	4	pontifica	2	73	77	19564
pontifiqués	2	4	pontifiques	2	4	8	19565
pontifiquí	2	0	pontifiqui	2	10	10	19566
pontà	2	0	ponta	2	162	162	19567
pontàrem	2	0	pontarem	2	1	1	19568
pontés	2	1	pontes	2	104	105	19569
pontó	4	57	ponto	2	56	113	19570
poparà	2	1	popara	2	0	1	19571
popularitzarà	2	18	popularitzara	2	2	20	19572
popularitzà	2	158	popularitza	2	139	297	19573
popularitzés	2	41	popularitzes	2	4	45	19574
popularitzí	2	0	popularitzi	2	23	23	19575
popà	2	1	popa	4	1398	1399	19576
popés	2	0	popes	4	142	142	19577
popí	2	0	popi	2	56	56	19578
porcarà	2	0	porcara	2	1	1	19579
porcellà	2	0	porcella	2	169	169	19580
porcellés	2	0	porcelles	2	22	22	19581
porcellí	2	1	porcelli	2	11	12	19582
porcà	2	0	porca	0	312	312	19583
porcí	0	1995	porci	4	87	2082	19584
porcó	0	0	porco	2	104	104	19585
porfidiegés	2	1	porfidieges	2	0	1	19586
porgarà	2	1	porgara	2	0	1	19587
porgués	2	0	porgues	2	30	30	19588
porgà	2	3	porga	2	36	39	19589
porquejarà	2	1	porquejara	2	0	1	19590
porquejà	2	1	porqueja	2	0	1	19591
porqués	2	3	porques	0	51	54	19592
porquí	2	32	porqui	2	7	39	19593
porrerà	0	15	porrera	4	1157	1172	19594
porró	4	719	porro	4	2053	2772	19595
portarà	2	21755	portara	2	358	22113	19596
portegí	2	0	portegi	2	1	1	19597
portejà	2	0	porteja	2	6	6	19598
portejàrem	2	0	portejarem	2	2	2	19599
portellà	0	8	portella	4	2278	2286	19600
portà	2	3520	porta	4	180785	184305	19601
portàrem	2	47	portarem	2	1598	1645	19602
portàreu	2	10	portareu	2	148	158	19603
portàveu	2	35	portaveu	4	39264	39299	19604
portés	2	2067	portes	4	67518	69585	19605
portí	2	31	porti	2	7449	7480	19606
portó	4	55	porto	2	14809	14864	19607
posarà	2	14456	posara	2	303	14759	19608
posicionarà	2	121	posicionara	2	8	129	19609
posicionà	2	89	posiciona	2	1923	2012	19610
posicionàrem	2	3	posicionarem	2	39	42	19611
posicionàreu	2	0	posicionareu	2	2	2	19612
posicionés	2	74	posiciones	2	91	165	19613
posicioní	2	0	posicioni	2	382	382	19614
positivitzà	2	0	positivitza	2	11	11	19615
positivà	2	0	positiva	0	31571	31571	19616
positivés	2	0	positives	0	10238	10238	19617
positiví	2	0	positivi	2	1	1	19618
posposarà	2	48	posposara	2	0	48	19619
posposà	2	25	posposa	2	310	335	19620
posposàrem	2	0	posposarem	2	9	9	19621
posposés	2	40	posposes	2	6	46	19622
posposí	2	0	posposi	2	130	130	19623
possessionà	2	9	possessiona	2	3	12	19624
possessionés	2	2	possessiones	2	2	4	19625
posseírem	2	2	posseirem	2	4	6	19626
posseíreu	2	0	posseireu	2	1	1	19627
possibilitarà	2	520	possibilitara	2	6	526	19628
possibilità	2	156	possibilita	2	3231	3387	19629
possibilitàrem	2	0	possibilitarem	2	14	14	19630
possibilités	2	59	possibilites	2	7	66	19631
possibilití	2	0	possibiliti	2	697	697	19632
postdatà	2	0	postdata	4	155	155	19633
postdatés	2	0	postdates	4	8	8	19634
postergarà	2	5	postergara	2	0	5	19635
postergués	2	2	postergues	2	1	3	19636
posterguí	2	1	postergui	2	9	10	19637
postergà	2	5	posterga	2	26	31	19638
postergàrem	2	0	postergarem	2	1	1	19639
posteritzà	2	0	posteritza	2	5	5	19640
posticà	2	0	postica	2	2	2	19641
postil·là	2	4	postil·la	4	182	186	19642
postil·lés	2	0	postil·les	4	39	39	19643
postprocessà	2	0	postprocessa	2	3	3	19644
postrarà	2	2	postrara	2	0	2	19645
postrà	2	7	postra	2	93	100	19646
postrés	2	0	postres	2	13428	13428	19647
postrí	2	0	postri	2	2	2	19648
posttesà	2	0	posttesa	2	1	1	19649
postularà	2	12	postulara	2	0	12	19650
postulà	2	71	postula	2	866	937	19651
postulés	2	20	postules	2	6	26	19652
postulí	2	0	postuli	2	33	33	19653
posturejà	2	0	postureja	2	1	1	19654
posà	2	4370	posa	4	91337	95707	19655
posàrem	2	248	posarem	2	11087	11335	19656
posàreu	2	4	posareu	2	299	303	19657
posés	2	2537	poses	4	4834	7371	19658
posí	2	15	posi	2	12085	12100	19659
potabilitzarà	2	1	potabilitzara	2	0	1	19660
potabilitzà	2	0	potabilitza	2	26	26	19661
potejà	2	0	poteja	2	1	1	19662
potenciarà	2	899	potenciara	2	6	905	19663
potencià	2	75	potencia	2	5408	5483	19664
potenciàrem	2	1	potenciarem	2	378	379	19665
potenciàreu	2	0	potenciareu	2	7	7	19666
potenciés	2	49	potencies	2	207	256	19667
potencií	2	44	potencii	2	34	78	19668
potinegés	2	1	potineges	2	1	2	19669
potinegí	2	0	potinegi	2	1	1	19670
potinejà	2	0	potineja	2	5	5	19671
potinejàrem	2	0	potinejarem	2	1	1	19672
potrós	0	10	potros	4	59	69	19673
potència	4	23703	potencia	2	5408	29111	19674
potències	4	6275	potencies	2	207	6482	19675
pouarà	2	2	pouara	2	1	3	19676
pouà	2	3	poua	4	131	134	19677
poués	2	1	poues	4	76	77	19678
pouí	2	0	poui	2	2	2	19679
poà	2	1	poa	4	84	85	19680
poàrem	2	0	poarem	2	1	1	19681
poés	2	0	poes	4	8	8	19682
practicarà	2	223	practicara	2	16	239	19683
practicà	2	272	practica	2	7530	7802	19684
practicàrem	2	4	practicarem	2	380	384	19685
practicàreu	2	0	practicareu	2	30	30	19686
practiqués	2	88	practiques	2	1634	1722	19687
practiquí	2	0	practiqui	2	535	535	19688
pradellà	0	0	pradella	4	38	38	19689
prearà	2	1	preara	2	1	2	19690
preassignà	2	0	preassigna	2	2	2	19691
preavisà	2	0	preavisa	2	1	1	19692
preavisí	2	0	preavisi	2	1	1	19693
precalculà	2	0	precalcula	2	2	2	19694
precaritzarà	2	19	precaritzara	2	0	19	19695
precaritzà	2	0	precaritza	2	124	124	19696
precaritzàrem	2	0	precaritzarem	2	1	1	19697
precaritzí	2	0	precaritzi	2	12	12	19698
precarregarà	2	1	precarregara	2	0	1	19699
precarregués	2	0	precarregues	2	1	1	19700
precarreguí	2	0	precarregui	2	1	1	19701
precarregà	2	0	precarrega	2	17	17	19702
precaucionarà	2	0	precaucionara	2	1	1	19703
precaucionàreu	2	1	precaucionareu	2	0	1	19704
precaucionés	2	0	precauciones	2	16	16	19705
precedirà	2	177	precedira	2	3	180	19706
precedíreu	2	0	precedireu	2	1	1	19707
preceptuà	2	1	preceptua	2	78	79	19708
precintarà	2	12	precintara	2	0	12	19709
precintà	2	3	precinta	2	23	26	19710
precintàrem	2	1	precintarem	2	1	2	19711
precintés	2	8	precintes	2	137	145	19712
precintí	2	0	precinti	2	13	13	19713
precipitarà	2	69	precipitara	2	1	70	19714
precipità	2	135	precipita	2	521	656	19715
precipitàrem	2	1	precipitarem	2	1	2	19716
precipités	2	54	precipites	2	11	65	19717
precipití	2	0	precipiti	2	76	76	19718
precisarà	2	269	precisara	2	4	273	19719
precisà	2	40	precisa	2	11144	11184	19720
precisàrem	2	0	precisarem	2	22	22	19721
precisàreu	2	0	precisareu	2	1	1	19722
precisés	2	30	precises	2	3254	3284	19723
precisí	2	0	precisi	2	286	286	19724
preclassificà	2	3	preclassifica	2	0	3	19725
preconcebré	2	0	preconcebre	2	4	4	19726
preconfigurà	2	0	preconfigura	2	3	3	19727
preconfigurí	2	0	preconfiguri	2	1	1	19728
preconitzarà	2	2	preconitzara	2	0	2	19729
preconitzà	2	27	preconitza	2	328	355	19730
preconitzàreu	2	1	preconitzareu	2	0	1	19731
preconitzés	2	1	preconitzes	2	0	1	19732
preconitzí	2	0	preconitzi	2	10	10	19733
precàrrega	4	59	precarrega	2	17	76	19734
precàrregues	4	3	precarregues	2	1	4	19735
predestinarà	2	5	predestinara	2	0	5	19736
predestinà	2	3	predestina	2	2	5	19737
predeterminarà	2	6	predeterminara	2	0	6	19738
predeterminà	2	1	predetermina	2	40	41	19739
predeterminés	2	1	predetermines	2	0	1	19740
predeterminí	2	0	predetermini	2	4	4	19741
predicarà	2	70	predicara	2	2	72	19742
predicà	2	159	predica	2	873	1032	19743
predicàrem	2	1	predicarem	2	6	7	19744
predicàreu	2	1	predicareu	2	2	3	19745
predigués	2	5	predigues	2	3	8	19746
prediguí	2	0	predigui	2	16	16	19747
prediqués	2	21	prediques	2	38	59	19748
prediquí	2	0	prediqui	2	48	48	19749
predisposarà	2	5	predisposara	2	0	5	19750
predisposà	2	6	predisposa	2	401	407	19751
predisposàrem	2	0	predisposarem	2	2	2	19752
predisposàreu	2	0	predisposareu	2	1	1	19753
predisposés	2	1	predisposes	2	7	8	19754
predisposí	2	0	predisposi	2	29	29	19755
predominarà	2	120	predominara	2	1	121	19756
predominà	2	52	predomina	2	3209	3261	19757
predominés	2	22	predomines	2	1	23	19758
predominí	2	1	predomini	2	3327	3328	19759
predís	2	1	predis	4	54	55	19760
preescalfà	2	0	preescalfa	2	51	51	19761
preescalfàrem	2	0	preescalfarem	2	8	8	19762
preescalfés	2	0	preescalfes	2	1	1	19763
preescalfí	2	0	preescalfi	2	1	1	19764
preestablirà	2	4	preestablira	2	0	4	19765
preestrenarà	2	27	preestrenara	2	0	27	19766
preestrenà	2	3	preestrena	4	684	687	19767
preestrenés	2	0	preestrenes	4	119	119	19768
preferirà	2	148	preferira	2	6	154	19769
preferírem	2	4	preferirem	2	32	36	19770
preferíreu	2	0	preferireu	2	22	22	19771
prefigurarà	2	3	prefigurara	2	0	3	19772
prefigurà	2	8	prefigura	2	196	204	19773
prefiguràrem	2	1	prefigurarem	2	0	1	19774
prefigurés	2	1	prefigures	2	0	1	19775
prefigurí	2	0	prefiguri	2	7	7	19776
prefixà	2	0	prefixa	2	20	20	19777
prefixés	2	0	prefixes	2	71	71	19778
pregadéu	4	25	pregadeu	4	5	30	19779
pregadéus	4	32	pregadeus	4	2	34	19780
pregarà	2	30	pregara	2	4	34	19781
pregonarà	2	5	pregonara	2	2	7	19782
pregonà	2	8	pregona	4	718	726	19783
pregonàrem	2	1	pregonarem	2	0	1	19784
pregonés	2	2	pregones	4	160	162	19785
pregoní	2	0	pregoni	2	11	11	19786
preguntarà	2	961	preguntara	2	38	999	19787
preguntà	2	908	pregunta	4	73176	74084	19788
preguntàrem	2	39	preguntarem	2	432	471	19789
preguntàreu	2	0	preguntareu	2	733	733	19790
preguntés	2	353	preguntes	4	62250	62603	19791
preguntí	2	10	pregunti	2	1025	1035	19792
pregués	2	35	pregues	2	17	52	19793
preguí	2	0	pregui	2	108	108	19794
pregà	2	105	prega	2	2108	2213	19795
pregàrem	2	9	pregarem	2	58	67	19796
pregàreu	2	0	pregareu	2	1	1	19797
pregària	4	7793	pregaria	2	546	8339	19798
pregàries	4	1722	pregaries	2	94	1816	19799
pregó	4	6204	prego	2	3264	9468	19800
preinscriguí	2	0	preinscrigui	2	2	2	19801
preinscriuré	2	0	preinscriure	2	262	262	19802
prejubilarà	2	1	prejubilara	2	0	1	19803
prejubilà	2	2	prejubila	2	9	11	19804
prejubilí	2	1	prejubili	2	1	2	19805
prejutgés	2	7	prejutges	2	1	8	19806
prejutgí	2	0	prejutgi	2	6	6	19807
prejutjarà	2	3	prejutjara	2	1	4	19808
prejutjà	2	0	prejutja	2	98	98	19809
prejutjàrem	2	0	prejutjarem	2	2	2	19810
preludiarà	2	3	preludiara	2	0	3	19811
preludià	2	4	preludia	2	45	49	19812
premeditarà	2	1	premeditara	2	0	1	19813
premedità	2	0	premedita	2	5	5	19814
premerà	2	9	premera	2	3	12	19815
premiarà	2	953	premiara	2	5	958	19816
premiàrem	2	1	premiarem	2	54	55	19817
premiàreu	2	0	premiareu	2	3	3	19818
premiés	2	30	premies	2	12	42	19819
premií	2	8	premii	2	19	27	19820
premorí	2	0	premori	2	1	1	19821
premsarà	2	3	premsara	2	0	3	19822
premsà	2	0	premsa	4	77950	77950	19823
premsàrem	2	0	premsarem	2	6	6	19824
premsàreu	2	1	premsareu	2	0	1	19825
premsés	2	0	premses	4	626	626	19826
premsí	2	0	premsi	2	4	4	19827
premérem	2	0	premerem	2	28	28	19828
preméreu	2	0	premereu	2	3	3	19829
premés	2	76	premes	2	2	78	19830
premí	2	23	premi	4	169315	169338	19831
premíem	2	4	premiem	2	137	141	19832
premíeu	2	0	premieu	2	14	14	19833
prendré	2	486	prendre	2	99016	99502	19834
prengués	2	1545	prengues	2	42	1587	19835
prenguí	2	17	prengui	2	6508	6525	19836
prenotí	2	0	prenoti	2	1	1	19837
prenuncià	2	1	prenuncia	2	0	1	19838
prenyarà	2	2	prenyara	2	0	2	19839
prenyà	2	6	prenya	2	11	17	19840
prenyés	2	2	prenyes	2	0	2	19841
prenyí	2	0	prenyi	2	12	12	19842
preocuparà	2	123	preocupara	2	26	149	19843
preocupà	2	160	preocupa	2	14933	15093	19844
preocupàrem	2	2	preocuparem	2	52	54	19845
preocupàreu	2	1	preocupareu	2	2	3	19846
preocupés	2	210	preocupes	2	302	512	19847
preocupí	2	0	preocupi	2	1156	1156	19848
prepararà	2	1168	preparara	2	34	1202	19849
preparà	2	561	prepara	2	16185	16746	19850
preparàrem	2	34	prepararem	2	1106	1140	19851
preparàreu	2	3	preparareu	2	39	42	19852
preparés	2	288	prepares	2	404	692	19853
preparí	2	0	prepari	2	936	936	19854
preponderarà	2	1	preponderara	2	0	1	19855
preponderà	2	1	prepondera	2	7	8	19856
preponderí	2	0	preponderi	2	1	1	19857
preposà	2	1	preposa	2	6	7	19858
preposés	2	0	preposes	2	1	1	19859
preprocessarà	2	1	preprocessara	2	0	1	19860
preprocessà	2	0	preprocessa	2	2	2	19861
preprogramà	2	0	preprograma	2	18	18	19862
prepòster	0	1	preposter	2	0	1	19863
prepòstera	0	1	prepostera	2	0	1	19864
preregistrés	2	0	preregistres	2	15	15	19865
presagiarà	2	2	presagiara	2	1	3	19866
presagià	2	5	presagia	2	170	175	19867
presagiés	2	3	presagies	2	0	3	19868
presagií	2	0	presagii	2	3	3	19869
prescindirà	2	54	prescindira	2	1	55	19870
prescindírem	2	2	prescindirem	2	25	27	19871
prescrigués	2	3	prescrigues	2	0	3	19872
prescriguí	2	0	prescrigui	2	95	95	19873
prescriuré	2	1	prescriure	2	794	795	19874
presenciarà	2	39	presenciara	2	1	40	19875
presencià	2	54	presencia	2	4754	4808	19876
presenciàrem	2	7	presenciarem	2	43	50	19877
presenciàreu	2	0	presenciareu	2	3	3	19878
presenciés	2	10	presencies	2	36	46	19879
presentarà	2	23595	presentara	2	169	23764	19880
presentà	2	4222	presenta	2	104143	108365	19881
presentàrem	2	241	presentarem	2	3345	3586	19882
presentàreu	2	6	presentareu	2	47	53	19883
presentés	2	1858	presentes	2	820	2678	19884
presentí	2	3	presenti	2	6165	6168	19885
preservarà	2	144	preservara	2	5	149	19886
preservà	2	33	preserva	2	1198	1231	19887
preservàrem	2	0	preservarem	2	32	32	19888
preservàreu	2	1	preservareu	2	1	2	19889
preservés	2	56	preserves	2	4	60	19890
preserví	2	0	preservi	2	361	361	19891
presidirà	2	1283	presidira	2	6	1289	19892
presidí	2	929	presidi	4	253	1182	19893
presidíreu	2	0	presidireu	2	1	1	19894
presidís	2	78	presidis	4	54	132	19895
pressentirà	2	0	pressentira	2	1	1	19896
pressentí	2	3	pressenti	2	2	5	19897
pressentís	2	7	pressentis	2	1	8	19898
pressionarà	2	125	pressionara	2	3	128	19899
pressionà	2	90	pressiona	2	1083	1173	19900
pressionàrem	2	0	pressionarem	2	49	49	19901
pressionàreu	2	0	pressionareu	2	2	2	19902
pressionés	2	59	pressiones	2	40	99	19903
pressioní	2	0	pressioni	2	325	325	19904
pressuposarà	2	11	pressuposara	2	0	11	19905
pressupostarà	2	15	pressupostara	2	1	16	19906
pressupostà	2	4	pressuposta	2	95	99	19907
pressupostàrem	2	0	pressupostarem	2	3	3	19908
pressupostària	0	12196	pressupostaria	2	332	12528	19909
pressupostàries	0	7101	pressupostaries	2	122	7223	19910
pressupostés	2	2	pressupostes	2	11	13	19911
pressupostí	2	5	pressuposti	2	15	20	19912
pressuposà	2	0	pressuposa	2	1587	1587	19913
pressuposàrem	2	0	pressuposarem	2	1	1	19914
pressuposés	2	0	pressuposes	2	15	15	19915
pressuposí	2	0	pressuposi	2	30	30	19916
pressuritzà	2	0	pressuritza	2	9	9	19917
prestarà	2	995	prestara	2	24	1019	19918
prestigiarà	2	6	prestigiara	2	1	7	19919
prestigià	2	1	prestigia	2	71	72	19920
prestigiàrem	2	0	prestigiarem	2	3	3	19921
prestigiés	2	1	prestigies	2	0	1	19922
prestà	2	175	presta	4	7808	7983	19923
prestàrem	2	1	prestarem	2	139	140	19924
prestàreu	2	0	prestareu	2	2	2	19925
prestés	2	194	prestes	0	78	272	19926
prestí	2	1	presti	2	1365	1366	19927
presumirà	2	71	presumira	2	2	73	19928
presumí	2	7	presumi	2	0	7	19929
presumírem	2	0	presumirem	2	2	2	19930
presumíreu	2	0	presumireu	2	1	1	19931
presumís	2	5	presumis	2	1	6	19932
presència	4	124982	presencia	2	4754	129736	19933
presències	4	818	presencies	2	36	854	19934
pretendré	2	19	pretendre	2	4062	4081	19935
pretengués	2	175	pretengues	2	4	179	19936
pretenguí	2	2	pretengui	2	1394	1396	19937
pretesà	2	0	pretesa	2	1351	1351	19938
pretesés	2	0	preteses	2	254	254	19939
pretextà	2	0	pretexta	4	12	12	19940
pretextés	2	0	pretextes	4	19	19	19941
pretèrit	0	399	preterit	2	26	425	19942
pretèrits	0	310	preterits	2	22	332	19943
preuà	2	0	preua	2	8	8	19944
preués	2	5	preues	2	1	6	19945
preuí	2	2	preui	2	22	24	19946
prevaldré	2	5	prevaldre	2	886	891	19947
prevalgués	2	69	prevalgues	2	1	70	19948
prevalguí	2	0	prevalgui	2	551	551	19949
prevaricarà	2	1	prevaricara	2	0	1	19950
prevaricà	2	2	prevarica	2	13	15	19951
prevariquí	2	0	prevariqui	2	2	2	19952
preveiés	2	62	preveies	2	8	70	19953
prevenguí	2	0	prevengui	2	1	1	19954
preveuré	2	2	preveure	2	10172	10174	19955
previndré	2	5	previndre	2	643	648	19956
previngués	2	9	previngues	2	0	9	19957
previnguí	2	3	previngui	2	85	88	19958
previsualitzarà	2	2	previsualitzara	2	0	2	19959
previsualitzà	2	0	previsualitza	2	162	162	19960
previsualitzàreu	2	0	previsualitzareu	2	2	2	19961
prevoré	2	0	prevore	2	3	3	19962
prevèiem	2	113	preveiem	2	611	724	19963
prevèieu	2	0	preveieu	2	47	47	19964
prevéiem	2	7	preveiem	2	611	618	19965
prevéieu	2	0	preveieu	2	47	47	19966
prevéu	2	5	preveu	2	42506	42511	19967
preà	2	3	prea	4	34	37	19968
preés	2	2	prees	4	6	8	19969
preí	2	1	prei	2	13	14	19970
preó	4	4	preo	2	29	33	19971
primarà	2	58	primara	2	19	77	19972
primejà	2	1	primeja	2	0	1	19973
primerejàrem	2	0	primerejarem	2	1	1	19974
primà	2	9	prima	4	8714	8723	19975
primàrem	2	0	primarem	2	7	7	19976
primària	0	68627	primaria	2	1201	69828	19977
primàries	0	7696	primaries	2	99	7795	19978
primés	2	11	primes	0	3965	3976	19979
primí	2	1	primi	2	136	137	19980
principià	2	1	principia	2	186	187	19981
principiés	2	0	principies	2	16	16	19982
principií	2	0	principii	2	5	5	19983
prioritzarà	2	458	prioritzara	2	5	463	19984
prioritzà	2	25	prioritza	2	1968	1993	19985
prioritzàrem	2	0	prioritzarem	2	117	117	19986
prioritzàreu	2	0	prioritzareu	2	3	3	19987
prioritzés	2	48	prioritzes	2	44	92	19988
prioritzí	2	0	prioritzi	2	632	632	19989
pristí	0	15	pristi	0	12	27	19990
prisà	2	0	prisa	2	426	426	19991
prisés	2	0	prises	2	11	11	19992
privarà	2	105	privara	2	0	105	19993
privatitzarà	2	28	privatitzara	2	0	28	19994
privatitzà	2	10	privatitza	2	206	216	19995
privatitzàrem	2	0	privatitzarem	2	1	1	19996
privatitzàreu	2	1	privatitzareu	2	0	1	19997
privatitzés	2	4	privatitzes	2	2	6	19998
privatitzí	2	0	privatitzi	2	52	52	19999
privilegiarà	2	4	privilegiara	2	1	5	20000
privilegià	2	8	privilegia	2	219	227	20001
privilegiés	2	2	privilegies	2	3	5	20002
privà	2	108	priva	2	998	1106	20003
privàrem	2	0	privarem	2	16	16	20004
privàreu	2	0	privareu	2	1	1	20005
privés	2	46	prives	2	13	59	20006
priví	2	0	privi	2	147	147	20007
problematitzarà	2	1	problematitzara	2	0	1	20008
problematitzà	2	0	problematitza	2	30	30	20009
problematitzàrem	2	0	problematitzarem	2	1	1	20010
problematitzí	2	0	problematitzi	2	3	3	20011
procedirà	2	4483	procedira	2	32	4515	20012
procedírem	2	4	procedirem	2	757	761	20013
procedíreu	2	0	procedireu	2	4	4	20014
processarà	2	149	processara	2	2	151	20015
processà	2	22	processa	2	1052	1074	20016
processàrem	2	0	processarem	2	27	27	20017
processàreu	2	0	processareu	2	1	1	20018
processés	2	12	processes	2	104	116	20019
processí	2	0	processi	2	165	165	20020
processó	4	11299	processo	2	175	11474	20021
proclamarà	2	315	proclamara	2	20	335	20022
proclamà	2	1136	proclama	4	3946	5082	20023
proclamàrem	2	3	proclamarem	2	57	60	20024
proclamàreu	2	0	proclamareu	2	2	2	20025
proclamés	2	228	proclames	4	1418	1646	20026
proclamí	2	0	proclami	2	353	353	20027
procrastinà	2	0	procrastina	2	3	3	20028
procrearà	2	1	procreara	2	0	1	20029
procreà	2	1	procrea	2	6	7	20030
procreàrem	2	0	procrearem	2	1	1	20031
procreés	2	0	procrees	2	1	1	20032
procurarà	2	712	procurara	2	1	713	20033
procurà	2	161	procura	4	2824	2985	20034
procuràrem	2	7	procurarem	2	612	619	20035
procurés	2	52	procures	4	71	123	20036
procurí	2	0	procuri	2	388	388	20037
prodigarà	2	1	prodigara	2	1	2	20038
prodigués	2	5	prodigues	2	5	10	20039
prodiguí	2	0	prodigui	2	20	20	20040
prodigà	2	13	prodiga	2	155	168	20041
produírem	2	6	produirem	2	48	54	20042
produíreu	2	1	produireu	2	2	3	20043
profanà	2	21	profana	2	413	434	20044
profanés	2	6	profanes	2	208	214	20045
profaní	2	0	profani	2	3	3	20046
proferirà	2	4	proferira	2	0	4	20047
professarà	2	4	professara	2	0	4	20048
professionalitzarà	2	3	professionalitzara	2	0	3	20049
professionalitzà	2	13	professionalitza	2	61	74	20050
professionalitzàrem	2	0	professionalitzarem	2	3	3	20051
professionalitzés	2	1	professionalitzes	2	2	3	20052
professionalitzí	2	0	professionalitzi	2	26	26	20053
professà	2	145	professa	4	354	499	20054
professàrem	2	0	professarem	2	2	2	20055
professés	2	5	professes	4	13	18	20056
professí	2	0	professi	2	48	48	20057
professó	4	268	professo	2	192	460	20058
profetitzarà	2	1	profetitzara	2	0	1	20059
profetitzà	2	27	profetitza	2	90	117	20060
profetitzés	2	1	profetitzes	2	1	2	20061
profetitzí	2	0	profetitzi	2	4	4	20062
profetà	2	0	profeta	4	3685	3685	20063
profetés	2	0	profetes	4	1822	1822	20064
profetí	2	0	profeti	2	1	1	20065
profunditzarà	2	30	profunditzara	2	1	31	20066
profunditzà	2	2	profunditza	2	148	150	20067
profunditzàrem	2	0	profunditzarem	2	30	30	20068
profunditzés	2	5	profunditzes	2	7	12	20069
profunditzí	2	0	profunditzi	2	7	7	20070
programarà	2	477	programara	2	6	483	20071
programà	2	69	programa	4	309876	309945	20072
programàrem	2	4	programarem	2	155	159	20073
programàreu	2	0	programareu	2	4	4	20074
programés	2	48	programes	4	92695	92743	20075
programí	2	0	programi	2	170	170	20076
progressarà	2	62	progressara	2	1	63	20077
progressà	2	47	progressa	2	896	943	20078
progressàrem	2	0	progressarem	2	44	44	20079
progressés	2	24	progresses	2	42	66	20080
progressí	2	1	progressi	2	286	287	20081
progrès	2	244	progres	0	685	929	20082
prohibirà	2	553	prohibira	2	18	571	20083
prohibírem	2	0	prohibirem	2	35	35	20084
prohibíreu	2	0	prohibireu	2	2	2	20085
projectarà	2	3077	projectara	2	11	3088	20086
projectà	2	453	projecta	2	4992	5445	20087
projectàrem	2	5	projectarem	2	380	385	20088
projectàreu	2	0	projectareu	2	1	1	20089
projectés	2	85	projectes	2	196705	196790	20090
projectí	2	0	projecti	2	281	281	20091
proletaritzà	2	2	proletaritza	2	2	4	20092
proletaritzàrem	2	1	proletaritzarem	2	0	1	20093
proletaritzí	2	0	proletaritzi	2	1	1	20094
proliferarà	2	7	proliferara	2	0	7	20095
proliferà	2	13	prolifera	2	226	239	20096
proliferés	2	5	proliferes	2	0	5	20097
proliferí	2	0	proliferi	2	36	36	20098
prologarà	2	3	prologara	2	0	3	20099
prologués	2	5	prologues	2	1	6	20100
prologuí	2	0	prologui	2	3	3	20101
prologà	2	45	prologa	2	75	120	20102
prolongarà	2	349	prolongara	2	5	354	20103
prolongués	2	38	prolongues	2	2	40	20104
prolonguí	2	0	prolongui	2	165	165	20105
prolongà	2	87	prolonga	2	590	677	20106
prolongàrem	2	0	prolongarem	2	11	11	20107
prolífer	0	18	prolifer	2	2	20	20108
prolífera	0	35	prolifera	2	226	261	20109
prolíferes	0	3	proliferes	2	0	3	20110
prometré	2	15	prometre	2	6475	6490	20111
prometés	2	74	prometes	2	6	80	20112
prometí	2	17	prometi	4	151	168	20113
promiscuà	2	0	promiscua	2	39	39	20114
promiscués	2	0	promiscues	2	15	15	20115
promocionarà	2	345	promocionara	2	6	351	20116
promocionà	2	25	promociona	2	1872	1897	20117
promocionàrem	2	2	promocionarem	2	53	55	20118
promocionàreu	2	0	promocionareu	2	2	2	20119
promocionés	2	31	promociones	2	235	266	20120
promocioní	2	0	promocioni	2	194	194	20121
promogués	2	139	promogues	2	2	141	20122
promoguí	2	0	promogui	2	1787	1787	20123
promouré	2	18	promoure	2	58152	58170	20124
promulgarà	2	23	promulgara	2	1	24	20125
promulgués	2	37	promulgues	2	2	39	20126
promulguí	2	0	promulgui	2	63	63	20127
promulgà	2	243	promulga	2	270	513	20128
promulgàrem	2	0	promulgarem	2	2	2	20129
promulgàreu	2	0	promulgareu	2	1	1	20130
promíscua	0	65	promiscua	2	39	104	20131
promíscues	0	42	promiscues	2	15	57	20132
pronominalitzarà	2	1	pronominalitzara	2	1	2	20133
pronominalitzà	2	0	pronominalitza	2	25	25	20134
pronominalitzés	2	1	pronominalitzes	2	0	1	20135
pronominalitzí	2	0	pronominalitzi	2	1	1	20136
pronosticarà	2	4	pronosticara	2	0	4	20137
pronosticà	2	27	pronostica	2	500	527	20138
pronosticàrem	2	0	pronosticarem	2	2	2	20139
pronostiqués	2	4	pronostiques	2	8	12	20140
pronostiquí	2	0	pronostiqui	2	1	1	20141
pronunciarà	2	1043	pronunciara	2	19	1062	20142
pronuncià	2	657	pronuncia	2	2545	3202	20143
pronunciàrem	2	5	pronunciarem	2	54	59	20144
pronunciés	2	253	pronuncies	2	43	296	20145
pronuncií	2	14	pronuncii	2	28	42	20146
pronà	2	0	prona	0	20	20	20147
proní	2	0	proni	2	3	3	20148
pronòstic	0	4106	pronostic	2	46	4152	20149
pronòstica	0	32	pronostica	2	500	532	20150
pronòstiques	0	6	pronostiques	2	8	14	20151
pronúncia	4	1172	pronuncia	2	2545	3717	20152
pronúncies	4	70	pronuncies	2	43	113	20153
propagarà	2	43	propagara	2	3	46	20154
propagués	2	67	propagues	2	6	73	20155
propaguí	2	0	propagui	2	159	159	20156
propagà	2	82	propaga	2	644	726	20157
propagàrem	2	0	propagarem	2	2	2	20158
propalà	2	1	propala	2	3	4	20159
propalés	2	1	propales	2	0	1	20160
propiciarà	2	299	propiciara	2	9	308	20161
propicià	2	355	propicia	2	1600	1955	20162
propiciàrem	2	0	propiciarem	2	20	20	20163
propiciés	2	41	propicies	2	44	85	20164
propicií	2	1	propicii	2	7	8	20165
propinarà	2	2	propinara	2	0	2	20166
propinà	2	8	propina	4	866	874	20167
propinés	2	3	propines	4	308	311	20168
propiní	2	0	propini	2	3	3	20169
proporcionarà	2	3112	proporcionara	2	13	3125	20170
proporcionà	2	317	proporciona	2	24738	25055	20171
proporcionàrem	2	3	proporcionarem	2	380	383	20172
proporcionàreu	2	0	proporcionareu	2	39	39	20173
proporcionés	2	268	proporciones	2	149	417	20174
proporcioní	2	1	proporcioni	2	2252	2253	20175
proposarà	2	2516	proposara	2	40	2556	20176
proposà	2	1585	proposa	2	51394	52979	20177
proposàrem	2	96	proposarem	2	996	1092	20178
proposàreu	2	2	proposareu	2	9	11	20179
proposés	2	386	proposes	2	704	1090	20180
proposí	2	9	proposi	2	2089	2098	20181
propugnarà	2	9	propugnara	2	0	9	20182
propugnà	2	108	propugna	2	1011	1119	20183
propugnàrem	2	0	propugnarem	2	3	3	20184
propugnés	2	8	propugnes	2	2	10	20185
propugní	2	0	propugni	2	36	36	20186
propulsarà	2	9	propulsara	2	0	9	20187
propulsà	2	16	propulsa	2	82	98	20188
propulsàrem	2	0	propulsarem	2	6	6	20189
propulsés	2	4	propulses	2	1	5	20190
propulsí	2	0	propulsi	2	8	8	20191
propí	4	14	propi	0	120197	120211	20192
propícia	0	634	propicia	2	1600	2234	20193
propícies	0	345	propicies	2	44	389	20194
prorrategí	2	0	prorrategi	2	1	1	20195
prorratejarà	2	23	prorratejara	2	0	23	20196
prorratejà	2	0	prorrateja	2	12	12	20197
prorrogarà	2	172	prorrogara	2	1	173	20198
prorrogués	2	35	prorrogues	2	54	89	20199
prorroguí	2	0	prorrogui	2	94	94	20200
prorrogà	2	14	prorroga	2	658	672	20201
prorrogàrem	2	0	prorrogarem	2	5	5	20202
prorrogàreu	2	0	prorrogareu	2	1	1	20203
prorrompré	2	0	prorrompre	2	11	11	20204
prorrompí	2	0	prorrompi	2	1	1	20205
proscriguí	2	0	proscrigui	2	6	6	20206
proscriuré	2	0	proscriure	2	91	91	20207
prospectarà	2	1	prospectara	2	0	1	20208
prospectà	2	0	prospecta	2	11	11	20209
prospectés	2	0	prospectes	2	303	303	20210
prosperarà	2	125	prosperara	2	9	134	20211
prosperà	2	135	prospera	2	663	798	20212
prosperàrem	2	0	prosperarem	2	2	2	20213
prosperàreu	2	1	prosperareu	2	0	1	20214
prosperés	2	173	prosperes	2	28	201	20215
prosperí	2	0	prosperi	2	383	383	20216
prosseguirà	2	288	prosseguira	2	2	290	20217
prosseguírem	2	4	prosseguirem	2	154	158	20218
prosternà	2	42	prosterna	2	3	45	20219
prosternàreu	2	1	prosternareu	2	0	1	20220
prosternés	2	0	prosternes	2	4	4	20221
prosterní	2	0	prosterni	2	1	1	20222
prostrarà	2	1	prostrara	2	0	1	20223
prostrà	2	6	prostra	2	8	14	20224
prostrés	2	1	prostres	2	8	9	20225
protagonitzarà	2	725	protagonitzara	2	3	728	20226
protagonitzà	2	331	protagonitza	2	2359	2690	20227
protagonitzàrem	2	10	protagonitzarem	2	15	25	20228
protagonitzàreu	2	1	protagonitzareu	2	2	3	20229
protagonitzés	2	58	protagonitzes	2	5	63	20230
protagonitzí	2	0	protagonitzi	2	47	47	20231
protegirà	2	653	protegira	2	21	674	20232
protegírem	2	1	protegirem	2	121	122	20233
protegíreu	2	0	protegireu	2	5	5	20234
protestarà	2	40	protestara	2	2	42	20235
protestà	2	116	protesta	4	16745	16861	20236
protestàrem	2	4	protestarem	2	18	22	20237
protestés	2	37	protestes	4	9285	9322	20238
protestí	2	1	protesti	2	85	86	20239
protocol·litzarà	2	1	protocol·litzara	2	0	1	20240
protocol·litzà	2	3	protocol·litza	2	0	3	20241
protocol·litzàreu	2	0	protocol·litzareu	2	1	1	20242
protocol·litzí	2	0	protocol·litzi	2	3	3	20243
prototiparà	2	1	prototipara	2	0	1	20244
prototipà	2	0	prototipa	2	1	1	20245
prototipàrem	2	0	prototiparem	2	4	4	20246
provarà	2	444	provara	2	7	451	20247
provenguí	2	0	provengui	2	19	19	20248
proveírem	2	1	proveirem	2	21	22	20249
provindré	2	1	provindre	2	43	44	20250
provingués	2	75	provingues	2	0	75	20251
provinguí	2	0	provingui	2	664	664	20252
provisòria	0	14	provisoria	4	6	20	20253
provisòries	0	7	provisories	4	0	7	20254
provocarà	2	2410	provocara	2	31	2441	20255
provocà	2	2578	provoca	2	22890	25468	20256
provocàrem	2	4	provocarem	2	62	66	20257
provocàreu	2	0	provocareu	2	9	9	20258
provoqués	2	319	provoques	2	75	394	20259
provoquí	2	0	provoqui	2	1175	1175	20260
provà	2	296	prova	4	107123	107419	20261
provàrem	2	15	provarem	2	480	495	20262
provàreu	2	2	provareu	2	25	27	20263
prové	2	17805	prove	2	180	17985	20264
provén	2	0	proven	2	1573	1573	20265
provés	2	278	proves	4	74256	74534	20266
proví	2	6	provi	2	641	647	20267
pràctic	0	14506	practic	2	128	14634	20268
pràctica	0	111433	practica	2	7530	118963	20269
pràctiques	0	82430	practiques	2	1634	84064	20270
prèdica	4	218	predica	2	873	1091	20271
prèdiques	4	148	prediques	2	38	186	20272
prístina	0	62	pristina	0	266	328	20273
prístines	0	15	pristines	0	3	18	20274
pròdiga	0	109	prodiga	2	155	264	20275
pròdigues	0	13	prodigues	2	5	18	20276
pròrroga	4	5582	prorroga	2	658	6240	20277
pròrrogues	4	789	prorrogues	2	54	843	20278
pròsperes	0	381	prosperes	2	28	409	20279
pròtasi	4	16	protasi	4	38	54	20280
pròteus	4	2	proteus	4	174	176	20281
psicoanalitzà	2	1	psicoanalitza	2	6	7	20282
psicoanalitzàrem	2	0	psicoanalitzarem	2	1	1	20283
psicoanalitzés	2	1	psicoanalitzes	2	1	2	20284
publicarà	2	5188	publicara	2	76	5264	20285
publicitarà	2	24	publicitara	2	1	25	20286
publicità	2	5	publicita	2	246	251	20287
publicitàrem	2	0	publicitarem	2	7	7	20288
publicitàreu	2	0	publicitareu	2	1	1	20289
publicitària	0	3915	publicitaria	2	182	4097	20290
publicitàries	0	3573	publicitaries	2	93	3666	20291
publicités	2	9	publicites	2	8	17	20292
publicití	2	1	publiciti	2	62	63	20293
publicà	2	7800	publica	2	24776	32576	20294
publicàrem	2	68	publicarem	2	1891	1959	20295
publicàreu	2	1	publicareu	2	18	19	20296
publiqués	2	746	publiques	2	1660	2406	20297
publiquí	2	3	publiqui	2	1900	1903	20298
pudelarà	2	1	pudelara	2	0	1	20299
pudirà	2	2	pudira	2	0	2	20300
pudí	2	0	pudi	2	5	5	20301
pudís	2	1	pudis	2	1	2	20302
pugnarà	2	11	pugnara	2	0	11	20303
pugnà	2	5	pugna	4	1725	1730	20304
pugnés	2	4	pugnes	4	199	203	20305
pugní	2	0	pugni	2	15	15	20306
pugés	2	462	puges	4	807	1269	20307
pugí	2	7	pugi	2	1786	1793	20308
pujarà	2	1708	pujara	2	78	1786	20309
pujà	2	733	puja	4	19179	19912	20310
pujàrem	2	147	pujarem	2	2139	2286	20311
pujàreu	2	2	pujareu	2	73	75	20312
pullés	0	4	pulles	4	29	33	20313
pul·lulà	2	1	pul·lula	2	48	49	20314
pul·lulés	2	1	pul·lules	2	0	1	20315
pul·lulí	2	0	pul·luli	2	2	2	20316
puncionà	2	0	punciona	2	1	1	20317
puntarà	2	1	puntara	2	0	1	20318
puntegés	2	0	punteges	2	2	2	20319
puntegí	2	0	puntegi	2	1	1	20320
puntejà	2	0	punteja	2	41	41	20321
puntejàrem	2	1	puntejarem	2	0	1	20322
puntualitzarà	2	4	puntualitzara	2	0	4	20323
puntualitzà	2	25	puntualitza	2	833	858	20324
puntualitzàrem	2	0	puntualitzarem	2	4	4	20325
puntualitzés	2	2	puntualitzes	2	6	8	20326
puntualitzí	2	0	puntualitzi	2	6	6	20327
puntuarà	2	339	puntuara	2	1	340	20328
puntuà	2	61	puntua	2	684	745	20329
puntuàrem	2	0	puntuarem	2	5	5	20330
puntuàreu	2	0	puntuareu	2	2	2	20331
puntués	2	16	puntues	2	13	29	20332
puntà	2	1	punta	4	24195	24196	20333
puntés	2	5	puntes	4	6032	6037	20334
puntí	2	2016	punti	2	32	2048	20335
punxarà	2	148	punxara	2	4	152	20336
punxà	2	23	punxa	4	1578	1601	20337
punxàrem	2	1	punxarem	2	80	81	20338
punxàreu	2	0	punxareu	2	2	2	20339
punxés	2	34	punxes	4	1131	1165	20340
punxí	2	0	punxi	2	125	125	20341
punxó	4	516	punxo	2	91	607	20342
punyà	2	1	punya	4	13	14	20343
punyés	2	0	punyes	4	1	1	20344
punyí	2	2	punyi	2	1	3	20345
punyís	2	1	punyis	2	0	1	20346
purgarà	2	16	purgara	2	0	16	20347
purgués	2	4	purgues	4	487	491	20348
purguí	2	0	purgui	2	6	6	20349
purgà	2	73	purga	4	885	958	20350
purgàrem	2	0	purgarem	2	1	1	20351
purificarà	2	24	purificara	2	0	24	20352
purificà	2	13	purifica	2	332	345	20353
purificàrem	2	0	purificarem	2	2	2	20354
purifiqués	2	7	purifiques	2	1	8	20355
purifiquí	2	0	purifiqui	2	22	22	20356
purpurí	0	1	purpuri	0	34	35	20357
purés	4	363	pures	0	1344	1707	20358
purí	4	207	puri	4	414	621	20359
putegés	2	0	puteges	2	1	1	20360
putegí	2	0	putegi	2	7	7	20361
putejarà	2	5	putejara	2	0	5	20362
putejà	2	0	puteja	2	31	31	20363
putejàrem	2	0	putejarem	2	1	1	20364
pàg	7	1302	pag	2	240	1542	20365
pàgina	4	145077	pagina	2	1841	146918	20366
pàgines	4	67384	pagines	2	997	68381	20367
pàixeres	4	1	paixeres	2	0	1	20368
pàlmer	4	3	palmer	4	1306	1309	20369
pàlmers	4	0	palmers	4	25	25	20370
pàl·lia	4	5	pal·lia	2	56	61	20371
pària	4	151	paria	4	112	263	20372
pàries	4	202	paries	4	64	266	20373
pàssera	4	17	passera	4	1031	1048	20374
pàsseres	4	2	passeres	4	434	436	20375
pàtina	4	869	patina	2	313	1182	20376
pàtines	4	97	patines	2	33	130	20377
pèl	4	13113	pel	2	1127309	1140422	20378
pèls	4	4803	pels	7	438056	442859	20379
pèndol	4	1004	pendol	2	6	1010	20380
pèndola	4	23	pendola	2	1	24	20381
pèndoles	4	4	pendoles	2	0	4	20382
pèndul	0	163	pendul	2	7	170	20383
pèndula	0	9	pendula	2	38	47	20384
pèndules	0	43	pendules	2	3	46	20385
pènol	4	95	penol	4	7	102	20386
pènols	4	13	penols	4	2	15	20387
pèon	4	1	peon	2	17	18	20388
pèona	4	0	peona	4	240	240	20389
pèones	4	0	peones	4	24	24	20390
pèons	4	1	peons	4	2509	2510	20391
pèrit	0	538	perit	2	491	1029	20392
pèrita	0	8	perita	0	19	27	20393
pèrites	0	2	perites	0	6	8	20394
pèrits	0	544	perits	2	712	1256	20395
pètita	4	1	petita	0	106107	106108	20396
pètites	4	1	petites	0	65586	65587	20397
pífia	4	204	pifia	2	31	235	20398
pífies	4	286	pifies	2	16	302	20399
píxel	4	1373	pixel	2	382	1755	20400
pòlies	4	9	polies	2	2	11	20401
pòlisses	4	1056	polisses	2	7	1063	20402
pòntic	0	41	pontic	4	6	47	20403
pòrtland	4	141	portland	4	2564	2705	20404
pórca	4	0	porca	0	312	312	20405
pórques	4	0	porques	0	51	51	20406
públic	0	272607	public	2	3663	276270	20407
pública	0	171408	publica	2	24776	196184	20408
públiques	0	80770	publiques	2	1660	82430	20409
quadrarà	2	5	quadrara	2	3	8	20410
quadriculà	2	0	quadricula	2	57	57	20411
quadriculés	2	0	quadricules	2	9	9	20412
quadrinéts	4	1	quadrinets	4	0	1	20413
quadruplicarà	2	16	quadruplicara	2	1	17	20414
quadruplicà	2	3	quadruplica	2	104	107	20415
quadrupliqués	2	1	quadrupliques	2	0	1	20416
quadrupliquí	2	0	quadrupliqui	2	5	5	20417
quadrà	2	4	quadra	4	2028	2032	20418
quadràrem	2	0	quadrarem	2	3	3	20419
quadrés	2	18	quadres	4	15049	15067	20420
quadrí	2	1	quadri	2	106	107	20421
quadrícula	4	1265	quadricula	2	57	1322	20422
quadrícules	4	215	quadricules	2	9	224	20423
quadró	4	5	quadro	4	342	347	20424
qualificarà	2	120	qualificara	2	5	125	20425
qualificà	2	305	qualifica	2	3838	4143	20426
qualificàrem	2	5	qualificarem	2	16	21	20427
qualifiqués	2	81	qualifiques	2	24	105	20428
qualifiquí	2	0	qualifiqui	2	184	184	20429
quallarà	2	30	quallara	2	1	31	20430
quallà	2	21	qualla	2	201	222	20431
quallés	2	23	qualles	2	2	25	20432
quallí	2	0	qualli	2	200	200	20433
quantificarà	2	42	quantificara	2	0	42	20434
quantificà	2	5	quantifica	2	439	444	20435
quantificàrem	2	1	quantificarem	2	13	14	20436
quantifiqués	2	5	quantifiques	2	4	9	20437
quantifiquí	2	0	quantifiqui	2	31	31	20438
quantitzà	2	0	quantitza	2	3	3	20439
quaranta-quatrè	0	9	quaranta-quatre	3	344	353	20440
quaranta-quatré	0	1	quaranta-quatre	3	344	345	20441
quarsós	0	0	quarsos	4	49	49	20442
quartarà	2	0	quartara	2	1	1	20443
quartejarà	2	1	quartejara	2	0	1	20444
quartejà	2	0	quarteja	2	6	6	20445
quarterà	2	0	quartera	0	278	278	20446
quarterés	2	0	quarteres	0	199	199	20447
quarteró	0	39	quartero	2	2	41	20448
quartà	2	29	quarta	0	29821	29850	20449
quartés	2	0	quartes	0	1607	1607	20450
quartí	2	1	quarti	2	6	7	20451
quartó	4	88	quarto	2	460	548	20452
quatretondà	0	0	quatretonda	4	775	775	20453
quatrè	0	5	quatre	3	244065	244070	20454
quatré	0	0	quatre	3	244065	244065	20455
quedarà	2	17132	quedara	2	428	17560	20456
quedà	2	4720	queda	4	118790	123510	20457
quedàrem	2	163	quedarem	2	1662	1825	20458
quedàreu	2	2	quedareu	2	616	618	20459
quedés	2	3907	quedes	4	2450	6357	20460
quedí	2	26	quedi	2	21974	22000	20461
queixalarà	2	2	queixalara	2	0	2	20462
queixalà	2	0	queixala	2	5	5	20463
queixalés	2	1	queixales	2	2	3	20464
queixalí	2	0	queixali	2	1	1	20465
queixarà	2	69	queixara	2	3	72	20466
queixà	2	100	queixa	4	10138	10238	20467
queixàrem	2	1	queixarem	2	68	69	20468
queixàreu	2	0	queixareu	2	16	16	20469
queixés	2	61	queixes	4	11698	11759	20470
queixí	2	0	queixi	2	200	200	20471
queixós	0	68	queixos	4	15	83	20472
quequegés	2	1	quequeges	2	0	1	20473
quequejà	2	3	quequeja	2	18	21	20474
querellarà	2	38	querellara	2	2	40	20475
querellà	2	2	querella	4	4020	4022	20476
querellàrem	2	0	querellarem	2	1	1	20477
querellés	2	4	querelles	4	764	768	20478
querellí	2	0	querelli	2	18	18	20479
querà	2	1	quera	4	494	495	20480
queràrem	2	0	querarem	2	1	1	20481
querés	2	5	queres	4	12	17	20482
querí	2	1	queri	2	5	6	20483
quillà	2	1	quilla	4	416	417	20484
quillés	2	0	quilles	4	56	56	20485
quilometrà	2	0	quilometra	2	1	1	20486
quilometrés	2	1	quilometres	2	1498	1499	20487
quilòmetre	4	7798	quilometre	2	200	7998	20488
quilòmetres	4	42779	quilometres	2	1498	44277	20489
quilós	0	0	quilos	4	8008	8008	20490
quintaessencià	2	0	quintaessencia	2	16	16	20491
quintuplicarà	2	2	quintuplicara	2	0	2	20492
quintuplicà	2	2	quintuplica	2	34	36	20493
quintupliqués	2	1	quintupliques	2	0	1	20494
quintupliquí	2	0	quintupliqui	2	2	2	20495
quintés	2	0	quintes	0	508	508	20496
quinzè	0	725	quinze	3	24908	25633	20497
quinzé	0	29	quinze	3	24908	24937	20498
quiratés	2	0	quirates	2	1	1	20499
quissoiés	2	0	quissoies	4	1	1	20500
quissoí	2	0	quissoi	4	1	1	20501
quissó	4	3	quisso	4	84	87	20502
quistós	0	0	quistos	4	15	15	20503
quitarà	2	1	quitara	2	4	5	20504
quità	2	0	quita	2	136	136	20505
quités	2	0	quites	2	27	27	20506
quití	2	0	quiti	2	10	10	20507
quitó	4	22	quito	4	644	666	20508
què	5	758464	que	1	21330591	22089055	20509
qüestionarà	2	98	qüestionara	2	5	103	20510
qüestionà	2	77	qüestiona	2	3899	3976	20511
qüestionàrem	2	3	qüestionarem	2	56	59	20512
qüestionàreu	2	0	qüestionareu	2	1	1	20513
qüestionés	2	89	qüestiones	2	90	179	20514
qüestioní	2	0	qüestioni	2	474	474	20515
rabegés	2	1	rabeges	2	1	2	20516
rabegí	2	0	rabegi	2	2	2	20517
rabejà	2	1	rabeja	2	36	37	20518
rabejàrem	2	1	rabejarem	2	0	1	20519
rabià	2	1	rabia	2	421	422	20520
rabiés	2	0	rabies	2	11	11	20521
rabií	2	0	rabii	2	1	1	20522
raciociní	2	0	raciocini	2	216	216	20523
racionalitzarà	2	20	racionalitzara	2	0	20	20524
racionalitzà	2	4	racionalitza	2	73	77	20525
racionalitzàrem	2	0	racionalitzarem	2	10	10	20526
racionalitzés	2	3	racionalitzes	2	4	7	20527
racionalitzí	2	0	racionalitzi	2	38	38	20528
racionarà	2	1	racionara	2	1	2	20529
racionà	2	1	raciona	2	7	8	20530
racionàrem	2	0	racionarem	2	3	3	20531
racionés	2	1	raciones	2	11	12	20532
racioní	2	0	racioni	2	2	2	20533
radiarà	2	8	radiara	2	0	8	20534
radicalitzarà	2	10	radicalitzara	2	0	10	20535
radicalitzà	2	26	radicalitza	2	88	114	20536
radicalitzàrem	2	0	radicalitzarem	2	1	1	20537
radicalitzés	2	6	radicalitzes	2	1	7	20538
radicalitzí	2	0	radicalitzi	2	21	21	20539
radicarà	2	40	radicara	2	0	40	20540
radicà	2	14	radica	2	2895	2909	20541
radiografià	2	1	radiografia	4	2535	2536	20542
radiografiés	2	0	radiografies	4	739	739	20543
radioguià	2	0	radioguia	2	5	5	20544
radioguiés	2	0	radioguies	2	18	18	20545
radiotelegrafià	2	0	radiotelegrafia	4	60	60	20546
radiqués	2	3	radiques	2	0	3	20547
radiquí	2	0	radiqui	2	58	58	20548
radià	2	1	radia	2	53	54	20549
radiés	2	1	radies	2	1	2	20550
radií	2	0	radii	2	1	1	20551
radó	4	257	rado	4	58	315	20552
ragusà	4	2	ragusa	4	199	201	20553
ragués	2	26	ragues	2	8	34	20554
raguí	2	1	ragui	2	3	4	20555
ragés	2	9	rages	2	43	52	20556
ragí	2	0	ragi	2	70	70	20557
rajarà	2	24	rajara	2	0	24	20558
rajà	2	75	raja	2	2149	2224	20559
rajàrem	2	0	rajarem	2	2	2	20560
ralentitzarà	2	2	ralentitzara	2	1	3	20561
ralentitzà	2	0	ralentitza	2	42	42	20562
ralentitzàrem	2	0	ralentitzarem	2	1	1	20563
ralentitzés	2	0	ralentitzes	2	1	1	20564
ralentitzí	2	0	ralentitzi	2	3	3	20565
ralingués	2	0	ralingues	4	3	3	20566
ralingà	2	0	ralinga	4	17	17	20567
rallarà	2	2	rallara	2	0	2	20568
rallà	2	0	ralla	2	137	137	20569
rallàrem	2	0	rallarem	2	13	13	20570
rallés	2	1	ralles	2	57	58	20571
rallí	2	0	ralli	2	137	137	20572
ramadà	4	686	ramada	4	203	889	20573
ramalà	2	1	ramala	2	23	24	20574
ramalés	2	0	ramales	2	20	20	20575
ramassà	2	82	ramassa	4	1	83	20576
ramblegés	2	1	rambleges	2	2	3	20577
ramblejà	2	0	rambleja	2	12	12	20578
ramificarà	2	4	ramificara	2	0	4	20579
ramificà	2	0	ramifica	2	112	112	20580
ramifiqués	2	1	ramifiques	2	0	1	20581
ramifiquí	2	0	ramifiqui	2	2	2	20582
rampellarà	2	1	rampellara	2	0	1	20583
rampillés	2	0	rampilles	2	2	2	20584
rampinyà	2	0	rampinya	2	89	89	20585
rampinyàreu	2	0	rampinyareu	2	1	1	20586
rampinyés	2	0	rampinyes	2	1	1	20587
rampinà	2	0	rampina	2	1	1	20588
rampiní	2	0	rampini	2	8	8	20589
ramà	2	6	rama	4	998	1004	20590
ramàreu	2	1	ramareu	2	0	1	20591
ramària	4	0	ramaria	2	6	6	20592
ramés	2	1	rames	4	438	439	20593
ramí	2	4	rami	2	251	255	20594
ramós	0	8	ramos	4	4946	4954	20595
ranciejà	2	0	rancieja	2	4	4	20596
rancià	2	0	rancia	2	34	34	20597
ranciés	2	0	rancies	2	5	5	20598
randà	2	0	randa	4	2313	2313	20599
randés	2	0	randes	4	106	106	20600
randí	2	5	randi	2	64	69	20601
ranejà	2	3	raneja	2	30	33	20602
ranejàrem	2	1	ranejarem	2	0	1	20603
ranquegés	2	0	ranqueges	2	1	1	20604
ranquejà	2	0	ranqueja	2	17	17	20605
ranurà	2	0	ranura	4	860	860	20606
ranurés	2	0	ranures	4	695	695	20607
raonarà	2	14	raonara	2	2	16	20608
raonà	2	17	raona	2	585	602	20609
raonàrem	2	2	raonarem	2	9	11	20610
raonés	2	5	raones	2	31	36	20611
raoní	2	0	raoni	2	37	37	20612
raparà	2	2	rapara	2	0	2	20613
rapegí	2	0	rapegi	2	2	2	20614
rapejà	2	0	rapeja	2	28	28	20615
rapelà	2	0	rapela	2	8	8	20616
rapelàrem	2	0	rapelarem	2	3	3	20617
rapelés	2	0	rapeles	2	1	1	20618
rapinyà	2	1	rapinya	4	351	352	20619
rapinyés	2	0	rapinyes	4	17	17	20620
rapissà	2	0	rapissa	2	29	29	20621
rapissàrem	2	0	rapissarem	2	1	1	20622
rapissés	2	0	rapisses	2	3	3	20623
raportà	2	1	raporta	2	1	2	20624
raportí	2	0	raporti	2	1	1	20625
raptarà	2	5	raptara	2	0	5	20626
raptà	2	16	rapta	2	58	74	20627
raptés	2	3	raptes	2	60	63	20628
raptí	2	0	rapti	2	25	25	20629
rapà	2	5	rapa	4	320	325	20630
rapàrem	2	0	raparem	2	4	4	20631
rapè	4	61	rape	2	85	146	20632
rapès	4	0	rapes	4	34	34	20633
rapé	4	5	rape	2	85	90	20634
rapés	2	2	rapes	4	34	36	20635
rapí	2	0	rapi	2	13	13	20636
rapís	2	1	rapis	2	4	5	20637
rarejà	2	0	rareja	2	1	1	20638
rarificà	2	0	rarifica	2	8	8	20639
rascarà	2	10	rascara	2	1	11	20640
rasclejà	2	0	rascleja	2	5	5	20641
rasclà	2	0	rascla	4	5	5	20642
rasclés	2	0	rascles	4	21	21	20643
rasclí	2	0	rascli	2	1	1	20644
rascló	4	64	rasclo	2	0	64	20645
rascà	2	6	rasca	4	420	426	20646
rascàrem	2	0	rascarem	2	9	9	20647
rascàreu	2	0	rascareu	2	1	1	20648
raspallarà	2	1	raspallara	2	1	2	20649
raspallà	2	1	raspalla	2	59	60	20650
raspallàrem	2	0	raspallarem	2	4	4	20651
raspallés	2	1	raspalles	2	13	14	20652
raspallí	2	0	raspalli	2	29	29	20653
raspà	2	1	raspa	4	96	97	20654
raspàrem	2	0	rasparem	2	2	2	20655
raspés	2	2	raspes	4	34	36	20656
raspí	2	0	raspi	2	17	17	20657
rasquerà	0	3	rasquera	4	677	680	20658
rasqués	2	9	rasques	4	69	78	20659
rasquí	2	4	rasqui	2	38	42	20660
rastellà	2	1	rastella	2	2	3	20661
rastellés	2	0	rastelles	2	1	1	20662
rastellí	2	0	rastelli	2	2	2	20663
rasteritzà	2	0	rasteritza	2	7	7	20664
rastregés	2	3	rastreges	2	3	6	20665
rastregí	2	0	rastregi	2	17	17	20666
rastrejarà	2	14	rastrejara	2	0	14	20667
rastrejà	2	5	rastreja	2	255	260	20668
rastrejàrem	2	1	rastrejarem	2	6	7	20669
rasurà	2	1	rasura	4	9	10	20670
rasuràrem	2	0	rasurarem	2	1	1	20671
rasurí	2	0	rasuri	2	3	3	20672
rasà	2	0	rasa	0	1945	1945	20673
rasés	2	15	rases	0	649	664	20674
rasí	2	0	rasi	2	26	26	20675
ratarà	2	1	ratara	2	0	1	20676
ratejà	2	0	rateja	2	2	2	20677
ratificarà	2	213	ratificara	2	8	221	20678
ratificà	2	146	ratifica	2	1391	1537	20679
ratificàrem	2	3	ratificarem	2	16	19	20680
ratificàreu	2	0	ratificareu	2	2	2	20681
ratifiqués	2	132	ratifiques	2	3	135	20682
ratifiquí	2	1	ratifiqui	2	515	516	20683
ratinà	2	0	ratina	4	2	2	20684
ratiní	2	0	ratini	2	1	1	20685
ratllarà	2	9	ratllara	2	0	9	20686
ratllà	2	4	ratlla	4	4307	4311	20687
ratllàrem	2	0	ratllarem	2	54	54	20688
ratllàreu	2	0	ratllareu	2	3	3	20689
ratllés	2	5	ratlles	4	5215	5220	20690
ratllí	2	0	ratlli	2	50	50	20691
ratxà	2	0	ratxa	4	3670	3670	20692
ratxés	2	0	ratxes	4	1314	1314	20693
ratà	2	1	rata	4	2780	2781	20694
ratés	2	71	rates	0	3376	3447	20695
ratí	2	0	rati	2	306	306	20696
raucarà	2	1	raucara	2	1	2	20697
raucà	2	1	rauca	0	13	14	20698
rauquí	2	0	rauqui	2	2	2	20699
rauré	2	0	raure	2	444	444	20700
rautà	2	0	rauta	2	17	17	20701
rautí	2	0	rauti	2	17	17	20702
raïmà	2	0	raïma	2	1	1	20703
raïmés	2	0	raïmes	2	2	2	20704
reabastà	2	0	reabasta	2	1	1	20705
reabsorbirà	2	3	reabsorbira	2	0	3	20706
reaccionarà	2	301	reaccionara	2	15	316	20707
reaccionà	2	147	reacciona	2	2457	2604	20708
reaccionàrem	2	3	reaccionarem	2	41	44	20709
reaccionàreu	2	0	reaccionareu	2	1	1	20710
reaccionària	0	968	reaccionaria	2	281	1249	20711
reaccionàries	0	474	reaccionaries	2	74	548	20712
reaccionés	2	91	reacciones	2	95	186	20713
reaccioní	2	0	reaccioni	2	395	395	20714
reacredità	2	0	reacredita	2	4	4	20715
reactivarà	2	121	reactivara	2	2	123	20716
reactivà	2	32	reactiva	0	1170	1202	20717
reactivàrem	2	0	reactivarem	2	17	17	20718
reactivés	2	19	reactives	0	347	366	20719
reactiví	2	0	reactivi	2	117	117	20720
readaptarà	2	7	readaptara	2	0	7	20721
readaptà	2	0	readapta	2	18	18	20722
readaptàrem	2	0	readaptarem	2	2	2	20723
readaptés	2	2	readaptes	2	0	2	20724
readaptí	2	0	readapti	2	5	5	20725
readmetré	2	0	readmetre	2	195	195	20726
readmetés	2	2	readmetes	2	0	2	20727
readmetí	2	0	readmeti	2	17	17	20728
readoptà	2	0	readopta	2	1	1	20729
reafirmarà	2	54	reafirmara	2	1	55	20730
reafirmà	2	75	reafirma	2	1974	2049	20731
reafirmàrem	2	2	reafirmarem	2	19	21	20732
reafirmés	2	33	reafirmes	2	10	43	20733
reafirmí	2	1	reafirmi	2	113	114	20734
reagruparà	2	13	reagrupara	2	0	13	20735
reagrupà	2	12	reagrupa	2	90	102	20736
reagrupàrem	2	0	reagruparem	2	17	17	20737
reagrupés	2	5	reagrupes	2	1	6	20738
reagrupí	2	0	reagrupi	2	14	14	20739
reajustarà	2	8	reajustara	2	0	8	20740
reajustà	2	2	reajusta	2	26	28	20741
reajustàrem	2	0	reajustarem	2	1	1	20742
reajustés	2	0	reajustes	2	2	2	20743
reajustí	2	0	reajusti	2	5	5	20744
realcés	2	1	realces	2	0	1	20745
realcí	2	0	realci	2	34	34	20746
realimentarà	2	6	realimentara	2	0	6	20747
realimentà	2	0	realimenta	2	21	21	20748
realimentés	2	1	realimentes	2	0	1	20749
realineà	2	2	realinea	2	3	5	20750
realitzarà	2	22439	realitzara	2	242	22681	20751
realitzà	2	3778	realitza	2	43027	46805	20752
realitzàrem	2	136	realitzarem	2	3794	3930	20753
realitzàreu	2	0	realitzareu	2	86	86	20754
realitzés	2	898	realitzes	2	426	1324	20755
realitzí	2	1	realitzi	2	5610	5611	20756
reallotgés	2	1	reallotges	2	0	1	20757
reallotgí	2	0	reallotgi	2	3	3	20758
reallotjarà	2	4	reallotjara	2	0	4	20759
reallotjà	2	0	reallotja	2	7	7	20760
realçarà	2	23	realçara	2	0	23	20761
realçà	2	5	realça	2	502	507	20762
realçàrem	2	0	realçarem	2	2	2	20763
reanimarà	2	1	reanimara	2	0	1	20764
reanimà	2	3	reanima	2	45	48	20765
reanimàrem	2	0	reanimarem	2	1	1	20766
reanimés	2	2	reanimes	2	1	3	20767
reanimí	2	0	reanimi	2	2	2	20768
reanomenarà	2	6	reanomenara	2	0	6	20769
reanomenà	2	42	reanomena	2	306	348	20770
reanomenés	2	4	reanomenes	2	1	5	20771
reanomení	2	0	reanomeni	2	6	6	20772
reaparegués	2	5	reaparegues	2	0	5	20773
reapareguí	2	0	reaparegui	2	44	44	20774
reaprendré	2	0	reaprendre	2	127	127	20775
reaprenguí	2	0	reaprengui	2	1	1	20776
reaprofitarà	2	12	reaprofitara	2	0	12	20777
reaprofità	2	5	reaprofita	2	52	57	20778
reaprofitàrem	2	0	reaprofitarem	2	3	3	20779
reaprofités	2	1	reaprofites	2	2	3	20780
reaprofití	2	0	reaprofiti	2	3	3	20781
rearmarà	2	3	rearmara	2	0	3	20782
rearmà	2	2	rearma	2	25	27	20783
rearmàreu	2	1	rearmareu	2	0	1	20784
rearmés	2	3	rearmes	2	0	3	20785
rearmí	2	0	rearmi	2	6	6	20786
rearticulà	2	0	rearticula	2	1	1	20787
reassegurà	2	0	reassegura	2	1	1	20788
reassegurés	2	1	reassegures	2	0	1	20789
reassegurí	2	0	reasseguri	2	1	1	20790
reassentarà	2	1	reassentara	2	0	1	20791
reassentà	2	1	reassenta	2	1	2	20792
reassentí	2	0	reassenti	2	1	1	20793
reassignarà	2	2	reassignara	2	0	2	20794
reassignà	2	2	reassigna	2	31	33	20795
reassignàrem	2	0	reassignarem	2	1	1	20796
reassignés	2	1	reassignes	2	0	1	20797
reassigní	2	0	reassigni	2	8	8	20798
reavaluarà	2	3	reavaluara	2	0	3	20799
reavaluà	2	2	reavalua	2	8	10	20800
reavaluàrem	2	0	reavaluarem	2	1	1	20801
rebaixarà	2	187	rebaixara	2	11	198	20802
rebaixà	2	44	rebaixa	4	5083	5127	20803
rebaixàrem	2	4	rebaixarem	2	27	31	20804
rebaixàreu	2	0	rebaixareu	2	2	2	20805
rebaixés	2	58	rebaixes	4	4329	4387	20806
rebaixí	2	0	rebaixi	2	224	224	20807
rebaldí	2	1	rebaldi	4	0	1	20808
reballà	2	5	reballa	2	11	16	20809
reballàrem	2	0	reballarem	2	1	1	20810
rebalsà	2	0	rebalsa	2	1	1	20811
rebategés	2	6	rebateges	2	0	6	20812
rebategí	2	0	rebategi	2	3	3	20813
rebatejarà	2	10	rebatejara	2	0	10	20814
rebatejà	2	36	rebateja	2	41	77	20815
rebatejàrem	2	0	rebatejarem	2	2	2	20816
rebatejàreu	2	1	rebatejareu	2	0	1	20817
rebatré	2	7	rebatre	2	1040	1047	20818
rebatés	2	4	rebates	2	5	9	20819
rebatí	2	0	rebati	2	6	6	20820
rebecà	2	0	rebeca	4	1163	1163	20821
rebel·larà	2	21	rebel·lara	2	2	23	20822
rebel·là	2	68	rebel·la	2	453	521	20823
rebel·làrem	2	0	rebel·larem	2	10	10	20824
rebel·lés	2	13	rebel·les	2	10	23	20825
rebel·lí	2	0	rebel·li	2	47	47	20826
rebentarà	2	26	rebentara	2	2	28	20827
rebentà	2	14	rebenta	2	345	359	20828
rebentàrem	2	0	rebentarem	2	12	12	20829
rebentàreu	2	0	rebentareu	2	3	3	20830
rebentés	2	22	rebentes	2	22	44	20831
rebentí	2	3	rebenti	2	78	81	20832
rebequés	2	0	rebeques	4	17	17	20833
rebesnét	4	58	rebesnet	4	19	77	20834
rebesnéta	4	31	rebesneta	4	6	37	20835
rebesnétes	4	6	rebesnetes	4	0	6	20836
rebesnéts	4	50	rebesnets	4	8	58	20837
reblanirà	2	1	reblanira	2	0	1	20838
reblanírem	2	0	reblanirem	2	1	1	20839
reblarà	2	18	reblara	2	0	18	20840
reblonà	2	0	reblona	2	4	4	20841
reblonés	2	0	reblones	2	2	2	20842
reblà	2	23	rebla	2	552	575	20843
reblàrem	2	0	reblarem	2	1	1	20844
reblés	2	1	rebles	2	45	46	20845
reblí	2	2	rebli	2	5	7	20846
reblíreu	2	0	reblireu	2	1	1	20847
rebló	4	38	reblo	2	6	44	20848
rebobinarà	2	2	rebobinara	2	0	2	20849
rebobinà	2	0	rebobina	2	64	64	20850
rebobinàrem	2	0	rebobinarem	2	2	2	20851
rebobinés	2	3	rebobines	2	1	4	20852
rebobiní	2	0	rebobini	2	3	3	20853
rebolcà	2	2	rebolca	2	34	36	20854
rebolcàrem	2	0	rebolcarem	2	1	1	20855
rebolcó	4	1	rebolco	2	0	1	20856
rebolicà	2	0	rebolica	4	22	22	20857
reboliqués	2	0	reboliques	4	1	1	20858
rebollà	2	0	rebolla	2	2	2	20859
rebolqués	2	0	rebolques	2	3	3	20860
rebolquí	2	0	rebolqui	2	1	1	20861
rebomboregés	2	0	rebomboreges	2	1	1	20862
rebostejà	2	0	rebosteja	2	1	1	20863
rebotarà	2	20	rebotara	2	1	21	20864
rebotegà	2	1	rebotega	2	0	1	20865
rebotirà	2	2	rebotira	2	0	2	20866
rebotré	2	0	rebotre	2	18	18	20867
rebotà	2	15	rebota	2	395	410	20868
reboté	2	0	rebote	2	26	26	20869
rebotés	2	18	rebotes	2	11	29	20870
rebotí	2	1	reboti	2	49	50	20871
rebotís	2	2	rebotis	2	1	3	20872
rebregarà	2	2	rebregara	2	0	2	20873
rebregués	2	0	rebregues	2	2	2	20874
rebreguí	2	0	rebregui	2	4	4	20875
rebregà	2	2	rebrega	2	24	26	20876
rebregàrem	2	0	rebregarem	2	2	2	20877
rebrollà	2	0	rebrolla	2	7	7	20878
rebrollí	2	0	rebrolli	2	2	2	20879
rebrostà	2	0	rebrosta	2	2	2	20880
rebrotarà	2	12	rebrotara	2	1	13	20881
rebrotà	2	6	rebrota	2	140	146	20882
rebrotàrem	2	0	rebrotarem	2	1	1	20883
rebrotés	2	2	rebrotes	2	0	2	20884
rebrotí	2	2	rebroti	2	20	22	20885
rebré	2	216	rebre	2	111250	111466	20886
rebufà	2	0	rebufa	2	35	35	20887
rebufés	2	0	rebufes	2	1	1	20888
rebufí	2	0	rebufi	2	6	6	20889
rebullirà	2	0	rebullira	2	1	1	20890
rebullí	2	1	rebulli	2	0	1	20891
rebuscarà	2	2	rebuscara	2	0	2	20892
rebuscà	2	2	rebusca	2	45	47	20893
rebuscàrem	2	0	rebuscarem	2	1	1	20894
rebusqués	2	3	rebusques	2	5	8	20895
rebusquí	2	0	rebusqui	2	1	1	20896
rebutgés	2	390	rebutges	2	82	472	20897
rebutgí	2	0	rebutgi	2	993	993	20898
rebutjarà	2	254	rebutjara	2	22	276	20899
rebutjà	2	630	rebutja	2	6795	7425	20900
rebutjàrem	2	4	rebutjarem	2	101	105	20901
rebutjàreu	2	0	rebutjareu	2	1	1	20902
rebés	2	1035	rebes	2	20	1055	20903
rebí	2	23	rebi	2	3738	3761	20904
rebò	0	6	rebo	2	1316	1322	20905
recacegés	2	2	recaceges	2	0	2	20906
recaigués	2	73	recaigues	2	0	73	20907
recaiguí	2	0	recaigui	2	435	435	20908
recalarà	2	76	recalara	2	1	77	20909
recalcarà	2	9	recalcara	2	0	9	20910
recalcitrí	2	1	recalcitri	2	0	1	20911
recalcularà	2	15	recalculara	2	0	15	20912
recalculà	2	0	recalcula	2	71	71	20913
recalculàrem	2	0	recalcularem	2	1	1	20914
recalculés	2	0	recalcules	2	1	1	20915
recalculí	2	0	recalculi	2	12	12	20916
recalcà	2	70	recalca	2	1013	1083	20917
recalcàrem	2	0	recalcarem	2	3	3	20918
recalcés	2	0	recalces	2	1	1	20919
recalcí	2	0	recalci	2	1	1	20920
recalqués	2	4	recalques	2	5	9	20921
recalquí	2	0	recalqui	2	24	24	20922
recalà	2	26	recala	2	140	166	20923
recalàrem	2	0	recalarem	2	4	4	20924
recalçarà	2	2	recalçara	2	0	2	20925
recalçàreu	2	1	recalçareu	2	0	1	20926
recalés	2	3	recales	2	0	3	20927
recalí	2	0	recali	2	7	7	20928
recamarà	2	0	recamara	2	20	20	20929
recamà	2	0	recama	2	2	2	20930
recamí	2	0	recami	2	3	3	20931
recanvià	2	0	recanvia	2	3	3	20932
recanviàrem	2	0	recanviarem	2	1	1	20933
recapacitarà	2	3	recapacitara	2	1	4	20934
recapacità	2	1	recapacita	2	24	25	20935
recapacitàrem	2	0	recapacitarem	2	4	4	20936
recapacités	2	5	recapacites	2	4	9	20937
recapacití	2	0	recapaciti	2	72	72	20938
recapitalitzà	2	0	recapitalitza	2	2	2	20939
recapitalitzí	2	0	recapitalitzi	2	1	1	20940
recapitularà	2	2	recapitulara	2	0	2	20941
recapitulà	2	1	recapitula	2	42	43	20942
recapitulés	2	1	recapitules	2	0	1	20943
recapitulí	2	0	recapituli	2	9	9	20944
recaptarà	2	249	recaptara	2	4	253	20945
recapturà	2	2	recaptura	2	44	46	20946
recapturàrem	2	1	recapturarem	2	0	1	20947
recapturés	2	0	recaptures	2	16	16	20948
recaptà	2	40	recapta	2	1163	1203	20949
recaptàrem	2	4	recaptarem	2	31	35	20950
recaptàreu	2	0	recaptareu	2	1	1	20951
recaptés	2	29	recaptes	2	104	133	20952
recaptí	2	0	recapti	2	338	338	20953
recaragolarà	2	1	recaragolara	2	0	1	20954
recaragolà	2	0	recaragola	2	5	5	20955
recaragolí	2	0	recaragoli	2	1	1	20956
recargolà	2	2	recargola	2	53	55	20957
recargolàrem	2	0	recargolarem	2	1	1	20958
recargolàreu	2	0	recargolareu	2	1	1	20959
recargolés	2	1	recargoles	2	1	2	20960
recargolí	2	1	recargoli	2	4	5	20961
recarregarà	2	34	recarregara	2	0	34	20962
recarregués	2	2	recarregues	2	41	43	20963
recarreguí	2	0	recarregui	2	98	98	20964
recarregà	2	0	recarrega	2	502	502	20965
recarregàrem	2	0	recarregarem	2	3	3	20966
recarà	2	6	recara	2	0	6	20967
recauré	2	3	recaure	2	2406	2409	20968
recautxutà	2	0	recautxuta	2	1	1	20969
recavarà	2	6	recavara	2	0	6	20970
recavà	2	0	recava	2	21	21	20971
recaví	2	0	recavi	2	1	1	20972
recelà	2	2	recela	2	93	95	20973
recelés	2	2	receles	2	0	2	20974
recelí	2	0	receli	2	6	6	20975
recensionà	2	0	recensiona	2	2	2	20976
recensionés	2	0	recensiones	2	2	2	20977
recensioní	2	0	recensioni	2	4	4	20978
recentralitzarà	2	1	recentralitzara	2	0	1	20979
recentralitzà	2	0	recentralitza	2	17	17	20980
recentralitzés	2	1	recentralitzes	2	0	1	20981
recenyírem	2	0	recenyirem	2	1	1	20982
recepcionarà	2	7	recepcionara	2	0	7	20983
recepcionà	2	0	recepciona	2	29	29	20984
recepcionés	2	2	recepciones	2	0	2	20985
recepcioní	2	0	recepcioni	2	10	10	20986
receptarà	2	20	receptara	2	0	20	20987
receptà	2	6	recepta	4	30766	30772	20988
receptés	2	4	receptes	4	23219	23223	20989
receptí	2	1	recepti	2	48	49	20990
recercarà	2	3	recercara	2	0	3	20991
recercà	2	7	recerca	4	181880	181887	20992
recercàrem	2	0	recercarem	2	3	3	20993
recerqués	2	0	recerques	4	8506	8506	20994
recerquí	2	0	recerqui	2	10	10	20995
reciclarà	2	31	reciclara	2	0	31	20996
reciclà	2	11	recicla	2	1007	1018	20997
reciclàrem	2	0	reciclarem	2	32	32	20998
reciclés	2	13	recicles	2	67	80	20999
reciclí	2	0	recicli	2	84	84	21000
recidivà	2	0	recidiva	4	87	87	21001
recidivés	2	0	recidives	4	68	68	21002
recidiví	2	0	recidivi	2	1	1	21003
recinglà	2	0	recingla	2	3	3	21004
recinglés	2	0	recingles	2	6	6	21005
reciprocà	2	0	reciproca	2	25	25	21006
reciproqués	2	0	reciproques	2	9	9	21007
recitarà	2	192	recitara	2	4	196	21008
recità	2	97	recita	2	787	884	21009
recitàrem	2	10	recitarem	2	43	53	21010
recités	2	40	recites	2	21	61	21011
recití	2	0	reciti	2	33	33	21012
reclamarà	2	658	reclamara	2	16	674	21013
reclamà	2	389	reclama	2	14691	15080	21014
reclamàrem	2	9	reclamarem	2	136	145	21015
reclamàreu	2	0	reclamareu	2	3	3	21016
reclamés	2	149	reclames	2	84	233	21017
reclamí	2	0	reclami	2	589	589	21018
reclassificarà	2	1	reclassificara	2	0	1	21019
reclassificà	2	12	reclassifica	2	15	27	21020
reclassifiqués	2	1	reclassifiques	2	0	1	21021
reclassifiquí	2	0	reclassifiqui	2	5	5	21022
reclavà	2	0	reclava	2	1	1	21023
reclinà	2	4	reclina	2	15	19	21024
reclinàrem	2	0	reclinarem	2	1	1	21025
reclinés	2	0	reclines	2	1	1	21026
recliní	2	0	reclini	2	2	2	21027
reclogués	2	2	reclogues	2	1	3	21028
recloguí	2	0	reclogui	2	3	3	21029
reclouré	2	0	recloure	2	348	348	21030
reclutarà	2	18	reclutara	2	2	20	21031
reclutà	2	54	recluta	4	325	379	21032
reclutàrem	2	0	reclutarem	2	2	2	21033
reclutés	2	10	reclutes	4	458	468	21034
reclutí	2	0	recluti	2	13	13	21035
recobrarà	2	23	recobrara	2	3	26	21036
recobrirà	2	20	recobrira	2	0	20	21037
recobrà	2	111	recobra	2	156	267	21038
recobràrem	2	1	recobrarem	2	9	10	21039
recobràreu	2	0	recobrareu	2	7	7	21040
recobrés	2	18	recobres	2	1	19	21041
recobrí	2	11	recobri	2	59	70	21042
recobrírem	2	0	recobrirem	2	4	4	21043
recobríreu	2	0	recobrireu	2	1	1	21044
recobrís	2	3	recobris	2	9	12	21045
recodificà	2	0	recodifica	2	15	15	21046
recogità	2	0	recogita	2	3	3	21047
recollirà	2	2154	recollira	2	26	2180	21048
recollírem	2	17	recollirem	2	589	606	21049
recollíreu	2	0	recollireu	2	39	39	21050
recolonitzarà	2	1	recolonitzara	2	0	1	21051
recolonitzà	2	2	recolonitza	2	2	4	21052
recolonitzés	2	1	recolonitzes	2	0	1	21053
recolzarà	2	507	recolzara	2	17	524	21054
recolzà	2	187	recolza	2	4847	5034	21055
recolzàrem	2	5	recolzarem	2	243	248	21056
recolzàreu	2	0	recolzareu	2	2	2	21057
recolzés	2	104	recolzes	2	59	163	21058
recolzí	2	0	recolzi	2	724	724	21059
recol·lectarà	2	6	recol·lectara	2	0	6	21060
recol·lectà	2	5	recol·lecta	2	363	368	21061
recol·lectàrem	2	0	recol·lectarem	2	31	31	21062
recol·lectàreu	2	0	recol·lectareu	2	3	3	21063
recol·lectés	2	3	recol·lectes	2	42	45	21064
recol·lectí	2	0	recol·lecti	2	12	12	21065
recol·locarà	2	10	recol·locara	2	0	10	21066
recol·locà	2	7	recol·loca	2	53	60	21067
recol·locàrem	2	0	recol·locarem	2	1	1	21068
recol·locàreu	2	0	recol·locareu	2	1	1	21069
recol·loqués	2	2	recol·loques	2	1	3	21070
recol·loquí	2	0	recol·loqui	2	5	5	21071
recolà	2	0	recola	2	2	2	21072
recolàrem	2	0	recolarem	2	1	1	21073
recomanarà	2	363	recomanara	2	9	372	21074
recomanà	2	285	recomana	2	19440	19725	21075
recomanàrem	2	0	recomanarem	2	344	344	21076
recomanàreu	2	0	recomanareu	2	8	8	21077
recomanés	2	118	recomanes	2	224	342	21078
recomaní	2	1	recomani	2	529	530	21079
recombinarà	2	1	recombinara	2	0	1	21080
recombinà	2	0	recombina	2	16	16	21081
recombinés	2	1	recombines	2	1	2	21082
recomencés	2	2	recomences	2	1	3	21083
recomencí	2	0	recomenci	2	9	9	21084
recomençarà	2	8	recomençara	2	0	8	21085
recomençà	2	13	recomença	2	99	112	21086
recomençàrem	2	0	recomençarem	2	3	3	21087
recompensarà	2	108	recompensara	2	0	108	21088
recompensà	2	26	recompensa	4	5663	5689	21089
recompensàrem	2	0	recompensarem	2	10	10	21090
recompensés	2	7	recompenses	4	1903	1910	21091
recompensí	2	0	recompensi	2	77	77	21092
recompilà	2	0	recompila	2	4	4	21093
recompilàrem	2	0	recompilarem	2	1	1	21094
recompilés	2	1	recompiles	2	0	1	21095
recompilí	2	0	recompili	2	3	3	21096
recompondré	2	1	recompondre	2	594	595	21097
recompongués	2	1	recompongues	2	0	1	21098
recomponguí	2	0	recompongui	2	14	14	21099
recomprà	2	1	recompra	4	225	226	21100
recompràrem	2	0	recomprarem	2	1	1	21101
recomprés	2	1	recompres	4	7	8	21102
recomprí	2	0	recompri	2	1	1	21103
recomptarà	2	8	recomptara	2	0	8	21104
recomptà	2	1	recompta	2	25	26	21105
recomptàrem	2	0	recomptarem	2	1	1	21106
recomptés	2	0	recomptes	2	470	470	21107
recomptí	2	0	recompti	2	1	1	21108
reconcentrà	2	2	reconcentra	2	5	7	21109
reconcentrí	2	0	reconcentri	2	1	1	21110
reconciliarà	2	17	reconciliara	2	1	18	21111
reconcilià	2	39	reconcilia	2	286	325	21112
reconciliàrem	2	0	reconciliarem	2	3	3	21113
reconciliàreu	2	1	reconciliareu	2	2	3	21114
reconciliés	2	16	reconcilies	2	13	29	21115
reconcilií	2	0	reconcilii	2	2	2	21116
recondicionarà	2	1	recondicionara	2	0	1	21117
recondicionà	2	0	recondiciona	2	2	2	21118
reconduírem	2	0	reconduirem	2	9	9	21119
reconegués	2	715	reconegues	2	8	723	21120
reconeguí	2	2	reconegui	2	3924	3926	21121
reconfigurarà	2	4	reconfigurara	2	2	6	21122
reconfigurà	2	2	reconfigura	2	46	48	21123
reconfiguràrem	2	0	reconfigurarem	2	1	1	21124
reconfigurés	2	1	reconfigures	2	1	2	21125
reconfigurí	2	0	reconfiguri	2	2	2	21126
reconfirmarà	2	2	reconfirmara	2	0	2	21127
reconfirmà	2	1	reconfirma	2	12	13	21128
reconfirmàrem	2	0	reconfirmarem	2	1	1	21129
reconfirmés	2	1	reconfirmes	2	0	1	21130
reconfirmí	2	0	reconfirmi	2	3	3	21131
reconfortarà	2	21	reconfortara	2	0	21	21132
reconfortà	2	5	reconforta	2	511	516	21133
reconfortàrem	2	0	reconfortarem	2	1	1	21134
reconfortés	2	3	reconfortes	2	4	7	21135
reconfortí	2	0	reconforti	2	20	20	21136
reconnectarà	2	1	reconnectara	2	1	2	21137
reconnectà	2	0	reconnecta	2	72	72	21138
reconnectàrem	2	0	reconnectarem	2	2	2	21139
reconnectés	2	1	reconnectes	2	1	2	21140
reconnectí	2	0	reconnecti	2	6	6	21141
reconquerirà	2	3	reconquerira	2	0	3	21142
reconquerírem	2	1	reconquerirem	2	3	4	21143
reconquistarà	2	1	reconquistara	2	0	1	21144
reconquistà	2	10	reconquista	4	230	240	21145
reconquistàrem	2	0	reconquistarem	2	2	2	21146
reconquistés	2	0	reconquistes	4	1	1	21147
reconsiderarà	2	32	reconsiderara	2	4	36	21148
reconsiderà	2	6	reconsidera	2	51	57	21149
reconsideràrem	2	0	reconsiderarem	2	4	4	21150
reconsiderés	2	87	reconsideres	2	4	91	21151
reconsiderí	2	0	reconsideri	2	472	472	21152
reconstruírem	2	1	reconstruirem	2	31	32	21153
recontarà	2	1	recontara	2	0	1	21154
recontextualitzà	2	0	recontextualitza	2	5	5	21155
recontà	2	5	reconta	2	12	17	21156
recontàrem	2	0	recontarem	2	2	2	21157
recontés	2	0	recontes	2	5	5	21158
recontí	2	0	reconti	2	1	1	21159
reconvertirà	2	49	reconvertira	2	0	49	21160
reconvertírem	2	3	reconvertirem	2	9	12	21161
reconvertíreu	2	0	reconvertireu	2	1	1	21162
recopilarà	2	122	recopilara	2	1	123	21163
recopilà	2	32	recopila	2	1306	1338	21164
recopilàrem	2	2	recopilarem	2	58	60	21165
recopilàreu	2	0	recopilareu	2	1	1	21166
recopilés	2	32	recopiles	2	8	40	21167
recopilí	2	0	recopili	2	76	76	21168
recordarà	2	2346	recordara	2	40	2386	21169
recordà	2	952	recorda	2	51303	52255	21170
recordàrem	2	58	recordarem	2	2162	2220	21171
recordàreu	2	2	recordareu	2	1150	1152	21172
recordés	2	420	recordes	2	2873	3293	21173
recordí	2	7	recordi	2	3357	3364	21174
recosírem	2	0	recosirem	2	1	1	21175
recouré	2	0	recoure	2	4	4	21176
recrearà	2	198	recreara	2	3	201	21177
recremà	2	0	recrema	2	8	8	21178
recremí	2	0	recremi	2	4	4	21179
recreà	2	40	recrea	2	3101	3141	21180
recreàrem	2	2	recrearem	2	46	48	21181
recreés	2	16	recrees	2	24	40	21182
recreí	2	0	recrei	2	9	9	21183
recriminarà	2	7	recriminara	2	1	8	21184
recriminà	2	24	recrimina	2	335	359	21185
recriminàrem	2	0	recriminarem	2	4	4	21186
recriminés	2	16	recrimines	2	9	25	21187
recriminí	2	0	recrimini	2	18	18	21188
recristal·litzà	2	0	recristal·litza	2	2	2	21189
recrià	2	0	recria	4	64	64	21190
recriés	2	0	recries	4	1	1	21191
rectificarà	2	162	rectificara	2	12	174	21192
rectificà	2	31	rectifica	2	611	642	21193
rectificàrem	2	0	rectificarem	2	123	123	21194
rectificàreu	2	0	rectificareu	2	8	8	21195
rectifiqués	2	66	rectifiques	2	25	91	21196
rectifiquí	2	0	rectifiqui	2	563	563	21197
recularà	2	33	reculara	2	2	35	21198
reculà	2	37	recula	2	313	350	21199
reculàrem	2	1	recularem	2	51	52	21200
reculàreu	2	0	reculareu	2	2	2	21201
reculés	2	15	recules	2	37	52	21202
reculí	2	0	reculi	2	45	45	21203
recuperarà	2	1515	recuperara	2	62	1577	21204
recuperà	2	790	recupera	2	286620	287410	21205
recuperàrem	2	31	recuperarem	2	625	656	21206
recuperàreu	2	0	recuperareu	2	41	41	21207
recuperés	2	434	recuperes	2	173	607	21208
recuperí	2	3	recuperi	2	2357	2360	21209
recusà	2	2	recusa	2	11	13	21210
recusés	2	2	recuses	2	0	2	21211
recusí	2	0	recusi	2	4	4	21212
recà	2	0	reca	2	122	122	21213
recàlcul	4	53	recalcul	2	3	56	21214
recàreu	2	1	recareu	2	0	1	21215
recàrrega	4	3640	recarrega	2	502	4142	21216
recàrregues	4	200	recarregues	2	41	241	21217
recàvem	2	0	recavem	2	12	12	21218
recàveu	2	0	recaveu	2	1	1	21219
recíproc	0	874	reciproc	2	7	881	21220
recíproca	0	1201	reciproca	2	25	1226	21221
recíproques	0	333	reciproques	2	9	342	21222
recòndit	0	287	recondit	2	16	303	21223
recòndits	0	347	recondits	2	30	377	21224
redactarà	2	498	redactara	2	11	509	21225
redactà	2	527	redacta	2	1012	1539	21226
redactàrem	2	11	redactarem	2	88	99	21227
redactàreu	2	0	redactareu	2	6	6	21228
redactés	2	111	redactes	2	24	135	21229
redactí	2	0	redacti	2	334	334	21230
redallí	2	0	redalli	2	3	3	21231
redargüíreu	2	1	redargüireu	2	0	1	21232
redecorà	2	5	redecora	2	13	18	21233
redecorés	2	2	redecores	2	2	4	21234
redecorí	2	0	redecori	2	1	1	21235
redefinirà	2	25	redefinira	2	1	26	21236
redefinírem	2	0	redefinirem	2	7	7	21237
redelimità	2	0	redelimita	2	1	1	21238
redelmà	2	0	redelma	2	4	4	21239
redelmés	2	0	redelmes	2	1	1	21240
redenominà	2	1	redenomina	2	0	1	21241
redenominí	2	0	redenomini	2	2	2	21242
redescobrirà	2	20	redescobrira	2	0	20	21243
redescobrírem	2	0	redescobrirem	2	30	30	21244
redescobríreu	2	0	redescobrireu	2	9	9	21245
redibuixarà	2	7	redibuixara	2	0	7	21246
redibuixà	2	5	redibuixa	2	53	58	21247
redibuixàrem	2	0	redibuixarem	2	1	1	21248
redibuixés	2	0	redibuixes	2	1	1	21249
redibuixí	2	0	redibuixi	2	3	3	21250
redifondré	2	0	redifondre	2	4	4	21251
redimensionarà	2	32	redimensionara	2	3	35	21252
redimensionà	2	0	redimensiona	2	236	236	21253
redimensionés	2	1	redimensiones	2	0	1	21254
redimensioní	2	0	redimensioni	2	11	11	21255
redimirà	2	20	redimira	2	0	20	21256
redimírem	2	0	redimirem	2	4	4	21257
redirigirà	2	83	redirigira	2	0	83	21258
redirigírem	2	2	redirigirem	2	11	13	21259
redirigíreu	2	0	redirigireu	2	2	2	21260
redissenyarà	2	8	redissenyara	2	0	8	21261
redissenyà	2	15	redissenya	2	51	66	21262
redissenyàrem	2	0	redissenyarem	2	5	5	21263
redissenyés	2	4	redissenyes	2	1	5	21264
redissenyí	2	0	redissenyi	2	4	4	21265
redistribuírem	2	0	redistribuirem	2	1	1	21266
redistribuíreu	2	0	redistribuireu	2	1	1	21267
redoblarà	2	25	redoblara	2	1	26	21268
redoblà	2	6	redobla	2	64	70	21269
redoblàrem	2	0	redoblarem	2	15	15	21270
redoblàreu	2	1	redoblareu	2	0	1	21271
redoblés	2	2	redobles	2	19	21	21272
redoblí	2	0	redobli	2	25	25	21273
redolà	2	0	redola	2	9	9	21274
redolés	2	0	redoles	2	9	9	21275
redolí	2	26	redoli	2	2	28	21276
redossà	2	0	redossa	2	28	28	21277
redossés	2	0	redosses	2	2	2	21278
redrecés	2	7	redreces	2	2	9	21279
redrecí	2	0	redreci	2	28	28	21280
redreçarà	2	16	redreçara	2	1	17	21281
redreçà	2	20	redreça	2	158	178	21282
redreçàrem	2	0	redreçarem	2	9	9	21283
redreçàreu	2	0	redreçareu	2	2	2	21284
redubtà	2	0	redubta	2	9	9	21285
redundarà	2	342	redundara	2	1	343	21286
redundà	2	3	redunda	2	713	716	21287
redundés	2	4	redundes	2	5	9	21288
redundí	2	0	redundi	2	126	126	21289
reduplicà	2	0	reduplica	2	2	2	21290
reduírem	2	2	reduirem	2	309	311	21291
reduíreu	2	1	reduireu	2	17	18	21292
redéu	7	158	redeu	7	44	202	21293
reedificà	2	37	reedifica	2	8	45	21294
reedifiquí	2	0	reedifiqui	2	1	1	21295
reeditarà	2	104	reeditara	2	2	106	21296
reedità	2	67	reedita	2	391	458	21297
reeditàrem	2	0	reeditarem	2	6	6	21298
reedités	2	15	reedites	2	0	15	21299
reedití	2	0	reediti	2	23	23	21300
reeducarà	2	1	reeducara	2	0	1	21301
reeducà	2	0	reeduca	2	41	41	21302
reeducàrem	2	0	reeducarem	2	1	1	21303
reeduqués	2	0	reeduques	2	1	1	21304
reeduquí	2	0	reeduqui	2	4	4	21305
reeixirà	2	42	reeixira	2	1	43	21306
reeixírem	2	0	reeixirem	2	10	10	21307
reelaborarà	2	2	reelaborara	2	1	3	21308
reelaborà	2	12	reelabora	2	50	62	21309
reelaborí	2	0	reelabori	2	7	7	21310
reelegirà	2	2	reelegira	2	1	3	21311
reembarcà	2	4	reembarca	2	3	7	21312
reemborsarà	2	505	reemborsara	2	0	505	21313
reemborsà	2	1	reemborsa	2	39	40	21314
reemborsàrem	2	0	reemborsarem	2	72	72	21315
reemborsàreu	2	0	reemborsareu	2	1	1	21316
reemborsés	2	3	reemborses	2	0	3	21317
reemborsí	2	0	reemborsi	2	34	34	21318
reembossarà	2	12	reembossara	2	0	12	21319
reembossà	2	0	reembossa	2	1	1	21320
reembossàrem	2	0	reembossarem	2	10	10	21321
reembossí	2	0	reembossi	2	1	1	21322
reemetré	2	0	reemetre	2	37	37	21323
reemetí	2	0	reemeti	2	2	2	21324
reempaquetà	2	0	reempaqueta	2	2	2	21325
reemplacés	2	42	reemplaces	2	8	50	21326
reemplací	2	0	reemplaci	2	79	79	21327
reemplaçarà	2	168	reemplaçara	2	5	173	21328
reemplaçà	2	136	reemplaça	2	977	1113	21329
reemplaçàrem	2	0	reemplaçarem	2	9	9	21330
reemprés	2	6	reempres	2	0	6	21331
reenamorà	2	0	reenamora	2	3	3	21332
reencaminarà	2	1	reencaminara	2	0	1	21333
reencaminà	2	0	reencamina	2	2	2	21334
reencaminés	2	0	reencamines	2	1	1	21335
reencaminí	2	0	reencamini	2	1	1	21336
reencarnarà	2	10	reencarnara	2	0	10	21337
reencarnà	2	1	reencarna	2	34	35	21338
reencarnàrem	2	0	reencarnarem	2	1	1	21339
reencarnés	2	1	reencarnes	2	1	2	21340
reencarní	2	0	reencarni	2	4	4	21341
reencunyà	2	1	reencunya	2	1	2	21342
reenfocarà	2	1	reenfocara	2	0	1	21343
reenfocà	2	0	reenfoca	2	8	8	21344
reenganxarà	2	3	reenganxara	2	0	3	21345
reenganxà	2	3	reenganxa	2	12	15	21346
reenganxàrem	2	0	reenganxarem	2	1	1	21347
reenganxés	2	1	reenganxes	2	1	2	21348
reenganxí	2	0	reenganxi	2	3	3	21349
reentrarà	2	1	reentrara	2	0	1	21350
reentrà	2	0	reentra	2	1	1	21351
reentrés	2	1	reentres	2	0	1	21352
reentrí	2	0	reentri	2	3	3	21353
reenviarà	2	24	reenviara	2	0	24	21354
reenvià	2	2	reenvia	2	205	207	21355
reenviàrem	2	0	reenviarem	2	20	20	21356
reenviàreu	2	0	reenviareu	2	1	1	21357
reenviés	2	1	reenvies	2	13	14	21358
reenvií	2	1	reenvii	2	2	3	21359
reequilibrarà	2	5	reequilibrara	2	1	6	21360
reequilibrà	2	0	reequilibra	2	76	76	21361
reequilibràrem	2	0	reequilibrarem	2	2	2	21362
reequilibràreu	2	0	reequilibrareu	2	1	1	21363
reequilibrés	2	3	reequilibres	2	0	3	21364
reequilibrí	2	0	reequilibri	2	580	580	21365
reescalfarà	2	1	reescalfara	2	0	1	21366
reescalfà	2	2	reescalfa	2	17	19	21367
reescalfàrem	2	0	reescalfarem	2	1	1	21368
reescalfí	2	0	reescalfi	2	5	5	21369
reescalfó	4	0	reescalfo	2	3	3	21370
reescrigués	2	3	reescrigues	2	0	3	21371
reescriguí	2	0	reescrigui	2	21	21	21372
reescriuré	2	2	reescriure	2	1085	1087	21373
reestimà	2	0	reestima	2	1	1	21374
reestrenarà	2	18	reestrenara	2	1	19	21375
reestrenà	2	6	reestrena	4	260	266	21376
reestrenàrem	2	0	reestrenarem	2	1	1	21377
reestrenés	2	1	reestrenes	4	30	31	21378
reestructurarà	2	18	reestructurara	2	1	19	21379
reestructurà	2	35	reestructura	2	206	241	21380
reestructuràrem	2	0	reestructurarem	2	8	8	21381
reestructurés	2	5	reestructures	2	3	8	21382
reestructurí	2	0	reestructuri	2	26	26	21383
reexaminarà	2	9	reexaminara	2	0	9	21384
reexaminà	2	4	reexamina	2	10	14	21385
reexaminàrem	2	0	reexaminarem	2	2	2	21386
reexaminés	2	1	reexamines	2	0	1	21387
reexaminí	2	0	reexamini	2	11	11	21388
reexpedirà	2	4	reexpedira	2	0	4	21389
reexplicà	2	0	reexplica	2	5	5	21390
reexportarà	2	1	reexportara	2	0	1	21391
reexportà	2	0	reexporta	2	9	9	21392
reexposà	2	0	reexposa	2	4	4	21393
refallà	2	0	refalla	2	1	1	21394
referenciarà	2	2	referenciara	2	0	2	21395
referencià	2	4	referencia	2	2107	2111	21396
referenciàrem	2	0	referenciarem	2	2	2	21397
referenciés	2	3	referencies	2	349	352	21398
referencií	2	0	referencii	2	1	1	21399
referendarà	2	1	referendara	2	0	1	21400
referendà	2	4	referenda	2	15	19	21401
referendària	0	172	referendaria	2	11	183	21402
referendàries	0	419	referendaries	2	10	429	21403
referendés	2	1	referendes	2	0	1	21404
referendí	2	0	referendi	2	2	2	21405
referirà	2	201	referira	2	9	210	21406
refermarà	2	42	refermara	2	0	42	21407
refermà	2	84	referma	2	1455	1539	21408
refermàrem	2	1	refermarem	2	5	6	21409
refermés	2	10	refermes	2	4	14	21410
refermí	2	0	refermi	2	47	47	21411
referrà	2	1	referra	2	0	1	21412
referència	4	117792	referencia	2	2107	119899	21413
referències	4	23281	referencies	2	349	23630	21414
referírem	2	1	referirem	2	212	213	21415
refiarà	2	5	refiara	2	0	5	21416
refilà	2	2	refila	2	61	63	21417
refilàrem	2	0	refilarem	2	2	2	21418
refilés	2	1	refiles	2	4	5	21419
refilí	2	0	refili	2	2	2	21420
refinancés	2	2	refinances	2	0	2	21421
refinancí	2	0	refinanci	2	5	5	21422
refinançarà	2	1	refinançara	2	1	2	21423
refinançà	2	1	refinança	2	4	5	21424
refinarà	2	10	refinara	2	0	10	21425
refinà	2	4	refina	2	91	95	21426
refinàrem	2	0	refinarem	2	3	3	21427
refinés	2	2	refines	2	1	3	21428
refiní	2	0	refini	2	2	2	21429
refià	2	6	refia	2	224	230	21430
refiàrem	2	0	refiarem	2	3	3	21431
refiés	2	10	refies	2	35	45	21432
refií	2	1	refii	2	6	7	21433
reflectirà	2	518	reflectira	2	22	540	21434
reflectírem	2	0	reflectirem	2	19	19	21435
reflectíreu	2	0	reflectireu	2	1	1	21436
reflexionarà	2	587	reflexionara	2	8	595	21437
reflexionà	2	77	reflexiona	2	5253	5330	21438
reflexionàrem	2	13	reflexionarem	2	521	534	21439
reflexionàreu	2	1	reflexionareu	2	7	8	21440
reflexionés	2	93	reflexiones	2	251	344	21441
reflexioní	2	0	reflexioni	2	626	626	21442
reflotarà	2	5	reflotara	2	0	5	21443
reflotà	2	0	reflota	2	10	10	21444
reflotés	2	1	reflotes	2	0	1	21445
reflotí	2	0	refloti	2	2	2	21446
refocil·là	2	0	refocil·la	2	1	1	21447
refondré	2	0	refondre	2	262	262	21448
refongués	2	1	refongues	2	0	1	21449
refonguí	2	0	refongui	2	10	10	21450
reforcés	2	107	reforces	2	27	134	21451
reforcí	2	1	reforci	2	968	969	21452
reforestarà	2	5	reforestara	2	0	5	21453
reforestà	2	0	reforesta	2	9	9	21454
reforestí	2	0	reforesti	2	1	1	21455
reforjà	2	0	reforja	2	4	4	21456
reformarà	2	194	reformara	2	3	197	21457
reformatarà	2	8	reformatara	2	0	8	21458
reformatà	2	0	reformata	2	17	17	21459
reformatí	2	0	reformati	2	2	2	21460
reformularà	2	9	reformulara	2	2	11	21461
reformulà	2	8	reformula	2	147	155	21462
reformulàrem	2	1	reformularem	2	6	7	21463
reformulés	2	7	reformules	2	0	7	21464
reformulí	2	0	reformuli	2	36	36	21465
reformà	2	191	reforma	4	62210	62401	21466
reformàrem	2	3	reformarem	2	58	61	21467
reformés	2	31	reformes	4	24196	24227	21468
reformí	2	0	reformi	2	176	176	21469
reforçarà	2	1715	reforçara	2	6	1721	21470
reforçà	2	189	reforça	2	6775	6964	21471
reforçàrem	2	3	reforçarem	2	185	188	21472
reforçàreu	2	0	reforçareu	2	9	9	21473
refractà	2	0	refracta	2	74	74	21474
refractària	0	215	refractaria	2	10	225	21475
refractàries	0	80	refractaries	2	7	87	21476
refractés	2	0	refractes	2	1	1	21477
refractí	2	0	refracti	2	2	2	21478
refredarà	2	75	refredara	2	2	77	21479
refredà	2	31	refreda	2	838	869	21480
refredàrem	2	0	refredarem	2	29	29	21481
refredés	2	39	refredes	2	8	47	21482
refredí	2	0	refredi	2	672	672	21483
refregués	2	5	refregues	2	7	12	21484
refreguí	2	0	refregui	2	11	11	21485
refregà	2	3	refrega	2	98	101	21486
refrenarà	2	2	refrenara	2	0	2	21487
refrendarà	2	1	refrendara	2	0	1	21488
refrendà	2	4	refrenda	2	10	14	21489
refrendés	2	1	refrendes	2	0	1	21490
refrendí	2	0	refrendi	2	2	2	21491
refrenà	2	3	refrena	2	22	25	21492
refrenés	2	3	refrenes	2	0	3	21493
refrení	2	0	refreni	2	3	3	21494
refrescarà	2	69	refrescara	2	0	69	21495
refrescà	2	2	refresca	2	789	791	21496
refrescàrem	2	3	refrescarem	2	48	51	21497
refrescàreu	2	0	refrescareu	2	3	3	21498
refresqués	2	9	refresques	2	16	25	21499
refresquí	2	0	refresqui	2	75	75	21500
refrigerarà	2	2	refrigerara	2	0	2	21501
refrigerà	2	1	refrigera	2	47	48	21502
refrigeràrem	2	0	refrigerarem	2	3	3	21503
refrigerés	2	2	refrigeres	2	1	3	21504
refrigerí	2	1	refrigeri	2	1560	1561	21505
refugiarà	2	26	refugiara	2	2	28	21506
refugià	2	377	refugia	2	635	1012	21507
refugiàrem	2	5	refugiarem	2	8	13	21508
refugiés	2	28	refugies	2	7	35	21509
refugií	2	0	refugii	2	8	8	21510
refundarà	2	6	refundara	2	1	7	21511
refundà	2	49	refunda	2	52	101	21512
refundàrem	2	0	refundarem	2	3	3	21513
refundí	2	1	refundi	2	20	21	21514
refusarà	2	24	refusara	2	0	24	21515
refusà	2	289	refusa	2	725	1014	21516
refusàrem	2	2	refusarem	2	4	6	21517
refusés	2	53	refuses	2	34	87	21518
refusí	2	1	refusi	2	48	49	21519
refutarà	2	3	refutara	2	0	3	21520
refutà	2	18	refuta	2	116	134	21521
refutés	2	4	refutes	2	2	6	21522
refutí	2	0	refuti	2	20	20	21523
reféu	2	42	refeu	2	34	76	21524
regalarà	2	603	regalara	2	17	620	21525
regalimarà	2	4	regalimara	2	0	4	21526
regalimà	2	3	regalima	2	305	308	21527
regalimés	2	5	regalimes	2	1	6	21528
regalimí	2	0	regalimi	2	28	28	21529
regallà	2	0	regalla	2	3	3	21530
regalló	4	0	regallo	2	1	1	21531
regalà	2	249	regala	4	4784	5033	21532
regalàrem	2	5	regalarem	2	264	269	21533
regalàreu	2	0	regalareu	2	23	23	21534
regalés	2	90	regales	4	212	302	21535
regalí	2	1	regali	2	267	268	21536
reganyà	2	67	reganya	2	16	83	21537
reganà	2	0	regana	2	29	29	21538
reganés	2	0	reganes	2	2	2	21539
reganí	2	0	regani	2	22	22	21540
regarà	2	37	regara	2	5	42	21541
regategés	2	0	regateges	2	5	5	21542
regategí	2	0	regategi	2	8	8	21543
regatejarà	2	6	regatejara	2	0	6	21544
regatejà	2	0	regateja	2	62	62	21545
regatejàrem	2	0	regatejarem	2	3	3	21546
regatà	2	0	regata	4	4128	4128	21547
regatés	2	0	regates	4	2229	2229	21548
regatí	2	0	regati	2	1	1	21549
regató	4	21	regato	2	6	27	21550
regelés	2	0	regeles	2	1	1	21551
regenerarà	2	38	regenerara	2	1	39	21552
regenerà	2	4	regenera	2	512	516	21553
regeneràrem	2	0	regenerarem	2	2	2	21554
regenerés	2	8	regeneres	2	4	12	21555
regenerí	2	0	regeneri	2	53	53	21556
regentarà	2	9	regentara	2	1	10	21557
regentà	2	92	regenta	2	909	1001	21558
regentés	2	5	regentes	2	9	14	21559
regentí	2	1	regenti	2	7	8	21560
regionalitzà	2	0	regionalitza	2	12	12	21561
regirarà	2	5	regirara	2	0	5	21562
regirà	2	1678	regira	2	247	1925	21563
regiràrem	2	0	regirarem	2	5	5	21564
regiré	2	1	regire	2	10	11	21565
regirés	2	6	regires	2	11	17	21566
regirí	2	0	regiri	2	26	26	21567
regiró	4	4	regiro	2	23	27	21568
registrarà	2	411	registrara	2	8	419	21569
registrà	2	244	registra	2	5350	5594	21570
registràrem	2	17	registrarem	2	45	62	21571
registràreu	2	0	registrareu	2	1	1	21572
registrés	2	76	registres	2	17830	17906	21573
registrí	2	0	registri	2	550	550	21574
reglamentarà	2	10	reglamentara	2	1	11	21575
reglamentà	2	11	reglamenta	2	76	87	21576
reglamentàrem	2	0	reglamentarem	2	3	3	21577
reglamentària	0	1206	reglamentaria	2	74	1280	21578
reglamentàries	0	1343	reglamentaries	2	60	1403	21579
reglamentés	2	8	reglamentes	2	1	9	21580
reglamentí	2	0	reglamenti	2	37	37	21581
reglarà	2	1	reglara	2	0	1	21582
reglotarà	2	1	reglotara	2	0	1	21583
reglà	2	121	regla	4	12603	12724	21584
reglés	2	1	regles	4	20584	20585	21585
reglí	2	0	regli	2	2	2	21586
regnarà	2	146	regnara	2	3	149	21587
regnà	2	197	regna	4	1898	2095	21588
regnàrem	2	0	regnarem	2	10	10	21589
regnés	2	54	regnes	4	7778	7832	21590
regní	2	0	regni	2	324	324	21591
regolfà	2	0	regolfa	2	10	10	21592
regosòl	4	0	regosol	4	1	1	21593
regracià	2	5	regracia	2	13	18	21594
regraciés	2	1	regracies	2	0	1	21595
regressarà	2	4	regressara	2	1	5	21596
regressà	2	13	regressa	2	53	66	21597
regressàrem	2	1	regressarem	2	1	2	21598
regressés	2	2	regresses	2	0	2	21599
regressí	2	0	regressi	2	3	3	21600
regruixà	2	0	regruixa	2	1	1	21601
regruàrem	2	1	regruarem	2	0	1	21602
regruàreu	2	1	regruareu	2	0	1	21603
reguanyà	2	1	reguanya	2	0	1	21604
reguanyàrem	2	1	reguanyarem	2	0	1	21605
reguanyí	2	0	reguanyi	2	1	1	21606
reguardà	2	0	reguarda	4	33	33	21607
reguardés	2	0	reguardes	4	12	12	21608
reguardí	2	0	reguardi	2	1	1	21609
reguinyà	2	0	reguinya	2	1	1	21610
regularitzarà	2	61	regularitzara	2	1	62	21611
regularitzà	2	7	regularitza	2	131	138	21612
regularitzàrem	2	0	regularitzarem	2	9	9	21613
regularitzés	2	10	regularitzes	2	3	13	21614
regularitzí	2	0	regularitzi	2	89	89	21615
regularà	2	1021	regulara	2	14	1035	21616
regulà	2	38	regula	2	13687	13725	21617
regulàrem	2	0	regularem	2	31	31	21618
regulàreu	2	0	regulareu	2	3	3	21619
regulés	2	137	regules	2	37	174	21620
regulí	2	0	reguli	2	1422	1422	21621
reguló	4	2	regulo	2	11	13	21622
regurgitarà	2	4	regurgitara	2	0	4	21623
regurgità	2	2	regurgita	2	18	20	21624
regurgití	2	0	regurgiti	2	3	3	21625
regués	2	11	regues	4	63	74	21626
reguí	2	0	regui	2	52	52	21627
regà	2	14	rega	4	728	742	21628
regàlia	4	4	regalia	4	76	80	21629
regàlies	4	0	regalies	4	131	131	21630
regàrem	2	3	regarem	2	127	130	21631
regírem	2	1	regirem	2	23	24	21632
regíreu	2	0	regireu	2	26	26	21633
regís	2	53	regis	0	316	369	21634
regó	4	12	rego	2	121	133	21635
rehabilitarà	2	146	rehabilitara	2	3	149	21636
rehabilità	2	44	rehabilita	2	564	608	21637
rehabilitàrem	2	0	rehabilitarem	2	17	17	21638
rehabilités	2	13	rehabilites	2	2	15	21639
rehabilití	2	0	rehabiliti	2	49	49	21640
rehidratarà	2	1	rehidratara	2	0	1	21641
rehidratà	2	1	rehidrata	2	29	30	21642
rehidratàrem	2	0	rehidratarem	2	3	3	21643
reimaginà	2	0	reimagina	2	11	11	21644
reimaginés	2	0	reimagines	2	3	3	21645
reimplantarà	2	1	reimplantara	2	2	3	21646
reimplantà	2	5	reimplanta	2	5	10	21647
reimplantàrem	2	0	reimplantarem	2	1	1	21648
reimplantés	2	1	reimplantes	2	1	2	21649
reimplantí	2	0	reimplanti	2	3	3	21650
reimposarà	2	1	reimposara	2	0	1	21651
reimposà	2	4	reimposa	2	0	4	21652
reimprimirà	2	1	reimprimira	2	0	1	21653
reimpulsà	2	0	reimpulsa	2	5	5	21654
reimpulsàrem	2	0	reimpulsarem	2	2	2	21655
reinaugurarà	2	5	reinaugurara	2	0	5	21656
reinaugurà	2	10	reinaugura	2	18	28	21657
reinauguràrem	2	0	reinaugurarem	2	1	1	21658
reinaugurés	2	1	reinaugures	2	0	1	21659
reincidirà	2	5	reincidira	2	1	6	21660
reincidírem	2	0	reincidirem	2	3	3	21661
reincorporarà	2	48	reincorporara	2	1	49	21662
reincorporà	2	58	reincorpora	2	202	260	21663
reincorporàrem	2	1	reincorporarem	2	4	5	21664
reincorporés	2	7	reincorpores	2	4	11	21665
reincorporí	2	0	reincorpori	2	44	44	21666
reindexà	2	0	reindexa	2	4	4	21667
reindexí	2	0	reindexi	2	1	1	21668
reindustrialitzàrem	2	0	reindustrialitzarem	2	1	1	21669
reindustrialitzí	2	0	reindustrialitzi	2	2	2	21670
reinfectà	2	0	reinfecta	2	1	1	21671
reingressarà	2	2	reingressara	2	0	2	21672
reingressà	2	14	reingressa	2	18	32	21673
reingressés	2	3	reingresses	2	0	3	21674
reingressí	2	0	reingressi	2	3	3	21675
reinicialitzarà	2	2	reinicialitzara	2	0	2	21676
reinicialitzà	2	0	reinicialitza	2	122	122	21677
reinicialitzí	2	0	reinicialitzi	2	1	1	21678
reiniciarà	2	120	reiniciara	2	1	121	21679
reinicià	2	31	reinicia	2	955	986	21680
reiniciàrem	2	3	reiniciarem	2	24	27	21681
reiniciàreu	2	0	reiniciareu	2	1	1	21682
reiniciés	2	14	reinicies	2	13	27	21683
reinicií	2	1	reinicii	2	8	9	21684
reinscriuré	2	0	reinscriure	2	4	4	21685
reinstal·larà	2	8	reinstal·lara	2	0	8	21686
reinstal·là	2	5	reinstal·la	2	36	41	21687
reinstal·làrem	2	0	reinstal·larem	2	2	2	21688
reinstal·lés	2	0	reinstal·les	2	2	2	21689
reinstal·lí	2	0	reinstal·li	2	5	5	21690
reinstaurarà	2	5	reinstaurara	2	0	5	21691
reinstaurà	2	20	reinstaura	2	20	40	21692
reinstaurés	2	8	reinstaures	2	0	8	21693
reinstaurí	2	0	reinstauri	2	16	16	21694
reintegrarà	2	59	reintegrara	2	0	59	21695
reintegrà	2	38	reintegra	2	93	131	21696
reintegràrem	2	0	reintegrarem	2	11	11	21697
reintegrés	2	6	reintegres	2	2	8	21698
reintegrí	2	0	reintegri	2	28	28	21699
reintentarà	2	2	reintentara	2	0	2	21700
reintentà	2	0	reintenta	2	30	30	21701
reintentés	2	0	reintentes	2	1	1	21702
reintentí	2	0	reintenti	2	2	2	21703
reinterpretarà	2	27	reinterpretara	2	0	27	21704
reinterpretà	2	7	reinterpreta	2	339	346	21705
reinterpretàrem	2	0	reinterpretarem	2	1	1	21706
reinterpretés	2	1	reinterpretes	2	2	3	21707
reinterpretí	2	0	reinterpreti	2	15	15	21708
reintroduírem	2	0	reintroduirem	2	2	2	21709
reinventarà	2	10	reinventara	2	1	11	21710
reinventà	2	17	reinventa	2	647	664	21711
reinventàrem	2	0	reinventarem	2	10	10	21712
reinventés	2	6	reinventes	2	5	11	21713
reinventí	2	0	reinventi	2	18	18	21714
reinvertirà	2	23	reinvertira	2	0	23	21715
reinvertírem	2	1	reinvertirem	2	3	4	21716
reiterarà	2	24	reiterara	2	0	24	21717
reiterà	2	93	reitera	2	1947	2040	21718
reiteràrem	2	1	reiterarem	2	28	29	21719
reiterés	2	23	reiteres	2	3	26	21720
reiterí	2	0	reiteri	2	97	97	21721
reivindicarà	2	196	reivindicara	2	4	200	21722
reivindicà	2	256	reivindica	2	6104	6360	21723
reivindicàrem	2	6	reivindicarem	2	99	105	21724
reivindicàreu	2	0	reivindicareu	2	1	1	21725
reivindiqués	2	64	reivindiques	2	31	95	21726
reivindiquí	2	0	reivindiqui	2	225	225	21727
rejovenirà	2	10	rejovenira	2	1	11	21728
rejovenírem	2	0	rejovenirem	2	1	1	21729
rejuntà	2	2	rejunta	2	3	5	21730
rejuntàrem	2	1	rejuntarem	2	1	2	21731
rejuntés	2	0	rejuntes	2	1	1	21732
rejuntí	2	1	rejunti	2	0	1	21733
relacionarà	2	175	relacionara	2	12	187	21734
relacionà	2	327	relaciona	2	6493	6820	21735
relacionàrem	2	2	relacionarem	2	69	71	21736
relacionàreu	2	0	relacionareu	2	10	10	21737
relacionés	2	87	relaciones	2	797	884	21738
relacioní	2	0	relacioni	2	436	436	21739
relatarà	2	69	relatara	2	5	74	21740
relativitzarà	2	3	relativitzara	2	0	3	21741
relativitzà	2	3	relativitza	2	200	203	21742
relativitzàrem	2	1	relativitzarem	2	0	1	21743
relativitzés	2	1	relativitzes	2	18	19	21744
relativitzí	2	0	relativitzi	2	18	18	21745
relatà	2	96	relata	2	5775	5871	21746
relatàrem	2	1	relatarem	2	21	22	21747
relatés	2	10	relates	2	38	48	21748
relatí	2	0	relati	2	36	36	21749
relaxarà	2	52	relaxara	2	3	55	21750
relaxà	2	12	relaxa	2	1500	1512	21751
relaxàrem	2	3	relaxarem	2	42	45	21752
relaxàreu	2	0	relaxareu	2	4	4	21753
relaxés	2	24	relaxes	2	86	110	21754
relaxí	2	0	relaxi	2	224	224	21755
relegarà	2	12	relegara	2	2	14	21756
relegués	2	7	relegues	2	2	9	21757
releguí	2	0	relegui	2	26	26	21758
relegà	2	24	relega	2	276	300	21759
rellampegà	2	0	rellampega	2	1	1	21760
rellancés	2	3	rellances	2	0	3	21761
rellancí	2	0	rellanci	2	36	36	21762
rellançarà	2	25	rellançara	2	0	25	21763
rellançà	2	28	rellança	2	114	142	21764
rellançàrem	2	0	rellançarem	2	6	6	21765
rellegirà	2	5	rellegira	2	1	6	21766
rellegírem	2	0	rellegirem	2	8	8	21767
rellegíreu	2	0	rellegireu	2	2	2	21768
rellentà	2	0	rellenta	2	1	1	21769
rellepà	2	0	rellepa	2	1	1	21770
rellevarà	2	117	rellevara	2	0	117	21771
rellevà	2	59	relleva	2	206	265	21772
rellevàrem	2	0	rellevarem	2	1	1	21773
rellevàreu	2	0	rellevareu	2	1	1	21774
rellevés	2	24	relleves	2	0	24	21775
relleví	2	1	rellevi	2	49	50	21776
relligarà	2	15	relligara	2	0	15	21777
relligués	2	5	relligues	2	2	7	21778
relliguí	2	0	relligui	2	29	29	21779
relligà	2	2	relliga	2	239	241	21780
relligàrem	2	0	relligarem	2	1	1	21781
relliscarà	2	8	relliscara	2	2	10	21782
relliscà	2	21	rellisca	2	412	433	21783
relliscàrem	2	0	relliscarem	2	1	1	21784
relliscàreu	2	0	relliscareu	2	1	1	21785
rellisqués	2	22	rellisques	2	14	36	21786
rellisquí	2	0	rellisqui	2	100	100	21787
rellogués	2	0	rellogues	2	2	2	21788
rellogà	2	0	relloga	2	12	12	21789
remallà	2	0	remalla	2	1	1	21790
remarcarà	2	23	remarcara	2	1	24	21791
remarcà	2	262	remarca	4	4746	5008	21792
remarcàrem	2	0	remarcarem	2	35	35	21793
remarcàreu	2	1	remarcareu	2	1	2	21794
remaridarà	2	0	remaridara	2	1	1	21795
remarqués	2	23	remarques	4	81	104	21796
remarquí	2	1	remarqui	2	47	48	21797
remarà	2	10	remara	2	1	11	21798
remasteritzà	2	0	remasteritza	2	1	1	21799
rematarà	2	49	rematara	2	6	55	21800
rematà	2	50	remata	2	934	984	21801
rematàrem	2	3	rematarem	2	35	38	21802
rematàreu	2	0	rematareu	2	1	1	21803
rematés	2	49	remates	2	15	64	21804
rematí	2	2	remati	2	18	20	21805
remeiarà	2	9	remeiara	2	0	9	21806
remeià	2	0	remeia	2	25	25	21807
remeiàrem	2	0	remeiarem	2	2	2	21808
remeiés	2	4	remeies	2	0	4	21809
remelsà	2	0	remelsa	2	2	2	21810
remembrà	2	2	remembra	2	10	12	21811
remembrés	2	0	remembres	2	3	3	21812
remembrí	2	0	remembri	2	1	1	21813
rememorarà	2	75	rememorara	2	1	76	21814
rememorà	2	19	rememora	2	1315	1334	21815
rememoràrem	2	2	rememorarem	2	39	41	21816
rememoràreu	2	0	rememorareu	2	2	2	21817
rememorés	2	6	rememores	2	12	18	21818
rememorí	2	0	rememori	2	24	24	21819
remenarà	2	23	remenara	2	0	23	21820
remenjà	2	0	remenja	2	54	54	21821
remenà	2	6	remena	0	1104	1110	21822
remenàrem	2	0	remenarem	2	184	184	21823
remenàreu	2	0	remenareu	2	9	9	21824
remenés	2	11	remenes	0	98	109	21825
remení	2	0	remeni	2	61	61	21826
remesclà	2	1	remescla	2	204	205	21827
remesclés	2	2	remescles	2	206	208	21828
remetré	2	65	remetre	2	3879	3944	21829
remetés	2	60	remetes	2	2	62	21830
remetí	2	0	remeti	2	554	554	21831
remeí	2	4	remei	4	13677	13681	21832
remineralitzà	2	0	remineralitza	2	37	37	21833
remirà	2	2	remira	2	47	49	21834
remiràrem	2	0	remirarem	2	1	1	21835
remiràreu	2	0	remirareu	2	1	1	21836
remirés	2	1	remires	2	18	19	21837
remirí	2	0	remiri	2	3	3	21838
remitjó	4	10	remitjo	2	0	10	21839
remodelarà	2	97	remodelara	2	1	98	21840
remodelà	2	45	remodela	2	141	186	21841
remodelàrem	2	0	remodelarem	2	8	8	21842
remodelés	2	9	remodeles	2	2	11	21843
remodelí	2	0	remodeli	2	11	11	21844
remogués	2	17	remogues	2	0	17	21845
remoguí	2	0	remogui	2	74	74	21846
remolcarà	2	5	remolcara	2	0	5	21847
remolcà	2	1	remolca	2	32	33	21848
remolinarà	2	1	remolinara	2	0	1	21849
remolinà	2	0	remolina	2	7	7	21850
remolqués	2	4	remolques	2	6	10	21851
remolquí	2	0	remolqui	2	4	4	21852
remolà	2	60	remola	2	2	62	21853
remolés	2	0	remoles	2	1	1	21854
remolín	2	1	remolin	2	0	1	21855
remorejarà	2	1	remorejara	2	0	1	21856
remorejà	2	1	remoreja	2	17	18	21857
remouré	2	5	remoure	2	1898	1903	21858
remudà	2	2	remuda	4	3	5	21859
remudés	2	0	remudes	4	1	1	21860
remugarà	2	4	remugara	2	0	4	21861
remuguejà	2	0	remugueja	2	1	1	21862
remuguejàreu	2	0	remuguejareu	2	1	1	21863
remugués	2	1	remugues	2	6	7	21864
remuguí	2	0	remugui	2	11	11	21865
remugà	2	6	remuga	2	127	133	21866
remugàrem	2	0	remugarem	2	1	1	21867
remugó	4	1	remugo	2	6	7	21868
remullarà	2	3	remullara	2	0	3	21869
remullà	2	27	remulla	4	171	198	21870
remullàrem	2	1	remullarem	2	28	29	21871
remullàreu	2	0	remullareu	2	1	1	21872
remullés	2	1	remulles	4	13	14	21873
remullí	2	0	remulli	2	6	6	21874
remunerarà	2	15	remunerara	2	1	16	21875
remunerà	2	1	remunera	2	71	72	21876
remunerés	2	2	remuneres	2	1	3	21877
remunerí	2	0	remuneri	2	19	19	21878
remuntarà	2	50	remuntara	2	4	54	21879
remuntà	2	35	remunta	4	6285	6320	21880
remuntàrem	2	3	remuntarem	2	210	213	21881
remuntàreu	2	0	remuntareu	2	5	5	21882
remuntés	2	34	remuntes	4	36	70	21883
remuntí	2	0	remunti	2	68	68	21884
remà	2	9	rema	2	201	210	21885
remàrem	2	1	remarem	2	22	23	21886
remàreu	2	0	remareu	2	2	2	21887
remèn	2	3	remen	2	84	87	21888
remès	2	1359	remes	2	19	1378	21889
remés	2	288	remes	2	19	307	21890
remí	2	10	remi	2	290	300	21891
remís	0	7	remis	2	30	37	21892
remòlt	2	0	remolt	2	2	2	21893
remòlta	2	2	remolta	2	2	4	21894
renacionalitzarà	2	1	renacionalitzara	2	0	1	21895
renacionalitzà	2	1	renacionalitza	2	3	4	21896
renacionalitzí	2	0	renacionalitzi	2	1	1	21897
renaixérem	2	0	renaixerem	2	5	5	21898
renaixés	2	6	renaixes	2	2	8	21899
renaixí	2	0	renaixi	2	3	3	21900
renasqués	2	1	renasques	2	0	1	21901
renaturalitzà	2	0	renaturalitza	2	2	2	21902
renaturalitzàrem	2	0	renaturalitzarem	2	1	1	21903
renderitzarà	2	30	renderitzara	2	0	30	21904
renderitzà	2	0	renderitza	2	163	163	21905
renderitzàreu	2	0	renderitzareu	2	1	1	21906
renderitzés	2	3	renderitzes	2	1	4	21907
renderitzí	2	0	renderitzi	2	11	11	21908
rendibilitzarà	2	10	rendibilitzara	2	0	10	21909
rendibilitzà	2	0	rendibilitza	2	81	81	21910
rendibilitzàrem	2	0	rendibilitzarem	2	4	4	21911
rendibilitzés	2	2	rendibilitzes	2	0	2	21912
rendibilitzí	2	0	rendibilitzi	2	12	12	21913
rendirà	2	193	rendira	2	12	205	21914
rendírem	2	1	rendirem	2	161	162	21915
rendíreu	2	0	rendireu	2	3	3	21916
renegarà	2	14	renegara	2	1	15	21917
renegociarà	2	12	renegociara	2	0	12	21918
renegocià	2	3	renegocia	2	13	16	21919
renegociàrem	2	0	renegociarem	2	4	4	21920
renegociés	2	5	renegocies	2	0	5	21921
renegués	2	16	renegues	2	8	24	21922
reneguí	2	1	renegui	2	38	39	21923
renegà	2	46	renega	2	367	413	21924
renegàrem	2	0	renegarem	2	11	11	21925
renillà	2	5	renilla	2	14	19	21926
renormalitzà	2	1	renormalitza	2	1	2	21927
renovarà	2	818	renovara	2	7	825	21928
renovellà	2	4	renovella	2	7	11	21929
renovellés	2	1	renovelles	2	0	1	21930
renovà	2	247	renova	2	3535	3782	21931
renovàrem	2	1	renovarem	2	124	125	21932
renovàreu	2	1	renovareu	2	7	8	21933
renovés	2	82	renoves	2	51	133	21934
renoví	2	1	renovi	2	335	336	21935
rentarà	2	44	rentara	2	3	47	21936
rentà	2	32	renta	2	2146	2178	21937
rentàrem	2	0	rentarem	2	94	94	21938
rentàreu	2	0	rentareu	2	12	12	21939
rentés	2	26	rentes	2	249	275	21940
rentí	2	2	renti	2	117	119	21941
renunciarà	2	425	renunciara	2	23	448	21942
renuncià	2	608	renuncia	2	3144	3752	21943
renunciàrem	2	6	renunciarem	2	261	267	21944
renunciàreu	2	0	renunciareu	2	2	2	21945
renunciés	2	326	renuncies	2	205	531	21946
renuncií	2	17	renuncii	2	36	53	21947
renyarà	2	19	renyara	2	2	21	21948
renyinà	2	0	renyina	4	29	29	21949
renyinés	2	0	renyines	4	47	47	21950
renyirà	2	7	renyira	2	0	7	21951
renyoquejarà	2	0	renyoquejara	2	1	1	21952
renyà	2	22	renya	2	265	287	21953
renyàrem	2	0	renyarem	2	3	3	21954
renyàreu	2	0	renyareu	2	1	1	21955
renyés	2	21	renyes	2	17	38	21956
renyí	2	2	renyi	2	34	36	21957
renyín	2	0	renyin	2	23	23	21958
renyírem	2	0	renyirem	2	1	1	21959
renyís	2	0	renyis	2	22	22	21960
renyó	4	40	renyo	2	39	79	21961
renét	4	6	renet	4	7	13	21962
renéta	4	2	reneta	4	3	5	21963
renétes	4	0	renetes	4	1	1	21964
renéts	4	15	renets	4	2	17	21965
renís	4	1	renis	4	2	3	21966
renúncia	4	8863	renuncia	2	3144	12007	21967
renúncies	4	1411	renuncies	2	205	1616	21968
reobrirà	2	288	reobrira	2	4	292	21969
reobrí	2	54	reobri	2	266	320	21970
reobrírem	2	0	reobrirem	2	20	20	21971
reobrís	2	50	reobris	2	1	51	21972
reocupà	2	4	reocupa	2	7	11	21973
reocupàrem	2	0	reocuparem	2	1	1	21974
reomplirà	2	8	reomplira	2	0	8	21975
reomplí	2	2	reompli	2	5	7	21976
reomplírem	2	0	reomplirem	2	7	7	21977
reomplís	2	3	reomplis	2	0	3	21978
reordenarà	2	57	reordenara	2	0	57	21979
reordenà	2	7	reordena	2	169	176	21980
reordenàrem	2	0	reordenarem	2	4	4	21981
reordenés	2	6	reordenes	2	0	6	21982
reordení	2	0	reordeni	2	14	14	21983
reorganitzarà	2	39	reorganitzara	2	2	41	21984
reorganitzà	2	177	reorganitza	2	200	377	21985
reorganitzàrem	2	1	reorganitzarem	2	7	8	21986
reorganitzés	2	12	reorganitzes	2	1	13	21987
reorganitzí	2	0	reorganitzi	2	28	28	21988
reorientarà	2	10	reorientara	2	2	12	21989
reorientà	2	15	reorienta	2	64	79	21990
reorientàrem	2	0	reorientarem	2	3	3	21991
reorientés	2	6	reorientes	2	0	6	21992
reorientí	2	0	reorienti	2	25	25	21993
reorquestrà	2	1	reorquestra	2	0	1	21994
repagarà	2	1	repagara	2	0	1	21995
repagués	2	0	repagues	2	2	2	21996
repagà	2	1	repaga	2	2	3	21997
repagàrem	2	0	repagarem	2	1	1	21998
repairà	2	0	repaira	2	2	2	21999
repantigà	2	0	repantiga	2	1	1	22000
repanxolarà	2	0	repanxolara	2	1	1	22001
repapiegés	2	0	repapieges	2	1	1	22002
repapiegí	2	0	repapiegi	2	2	2	22003
repapiejà	2	0	repapieja	2	13	13	22004
repapà	2	2	repapa	2	0	2	22005
repapàreu	2	1	repapareu	2	0	1	22006
repararà	2	131	reparara	2	5	136	22007
repartirà	2	1767	repartira	2	9	1776	22008
repartírem	2	25	repartirem	2	485	510	22009
repartíreu	2	0	repartireu	2	14	14	22010
reparà	2	42	repara	2	687	729	22011
reparàrem	2	1	repararem	2	25	26	22012
reparàreu	2	0	reparareu	2	3	3	22013
reparés	2	32	repares	2	10	42	22014
reparí	2	0	repari	2	174	174	22015
repassarà	2	717	repassara	2	1	718	22016
repassà	2	70	repassa	2	4359	4429	22017
repassàrem	2	30	repassarem	2	834	864	22018
repassàreu	2	0	repassareu	2	7	7	22019
repassés	2	17	repasses	2	90	107	22020
repassí	2	0	repassi	2	95	95	22021
repatriarà	2	10	repatriara	2	0	10	22022
repatrià	2	5	repatria	2	10	15	22023
repatriés	2	3	repatries	2	0	3	22024
repel·lirà	2	1	repel·lira	2	0	1	22025
repel·lírem	2	1	repel·lirem	2	0	1	22026
repelà	2	0	repela	2	4	4	22027
repelàrem	2	0	repelarem	2	3	3	22028
repeló	4	3	repelo	2	1	4	22029
repengés	2	1	repenges	2	4	5	22030
repengí	2	0	repengi	2	5	5	22031
repenjarà	2	4	repenjara	2	0	4	22032
repenjà	2	3	repenja	2	78	81	22033
repenjàrem	2	0	repenjarem	2	1	1	22034
repensarà	2	27	repensara	2	0	27	22035
repensà	2	10	repensa	2	196	206	22036
repensàrem	2	0	repensarem	2	18	18	22037
repensés	2	23	repenses	2	22	45	22038
repensí	2	0	repensi	2	134	134	22039
repercutirà	2	819	repercutira	2	6	825	22040
repercutírem	2	0	repercutirem	2	1	1	22041
repescarà	2	4	repescara	2	0	4	22042
repescà	2	1	repesca	4	443	444	22043
repescàrem	2	0	repescarem	2	2	2	22044
repesqués	2	1	repesques	4	26	27	22045
repesquí	2	0	repesqui	2	5	5	22046
repesà	2	0	repesa	2	9	9	22047
repesàrem	2	1	repesarem	2	1	2	22048
repetirà	2	2119	repetira	2	29	2148	22049
repetírem	2	12	repetirem	2	1257	1269	22050
repetíreu	2	0	repetireu	2	72	72	22051
repicarà	2	21	repicara	2	10	31	22052
repicà	2	9	repica	2	145	154	22053
repicàrem	2	0	repicarem	2	1	1	22054
repicó	4	92	repico	2	4	96	22055
repintarà	2	21	repintara	2	0	21	22056
repintà	2	7	repinta	2	22	29	22057
repintàrem	2	0	repintarem	2	1	1	22058
repintés	2	2	repintes	2	4	6	22059
repintí	2	0	repinti	2	3	3	22060
repiqués	2	4	repiques	2	23	27	22061
repiquí	2	0	repiqui	2	13	13	22062
repiulà	2	0	repiula	2	10	10	22063
repiulàrem	2	0	repiularem	2	1	1	22064
repiulés	2	2	repiules	2	0	2	22065
repiulí	2	0	repiuli	2	3	3	22066
repixà	2	0	repixa	2	2	2	22067
replanificarà	2	3	replanificara	2	0	3	22068
replanificà	2	0	replanifica	2	8	8	22069
replantarà	2	9	replantara	2	0	9	22070
replantegés	2	58	replanteges	2	5	63	22071
replantegí	2	1	replantegi	2	228	229	22072
replantejarà	2	51	replantejara	2	3	54	22073
replantejà	2	10	replanteja	2	265	275	22074
replantejàrem	2	5	replantejarem	2	23	28	22075
replantejàreu	2	0	replantejareu	2	1	1	22076
replantà	2	6	replanta	2	9	15	22077
replantàrem	2	0	replantarem	2	3	3	22078
replantés	2	1	replantes	2	1	2	22079
replantí	2	0	replanti	2	2	2	22080
replanà	2	0	replana	4	21	21	22081
replegarà	2	16	replegara	2	5	21	22082
replegués	2	6	replegues	4	6	12	22083
repleguí	2	0	replegui	2	14	14	22084
replegà	2	23	replega	4	272	295	22085
replegàrem	2	2	replegarem	2	9	11	22086
replegàreu	2	0	replegareu	2	1	1	22087
replicarà	2	32	replicara	2	0	32	22088
replicà	2	175	replica	2	1018	1193	22089
replicàrem	2	0	replicarem	2	1	1	22090
replicàreu	2	0	replicareu	2	3	3	22091
replicó	4	1	replico	2	37	38	22092
repliqués	2	12	repliques	2	78	90	22093
repliquí	2	1	repliqui	2	37	38	22094
repoblarà	2	15	repoblara	2	0	15	22095
repoblà	2	36	repobla	2	22	58	22096
repoblàrem	2	0	repoblarem	2	1	1	22097
repoblés	2	10	repobles	2	1	11	22098
repoblí	2	0	repobli	2	4	4	22099
repolaritzà	2	0	repolaritza	2	4	4	22100
repolititzà	2	0	repolititza	2	1	1	22101
repolititzí	2	0	repolititzi	2	1	1	22102
reportarà	2	286	reportara	2	3	289	22103
reportà	2	70	reporta	2	773	843	22104
reportàrem	2	0	reportarem	2	2	2	22105
reportés	2	12	reportes	2	12	24	22106
reportí	2	0	reporti	2	136	136	22107
reposarà	2	145	reposara	2	4	149	22108
reposicionarà	2	1	reposicionara	2	0	1	22109
reposicionà	2	0	reposiciona	2	8	8	22110
reposicionàrem	2	0	reposicionarem	2	1	1	22111
reposà	2	36	reposa	2	1530	1566	22112
reposàrem	2	2	reposarem	2	35	37	22113
reposàreu	2	0	reposareu	2	2	2	22114
reposés	2	30	reposes	2	20	50	22115
reposí	2	0	reposi	2	327	327	22116
repoteguí	2	0	repotegui	2	1	1	22117
repreguntarà	2	1	repreguntara	2	0	1	22118
repreguntà	2	0	repregunta	4	10	10	22119
repreguntés	2	1	repreguntes	4	10	11	22120
repreguntí	2	0	repregunti	2	1	1	22121
reprendré	2	89	reprendre	2	8424	8513	22122
reprengués	2	103	reprengues	2	1	104	22123
reprenguí	2	2	reprengui	2	455	457	22124
represalià	2	0	represalia	2	33	33	22125
represaliés	2	0	represalies	2	45	45	22126
representarà	2	3715	representara	2	52	3767	22127
representà	2	1309	representa	2	60729	62038	22128
representàrem	2	13	representarem	2	160	173	22129
representàreu	2	0	representareu	2	1	1	22130
representés	2	499	representes	2	198	697	22131
representí	2	4	representi	2	2336	2340	22132
represàlia	4	1078	represalia	2	33	1111	22133
represàlies	4	1717	represalies	2	45	1762	22134
reprimirà	2	14	reprimira	2	1	15	22135
reprimírem	2	0	reprimirem	2	8	8	22136
reprocessà	2	0	reprocessa	2	5	5	22137
reprocessí	2	0	reprocessi	2	1	1	22138
reproduírem	2	3	reproduirem	2	82	85	22139
reproduíreu	2	0	reproduireu	2	2	2	22140
reprogramarà	2	6	reprogramara	2	0	6	22141
reprogramà	2	0	reprograma	2	26	26	22142
reprogramàrem	2	0	reprogramarem	2	2	2	22143
reprogramés	2	0	reprogrames	2	1	1	22144
reprogramí	2	0	reprogrami	2	6	6	22145
reprotxarà	2	5	reprotxara	2	0	5	22146
reprotxà	2	6	reprotxa	2	16	22	22147
reprotxés	2	2	reprotxes	2	14	16	22148
reprotxí	2	0	reprotxi	2	2	2	22149
reprovarà	2	1	reprovara	2	1	2	22150
reprovà	2	13	reprova	4	127	140	22151
reprovàrem	2	0	reprovarem	2	2	2	22152
reprovés	2	9	reproves	4	0	9	22153
reproví	2	0	reprovi	2	19	19	22154
reptarà	2	25	reptara	2	0	25	22155
reptà	2	22	repta	2	413	435	22156
reptàrem	2	0	reptarem	2	1	1	22157
reptés	2	8	reptes	2	42069	42077	22158
reptí	2	0	repti	2	9	9	22159
repudiarà	2	3	repudiara	2	1	4	22160
repudià	2	42	repudia	2	96	138	22161
repudiàreu	2	0	repudiareu	2	1	1	22162
repudiés	2	8	repudies	2	2	10	22163
repudií	2	1	repudii	2	0	1	22164
repugnarà	2	2	repugnara	2	1	3	22165
repugnà	2	1	repugna	2	252	253	22166
repugní	2	0	repugni	2	19	19	22167
repugí	2	0	repugi	2	2	2	22168
repujarà	2	1	repujara	2	1	2	22169
repujà	2	0	repuja	2	3	3	22170
repulsà	2	0	repulsa	4	871	871	22171
repulsés	2	0	repulses	4	9	9	22172
repul·lulàrem	2	1	repul·lularem	2	0	1	22173
repuntarà	2	9	repuntara	2	0	9	22174
repuntà	2	1	repunta	2	80	81	22175
repuntàrem	2	1	repuntarem	2	0	1	22176
repuntés	2	6	repuntes	2	0	6	22177
repuntí	2	0	repunti	2	11	11	22178
repussà	2	0	repussa	2	1	1	22179
reputarà	2	5	reputara	2	0	5	22180
reputà	2	1	reputa	2	20	21	22181
reputés	2	1	reputes	2	5	6	22182
repèl	4	73	repel	4	78	151	22183
repèls	4	0	repels	4	2	2	22184
repòrter	4	49	reporter	0	1925	1974	22185
repòrters	4	26	reporters	0	1158	1184	22186
requadrés	2	0	requadres	2	258	258	22187
requalificarà	2	5	requalificara	2	0	5	22188
requalificà	2	5	requalifica	2	25	30	22189
requalifiqués	2	3	requalifiques	2	3	6	22190
requalifiquí	2	0	requalifiqui	2	9	9	22191
requerirà	2	2445	requerira	2	16	2461	22192
requerírem	2	1	requerirem	2	45	46	22193
requeríreu	2	0	requerireu	2	2	2	22194
requestà	2	0	requesta	4	103	103	22195
requestés	2	0	requestes	4	12	12	22196
requisarà	2	10	requisara	2	3	13	22197
requisà	2	24	requisa	4	138	162	22198
requisés	2	11	requises	4	71	82	22199
requisí	2	0	requisi	2	12	12	22200
requés	2	4	reques	2	1	5	22201
requí	2	2	requi	2	15	17	22202
requís	2	1	requis	2	3	4	22203
reressagà	2	0	reressaga	4	5	5	22204
resarà	2	37	resara	2	1	38	22205
rescabalarà	2	22	rescabalara	2	0	22	22206
rescabalà	2	5	rescabala	2	29	34	22207
rescabalàrem	2	0	rescabalarem	2	3	3	22208
rescabalés	2	3	rescabales	2	1	4	22209
rescabalí	2	0	rescabali	2	22	22	22210
rescatarà	2	73	rescatara	2	4	77	22211
rescatà	2	65	rescata	2	796	861	22212
rescatàrem	2	2	rescatarem	2	30	32	22213
rescatàreu	2	0	rescatareu	2	2	2	22214
rescatés	2	44	rescates	2	19	63	22215
rescatí	2	0	rescati	2	87	87	22216
rescindirà	2	36	rescindira	2	2	38	22217
rescolà	2	2	rescola	2	1	3	22218
rescolés	2	0	rescoles	2	1	1	22219
resecà	2	0	reseca	2	20	20	22220
resequés	2	0	reseques	2	2	2	22221
resequí	2	0	resequi	2	2	2	22222
reservarà	2	379	reservara	2	7	386	22223
reservà	2	104	reserva	4	59080	59184	22224
reservàrem	2	4	reservarem	2	367	371	22225
reservàreu	2	0	reservareu	2	28	28	22226
reservés	2	46	reserves	4	22686	22732	22227
reserví	2	0	reservi	2	818	818	22228
resguardarà	2	4	resguardara	2	1	5	22229
resguardà	2	2	resguarda	2	71	73	22230
resguardí	2	0	resguardi	2	9	9	22231
residencià	2	2	residencia	2	1417	1419	22232
residenciàrem	2	0	residenciarem	2	1	1	22233
residenciés	2	0	residencies	2	193	193	22234
residirà	2	98	residira	2	10	108	22235
residualitzarà	2	1	residualitzara	2	0	1	22236
residualitzà	2	0	residualitza	2	1	1	22237
residència	4	38027	residencia	2	1417	39444	22238
residències	4	9787	residencies	2	193	9980	22239
residíreu	2	0	residireu	2	2	2	22240
resignarà	2	14	resignara	2	0	14	22241
resignificarà	2	2	resignificara	2	0	2	22242
resignificà	2	0	resignifica	2	18	18	22243
resignifiquí	2	0	resignifiqui	2	2	2	22244
resignà	2	17	resigna	2	326	343	22245
resignàrem	2	0	resignarem	2	25	25	22246
resignés	2	2	resignes	2	19	21	22247
resigní	2	0	resigni	2	33	33	22248
resincronitzà	2	1	resincronitza	2	1	2	22249
resincronitzàrem	2	0	resincronitzarem	2	1	1	22250
resintonitzà	2	0	resintonitza	2	8	8	22251
resinà	2	0	resina	4	2442	2442	22252
resinés	2	1	resines	4	999	1000	22253
resistirà	2	208	resistira	2	6	214	22254
resistírem	2	1	resistirem	2	97	98	22255
resistíreu	2	0	resistireu	2	4	4	22256
resituarà	2	8	resituara	2	0	8	22257
resituà	2	5	resitua	2	45	50	22258
resitués	2	3	resitues	2	1	4	22259
resoldré	2	31	resoldre	2	55840	55871	22260
resolgués	2	299	resolgues	2	6	305	22261
resolguí	2	0	resolgui	2	2144	2144	22262
respectarà	2	768	respectara	2	27	795	22263
respectà	2	84	respecta	2	11828	11912	22264
respectàrem	2	3	respectarem	2	207	210	22265
respectàreu	2	0	respectareu	2	12	12	22266
respectés	2	343	respectes	2	1231	1574	22267
respectí	2	1	respecti	2	3775	3776	22268
respirarà	2	55	respirara	2	4	59	22269
respirà	2	49	respira	2	5323	5372	22270
respiràrem	2	2	respirarem	2	35	37	22271
respiràreu	2	0	respirareu	2	5	5	22272
respirés	2	61	respires	2	276	337	22273
respirí	2	0	respiri	2	312	312	22274
resplendirà	2	11	resplendira	2	0	11	22275
resplendíreu	2	0	resplendireu	2	1	1	22276
respondré	2	559	respondre	2	39984	40543	22277
respongués	2	526	respongues	2	6	532	22278
responguí	2	14	respongui	2	3253	3267	22279
responsabilitzarà	2	335	responsabilitzara	2	2	337	22280
responsabilitzà	2	27	responsabilitza	2	4097	4124	22281
responsabilitzàrem	2	0	responsabilitzarem	2	15	15	22282
responsabilitzés	2	33	responsabilitzes	2	14	47	22283
responsabilitzí	2	0	responsabilitzi	2	173	173	22284
resquitllà	2	0	resquitlla	2	2	2	22285
resquitllés	2	0	resquitlles	2	1	1	22286
ressagués	2	0	ressagues	4	1	1	22287
ressaguí	2	0	ressagui	2	1	1	22288
ressagà	2	0	ressaga	4	8	8	22289
ressaltarà	2	96	ressaltara	2	3	99	22290
ressaltà	2	58	ressalta	2	2480	2538	22291
ressaltàrem	2	0	ressaltarem	2	15	15	22292
ressaltàreu	2	0	ressaltareu	2	1	1	22293
ressaltés	2	21	ressaltes	2	4	25	22294
ressaltí	2	0	ressalti	2	99	99	22295
ressecarà	2	5	ressecara	2	0	5	22296
ressecà	2	0	resseca	0	242	242	22297
ressegellà	2	1	ressegella	2	0	1	22298
resseguirà	2	90	resseguira	2	0	90	22299
ressegué	2	0	ressegue	2	3	3	22300
resseguí	2	19	ressegui	2	1	20	22301
resseguírem	2	2	resseguirem	2	223	225	22302
resseguíreu	2	1	resseguireu	2	17	18	22303
resseguís	2	6	resseguis	2	0	6	22304
ressemblà	2	0	ressembla	2	6	6	22305
ressemblí	2	0	ressembli	2	1	1	22306
ressembrarà	2	1	ressembrara	2	0	1	22307
ressembrà	2	0	ressembra	2	23	23	22308
ressentirà	2	113	ressentira	2	2	115	22309
ressentí	2	28	ressenti	2	112	140	22310
ressentírem	2	0	ressentirem	2	2	2	22311
ressentís	2	30	ressentis	2	0	30	22312
ressenyarà	2	6	ressenyara	2	2	8	22313
ressenyà	2	20	ressenya	4	7350	7370	22314
ressenyàrem	2	1	ressenyarem	2	17	18	22315
ressenyés	2	4	ressenyes	4	3996	4000	22316
ressenyí	2	0	ressenyi	2	11	11	22317
ressequés	2	3	resseques	0	72	75	22318
ressequí	2	0	ressequi	2	73	73	22319
ressituarà	2	8	ressituara	2	1	9	22320
ressituà	2	0	ressitua	2	26	26	22321
ressitués	2	1	ressitues	2	0	1	22322
ressolà	2	0	ressola	2	1	1	22323
ressolés	2	1	ressoles	2	0	1	22324
ressonarà	2	86	ressonara	2	0	86	22325
ressonà	2	43	ressona	2	1234	1277	22326
ressonés	2	14	ressones	2	1	15	22327
ressoní	2	0	ressoni	2	126	126	22328
ressopà	2	0	ressopa	2	1	1	22329
ressopó	4	201	ressopo	2	1	202	22330
ressorgirà	2	33	ressorgira	2	0	33	22331
ressorgírem	2	0	ressorgirem	2	3	3	22332
ressorgíreu	2	0	ressorgireu	2	1	1	22333
ressuscitarà	2	90	ressuscitara	2	2	92	22334
ressuscità	2	121	ressuscita	2	273	394	22335
ressuscitàrem	2	1	ressuscitarem	2	7	8	22336
ressuscitàreu	2	0	ressuscitareu	2	1	1	22337
ressuscités	2	40	ressuscites	2	5	45	22338
ressuscití	2	0	ressusciti	2	49	49	22339
ressòl	4	2	ressol	4	36	38	22340
ressòls	4	1	ressols	4	1	2	22341
restablirà	2	246	restablira	2	3	249	22342
restablírem	2	1	restablirem	2	13	14	22343
restablíreu	2	0	restablireu	2	10	10	22344
restarà	2	2220	restara	2	26	2246	22345
restaurarà	2	232	restaurara	2	1	233	22346
restaurà	2	261	restaura	2	1225	1486	22347
restauràrem	2	2	restaurarem	2	19	21	22348
restauràreu	2	0	restaurareu	2	2	2	22349
restaurés	2	72	restaures	2	18	90	22350
restaurí	2	0	restauri	2	143	143	22351
restituírem	2	0	restituirem	2	4	4	22352
restoblés	2	0	restobles	2	1	1	22353
restringirà	2	205	restringira	2	1	206	22354
restringírem	2	0	restringirem	2	6	6	22355
restringíreu	2	0	restringireu	2	1	1	22356
restà	2	1929	resta	4	177529	179458	22357
restàrem	2	17	restarem	2	123	140	22358
restàreu	2	1	restareu	2	14	15	22359
restés	2	191	restes	4	42891	43082	22360
restí	2	3	resti	2	704	707	22361
resultarà	2	3040	resultara	2	70	3110	22362
resultà	2	1367	resulta	4	65151	66518	22363
resultàrem	2	0	resultarem	2	6	6	22364
resultés	2	765	resultes	4	2001	2766	22365
resultí	2	1	resulti	2	5387	5388	22366
resumirà	2	71	resumira	2	3	74	22367
resumí	2	64	resumi	2	0	64	22368
resumírem	2	0	resumirem	2	69	69	22369
resumís	2	56	resumis	2	0	56	22370
resà	2	16	resa	2	1217	1233	22371
resàrem	2	8	resarem	2	21	29	22372
resàreu	2	1	resareu	2	3	4	22373
resés	2	23	reses	2	68	91	22374
resí	2	3	resi	2	192	195	22375
resín	2	0	resin	2	65	65	22376
retallarà	2	214	retallara	2	8	222	22377
retallà	2	34	retalla	2	1889	1923	22378
retallàrem	2	3	retallarem	2	92	95	22379
retallàreu	2	0	retallareu	2	2	2	22380
retallés	2	59	retalles	2	62	121	22381
retallí	2	1	retalli	2	197	198	22382
retalló	4	4	retallo	2	79	83	22383
retardarà	2	172	retardara	2	8	180	22384
retardà	2	63	retarda	2	858	921	22385
retardàrem	2	0	retardarem	2	16	16	22386
retardés	2	64	retardes	2	6	70	22387
retardí	2	1	retardi	2	262	263	22388
retastarà	2	1	retastara	2	0	1	22389
retemptarà	2	1	retemptara	2	0	1	22390
retemptàreu	2	1	retemptareu	2	0	1	22391
retenguí	2	0	retengui	2	4	4	22392
retindré	2	23	retindre	2	193	216	22393
retingués	2	38	retingues	2	6	44	22394
retinguí	2	0	retingui	2	139	139	22395
retintà	2	0	retinta	2	1	1	22396
retintés	2	0	retintes	2	1	1	22397
retirarà	2	714	retirara	2	54	768	22398
retirà	2	1236	retira	2	3157	4393	22399
retiràrem	2	5	retirarem	2	257	262	22400
retiràreu	2	0	retirareu	2	9	9	22401
retirés	2	794	retires	2	82	876	22402
retirí	2	2	retiri	2	1850	1852	22403
retià	0	3	retia	2	173	176	22404
retocarà	2	8	retocara	2	0	8	22405
retocà	2	12	retoca	2	103	115	22406
retocàrem	2	0	retocarem	2	11	11	22407
retolarà	2	12	retolara	2	0	12	22408
retolà	2	3	retola	2	18	21	22409
retolàrem	2	0	retolarem	2	5	5	22410
retolés	2	4	retoles	2	3	7	22411
retolí	2	8	retoli	2	9	17	22412
retoparà	2	0	retopara	2	1	1	22413
retopà	2	0	retopa	2	4	4	22414
retoqués	2	5	retoques	2	11	16	22415
retoquí	2	0	retoqui	2	5	5	22416
retorcé	2	1	retorce	2	0	1	22417
retorcés	2	7	retorces	2	5	12	22418
retorcí	2	1	retorci	2	5	6	22419
retornarà	2	2287	retornara	2	27	2314	22420
retornà	2	2358	retorna	2	8473	10831	22421
retornàrem	2	15	retornarem	2	542	557	22422
retornàreu	2	0	retornareu	2	14	14	22423
retornés	2	284	retornes	2	61	345	22424
retorní	2	3	retorni	2	1202	1205	22425
retortilló	4	1	retortillo	2	7	8	22426
retorçarà	2	1	retorçara	2	0	1	22427
retorçà	2	1	retorça	2	84	85	22428
retorçàrem	2	0	retorçarem	2	1	1	22429
retorçó	4	0	retorço	2	1	1	22430
retractarà	2	6	retractara	2	4	10	22431
retractilà	2	0	retractila	2	1	1	22432
retractà	2	13	retracta	2	94	107	22433
retractàrem	2	0	retractarem	2	1	1	22434
retractés	2	29	retractes	2	9	38	22435
retractí	2	0	retracti	2	48	48	22436
retragués	2	13	retragues	2	1	14	22437
retransmetré	2	3	retransmetre	2	926	929	22438
retransmetés	2	21	retransmetes	2	0	21	22439
retransmetí	2	0	retransmeti	2	25	25	22440
retratarà	2	40	retratara	2	2	42	22441
retratà	2	86	retrata	2	3414	3500	22442
retratàrem	2	2	retratarem	2	8	10	22443
retratàreu	2	1	retratareu	2	0	1	22444
retratés	2	31	retrates	2	29	60	22445
retratí	2	0	retrati	2	41	41	22446
retrauré	2	7	retraure	2	81	88	22447
retreballà	2	0	retreballa	2	1	1	22448
retreballàrem	2	0	retreballarem	2	1	1	22449
retribuírem	2	0	retribuirem	2	1	1	22450
retribuíreu	2	0	retribuireu	2	1	1	22451
retrinxarà	2	1	retrinxara	2	0	1	22452
retrià	2	0	retria	2	28	28	22453
retroalimentarà	2	10	retroalimentara	2	0	10	22454
retroalimentà	2	0	retroalimenta	2	214	214	22455
retroalimentàrem	2	0	retroalimentarem	2	1	1	22456
retroalimentés	2	0	retroalimentes	2	2	2	22457
retroalimentí	2	0	retroalimenti	2	14	14	22458
retrobarà	2	207	retrobara	2	3	210	22459
retrobà	2	95	retroba	2	1076	1171	22460
retrobàrem	2	23	retrobarem	2	467	490	22461
retrobàreu	2	0	retrobareu	2	35	35	22462
retrobés	2	16	retrobes	2	78	94	22463
retrobí	2	0	retrobi	2	86	86	22464
retrocedirà	2	70	retrocedira	2	3	73	22465
retrocedírem	2	6	retrocedirem	2	64	70	22466
retrocedíreu	2	0	retrocedireu	2	3	3	22467
retrogradà	2	0	retrograda	2	44	44	22468
retrogradés	2	0	retrogrades	2	32	32	22469
retronarà	2	6	retronara	2	0	6	22470
retronà	2	8	retrona	2	56	64	22471
retroní	2	0	retroni	2	6	6	22472
retrossés	2	0	retrosses	2	1	1	22473
retrotragués	2	3	retrotragues	2	0	3	22474
retrotrauré	2	0	retrotraure	2	42	42	22475
retrovendré	2	0	retrovendre	2	1	1	22476
retrucà	2	1	retruca	2	11	12	22477
retrunyirà	2	5	retrunyira	2	0	5	22478
retrunyí	2	6	retrunyi	2	2	8	22479
retràctil	0	435	retractil	2	11	446	22480
retré	2	18	retre	2	6198	6216	22481
retrò	4	34	retro	0	1903	1937	22482
retrògrad	0	311	retrograd	2	4	315	22483
retrògrada	0	511	retrograda	2	44	555	22484
retrògrades	0	197	retrogrades	2	32	229	22485
retuità	2	0	retuita	2	4	4	22486
returà	2	3	retura	2	7	10	22487
retxarà	2	2	retxara	2	0	2	22488
retxà	2	0	retxa	4	70	70	22489
retxés	2	0	retxes	4	164	164	22490
retén	2	104	reten	2	423	527	22491
retés	2	41	retes	2	21	62	22492
retí	2	1	reti	2	95	96	22493
retín	2	2	retin	2	44	46	22494
reubicarà	2	49	reubicara	2	0	49	22495
reubicà	2	5	reubica	2	49	54	22496
reubicàrem	2	0	reubicarem	2	1	1	22497
reubicàreu	2	0	reubicareu	2	1	1	22498
reubiqués	2	6	reubiques	2	0	6	22499
reubiquí	2	0	reubiqui	2	12	12	22500
reunificarà	2	5	reunificara	2	0	5	22501
reunificà	2	23	reunifica	2	19	42	22502
reunificàrem	2	0	reunificarem	2	1	1	22503
reunifiqués	2	8	reunifiques	2	0	8	22504
reunifiquí	2	1	reunifiqui	2	4	5	22505
reunirà	2	5276	reunira	2	36	5312	22506
reunírem	2	90	reunirem	2	763	853	22507
reuníreu	2	0	reunireu	2	14	14	22508
reurbanitzarà	2	28	reurbanitzara	2	0	28	22509
reurbanitzà	2	5	reurbanitza	2	7	12	22510
reurbanitzàrem	2	0	reurbanitzarem	2	1	1	22511
reurbanitzés	2	1	reurbanitzes	2	0	1	22512
reurbanitzí	2	0	reurbanitzi	2	2	2	22513
reutilitzarà	2	21	reutilitzara	2	0	21	22514
reutilitzà	2	6	reutilitza	2	337	343	22515
reutilitzàrem	2	1	reutilitzarem	2	19	20	22516
reutilitzàreu	2	0	reutilitzareu	2	1	1	22517
reutilitzés	2	5	reutilitzes	2	2	7	22518
reutilitzí	2	0	reutilitzi	2	35	35	22519
revacunà	2	0	revacuna	2	65	65	22520
revacunàrem	2	0	revacunarem	2	1	1	22521
revacunés	2	0	revacunes	2	1	1	22522
revalidarà	2	22	revalidara	2	1	23	22523
revalidà	2	87	revalida	2	336	423	22524
revalidàrem	2	0	revalidarem	2	2	2	22525
revalidés	2	8	revalides	2	12	20	22526
revalidí	2	0	revalidi	2	16	16	22527
revalorarà	2	5	revalorara	2	0	5	22528
revaloritzarà	2	36	revaloritzara	2	0	36	22529
revaloritzà	2	8	revaloritza	2	120	128	22530
revaloritzàrem	2	0	revaloritzarem	2	1	1	22531
revaloritzés	2	7	revaloritzes	2	2	9	22532
revaloritzí	2	0	revaloritzi	2	21	21	22533
revalorà	2	9	revalora	2	39	48	22534
revalorés	2	0	revalores	2	2	2	22535
revalorí	2	0	revalori	2	17	17	22536
revaluarà	2	2	revaluara	2	0	2	22537
revaluà	2	0	revalua	2	12	12	22538
revelarà	2	485	revelara	2	4	489	22539
revel·lirà	2	0	revel·lira	2	1	1	22540
revelà	2	317	revela	2	8573	8890	22541
revelàrem	2	0	revelarem	2	83	83	22542
revelàreu	2	1	revelareu	2	1	2	22543
revelés	2	127	reveles	2	12	139	22544
revelí	2	1	reveli	2	289	290	22545
revendré	2	1	revendre	2	296	297	22546
revenguí	2	0	revengui	2	5	5	22547
revengés	2	2	revenges	4	136	138	22548
revengí	2	0	revengi	2	2	2	22549
revenjà	2	3	revenja	4	1596	1599	22550
reverberarà	2	1	reverberara	2	0	1	22551
reverberà	2	0	reverbera	2	61	61	22552
reverberés	2	4	reverberes	2	0	4	22553
reverberí	2	0	reverberi	2	12	12	22554
reverdirà	2	8	reverdira	2	0	8	22555
reverencià	2	0	reverencia	2	58	58	22556
reverenciés	2	1	reverencies	2	31	32	22557
revertirà	2	226	revertira	2	2	228	22558
revertírem	2	1	revertirem	2	22	23	22559
reverència	4	771	reverencia	2	58	829	22560
reverències	4	185	reverencies	2	31	216	22561
revessà	2	0	revessa	4	147	147	22562
revessés	2	0	revesses	4	112	112	22563
revessí	2	1	revessi	2	1	2	22564
revestirà	2	71	revestira	2	0	71	22565
revestírem	2	1	revestirem	2	0	1	22566
reveuré	2	1	reveure	2	616	617	22567
revifarà	2	25	revifara	2	2	27	22568
revifà	2	33	revifa	2	253	286	22569
revifàrem	2	0	revifarem	2	3	3	22570
revifàreu	2	0	revifareu	2	1	1	22571
revifés	2	28	revifes	2	3	31	22572
revifí	2	0	revifi	2	43	43	22573
revigoritzà	2	1	revigoritza	2	2	3	22574
revigoritzí	2	0	revigoritzi	2	1	1	22575
revinclà	2	1	revincla	2	5	6	22576
revindré	2	2	revindre	2	4	6	22577
revinguí	2	0	revingui	2	1	1	22578
revirà	2	3	revira	2	7	10	22579
revirí	2	0	reviri	2	1	1	22580
revisarà	2	955	revisara	2	18	973	22581
reviscolarà	2	8	reviscolara	2	1	9	22582
reviscolà	2	19	reviscola	2	123	142	22583
reviscolàreu	2	0	reviscolareu	2	1	1	22584
reviscolés	2	4	reviscoles	2	0	4	22585
reviscolí	2	0	reviscoli	2	9	9	22586
revisitarà	2	9	revisitara	2	0	9	22587
revisità	2	5	revisita	2	139	144	22588
revisitàrem	2	0	revisitarem	2	6	6	22589
revisités	2	1	revisites	2	5	6	22590
revisití	2	0	revisiti	2	1	1	22591
revisqués	2	10	revisques	2	0	10	22592
revisquí	2	0	revisqui	2	47	47	22593
revistarà	2	1	revistara	2	0	1	22594
revistà	2	5	revista	2	76366	76371	22595
revistés	2	2	revistes	2	23233	23235	22596
revisà	2	112	revisa	2	2647	2759	22597
revisàrem	2	2	revisarem	2	471	473	22598
revisàreu	2	0	revisareu	2	8	8	22599
revisés	2	159	revises	2	63	222	22600
revisí	2	0	revisi	2	1316	1316	22601
revitalitzarà	2	41	revitalitzara	2	1	42	22602
revitalitzà	2	21	revitalitza	2	239	260	22603
revitalitzàrem	2	0	revitalitzarem	2	8	8	22604
revitalitzés	2	7	revitalitzes	2	1	8	22605
revitalitzí	2	0	revitalitzi	2	37	37	22606
reviuré	2	8	reviure	2	5421	5429	22607
revivificàreu	2	1	revivificareu	2	0	1	22608
revivifiqués	2	1	revivifiques	2	0	1	22609
revivà	2	1	reviva	2	2	3	22610
revivés	2	0	revives	2	1	1	22611
revocarà	2	43	revocara	2	5	48	22612
revocà	2	38	revoca	2	262	300	22613
revocàrem	2	0	revocarem	2	1	1	22614
revoldré	2	0	revoldre	2	1	1	22615
revolotejarà	2	1	revolotejara	2	0	1	22616
revolotejà	2	0	revoloteja	2	3	3	22617
revoltarà	2	15	revoltara	2	0	15	22618
revoltilló	4	0	revoltillo	2	10	10	22619
revoltà	2	82	revolta	2	12391	12473	22620
revoltàrem	2	1	revoltarem	2	13	14	22621
revoltés	2	21	revoltes	2	3526	3547	22622
revoltí	2	0	revolti	2	32	32	22623
revoltó	4	77	revolto	2	13	90	22624
revolucionarà	2	178	revolucionara	2	3	181	22625
revolucionà	2	73	revoluciona	2	283	356	22626
revolucionàrem	2	0	revolucionarem	2	2	2	22627
revolucionària	0	6115	revolucionaria	2	521	6636	22628
revolucionàries	0	1958	revolucionaries	2	125	2083	22629
revolucionés	2	15	revoluciones	2	38	53	22630
revolucioní	2	0	revolucioni	2	23	23	22631
revolà	2	0	revola	2	12	12	22632
revolés	2	0	revoles	2	3	3	22633
revoqués	2	68	revoques	2	2	70	22634
revoquí	2	0	revoqui	2	231	231	22635
revoré	2	0	revore	2	1	1	22636
revàlida	4	297	revalida	2	336	633	22637
revàlides	4	433	revalides	2	12	445	22638
revèiem	2	1	reveiem	2	0	1	22639
revèieu	2	0	reveieu	2	1	1	22640
revès	2	94	reves	4	235	329	22641
revéieu	2	0	reveieu	2	1	1	22642
revénc	2	0	revenc	2	1	1	22643
revénen	2	10	revenen	2	64	74	22644
revéngui	2	0	revengui	2	5	5	22645
revénguin	2	1	revenguin	2	3	4	22646
revéns	2	1	revens	2	2	3	22647
revés	2	5663	reves	4	235	5898	22648
revéu	2	0	reveu	2	10	10	22649
reïficà	2	0	reïfica	2	3	3	22650
reïfiquí	2	0	reïfiqui	2	1	1	22651
reïsqués	2	0	reïsques	2	1	1	22652
reüllà	2	0	reülla	2	3	3	22653
riallà	2	0	rialla	4	1722	1722	22654
riallés	2	0	rialles	4	4440	4440	22655
ribagorçà	0	150	ribagorça	4	3327	3477	22656
riberegí	2	0	riberegi	2	1	1	22657
ribotejà	2	0	riboteja	2	1	1	22658
ribotà	2	0	ribota	2	10	10	22659
ribotí	2	0	riboti	2	4	4	22660
ricà	2	0	rica	4	15542	15542	22661
ricàreu	2	0	ricareu	2	1	1	22662
ridiculitzarà	2	5	ridiculitzara	2	0	5	22663
ridiculitzà	2	9	ridiculitza	2	218	227	22664
ridiculitzés	2	5	ridiculitzes	2	2	7	22665
ridiculitzí	2	0	ridiculitzi	2	17	17	22666
rifarà	2	24	rifara	2	1	25	22667
rifàrem	2	0	rifarem	2	20	20	22668
rifés	2	3	rifes	4	283	286	22669
rifí	2	0	rifi	2	13	13	22670
rigués	2	49	rigues	2	13	62	22671
riguí	2	2	rigui	2	186	188	22672
rimarà	2	7	rimara	2	1	8	22673
rimà	2	0	rima	4	1980	1980	22674
rimés	2	5	rimes	4	977	982	22675
rimí	2	0	rimi	2	19	19	22676
rinxolà	2	0	rinxola	2	1	1	22677
rinxolés	2	0	rinxoles	2	1	1	22678
riojà	0	42	rioja	4	3141	3183	22679
riquerés	2	0	riqueres	2	1	1	22680
riqués	2	1	riques	0	4420	4421	22681
riquí	2	0	riqui	2	115	115	22682
riscós	0	4	riscos	4	31817	31821	22683
rissà	2	0	rissa	2	44	44	22684
rissés	2	0	risses	2	69	69	22685
rissí	2	0	rissi	2	4	4	22686
ritmà	2	0	ritma	2	18	18	22687
ritmés	2	0	ritmes	2	10595	10595	22688
ritmí	2	0	ritmi	2	3	3	22689
ritualitzà	2	0	ritualitza	2	2	2	22690
ritualitzàrem	2	0	ritualitzarem	2	1	1	22691
riuré	2	49	riure	4	18397	18446	22692
rivalitzarà	2	16	rivalitzara	2	1	17	22693
rivalitzà	2	13	rivalitza	2	118	131	22694
rivalitzàrem	2	0	rivalitzarem	2	1	1	22695
rivalitzés	2	6	rivalitzes	2	1	7	22696
rivalitzí	2	1	rivalitzi	2	11	12	22697
rivetejàreu	2	0	rivetejareu	2	1	1	22698
rivetà	2	1	riveta	2	0	1	22699
robarà	2	94	robara	2	3	97	22700
robotitzà	2	0	robotitza	2	4	4	22701
robotitzí	2	0	robotitzi	2	1	1	22702
robà	2	65	roba	4	51329	51394	22703
robàrem	2	2	robarem	2	21	23	22704
robàreu	2	0	robareu	2	10	10	22705
robés	2	70	robes	4	2053	2123	22706
robí	2	492	robi	2	199	691	22707
rocatí	0	8	rocati	4	0	8	22708
rodamón	4	656	rodamon	4	161	817	22709
rodarà	2	252	rodara	2	3	255	22710
rodegés	2	4	rodeges	2	7	11	22711
rodegí	2	0	rodegi	2	11	11	22712
rodejarà	2	15	rodejara	2	1	16	22713
rodejà	2	23	rodeja	4	1336	1359	22714
rodejàrem	2	2	rodejarem	2	22	24	22715
rodolarà	2	4	rodolara	2	0	4	22716
rodolà	2	8	rodola	2	103	111	22717
rodolàrem	2	2	rodolarem	2	3	5	22718
rodolàreu	2	0	rodolareu	2	1	1	22719
rodolés	2	19	rodoles	2	3	22	22720
rodolí	2	243	rodoli	2	27	270	22721
rodà	2	492	roda	4	32614	33106	22722
rodàrem	2	3	rodarem	2	46	49	22723
rodàreu	2	0	rodareu	2	7	7	22724
rodí	2	0	rodi	2	417	417	22725
roentà	2	0	roenta	2	13	13	22726
roentés	2	0	roentes	2	3	3	22727
rogegí	2	0	rogegi	2	1	1	22728
rogés	2	14	roges	4	1579	1593	22729
rogí	2	0	rogi	2	3	3	22730
roinà	2	0	roina	4	173	173	22731
roinés	2	0	roines	4	35	35	22732
rojà	2	54	roja	4	18739	18793	22733
rojàrem	2	0	rojarem	2	1	1	22734
rojós	0	0	rojos	0	1699	1699	22735
rollà	2	0	rolla	2	28	28	22736
rollés	2	0	rolles	2	1	1	22737
rollí	2	0	rolli	2	18	18	22738
rolà	2	0	rola	2	30	30	22739
rolés	2	2	roles	2	80	82	22740
rolí	2	0	roli	2	3	3	22741
romancegés	2	0	romanceges	2	1	1	22742
romancejà	2	1	romanceja	2	7	8	22743
romandré	2	41	romandre	2	12174	12215	22744
romangués	2	205	romangues	2	2	207	22745
romanguí	2	3	romangui	2	701	704	22746
romanitzà	2	5	romanitza	2	9	14	22747
romanès	0	3043	romanes	4	4714	7757	22748
romanés	0	146	romanes	4	4714	4860	22749
rombododecàedre	4	0	rombododecaedre	4	1	1	22750
rombòedre	4	2	romboedre	4	7	9	22751
rombòedres	4	2	romboedres	4	2	4	22752
rompré	2	5	rompre	2	1004	1009	22753
rompés	2	6	rompes	2	2	8	22754
rompí	2	2	rompi	2	29	31	22755
romànic	0	11137	romanic	4	58	11195	22756
roncà	2	2	ronca	0	313	315	22757
rondarà	2	188	rondara	2	5	193	22758
rondinarà	2	4	rondinara	2	0	4	22759
rondinejà	2	1	rondineja	2	3	4	22760
rondinà	2	4	rondina	2	93	97	22761
rondinàreu	2	0	rondinareu	2	1	1	22762
rondinés	2	2	rondines	2	4	6	22763
rondiní	2	0	rondini	2	13	13	22764
rondà	2	1	ronda	4	30874	30875	22765
rondàrem	2	1	rondarem	2	1	2	22766
rondàreu	2	0	rondareu	2	1	1	22767
rondés	2	11	rondes	4	4865	4876	22768
rondí	2	0	rondi	2	47	47	22769
rondín	2	3	rondin	2	15	18	22770
rondó	4	225	rondo	2	223	448	22771
ronquejà	2	0	ronqueja	2	1	1	22772
ronqués	2	2	ronques	0	18	20	22773
ronquí	2	0	ronqui	2	8	8	22774
ronsegés	2	1	ronseges	2	0	1	22775
ronsejà	2	0	ronseja	2	7	7	22776
ronxà	2	0	ronxa	2	3	3	22777
ronxés	2	0	ronxes	2	9	9	22778
ronyà	2	0	ronya	4	126	126	22779
ronyés	2	1	ronyes	4	2	3	22780
ronyó	4	1700	ronyo	2	22	1722	22781
roscà	2	2	rosca	4	1313	1315	22782
roscàrem	2	0	roscarem	2	1	1	22783
rosegarà	2	3	rosegara	2	1	4	22784
rosegués	2	9	rosegues	2	2	11	22785
roseguí	2	0	rosegui	2	18	18	22786
rosegà	2	1	rosega	2	158	159	22787
rosegàrem	2	1	rosegarem	2	0	1	22788
rosegó	4	58	rosego	2	16	74	22789
rosqués	2	0	rosques	4	206	206	22790
rossegarà	2	0	rossegara	2	1	1	22791
rossegués	2	1	rossegues	2	1	2	22792
rosseguí	2	0	rossegui	2	1	1	22793
rossegà	2	0	rossega	2	27	27	22794
rossegàrem	2	0	rossegarem	2	1	1	22795
rossegàreu	2	0	rossegareu	2	1	1	22796
rossegés	2	0	rosseges	2	2	2	22797
rossegí	2	0	rossegi	2	11	11	22798
rossejà	2	0	rosseja	2	24	24	22799
rossejàrem	2	0	rossejarem	2	10	10	22800
rossellonès	0	494	rossellones	4	46	540	22801
rossellonés	0	16	rossellones	4	46	62	22802
rossolà	2	0	rossola	4	9	9	22803
rossolí	2	1	rossoli	2	0	1	22804
rostirà	2	2	rostira	2	0	2	22805
rostollàrem	2	0	rostollarem	2	2	2	22806
rostà	2	0	rosta	0	176	176	22807
rostària	4	5	rostaria	2	0	5	22808
rostàries	4	1	rostaries	2	0	1	22809
rostés	2	0	rostes	0	97	97	22810
rostí	2	0	rosti	2	8	8	22811
rostírem	2	0	rostirem	2	20	20	22812
rostís	2	2	rostis	2	4	6	22813
rosà	2	7	rosa	4	49543	49550	22814
rosés	2	700	roses	4	26060	26760	22815
rosí	2	3	rosi	2	212	215	22816
rosó	4	212	roso	2	52	264	22817
rotarà	2	13	rotara	2	7	20	22818
rotllarà	2	1	rotllara	2	0	1	22819
rotllàrem	2	0	rotllarem	2	1	1	22820
rotllés	2	1	rotlles	2	758	759	22821
rotllí	2	1	rotlli	2	1	2	22822
rotà	2	2	rota	4	1013	1015	22823
rotàreu	2	0	rotareu	2	1	1	22824
rotària	0	67	rotaria	2	43	110	22825
rotàries	0	9	rotaries	2	2	11	22826
rotés	2	60	rotes	4	221	281	22827
rotí	2	0	roti	2	186	186	22828
rotó	4	6	roto	2	262	268	22829
rovellarà	2	2	rovellara	2	0	2	22830
rovellà	2	3	rovella	2	139	142	22831
rovellés	2	3	rovelles	2	1	4	22832
rovellí	2	0	rovelli	2	51	51	22833
roín	0	120	roin	2	72	192	22834
ruandès	0	613	ruandes	0	3	616	22835
ruandés	0	9	ruandes	0	3	12	22836
rubinès	0	0	rubines	4	8	8	22837
rubinés	0	0	rubines	4	8	8	22838
ruboritzarà	2	1	ruboritzara	2	0	1	22839
ruboritzà	2	2	ruboritza	2	18	20	22840
ruboritzí	2	0	ruboritzi	2	3	3	22841
rubricarà	2	24	rubricara	2	0	24	22842
rubricà	2	10	rubrica	2	138	148	22843
rubriqués	2	3	rubriques	2	32	35	22844
rubriquí	2	0	rubriqui	2	6	6	22845
rufejarà	2	0	rufejara	2	1	1	22846
rufianejarà	2	0	rufianejara	2	1	1	22847
ruflà	2	0	rufla	2	1	1	22848
ruflàrem	2	0	ruflarem	2	1	1	22849
ruflés	2	0	rufles	2	2	2	22850
rugirà	2	2	rugira	2	0	2	22851
ruixarà	2	7	ruixara	2	0	7	22852
ruixà	2	2	ruixa	4	107	109	22853
ruixàrem	2	0	ruixarem	2	28	28	22854
ruixàreu	2	1	ruixareu	2	1	2	22855
ruixés	2	5	ruixes	4	3	8	22856
ruixí	2	0	ruixi	2	8	8	22857
ruixó	4	4	ruixo	2	12	16	22858
rullà	2	0	rulla	0	14	14	22859
rullés	2	0	rulles	0	1	1	22860
rullí	2	0	rulli	2	27	27	22861
rumbejà	2	0	rumbeja	2	3	3	22862
rumiarà	2	1	rumiara	2	0	1	22863
ruminà	2	0	rumina	2	3	3	22864
rumià	2	15	rumia	2	227	242	22865
rumiàrem	2	0	rumiarem	2	9	9	22866
rumiés	2	13	rumies	2	22	35	22867
rumií	2	0	rumii	2	2	2	22868
rumorejà	2	5	rumoreja	2	182	187	22869
ruralitzà	2	0	ruralitza	2	4	4	22870
rutilà	2	0	rutila	2	2	2	22871
rutilí	2	0	rutili	4	17	17	22872
rutllarà	2	9	rutllara	2	1	10	22873
rutllà	2	10	rutlla	4	699	709	22874
rutllés	2	22	rutlles	4	15	37	22875
rutllí	2	0	rutlli	2	166	166	22876
rutlà	2	0	rutla	2	3	3	22877
rutlés	2	0	rutles	2	4	4	22878
rutló	4	16	rutlo	2	1	17	22879
ruà	0	15	rua	4	5364	5379	22880
ràbia	4	10024	rabia	2	421	10445	22881
ràbies	4	58	rabies	2	11	69	22882
ràdio	4	79256	radio	2	10487	89743	22883
ràfega	4	467	rafega	4	8	475	22884
ràfegues	4	779	rafegues	4	29	808	22885
rància	0	696	rancia	2	34	730	22886
ràncies	0	132	rancies	2	5	137	22887
ràpel	4	1097	rapel	2	169	1266	22888
ràpida	0	36113	rapida	2	447	36560	22889
ràpides	0	6305	rapides	2	129	6434	22890
rècord	0	14835	record	4	36713	51548	22891
rècords	4	3254	records	4	29552	32806	22892
rècula	4	71	recula	2	313	384	22893
rècules	4	14	recules	2	37	51	22894
rèdit	4	877	redit	2	83	960	22895
rèdits	4	684	redits	2	44	728	22896
rèflex	0	343	reflex	0	10083	10426	22897
règia	0	208	regia	2	720	928	22898
règies	0	30	regies	2	3	33	22899
règim	4	67988	regim	2	1624	69612	22900
rèmol	4	97	remol	2	10	107	22901
rèmols	4	9	remols	2	3	12	22902
rènec	0	3	renec	4	157	160	22903
rènecs	0	8	renecs	4	322	330	22904
rènega	0	1	renega	2	367	368	22905
rènegues	0	0	renegues	2	8	8	22906
rèplica	4	4480	replica	2	1018	5498	22907
rèpliques	4	1790	repliques	2	78	1868	22908
rètol	4	3967	retol	2	50	4017	22909
rètor	4	18	retor	4	222	240	22910
rètors	4	11	retors	4	41	52	22911
rèvola	4	8	revola	2	12	20	22912
rèvoles	4	0	revoles	2	3	3	22913
rémol	4	0	remol	2	10	10	22914
rémols	4	0	remols	2	3	3	22915
rés	4	1513	res	4	239878	241391	22916
rínxol	4	92	rinxol	4	13	105	22917
rínxols	4	665	rinxols	4	91	756	22918
ròdol	4	13	rodol	2	9	22	22919
ròssa	4	3	rossa	0	2580	2583	22920
ròssec	4	202	rossec	4	12	214	22921
ròssecs	4	24	rossecs	4	0	24	22922
ròssega	4	1	rossega	2	27	28	22923
ròssegues	4	3	rossegues	2	1	4	22924
ròsses	4	1	rosses	0	724	725	22925
rúbrica	4	2003	rubrica	2	138	2141	22926
rúbriques	4	796	rubriques	2	32	828	22927
rúpia	4	18	rupia	4	169	187	22928
rúpies	4	97	rupies	4	203	300	22929
rútil	4	117	rutil	2	15	132	22930
sabatitzés	2	0	sabatitzes	2	1	1	22931
sabotegés	2	6	saboteges	2	1	7	22932
sabotegí	2	0	sabotegi	2	5	5	22933
sabotejarà	2	3	sabotejara	2	0	3	22934
sabotejà	2	8	saboteja	2	71	79	22935
sabotejàrem	2	0	sabotejarem	2	1	1	22936
sabré	2	762	sabre	4	989	1751	22937
sabés	2	1626	sabes	4	306	1932	22938
sacarà	2	1	sacara	2	2	3	22939
saciarà	2	23	saciara	2	0	23	22940
sacià	2	1	sacia	2	166	167	22941
saciàrem	2	0	saciarem	2	3	3	22942
saciàreu	2	0	saciareu	2	19	19	22943
saciés	2	2	sacies	2	0	2	22944
sacralitzarà	2	1	sacralitzara	2	0	1	22945
sacralitzà	2	1	sacralitza	2	36	37	22946
sacralitzàrem	2	0	sacralitzarem	2	1	1	22947
sacralitzés	2	1	sacralitzes	2	0	1	22948
sacralitzí	2	0	sacralitzi	2	2	2	22949
sacrificarà	2	68	sacrificara	2	1	69	22950
sacrificà	2	45	sacrifica	2	446	491	22951
sacrificàrem	2	1	sacrificarem	2	23	24	22952
sacrifiqués	2	35	sacrifiques	2	20	55	22953
sacrifiquí	2	0	sacrifiqui	2	98	98	22954
sacsarà	2	1	sacsara	2	1	2	22955
sacsegés	2	29	sacseges	2	17	46	22956
sacsegí	2	0	sacsegi	2	52	52	22957
sacsejarà	2	98	sacsejara	2	3	101	22958
sacsejà	2	104	sacseja	2	817	921	22959
sacsejàrem	2	0	sacsejarem	2	13	13	22960
sacsà	2	0	sacsa	2	14	14	22961
sacsàrem	2	0	sacsarem	2	2	2	22962
sacsés	2	0	sacses	2	1	1	22963
sacsó	4	9	sacso	2	0	9	22964
sacà	2	0	saca	4	450	450	22965
sacàrem	2	0	sacarem	2	1	1	22966
sadollarà	2	7	sadollara	2	0	7	22967
sadollà	2	3	sadolla	0	63	66	22968
sadollés	2	0	sadolles	0	3	3	22969
sadollí	2	0	sadolli	2	7	7	22970
safrà	0	2090	safra	4	49	2139	22971
saginà	2	0	sagina	2	4	4	22972
sagnarà	2	19	sagnara	2	0	19	22973
sagnà	2	0	sagna	2	246	246	22974
sagnés	2	2	sagnes	2	11	13	22975
sagní	2	0	sagni	2	24	24	22976
sagramentarà	2	0	sagramentara	2	1	1	22977
salaritzà	2	0	salaritza	2	1	1	22978
salarà	2	5	salara	2	0	5	22979
saldarà	2	22	saldara	2	1	23	22980
saldà	2	76	salda	2	199	275	22981
saldàrem	2	2	saldarem	2	4	6	22982
saldés	2	9	saldes	4	898	907	22983
saldí	2	0	saldi	2	32	32	22984
salegí	2	0	salegi	2	2	2	22985
salellès	0	0	salelles	4	285	285	22986
salellés	0	0	salelles	4	285	285	22987
salicà	2	0	salica	2	17	17	22988
salicària	4	13	salicaria	2	15	28	22989
salicàries	4	1	salicaries	2	0	1	22990
salinitzarà	2	1	salinitzara	2	0	1	22991
salinitzà	2	1	salinitza	2	15	16	22992
salinitzàrem	2	1	salinitzarem	2	0	1	22993
salinitzés	2	2	salinitzes	2	0	2	22994
salinitzí	2	0	salinitzi	2	2	2	22995
salinà	2	0	salina	4	745	745	22996
salinàs	2	0	salinas	4	1181	1181	22997
salinés	2	0	salines	4	3121	3121	22998
saliní	2	0	salini	2	1	1	22999
saliquegés	2	1	saliqueges	2	0	1	23000
salivarà	2	1	salivara	2	0	1	23001
salivegés	2	0	saliveges	2	1	1	23002
salivejà	2	0	saliveja	2	5	5	23003
salivà	2	0	saliva	4	1402	1402	23004
salivàreu	2	0	salivareu	2	3	3	23005
salivés	2	0	salives	4	19	19	23006
saliví	2	0	salivi	2	1	1	23007
sallarà	2	1	sallara	2	0	1	23008
sallà	2	0	salla	2	173	173	23009
sallés	2	676	salles	2	79	755	23010
sallí	2	0	salli	2	4	4	23011
salmejà	2	0	salmeja	2	1	1	23012
salmodià	2	0	salmodia	2	12	12	23013
salmodiés	2	0	salmodies	2	4	4	23014
salmorrà	2	0	salmorra	4	527	527	23015
salmorrés	2	0	salmorres	4	186	186	23016
salmòdia	4	64	salmodia	2	12	76	23017
salmòdies	4	19	salmodies	2	4	23	23018
salparà	2	47	salpara	2	0	47	23019
salpebrà	2	0	salpebra	2	186	186	23020
salpebràrem	2	1	salpebrarem	2	89	90	23021
salpebràreu	2	0	salpebrareu	2	10	10	23022
salpebrés	2	0	salpebres	2	7	7	23023
salpebrí	2	0	salpebri	2	3	3	23024
salpicarà	2	1	salpicara	2	0	1	23025
salpicà	2	0	salpica	2	9	9	23026
salpicàrem	2	1	salpicarem	2	0	1	23027
salpicó	4	17	salpico	2	0	17	23028
salpiquí	2	0	salpiqui	2	1	1	23029
salprendré	2	0	salprendre	2	1	1	23030
salpà	2	124	salpa	4	115	239	23031
salpàrem	2	4	salparem	2	20	24	23032
salpàreu	2	0	salpareu	2	3	3	23033
salpés	2	23	salpes	4	52	75	23034
salpí	2	0	salpi	2	10	10	23035
salsarà	2	1	salsara	2	0	1	23036
salsà	2	0	salsa	4	15745	15745	23037
salsàrem	2	0	salsarem	2	2	2	23038
salsés	2	0	salses	4	3153	3153	23039
salsí	2	1	salsi	2	30	31	23040
salsís	2	0	salsis	2	8	8	23041
saltarà	2	289	saltara	2	11	300	23042
saltegés	2	0	salteges	2	12	12	23043
saltejà	2	1	salteja	2	43	44	23044
saltejàrem	2	0	saltejarem	2	94	94	23045
saltejàreu	2	0	saltejareu	2	1	1	23046
saltironegí	2	0	saltironegi	2	1	1	23047
saltironejà	2	0	saltironeja	2	12	12	23048
saltironà	2	0	saltirona	2	10	10	23049
saltironés	2	0	saltirones	2	2	2	23050
saltironí	2	0	saltironi	2	1	1	23051
saltà	2	205	salta	4	4074	4279	23052
saltàrem	2	4	saltarem	2	141	145	23053
saltàreu	2	0	saltareu	2	17	17	23054
saltés	2	165	saltes	2	136	301	23055
saltí	2	1	salti	2	369	370	23056
saludarà	2	71	saludara	2	0	71	23057
saludà	2	126	saluda	2	1642	1768	23058
saludàrem	2	11	saludarem	2	36	47	23059
saludàreu	2	1	saludareu	2	1	2	23060
saludés	2	34	saludes	4	189	223	23061
saludí	2	3	saludi	2	102	105	23062
salvaguardarà	2	24	salvaguardara	2	0	24	23063
salvaguardà	2	6	salvaguarda	4	3199	3205	23064
salvaguardàrem	2	0	salvaguardarem	2	5	5	23065
salvaguardés	2	8	salvaguardes	4	497	505	23066
salvaguardí	2	0	salvaguardi	2	94	94	23067
salvarà	2	768	salvara	2	15	783	23068
salvatgejà	2	0	salvatgeja	2	1	1	23069
salvatgejàrem	2	0	salvatgejarem	2	1	1	23070
salvàrem	2	5	salvarem	2	173	178	23071
salvàreu	2	1	salvareu	2	24	25	23072
salvés	2	155	salves	4	467	622	23073
salzadellà	0	0	salzadella	4	95	95	23074
salzedellà	0	0	salzedella	4	10	10	23075
salà	2	17	sala	4	151608	151625	23076
salàrem	2	0	salarem	2	66	66	23077
salàreu	2	0	salareu	2	1	1	23078
salés	2	39	sales	4	30419	30458	23079
salín	2	12	salin	2	207	219	23080
saló	4	31699	salo	4	357	32056	23081
samoà	0	58	samoa	4	920	978	23082
sanarà	2	7	sanara	2	1	8	23083
sancionarà	2	245	sancionara	2	8	253	23084
sancionà	2	36	sanciona	2	511	547	23085
sancionàrem	2	0	sancionarem	2	16	16	23086
sancionàreu	2	0	sancionareu	2	2	2	23087
sancionés	2	23	sanciones	2	35	58	23088
sancioní	2	0	sancioni	2	226	226	23089
sanegés	2	4	saneges	2	1	5	23090
sanegí	2	0	sanegi	2	8	8	23091
sanejarà	2	17	sanejara	2	0	17	23092
sanejà	2	7	saneja	4	104	111	23093
sanejàrem	2	0	sanejarem	2	2	2	23094
sanglotegí	2	0	sanglotegi	2	1	1	23095
sanglotà	2	5	sanglota	2	10	15	23096
sanglotés	2	1	sanglotes	2	3	4	23097
sanglotí	2	0	sangloti	2	1	1	23098
sangós	0	10	sangos	0	0	10	23099
santceloní	0	0	santceloni	4	31	31	23100
santejà	2	0	santeja	2	1	1	23101
santejàreu	2	1	santejareu	2	0	1	23102
santificarà	2	1	santificara	2	0	1	23103
santificà	2	4	santifica	2	87	91	23104
santifiqués	2	1	santifiques	2	0	1	23105
santifiquí	2	0	santifiqui	2	6	6	23106
santjordí	0	0	santjordi	4	29	29	23107
sanà	2	86	sana	0	8612	8698	23108
sanàrem	2	0	sanarem	2	4	4	23109
sanàreu	2	0	sanareu	2	2	2	23110
sanés	2	6	sanes	0	2209	2215	23111
saní	2	2	sani	2	133	135	23112
saorrà	0	0	saorra	4	48	48	23113
saponificà	2	0	saponifica	2	1	1	23114
saponifiquí	2	0	saponifiqui	2	2	2	23115
saquegés	2	7	saqueges	2	0	7	23116
saquegí	2	0	saquegi	2	3	3	23117
saquejarà	2	6	saquejara	2	0	6	23118
saquejà	2	75	saqueja	2	90	165	23119
saqués	2	26	saques	4	237	263	23120
saquí	2	2	saqui	2	3	5	23121
saragossà	0	307	saragossa	4	10046	10353	23122
sardanejà	2	0	sardaneja	2	1	1	23123
sardanejàrem	2	1	sardanejarem	2	0	1	23124
sargés	4	0	sarges	4	29	29	23125
sarrí	0	0	sarri	4	236	236	23126
satanitzà	2	1	satanitza	2	10	11	23127
satanitzés	2	1	satanitzes	2	0	1	23128
satiritzarà	2	1	satiritzara	2	0	1	23129
satiritzà	2	9	satiritza	2	93	102	23130
satiritzí	2	0	satiritzi	2	1	1	23131
satisféu	2	5	satisfeu	2	21	26	23132
saturarà	2	21	saturara	2	0	21	23133
saturà	2	4	satura	2	210	214	23134
saturàrem	2	0	saturarem	2	1	1	23135
saturàreu	2	0	saturareu	2	1	1	23136
saturés	2	5	satures	2	2	7	23137
saturí	2	0	saturi	4	37	37	23138
savoià	0	24	savoia	4	1574	1598	23139
saxòfon	4	600	saxofon	4	321	921	23140
saxòfons	4	141	saxofons	4	90	231	23141
saxó	0	314	saxo	4	2851	3165	23142
saïmà	2	0	saïma	2	7	7	23143
sebollíreu	2	1	sebollireu	2	0	1	23144
secarà	2	4	secara	2	21	25	23145
seccionarà	2	1	seccionara	2	0	1	23146
seccionà	2	3	secciona	2	38	41	23147
seccionés	2	1	secciones	2	112	113	23148
seccioní	2	0	seccioni	2	1	1	23149
secretarà	2	0	secretara	2	2	2	23150
secretà	2	0	secreta	0	5451	5451	23151
secretàrem	2	0	secretarem	2	1	1	23152
secretària	4	11213	secretaria	2	21202	32415	23153
secretàries	4	335	secretaries	2	664	999	23154
secretés	2	0	secretes	0	1812	1812	23155
secretí	2	0	secreti	2	14	14	23156
sectoritzarà	2	1	sectoritzara	2	0	1	23157
sectoritzà	2	0	sectoritza	2	4	4	23158
secularitzarà	2	1	secularitzara	2	0	1	23159
secularitzà	2	13	secularitza	2	9	22	23160
secularitzí	2	0	secularitzi	2	1	1	23161
secundarà	2	276	secundara	2	0	276	23162
secundà	2	43	secunda	2	1491	1534	23163
secundàrem	2	0	secundarem	2	243	243	23164
secundàreu	2	0	secundareu	2	1	1	23165
secundària	0	39100	secundaria	2	1257	40357	23166
secundàries	0	2851	secundaries	2	121	2972	23167
secundés	2	36	secundes	2	1	37	23168
secà	2	3139	seca	4	13811	16950	23169
secàrem	2	0	secarem	2	5	5	23170
sedarà	2	0	sedara	2	5	5	23171
sedassà	2	0	sedassa	2	1	1	23172
sedassés	2	1	sedasses	2	2	3	23173
sedegués	2	0	sedegues	0	3	3	23174
sedegà	2	0	sedega	0	3	3	23175
sedejà	2	0	sedeja	2	1	1	23176
sedejàreu	2	0	sedejareu	2	1	1	23177
sedentaritzà	2	0	sedentaritza	2	1	1	23178
sedimentarà	2	1	sedimentara	2	0	1	23179
sedimentà	2	1	sedimenta	2	37	38	23180
sedimentària	0	310	sedimentaria	2	33	343	23181
sedimentàries	0	465	sedimentaries	2	39	504	23182
sedimentés	2	0	sedimentes	2	2	2	23183
sedimentí	2	0	sedimenti	2	2	2	23184
seduírem	2	0	seduirem	2	7	7	23185
sedà	2	0	seda	4	6992	6992	23186
sedàssem	2	0	sedassem	2	1	1	23187
sedés	2	1	sedes	4	441	442	23188
sedí	2	0	sedi	2	79	79	23189
segarà	2	8	segara	2	11	19	23190
segellarà	2	91	segellara	2	4	95	23191
segellà	2	24	segella	2	279	303	23192
segellàrem	2	2	segellarem	2	19	21	23193
segellés	2	8	segelles	2	16	24	23194
segellí	2	0	segelli	2	26	26	23195
segmentarà	2	3	segmentara	2	0	3	23196
segmentà	2	0	segmenta	2	71	71	23197
segmentàrem	2	0	segmentarem	2	1	1	23198
segmentària	0	27	segmentaria	2	0	27	23199
segmentàries	0	6	segmentaries	2	3	9	23200
segmentés	2	1	segmentes	2	1	2	23201
segmentí	2	0	segmenti	2	6	6	23202
segovià	2	43	segovia	2	829	872	23203
segoviés	2	0	segovies	2	1	1	23204
segregarà	2	13	segregara	2	4	17	23205
segregués	2	4	segregues	2	5	9	23206
segreguí	2	0	segregui	2	63	63	23207
segregà	2	37	segrega	2	364	401	23208
segregàrem	2	0	segregarem	2	2	2	23209
segrestarà	2	15	segrestara	2	1	16	23210
segrestà	2	42	segresta	2	348	390	23211
segrestàrem	2	0	segrestarem	2	1	1	23212
segrestés	2	15	segrestes	2	5	20	23213
segrestí	2	0	segresti	2	41	41	23214
seguirà	2	12674	seguira	2	122	12796	23215
segué	2	29	segue	2	28	57	23216
segués	2	136	segues	4	56	192	23217
seguírem	2	95	seguirem	2	12869	12964	23218
seguíreu	2	1	seguireu	2	304	305	23219
seguís	2	1139	seguis	2	93	1232	23220
segà	2	17	sega	4	1965	1982	23221
segàrem	2	0	segarem	2	20	20	23222
segó	4	445	sego	2	91	536	23223
seixanta-quatrè	0	14	seixanta-quatre	3	177	191	23224
seixanta-quatré	0	0	seixanta-quatre	3	177	177	23225
seixantejà	2	0	seixanteja	2	2	2	23226
seleccionarà	2	851	seleccionara	2	5	856	23227
seleccionà	2	49	selecciona	2	10197	10246	23228
seleccionàrem	2	2	seleccionarem	2	197	199	23229
seleccionàreu	2	0	seleccionareu	2	23	23	23230
seleccionés	2	31	selecciones	2	263	294	23231
seleccioní	2	0	seleccioni	2	950	950	23232
semaforitzà	2	0	semaforitza	2	1	1	23233
semarà	2	0	semara	2	9	9	23234
semblarà	2	1429	semblara	2	62	1491	23235
semblà	2	560	sembla	2	226598	227158	23236
semblàrem	2	1	semblarem	2	20	21	23237
semblàreu	2	0	semblareu	2	8	8	23238
semblés	2	763	sembles	2	590	1353	23239
semblí	2	0	sembli	2	7718	7718	23240
sembrarà	2	22	sembrara	2	4	26	23241
sembrà	2	56	sembra	4	2685	2741	23242
sembràrem	2	6	sembrarem	2	56	62	23243
sembràreu	2	0	sembrareu	2	4	4	23244
sembrés	2	15	sembres	4	214	229	23245
sembrí	2	0	sembri	2	60	60	23246
semidéu	4	107	semideu	4	5	112	23247
semidéus	4	125	semideus	4	9	134	23248
semà	2	0	sema	0	160	160	23249
semés	2	0	semes	0	34	34	23250
semí	2	3	semi	2	2045	2048	23251
sensibilitzarà	2	31	sensibilitzara	2	1	32	23252
sensibilitzà	2	5	sensibilitza	2	218	223	23253
sensibilitzàrem	2	0	sensibilitzarem	2	10	10	23254
sensibilitzàreu	2	0	sensibilitzareu	2	3	3	23255
sensibilitzés	2	4	sensibilitzes	2	4	8	23256
sensibilitzí	2	0	sensibilitzi	2	53	53	23257
sensualitzà	2	0	sensualitza	2	2	2	23258
sentenciarà	2	23	sentenciara	2	3	26	23259
sentencià	2	133	sentencia	2	2036	2169	23260
sentenciàrem	2	0	sentenciarem	2	1	1	23261
sentenciés	2	38	sentencies	2	270	308	23262
sentencií	2	0	sentencii	2	2	2	23263
sentirà	2	2304	sentira	2	66	2370	23264
sentència	4	35295	sentencia	2	2036	37331	23265
sentències	4	8158	sentencies	2	270	8428	23266
sentí	2	1076	senti	2	5546	6622	23267
sentírem	2	67	sentirem	2	1597	1664	23268
sentíreu	2	5	sentireu	2	889	894	23269
senyalarà	2	16	senyalara	2	2	18	23270
senyalitzarà	2	114	senyalitzara	2	2	116	23271
senyalitzà	2	2	senyalitza	2	120	122	23272
senyalitzàrem	2	0	senyalitzarem	2	18	18	23273
senyalitzés	2	6	senyalitzes	2	1	7	23274
senyalitzí	2	0	senyalitzi	2	35	35	23275
senyalà	2	110	senyala	4	1017	1127	23276
senyalàrem	2	0	senyalarem	2	11	11	23277
senyalés	2	16	senyales	4	25	41	23278
senyalí	2	0	senyali	2	35	35	23279
senyoregés	2	0	senyoreges	2	2	2	23280
senyoregí	2	0	senyoregi	2	5	5	23281
senyorejarà	2	1	senyorejara	2	2	3	23282
senyorejà	2	18	senyoreja	2	174	192	23283
senyorejàreu	2	1	senyorejareu	2	0	1	23284
senyà	2	4	senya	4	569	573	23285
senyàrem	2	0	senyarem	2	1	1	23286
senyés	2	0	senyes	4	1331	1331	23287
senyí	2	0	senyi	2	3	3	23288
senzillà	2	1	senzilla	0	27647	27648	23289
senzillés	2	1	senzilles	0	8697	8698	23290
senés	0	6	senes	4	54	60	23291
separarà	2	238	separara	2	9	247	23292
separà	2	437	separa	2	9042	9479	23293
separàrem	2	7	separarem	2	106	113	23294
separàreu	2	0	separareu	2	5	5	23295
separés	2	138	separes	2	74	212	23296
separí	2	0	separi	2	544	544	23297
septuplicarà	2	1	septuplicara	2	0	1	23298
septupliqués	2	0	septupliques	2	1	1	23299
sepultarà	2	7	sepultara	2	1	8	23300
sepultà	2	12	sepulta	2	30	42	23301
sepultàrem	2	0	sepultarem	2	3	3	23302
sepultés	2	1	sepultes	2	0	1	23303
sepultí	2	1	sepulti	2	7	8	23304
sequés	2	3	seques	0	4948	4951	23305
sequí	2	4	sequi	2	55	59	23306
seqüenciarà	2	1	seqüenciara	2	0	1	23307
seqüencià	2	1	seqüencia	2	192	193	23308
seqüenciàrem	2	0	seqüenciarem	2	2	2	23309
seqüenciés	2	0	seqüencies	2	86	86	23310
seqüencií	2	1	seqüencii	2	0	1	23311
seqüència	4	10390	seqüencia	2	192	10582	23312
seqüències	4	5070	seqüencies	2	86	5156	23313
serialitzà	2	1	serialitza	2	9	10	23314
serigrafiarà	2	2	serigrafiara	2	0	2	23315
serigrafià	2	0	serigrafia	4	2023	2023	23316
serigrafiàrem	2	0	serigrafiarem	2	2	2	23317
serigrafiés	2	0	serigrafies	4	287	287	23318
serià	2	32	seria	2	145810	145842	23319
seriés	2	1	series	2	4268	4269	23320
serií	2	1	serii	2	2	3	23321
sermonegés	2	1	sermoneges	2	0	1	23322
sermonegí	2	0	sermonegi	2	3	3	23323
sermonejarà	2	1	sermonejara	2	0	1	23324
sermonejà	2	1	sermoneja	2	17	18	23325
sermonés	2	0	sermones	2	17	17	23326
sermoní	2	0	sermoni	2	4	4	23327
serosà	0	0	serosa	4	65	65	23328
serpegí	2	0	serpegi	2	1	1	23329
serpejà	2	0	serpeja	2	12	12	23330
serpejàrem	2	0	serpejarem	2	1	1	23331
serpentegés	2	0	serpenteges	2	1	1	23332
serpentegí	2	0	serpentegi	2	3	3	23333
serpentejà	2	2	serpenteja	2	276	278	23334
serpentejàrem	2	0	serpentejarem	2	2	2	23335
serrarà	2	1	serrara	2	0	1	23336
serratellà	0	0	serratella	4	97	97	23337
serregés	2	0	serreges	2	1	1	23338
serràrem	2	1	serrarem	2	1	2	23339
serrés	2	24	serres	4	3774	3798	23340
serrí	2	1	serri	2	55	56	23341
servarà	2	8	servara	2	0	8	23342
servirà	2	14215	servira	2	158	14373	23343
servà	2	21	serva	4	522	543	23344
servàrem	2	1	servarem	2	14	15	23345
servés	2	2	serves	4	233	235	23346
serví	2	1973	servi	2	319	2292	23347
servírem	2	1	servirem	2	345	346	23348
servíreu	2	0	servireu	2	45	45	23349
servís	2	1210	servis	2	238	1448	23350
seríem	2	1613	seriem	2	568	2181	23351
seríeu	2	96	serieu	2	74	170	23352
sestarà	2	2	sestara	2	0	2	23353
sestejà	2	0	sesteja	2	2	2	23354
sestà	2	38	sesta	4	169	207	23355
sestés	2	0	sestes	4	10	10	23356
sestí	2	1	sesti	2	4	5	23357
setanta-quatrè	0	3	setanta-quatre	3	97	100	23358
setanta-quatré	0	0	setanta-quatre	3	97	97	23359
setinarà	2	1	setinara	2	0	1	23360
setinà	2	0	setina	4	3	3	23361
setià	2	2	setia	2	9	11	23362
setzè	0	388	setze	3	8191	8579	23363
setzé	0	12	setze	3	8191	8203	23364
setí	4	263	seti	4	324	587	23365
seuré	2	26	seure	2	7960	7986	23366
sevillà	0	672	sevilla	4	13274	13946	23367
sextuplicà	2	1	sextuplica	2	5	6	23368
sextà	0	0	sexta	0	1682	1682	23369
sexualitzà	2	0	sexualitza	2	14	14	23370
sexà	2	12	sexa	2	5	17	23371
sexés	2	0	sexes	2	3837	3837	23372
sexí	2	1	sexi	2	295	296	23373
sienès	0	16	sienes	4	13	29	23374
sienés	0	1	sienes	4	13	14	23375
sigil·là	2	0	sigil·la	2	1	1	23376
sigil·lí	2	0	sigil·li	2	2	2	23377
signarà	2	1238	signara	2	36	1274	23378
significarà	2	1493	significara	2	11	1504	23379
significà	2	866	significa	2	58710	59576	23380
significàrem	2	1	significarem	2	0	1	23381
signifiqués	2	178	signifiques	2	18	196	23382
signifiquí	2	0	signifiqui	2	1058	1058	23383
signà	2	1601	signa	4	5892	7493	23384
signàrem	2	24	signarem	2	131	155	23385
signàreu	2	1	signareu	2	10	11	23386
signés	2	397	signes	2	16322	16719	23387
signí	2	0	signi	2	738	738	23388
silenciarà	2	17	silenciara	2	1	18	23389
silencià	2	18	silencia	2	396	414	23390
silenciàrem	2	0	silenciarem	2	1	1	23391
silenciés	2	13	silencies	2	20	33	23392
silencií	2	0	silencii	2	3	3	23393
silicifiqués	2	1	silicifiques	2	0	1	23394
siliconà	2	0	silicona	4	2362	2362	23395
siliconés	2	0	silicones	4	132	132	23396
sillà	0	2	silla	4	2245	2247	23397
siluetà	2	0	silueta	4	3247	3247	23398
siluetés	2	0	siluetes	4	1021	1021	23399
siluetí	2	0	silueti	2	1	1	23400
silvestrè	4	0	silvestre	4	4794	4794	23401
silvestré	4	0	silvestre	4	4794	4794	23402
sil·labejà	2	0	sil·labeja	2	2	2	23403
silà	4	24	sila	4	95	119	23404
simbolitzarà	2	75	simbolitzara	2	2	77	23405
simbolitzà	2	21	simbolitza	2	3523	3544	23406
simbolitzàrem	2	0	simbolitzarem	2	2	2	23407
simbolitzés	2	29	simbolitzes	2	4	33	23408
simbolitzí	2	0	simbolitzi	2	47	47	23409
simetritzà	2	1	simetritza	2	1	2	23410
simpatitzarà	2	1	simpatitzara	2	1	2	23411
simpatitzà	2	25	simpatitza	2	148	173	23412
simpatitzàrem	2	1	simpatitzarem	2	0	1	23413
simpatitzés	2	7	simpatitzes	2	10	17	23414
simpatitzí	2	0	simpatitzi	2	40	40	23415
simplificarà	2	187	simplificara	2	2	189	23416
simplificà	2	24	simplifica	2	1099	1123	23417
simplificàrem	2	0	simplificarem	2	28	28	23418
simplifiqués	2	12	simplifiques	2	9	21	23419
simplifiquí	2	0	simplifiqui	2	151	151	23420
simularà	2	67	simulara	2	1	68	23421
simultaniegí	2	0	simultaniegi	2	1	1	23422
simultaniejarà	2	4	simultaniejara	2	0	4	23423
simultaniejà	2	4	simultanieja	2	25	29	23424
simulà	2	10	simula	2	1118	1128	23425
simulàrem	2	0	simularem	2	29	29	23426
simulés	2	19	simules	2	11	30	23427
simulí	2	0	simuli	2	62	62	23428
sincerà	2	1	sincera	0	4249	4250	23429
sincerés	2	1	sinceres	0	1138	1139	23430
sincerí	2	0	sinceri	2	5	5	23431
sincopà	2	0	sincopa	2	5	5	23432
sincopés	2	0	sincopes	2	1	1	23433
sincretitzà	2	1	sincretitza	2	3	4	23434
sincronitzarà	2	48	sincronitzara	2	2	50	23435
sincronitzà	2	2	sincronitza	2	638	640	23436
sincronitzàrem	2	0	sincronitzarem	2	4	4	23437
sincronitzés	2	3	sincronitzes	2	4	7	23438
sincronitzí	2	0	sincronitzi	2	27	27	23439
sindicalitzà	2	0	sindicalitza	2	1	1	23440
sindicarà	2	1	sindicara	2	0	1	23441
sindicà	2	1	sindica	2	44	45	23442
sindicàreu	2	1	sindicareu	2	0	1	23443
sindiqués	2	0	sindiques	2	3	3	23444
sindiquí	2	0	sindiqui	2	4	4	23445
singlà	2	6	singla	2	178	184	23446
singlés	2	1	singles	2	1711	1712	23447
singló	4	23	singlo	2	0	23	23448
singularitzarà	2	3	singularitzara	2	0	3	23449
singularitzà	2	5	singularitza	2	227	232	23450
singularitzés	2	1	singularitzes	2	1	2	23451
singularitzí	2	0	singularitzi	2	12	12	23452
sinteritzà	2	0	sinteritza	2	2	2	23453
sintetitzarà	2	16	sintetitzara	2	1	17	23454
sintetitzà	2	59	sintetitza	2	1306	1365	23455
sintetitzàrem	2	1	sintetitzarem	2	7	8	23456
sintetitzés	2	9	sintetitzes	2	4	13	23457
sintetitzí	2	0	sintetitzi	2	56	56	23458
sintonitzarà	2	8	sintonitzara	2	1	9	23459
sintonitzà	2	6	sintonitza	2	230	236	23460
sintonitzàrem	2	0	sintonitzarem	2	6	6	23461
sintonitzés	2	5	sintonitzes	2	9	14	23462
sintonitzí	2	0	sintonitzi	2	33	33	23463
sipà	2	0	sipa	2	22	22	23464
sipàreu	2	0	sipareu	2	1	1	23465
sipés	2	0	sipes	2	4	4	23466
sipí	2	0	sipi	2	41	41	23467
siracusà	0	17	siracusa	4	553	570	23468
sirgués	2	0	sirgues	4	26	26	23469
sirguí	2	1	sirgui	2	1	2	23470
sirgà	2	0	sirga	4	663	663	23471
sirventès	4	63	sirventes	4	4	67	23472
sirventés	4	6	sirventes	4	4	10	23473
sirà	4	331	sira	4	574	905	23474
sistematitzarà	2	2	sistematitzara	2	0	2	23475
sistematitzà	2	16	sistematitza	2	133	149	23476
sistematitzàrem	2	0	sistematitzarem	2	2	2	23477
sistematitzés	2	2	sistematitzes	2	1	3	23478
sistematitzí	2	0	sistematitzi	2	17	17	23479
situarà	2	1908	situara	2	16	1924	23480
situà	2	552	situa	2	28217	28769	23481
situàrem	2	15	situarem	2	318	333	23482
situàreu	2	0	situareu	2	8	8	23483
situés	2	213	situes	2	111	324	23484
siulà	2	0	siula	2	7	7	23485
soanyès	0	0	soanyes	4	31	31	23486
soanyés	0	0	soanyes	4	31	31	23487
soberguejà	2	0	sobergueja	2	2	2	23488
sobrarà	2	89	sobrara	2	5	94	23489
sobreabundà	2	1	sobreabunda	2	3	4	23490
sobreactuà	2	0	sobreactua	2	16	16	23491
sobreactués	2	0	sobreactues	2	1	1	23492
sobrealimentà	2	1	sobrealimenta	2	3	4	23493
sobrealimentés	2	0	sobrealimentes	2	1	1	23494
sobrealçà	2	14	sobrealça	2	1	15	23495
sobrebaixàreu	2	1	sobrebaixareu	2	0	1	23496
sobrecarregarà	2	7	sobrecarregara	2	0	7	23497
sobrecarregués	2	0	sobrecarregues	2	52	52	23498
sobrecarreguí	2	0	sobrecarregui	2	53	53	23499
sobrecarregà	2	1	sobrecarrega	2	125	126	23500
sobrecarregàreu	2	0	sobrecarregareu	2	1	1	23501
sobrecongelàreu	2	1	sobrecongelareu	2	0	1	23502
sobrecàrrega	4	2087	sobrecarrega	2	125	2212	23503
sobrecàrregues	4	756	sobrecarregues	2	52	808	23504
sobrediagnosticà	2	0	sobrediagnostica	2	1	1	23505
sobrediagnòstic	4	176	sobrediagnostic	2	1	177	23506
sobredimensionà	2	3	sobredimensiona	2	24	27	23507
sobredimensionés	2	2	sobredimensiones	2	2	4	23508
sobredimensioní	2	0	sobredimensioni	2	1	1	23509
sobredosificà	2	0	sobredosifica	2	1	1	23510
sobreeixirà	2	6	sobreeixira	2	0	6	23511
sobreeixírem	2	0	sobreeixirem	2	2	2	23512
sobreentendré	2	0	sobreentendre	2	37	37	23513
sobreentengués	2	2	sobreentengues	2	0	2	23514
sobreentenguí	2	0	sobreentengui	2	2	2	23515
sobreentrenà	2	0	sobreentrena	2	1	1	23516
sobreescalfà	2	0	sobreescalfa	2	7	7	23517
sobreescalfí	2	0	sobreescalfi	2	2	2	23518
sobreescrigués	2	0	sobreescrigues	2	1	1	23519
sobreescriguí	2	0	sobreescrigui	2	16	16	23520
sobreescriuré	2	0	sobreescriure	2	379	379	23521
sobreestimulà	2	0	sobreestimula	2	5	5	23522
sobreestimulés	2	0	sobreestimules	2	1	1	23523
sobreestimulí	2	0	sobreestimuli	2	1	1	23524
sobreestimà	2	6	sobreestima	2	24	30	23525
sobreestimés	2	0	sobreestimes	2	3	3	23526
sobreestimí	2	1	sobreestimi	2	3	4	23527
sobreexcità	2	0	sobreexcita	2	3	3	23528
sobreexcití	2	0	sobreexciti	2	2	2	23529
sobreexplotà	2	0	sobreexplota	2	7	7	23530
sobreexplotí	2	0	sobreexploti	2	2	2	23531
sobreexposà	2	0	sobreexposa	2	6	6	23532
sobrefilà	2	0	sobrefila	2	1	1	23533
sobrefilàrem	2	0	sobrefilarem	2	5	5	23534
sobrefilí	2	0	sobrefili	2	1	1	23535
sobremuntarà	2	0	sobremuntara	2	1	1	23536
sobremuntà	2	0	sobremunta	2	6	6	23537
sobrenedà	2	0	sobreneda	2	3	3	23538
sobrenomenà	2	0	sobrenomena	2	5	5	23539
sobrepassarà	2	79	sobrepassara	2	5	84	23540
sobrepassà	2	55	sobrepassa	2	1616	1671	23541
sobrepassàrem	2	2	sobrepassarem	2	20	22	23542
sobrepassàreu	2	0	sobrepassareu	2	3	3	23543
sobrepassés	2	34	sobrepasses	2	11	45	23544
sobrepassí	2	0	sobrepassi	2	309	309	23545
sobreposarà	2	6	sobreposara	2	0	6	23546
sobreposà	2	10	sobreposa	2	167	177	23547
sobreposàrem	2	0	sobreposarem	2	2	2	23548
sobreposés	2	0	sobreposes	2	4	4	23549
sobreposí	2	0	sobreposi	2	22	22	23550
sobrepugés	2	0	sobrepuges	4	3	3	23551
sobrepugí	2	0	sobrepugi	2	3	3	23552
sobrepujà	2	1	sobrepuja	4	17	18	23553
sobresaltarà	2	1	sobresaltara	2	0	1	23554
sobresaltà	2	9	sobresalta	2	27	36	23555
sobresaltés	2	1	sobresaltes	2	0	1	23556
sobresaltí	2	0	sobresalti	2	3	3	23557
sobresanàrem	2	0	sobresanarem	2	1	1	23558
sobresanàreu	2	1	sobresanareu	2	0	1	23559
sobresaturarà	2	1	sobresaturara	2	0	1	23560
sobresaturà	2	0	sobresatura	2	9	9	23561
sobresaturàreu	2	0	sobresaturareu	2	1	1	23562
sobresegellarà	2	1	sobresegellara	2	0	1	23563
sobreseguí	2	0	sobresegui	2	1	1	23564
sobreseuré	2	0	sobreseure	2	52	52	23565
sobresortirà	2	22	sobresortira	2	1	23	23566
sobrevalorà	2	2	sobrevalora	2	51	53	23567
sobrevaloràrem	2	0	sobrevalorarem	2	1	1	23568
sobrevaloràreu	2	1	sobrevalorareu	2	0	1	23569
sobrevalorés	2	1	sobrevalores	2	8	9	23570
sobrevalorí	2	0	sobrevalori	2	3	3	23571
sobrevindré	2	2	sobrevindre	2	20	22	23572
sobrevingués	2	6	sobrevingues	2	0	6	23573
sobrevinguí	2	0	sobrevingui	2	32	32	23574
sobrevisqués	2	100	sobrevisques	2	2	102	23575
sobrevisquí	2	0	sobrevisqui	2	252	252	23576
sobreviuré	2	32	sobreviure	2	14557	14589	23577
sobrevolarà	2	47	sobrevolara	2	0	47	23578
sobrevolà	2	25	sobrevola	2	413	438	23579
sobrevolàrem	2	0	sobrevolarem	2	31	31	23580
sobrevolàreu	2	0	sobrevolareu	2	4	4	23581
sobrevolés	2	17	sobrevoles	2	5	22	23582
sobrevolí	2	0	sobrevoli	2	20	20	23583
sobrà	2	13	sobra	4	3545	3558	23584
sobràrem	2	0	sobrarem	2	1	1	23585
sobrés	2	52	sobres	4	5415	5467	23586
sobrí	2	3	sobri	2	1511	1514	23587
sobtarà	2	36	sobtara	2	0	36	23588
sobtà	2	44	sobta	2	1693	1737	23589
sobtàrem	2	0	sobtarem	2	1	1	23590
sobtés	2	6	sobtes	2	1	7	23591
sobtí	2	0	sobti	2	32	32	23592
socarrarà	2	2	socarrara	2	0	2	23593
socarrimarà	2	2	socarrimara	2	0	2	23594
socarrimà	2	0	socarrima	2	17	17	23595
socarrimàrem	2	0	socarrimarem	2	1	1	23596
socarrimés	2	1	socarrimes	2	0	1	23597
socarrimí	2	0	socarrimi	2	3	3	23598
socarrà	2	55	socarra	2	10	65	23599
socarràrem	2	0	socarrarem	2	2	2	23600
socarràreu	2	1	socarrareu	2	2	3	23601
socarrí	2	0	socarri	2	1	1	23602
socialitzarà	2	8	socialitzara	2	0	8	23603
socialitzà	2	3	socialitza	2	130	133	23604
socialitzàrem	2	1	socialitzarem	2	7	8	23605
socialitzés	2	1	socialitzes	2	1	2	23606
socialitzí	2	0	socialitzi	2	23	23	23607
sodomitzà	2	1	sodomitza	2	14	15	23608
sodomitzés	2	1	sodomitzes	2	0	1	23609
sodomitzí	2	0	sodomitzi	2	1	1	23610
sofisticà	2	0	sofistica	2	23	23	23611
sofistiquí	2	0	sofistiqui	2	1	1	23612
soflamà	2	0	soflama	4	31	31	23613
soflamés	2	0	soflames	4	73	73	23614
sofregirà	2	2	sofregira	2	0	2	23615
sofregírem	2	0	sofregirem	2	187	187	23616
sofregíreu	2	0	sofregireu	2	3	3	23617
sofrenà	2	1	sofrena	2	0	1	23618
sofrirà	2	234	sofrira	2	6	240	23619
sofrà	2	5	sofra	4	7	12	23620
sofrèn	2	0	sofren	2	2	2	23621
sofrés	2	0	sofres	4	42	42	23622
sofrí	2	501	sofri	2	11	512	23623
sofrírem	2	2	sofrirem	2	53	55	23624
sofríreu	2	1	sofrireu	2	5	6	23625
sofrís	2	65	sofris	2	1	66	23626
sofístic	0	5	sofistic	2	0	5	23627
sofística	0	44	sofistica	2	23	67	23628
sofístiques	0	7	sofistiques	2	0	7	23629
sogués	2	2	sogues	4	146	148	23630
soguí	2	0	sogui	2	8	8	23631
sogà	2	0	soga	4	323	323	23632
sogàreu	2	1	sogareu	2	0	1	23633
sogàs	2	0	sogas	4	75	75	23634
sojornà	2	45	sojorna	2	28	73	23635
sojornàrem	2	0	sojornarem	2	2	2	23636
sojornés	2	2	sojornes	2	0	2	23637
sojorní	2	0	sojorni	2	6	6	23638
solaparà	2	13	solapara	2	0	13	23639
solapà	2	0	solapa	4	1196	1196	23640
solapàrem	2	0	solaparem	2	1	1	23641
solapés	2	1	solapes	4	4482	4483	23642
solapí	2	0	solapi	2	27	27	23643
solarà	2	0	solara	2	13	13	23644
solaçà	2	0	solaça	2	2	2	23645
solcarà	2	14	solcara	2	0	14	23646
solcà	2	6	solca	2	143	149	23647
solcàrem	2	0	solcarem	2	6	6	23648
solcàreu	2	0	solcareu	2	2	2	23649
soldarà	2	8	soldara	2	0	8	23650
soldejà	2	1	soldeja	2	0	1	23651
soldré	2	0	soldre	2	4	4	23652
soldà	2	1186	solda	2	54	1240	23653
soldàrem	2	0	soldarem	2	7	7	23654
soldés	2	6	soldes	2	30	36	23655
soldí	2	0	soldi	2	16	16	23656
solejà	2	0	soleja	2	2	2	23657
solemnitzarà	2	5	solemnitzara	2	0	5	23658
solemnitzà	2	4	solemnitza	2	25	29	23659
solemnitzàrem	2	0	solemnitzarem	2	1	1	23660
solemnitzàreu	2	1	solemnitzareu	2	0	1	23661
solemnitzés	2	2	solemnitzes	2	1	3	23662
solfejà	2	0	solfeja	2	3	3	23663
solguí	2	0	solgui	2	7	7	23664
solidaritzarà	2	12	solidaritzara	2	0	12	23665
solidaritzà	2	17	solidaritza	2	489	506	23666
solidaritzàrem	2	0	solidaritzarem	2	2	2	23667
solidaritzés	2	6	solidaritzes	2	7	13	23668
solidaritzí	2	0	solidaritzi	2	41	41	23669
solidarà	2	0	solidara	2	6	6	23670
solidificarà	2	16	solidificara	2	0	16	23671
solidificà	2	7	solidifica	2	149	156	23672
solidifiqués	2	5	solidifiques	2	1	6	23673
solidifiquí	2	0	solidifiqui	2	72	72	23674
solidà	2	3	solida	2	217	220	23675
solidària	0	28593	solidaria	2	1803	30396	23676
solidàries	0	7077	solidaries	2	529	7606	23677
solidés	2	4	solides	2	66	70	23678
solidí	2	0	solidi	2	10	10	23679
sollevà	2	2	solleva	2	5	7	23680
sollevàrem	2	0	sollevarem	2	2	2	23681
sollà	2	0	solla	2	59	59	23682
sollés	2	0	solles	2	1	1	23683
sollí	2	0	solli	2	1	1	23684
solqués	2	2	solques	2	1	3	23685
solquí	2	0	solqui	2	8	8	23686
solsirà	2	1	solsira	2	1	2	23687
soltarà	2	8	soltara	2	8	16	23688
soltà	2	21	solta	0	1518	1539	23689
soltàrem	2	0	soltarem	2	3	3	23690
soltàreu	2	0	soltareu	2	2	2	23691
soltés	2	2	soltes	0	897	899	23692
soltí	2	1	solti	2	82	83	23693
solubilitzà	2	0	solubilitza	2	4	4	23694
solubilitzés	2	1	solubilitzes	2	0	1	23695
solucionarà	2	667	solucionara	2	25	692	23696
solucionà	2	40	soluciona	2	2139	2179	23697
solucionàrem	2	2	solucionarem	2	244	246	23698
solucionàreu	2	0	solucionareu	2	10	10	23699
solucionés	2	115	soluciones	2	354	469	23700
solucioní	2	0	solucioni	2	719	719	23701
sol·licitarà	2	1277	sol·licitara	2	34	1311	23702
sol·licità	2	305	sol·licita	2	7352	7657	23703
sol·licitàrem	2	15	sol·licitarem	2	232	247	23704
sol·licitàreu	2	0	sol·licitareu	2	5	5	23705
sol·licités	2	204	sol·licites	2	129	333	23706
sol·licití	2	1	sol·liciti	2	2554	2555	23707
sol·lícit	0	82	sol·licit	2	6	88	23708
sol·lícita	0	64	sol·licita	2	7352	7416	23709
sol·lícites	0	12	sol·licites	2	129	141	23710
solés	2	192	soles	0	11639	11831	23711
solí	2	20	soli	2	404	424	23712
somatitzà	2	1	somatitza	2	11	12	23713
somatitzés	2	0	somatitzes	2	2	2	23714
somatitzí	2	0	somatitzi	2	2	2	23715
somiarà	2	17	somiara	2	0	17	23716
somicà	2	1	somica	2	26	27	23717
somicó	0	0	somico	2	1	1	23718
somiejà	2	0	somieja	2	1	1	23719
somiquejà	2	2	somiqueja	2	2	4	23720
somiqués	2	2	somiques	2	2	4	23721
somiquí	2	0	somiqui	2	3	3	23722
somià	2	21	somia	2	1761	1782	23723
somiàrem	2	1	somiarem	2	18	19	23724
somiàreu	2	0	somiareu	2	5	5	23725
somiés	2	11	somies	2	189	200	23726
somií	2	2	somii	2	20	22	23727
somniarà	2	1	somniara	2	1	2	23728
somnià	2	15	somnia	2	402	417	23729
somniàrem	2	1	somniarem	2	4	5	23730
somniàreu	2	0	somniareu	2	1	1	23731
somniés	2	8	somnies	2	63	71	23732
somnií	2	0	somnii	2	2	2	23733
somoguí	2	0	somogui	2	1	1	23734
somorgollà	2	0	somorgolla	2	1	1	23735
somouré	2	0	somoure	2	77	77	23736
somrigués	2	21	somrigues	2	3	24	23737
somriguí	2	0	somrigui	2	116	116	23738
somriuré	2	18	somriure	4	19871	19889	23739
sonarà	2	1122	sonara	2	59	1181	23740
sondegés	2	3	sondeges	2	0	3	23741
sondegí	2	0	sondegi	2	5	5	23742
sondejarà	2	8	sondejara	2	0	8	23743
sondejà	2	3	sondeja	2	48	51	23744
sondejàrem	2	1	sondejarem	2	3	4	23745
sondejàreu	2	1	sondejareu	2	0	1	23746
sondrollà	2	0	sondrolla	2	2	2	23747
sondà	2	0	sonda	4	2813	2813	23748
sondàrem	2	1	sondarem	2	0	1	23749
sondés	2	1	sondes	4	1059	1060	23750
sondí	2	0	sondi	2	1	1	23751
sonoritzarà	2	7	sonoritzara	2	0	7	23752
sonoritzà	2	0	sonoritza	2	15	15	23753
sonoritzàrem	2	0	sonoritzarem	2	2	2	23754
sonoritzés	2	1	sonoritzes	2	0	1	23755
sonoritzí	2	0	sonoritzi	2	4	4	23756
sonà	2	184	sona	2	13230	13414	23757
sonàrem	2	6	sonarem	2	9	15	23758
sonàreu	2	1	sonareu	2	1	2	23759
sonés	2	312	sones	2	174	486	23760
soní	2	0	soni	2	1536	1536	23761
soparà	2	44	sopara	2	6	50	23762
soplujà	2	0	sopluja	2	3	3	23763
sopà	2	26	sopa	4	8524	8550	23764
sopàrem	2	42	soparem	2	417	459	23765
sopàreu	2	0	sopareu	2	15	15	23766
sopés	2	8	sopes	4	2577	2585	23767
sopí	2	0	sopi	2	36	36	23768
sordegés	2	1	sordeges	2	0	1	23769
sordejà	2	0	sordeja	2	9	9	23770
sorgirà	2	545	sorgira	2	18	563	23771
sorgírem	2	0	sorgirem	2	4	4	23772
sorità	0	1	sorita	4	139	140	23773
sorollarà	2	0	sorollara	2	1	1	23774
sorollà	2	1	sorolla	4	1480	1481	23775
sorollàrem	2	0	sorollarem	2	1	1	23776
sorollés	2	0	sorolles	4	6	6	23777
sorprendré	2	53	sorprendre	2	16041	16094	23778
sorprengués	2	83	sorprengues	2	8	91	23779
sorprenguí	2	0	sorprengui	2	591	591	23780
sorregés	2	1	sorreges	2	0	1	23781
sorrejà	2	1	sorreja	2	0	1	23782
sorrà	2	1	sorra	4	22009	22010	23783
sorrés	2	0	sorres	4	1021	1021	23784
sorrí	2	0	sorri	2	22	22	23785
sortegés	2	2	sorteges	2	5	7	23786
sortegí	2	0	sortegi	2	15	15	23787
sortejarà	2	854	sortejara	2	0	854	23788
sortejà	2	14	sorteja	2	424	438	23789
sortejàrem	2	4	sortejarem	2	492	496	23790
sortirà	2	10631	sortira	2	165	10796	23791
sortírem	2	112	sortirem	2	4510	4622	23792
sortíreu	2	1	sortireu	2	473	474	23793
soscavarà	2	48	soscavara	2	0	48	23794
soscavà	2	4	soscava	2	486	490	23795
soscavàrem	2	0	soscavarem	2	6	6	23796
soscavés	2	5	soscaves	2	0	5	23797
soscaví	2	0	soscavi	2	81	81	23798
sospedrà	2	0	sospedra	4	159	159	23799
sospedràrem	2	0	sospedrarem	2	1	1	23800
sospesarà	2	11	sospesara	2	0	11	23801
sospesà	2	4	sospesa	2	141	145	23802
sospesàrem	2	0	sospesarem	2	2	2	23803
sospesés	2	7	sospeses	2	25	32	23804
sospesí	2	0	sospesi	2	12	12	23805
sospirarà	2	2	sospirara	2	0	2	23806
sospirà	2	50	sospira	2	188	238	23807
sospiràrem	2	0	sospirarem	2	1	1	23808
sospirés	2	2	sospires	2	18	20	23809
sospirí	2	0	sospiri	2	24	24	23810
sospitarà	2	20	sospitara	2	3	23	23811
sospità	2	48	sospita	4	5828	5876	23812
sospitàrem	2	2	sospitarem	2	10	12	23813
sospitàreu	2	1	sospitareu	2	6	7	23814
sospités	2	59	sospites	4	2839	2898	23815
sospití	2	0	sospiti	2	160	160	23816
sostenguí	2	0	sostengui	2	6	6	23817
sostindré	2	15	sostindre	2	162	177	23818
sostingués	2	38	sostingues	2	8	46	23819
sostinguí	2	1	sostingui	2	229	230	23820
sostovà	2	0	sostova	2	2	2	23821
sostragués	2	6	sostragues	2	0	6	23822
sostraguí	2	0	sostragui	2	1	1	23823
sostrauré	2	0	sostraure	2	163	163	23824
sostrà	2	0	sostra	2	5	5	23825
sostrés	2	0	sostres	4	4152	4152	23826
sotaescriuré	2	0	sotaescriure	2	1	1	23827
sotaiguà	2	0	sotaigua	2	17	17	23828
sotaplugés	2	1	sotapluges	2	0	1	23829
sotaposà	2	0	sotaposa	2	1	1	23830
soterrarà	2	31	soterrara	2	3	34	23831
soterrà	2	8	soterra	2	43	51	23832
soterràrem	2	1	soterrarem	2	4	5	23833
soterrés	2	8	soterres	2	0	8	23834
soterrí	2	0	soterri	2	14	14	23835
sotgés	2	1	sotges	2	4	5	23836
sotjà	2	9	sotja	2	45	54	23837
sotmetré	2	100	sotmetre	2	11301	11401	23838
sotmetés	2	131	sotmetes	2	3	134	23839
sotmetí	2	0	sotmeti	2	616	616	23840
sotraguegés	2	3	sotragueges	2	0	3	23841
sotraguegí	2	0	sotraguegi	2	2	2	23842
sotraguejà	2	0	sotragueja	2	6	6	23843
sotragués	2	2	sotragues	2	0	2	23844
sotraguí	2	0	sotragui	2	1	1	23845
sotragà	2	4	sotraga	2	18	22	23846
sotsarrendà	2	0	sotsarrenda	2	1	1	23847
sotsarrendí	2	0	sotsarrendi	2	1	1	23848
sotsobrarà	2	1	sotsobrara	2	0	1	23849
sotsobrà	2	2	sotsobra	2	30	32	23850
sotsobrés	2	1	sotsobres	2	7	8	23851
sotsobrí	2	0	sotsobri	2	1	1	23852
sotssecretària	4	65	sotssecretaria	4	56	121	23853
sotssecretàries	4	6	sotssecretaries	4	7	13	23854
sovintegés	2	2	sovinteges	2	5	7	23855
sovintegí	2	0	sovintegi	2	8	8	23856
sovintejarà	2	5	sovintejara	2	0	5	23857
sovintejà	2	17	sovinteja	2	256	273	23858
sovintejàrem	2	0	sovintejarem	2	2	2	23859
suarà	2	16	suara	2	1146	1162	23860
suavitzarà	2	42	suavitzara	2	1	43	23861
suavitzà	2	12	suavitza	2	789	801	23862
suavitzàrem	2	0	suavitzarem	2	2	2	23863
suavitzàreu	2	0	suavitzareu	2	1	1	23864
suavitzés	2	17	suavitzes	2	3	20	23865
suavitzí	2	0	suavitzi	2	39	39	23866
subalternà	2	0	subalterna	0	124	124	23867
subalternés	2	0	subalternes	0	154	154	23868
subarrendarà	2	0	subarrendara	2	1	1	23869
subarrendà	2	0	subarrenda	2	1	1	23870
subcategoritzà	2	0	subcategoritza	2	2	2	23871
subcontractarà	2	23	subcontractara	2	0	23	23872
subcontractà	2	1	subcontracta	2	141	142	23873
subcontractàrem	2	0	subcontractarem	2	1	1	23874
subcontractés	2	3	subcontractes	2	202	205	23875
subcontractí	2	0	subcontracti	2	22	22	23876
subdividirà	2	14	subdividira	2	0	14	23877
subdividírem	2	0	subdividirem	2	1	1	23878
suberitzàrem	2	0	suberitzarem	2	1	1	23879
subespecialitzà	2	0	subespecialitza	2	2	2	23880
subestimarà	2	1	subestimara	2	0	1	23881
subestimà	2	11	subestima	2	142	153	23882
subestimés	2	1	subestimes	2	20	21	23883
subestimí	2	1	subestimi	2	32	33	23884
subhastarà	2	53	subhastara	2	0	53	23885
subhastà	2	9	subhasta	4	4170	4179	23886
subhastàrem	2	0	subhastarem	2	2	2	23887
subhastés	2	3	subhastes	4	1340	1343	23888
subhastí	2	0	subhasti	2	18	18	23889
subinfeudà	2	2	subinfeuda	2	1	3	23890
subintrés	2	1	subintres	2	0	1	23891
subjauré	2	0	subjaure	2	2	2	23892
subjectarà	2	49	subjectara	2	2	51	23893
subjectivà	2	0	subjectiva	0	2264	2264	23894
subjectivés	2	0	subjectives	0	806	806	23895
subjectà	2	16	subjecta	2	4076	4092	23896
subjectàrem	2	0	subjectarem	2	3	3	23897
subjectés	2	9	subjectes	2	12728	12737	23898
subjectí	2	0	subjecti	2	50	50	23899
subjugarà	2	2	subjugara	2	0	2	23900
subjugués	2	3	subjugues	2	0	3	23901
subjuguí	2	0	subjugui	2	3	3	23902
subjugà	2	11	subjuga	2	71	82	23903
sublevarà	2	1	sublevara	2	1	2	23904
sublevà	2	9	subleva	2	46	55	23905
sublevàrem	2	0	sublevarem	2	1	1	23906
sublevés	2	4	subleves	2	0	4	23907
sublimarà	2	2	sublimara	2	1	3	23908
sublimà	2	1	sublima	2	162	163	23909
sublimàrem	2	0	sublimarem	2	1	1	23910
sublimés	2	6	sublimes	2	12	18	23911
sublimí	2	0	sublimi	2	11	11	23912
submergirà	2	154	submergira	2	2	156	23913
submergírem	2	2	submergirem	2	88	90	23914
submergíreu	2	0	submergireu	2	14	14	23915
subministrarà	2	225	subministrara	2	1	226	23916
subministrà	2	36	subministra	2	1780	1816	23917
subministràrem	2	0	subministrarem	2	17	17	23918
subministrés	2	25	subministres	2	465	490	23919
subministrí	2	1	subministri	2	248	249	23920
submón	4	318	submon	4	174	492	23921
subordinarà	2	10	subordinara	2	0	10	23922
subordinà	2	9	subordina	2	202	211	23923
subordinàrem	2	0	subordinarem	2	4	4	23924
subordinés	2	3	subordines	2	0	3	23925
subordiní	2	0	subordini	2	32	32	23926
subornarà	2	2	subornara	2	0	2	23927
subornà	2	9	suborna	2	24	33	23928
subornàrem	2	0	subornarem	2	1	1	23929
subornés	2	2	subornes	2	0	2	23930
suborní	2	0	suborni	2	2	2	23931
subratllarà	2	46	subratllara	2	1	47	23932
subratllà	2	98	subratlla	2	5651	5749	23933
subratllàrem	2	0	subratllarem	2	25	25	23934
subratllàreu	2	0	subratllareu	2	1	1	23935
subratllés	2	16	subratlles	2	11	27	23936
subratllí	2	2	subratlli	2	139	141	23937
subrogarà	2	30	subrogara	2	0	30	23938
subroguí	2	0	subrogui	2	21	21	23939
subrogà	2	1	subroga	2	62	63	23940
subscrigués	2	7	subscrigues	2	1	8	23941
subscriguí	2	0	subscrigui	2	258	258	23942
subscriuré	2	11	subscriure	2	4282	4293	23943
subsecretària	4	65	subsecretaria	4	128	193	23944
subsecretàries	4	2	subsecretaries	4	7	9	23945
subsidiarà	2	1	subsidiara	2	0	1	23946
subsidià	2	1	subsidia	2	11	12	23947
subsidiària	0	1297	subsidiaria	2	26	1323	23948
subsidiàries	0	1082	subsidiaries	2	24	1106	23949
subsidiés	2	0	subsidies	2	7	7	23950
subsistirà	2	69	subsistira	2	1	70	23951
subsistírem	2	2	subsistirem	2	1	3	23952
subsolàrem	2	0	subsolarem	2	1	1	23953
substanciarà	2	24	substanciara	2	0	24	23954
substancià	2	3	substancia	2	195	198	23955
substanciés	2	3	substancies	2	273	276	23956
substantivarà	2	2	substantivara	2	0	2	23957
substantivà	2	2	substantiva	0	347	349	23958
substantivés	2	0	substantives	0	161	161	23959
substantiví	2	0	substantivi	2	1	1	23960
substituírem	2	3	substituirem	2	110	113	23961
substituíreu	2	0	substituireu	2	8	8	23962
substància	4	9440	substancia	2	195	9635	23963
substàncies	4	17392	substancies	2	273	17665	23964
subsumirà	2	2	subsumira	2	0	2	23965
subsòl	4	3310	subsol	4	297	3607	23966
subsòls	4	40	subsols	4	2	42	23967
subtendirà	2	1	subtendira	2	0	1	23968
subtendíreu	2	1	subtendireu	2	0	1	23969
subtilitzà	2	0	subtilitza	2	7	7	23970
subtilitzés	2	0	subtilitzes	2	1	1	23971
subtitularà	2	5	subtitulara	2	0	5	23972
subtitulà	2	5	subtitula	2	69	74	23973
subtitulàrem	2	0	subtitularem	2	1	1	23974
subtitulés	2	1	subtitules	2	1	2	23975
subtitulí	2	0	subtituli	2	3	3	23976
subvalorà	2	1	subvalora	2	2	3	23977
subvencionarà	2	477	subvencionara	2	4	481	23978
subvencionà	2	21	subvenciona	2	1038	1059	23979
subvencionàrem	2	0	subvencionarem	2	12	12	23980
subvencionés	2	19	subvenciones	2	102	121	23981
subvencioní	2	0	subvencioni	2	133	133	23982
subvertírem	2	0	subvertirem	2	3	3	23983
sucarà	2	4	sucara	2	0	4	23984
succionarà	2	5	succionara	2	1	6	23985
succionà	2	1	succiona	2	75	76	23986
succionàrem	2	0	succionarem	2	1	1	23987
succionés	2	6	succiones	2	0	6	23988
succioní	2	0	succioni	2	10	10	23989
sucumbirà	2	32	sucumbira	2	0	32	23990
sucumbírem	2	0	sucumbirem	2	7	7	23991
sucà	2	12	suca	2	133	145	23992
sucàrem	2	0	sucarem	2	16	16	23993
sucàreu	2	0	sucareu	2	2	2	23994
suecà	0	298	sueca	4	10470	10768	23995
sufixà	2	0	sufixa	0	2	2	23996
sufixés	2	0	sufixes	0	39	39	23997
sufocarà	2	2	sufocara	2	0	2	23998
sufocà	2	36	sufoca	2	46	82	23999
sufocàrem	2	0	sufocarem	2	1	1	24000
sufoqués	2	1	sufoques	2	2	3	24001
sufoquí	2	0	sufoqui	2	2	2	24002
sufragarà	2	125	sufragara	2	3	128	24003
sufragués	2	10	sufragues	2	0	10	24004
sufraguí	2	0	sufragui	2	27	27	24005
sufragà	2	17	sufraga	2	135	152	24006
suggerirà	2	101	suggerira	2	3	104	24007
suggerírem	2	2	suggerirem	2	40	42	24008
suggestionà	2	0	suggestiona	2	5	5	24009
suggestionés	2	0	suggestiones	2	1	1	24010
sulfatarà	2	0	sulfatara	2	2	2	24011
sulfatà	2	0	sulfata	2	2	2	24012
sulfatàrem	2	0	sulfatarem	2	2	2	24013
sulfatés	2	0	sulfates	2	3	3	24014
sulfità	2	0	sulfita	2	2	2	24015
sulfitàrem	2	1	sulfitarem	2	0	1	24016
sulfités	2	0	sulfites	2	1	1	24017
sulfonà	2	0	sulfona	4	10	10	24018
sulfonés	2	0	sulfones	4	16	16	24019
sulfoní	2	0	sulfoni	2	2	2	24020
sulfurà	2	1	sulfura	2	15	16	24021
sulfurés	2	0	sulfures	2	1	1	24022
sulfurí	2	0	sulfuri	2	1	1	24023
sullà	2	107	sulla	0	127	234	24024
sullés	2	0	sulles	0	2	2	24025
sullí	2	0	sulli	2	4	4	24026
sumarià	2	0	sumaria	2	311	311	24027
sumariés	2	0	sumaries	2	10	10	24028
sumarà	2	1344	sumara	2	20	1364	24029
sumaríem	2	14	sumariem	2	0	14	24030
sumaríeu	2	1	sumarieu	2	0	1	24031
sumirà	2	27	sumira	2	1	28	24032
sumà	2	202	suma	4	31502	31704	24033
sumàrem	2	8	sumarem	2	185	193	24034
sumàreu	2	0	sumareu	2	13	13	24035
sumària	0	148	sumaria	2	311	459	24036
sumàries	0	144	sumaries	2	10	154	24037
sumés	2	183	sumes	4	2455	2638	24038
sumí	2	11	sumi	2	848	859	24039
sumírem	2	0	sumirem	2	1	1	24040
sumís	2	32	sumis	2	45	77	24041
supeditarà	2	7	supeditara	2	0	7	24042
supedità	2	6	supedita	2	187	193	24043
supeditàrem	2	0	supeditarem	2	6	6	24044
supedités	2	6	supedites	2	4	10	24045
supedití	2	0	supediti	2	29	29	24046
superarà	2	1106	superara	2	32	1138	24047
superposarà	2	14	superposara	2	1	15	24048
superposà	2	12	superposa	2	383	395	24049
superposàrem	2	0	superposarem	2	2	2	24050
superposés	2	5	superposes	2	1	6	24051
superposí	2	0	superposi	2	13	13	24052
supervisarà	2	245	supervisara	2	1	246	24053
supervisà	2	92	supervisa	2	1126	1218	24054
supervisàrem	2	0	supervisarem	2	40	40	24055
supervisàreu	2	0	supervisareu	2	1	1	24056
supervisés	2	36	supervises	2	3	39	24057
supervisí	2	0	supervisi	2	221	221	24058
superà	2	407	supera	2	14443	14850	24059
superàrem	2	7	superarem	2	352	359	24060
superàreu	2	2	superareu	2	17	19	24061
superés	2	415	superes	2	248	663	24062
superí	2	10	superi	2	3200	3210	24063
suplantarà	2	10	suplantara	2	0	10	24064
suplantà	2	10	suplanta	2	106	116	24065
suplantés	2	6	suplantes	2	4	10	24066
suplantí	2	0	suplanti	2	17	17	24067
suplementarà	2	4	suplementara	2	0	4	24068
suplementà	2	2	suplementa	2	16	18	24069
suplementària	0	692	suplementaria	2	17	709	24070
suplementàries	0	425	suplementaries	2	7	432	24071
suplementés	2	0	suplementes	2	3	3	24072
suplementí	2	0	suplementi	2	1	1	24073
suplicarà	2	3	suplicara	2	0	3	24074
suplicà	2	38	suplica	2	206	244	24075
suplicàreu	2	0	suplicareu	2	1	1	24076
supliqués	2	8	supliques	2	33	41	24077
supliquí	2	0	supliqui	2	12	12	24078
suplirà	2	37	suplira	2	4	41	24079
suplírem	2	0	suplirem	2	2	2	24080
suportarà	2	136	suportara	2	7	143	24081
suportà	2	50	suporta	2	3471	3521	24082
suportàrem	2	3	suportarem	2	23	26	24083
suportàreu	2	0	suportareu	2	1	1	24084
suportés	2	28	suportes	2	58	86	24085
suportí	2	0	suporti	2	249	249	24086
suposarà	2	7638	suposara	2	53	7691	24087
suposà	2	1229	suposa	2	64728	65957	24088
suposàrem	2	3	suposarem	2	93	96	24089
suposàreu	2	0	suposareu	2	28	28	24090
suposés	2	269	suposes	2	76	345	24091
suposí	2	0	suposi	2	2860	2860	24092
suprimirà	2	506	suprimira	2	11	517	24093
suprimírem	2	0	suprimirem	2	52	52	24094
suprimíreu	2	0	suprimireu	2	18	18	24095
supurarà	2	2	supurara	2	1	3	24096
supurà	2	0	supura	2	92	92	24097
supurés	2	1	supures	2	2	3	24098
supurí	2	0	supuri	2	5	5	24099
suputà	2	0	suputa	2	3	3	24100
suquegí	2	0	suquegi	2	1	1	24101
suqués	2	2	suques	2	20	22	24102
suquí	2	1	suqui	2	5	6	24103
surarà	2	26	surara	2	5	31	24104
surfegí	2	0	surfegi	2	2	2	24105
surfejarà	2	1	surfejara	2	0	1	24106
surfejà	2	1	surfeja	2	32	33	24107
surfejàrem	2	0	surfejarem	2	5	5	24108
surà	2	9	sura	4	855	864	24109
suràrem	2	0	surarem	2	1	1	24110
surés	2	21	sures	4	70	91	24111
surí	2	2	suri	2	170	172	24112
suscitarà	2	87	suscitara	2	3	90	24113
suscità	2	169	suscita	2	1622	1791	24114
suscitàrem	2	1	suscitarem	2	2	3	24115
suscitàreu	2	1	suscitareu	2	0	1	24116
suscités	2	27	suscites	2	2	29	24117
suscití	2	0	susciti	2	160	160	24118
suspendré	2	14	suspendre	2	9401	9415	24119
suspengués	2	246	suspengues	2	3	249	24120
suspenguí	2	0	suspengui	2	545	545	24121
sustentarà	2	49	sustentara	2	2	51	24122
sustentà	2	6	sustenta	2	2314	2320	24123
sustentàrem	2	0	sustentarem	2	2	2	24124
sustentés	2	19	sustentes	2	2	21	24125
sustentí	2	1	sustenti	2	141	142	24126
suturarà	2	3	suturara	2	0	3	24127
suturà	2	1	sutura	4	532	533	24128
suturàrem	2	0	suturarem	2	1	1	24129
suturés	2	0	sutures	4	225	225	24130
suturí	2	0	suturi	2	2	2	24131
suà	2	8	sua	2	1088	1096	24132
suàrem	2	1	suarem	2	28	29	24133
suàreu	2	0	suareu	2	6	6	24134
sués	2	11	sues	2	339	350	24135
suí	2	31	sui	4	801	832	24136
suïcidarà	2	14	suïcidara	2	5	19	24137
suïcidà	2	180	suïcida	0	1889	2069	24138
suïcidàrem	2	0	suïcidarem	2	2	2	24139
suïcidés	2	49	suïcides	0	1097	1146	24140
suïcidí	2	1	suïcidi	2	4722	4723	24141
sàlic	0	11	salic	4	2	13	24142
sàlica	0	105	salica	2	17	122	24143
sàlics	0	12	salics	4	3	15	24144
sàliques	0	4	saliques	2	0	4	24145
sàmara	4	31	samara	4	224	255	24146
sèiem	2	57	seiem	2	490	547	24147
sèieu	2	2	seieu	2	160	162	24148
sènons	0	32	senons	4	3	35	24149
sèrie	4	134175	serie	2	4334	138509	24150
sèries	4	19264	series	2	4268	23532	24151
sèu	4	517	seu	4	1711460	1711977	24152
sèus	4	21	seus	4	819800	819821	24153
sèver	4	30	sever	4	2361	2391	24154
sèvers	4	0	severs	4	878	878	24155
sé	2	94946	se	5	671785	766731	24156
séc	4	35	sec	4	16553	16588	24157
sécs	4	13	secs	0	8590	8603	24158
séiem	2	4	seiem	2	490	494	24159
séieu	2	0	seieu	2	160	160	24160
séver	4	1	sever	4	2361	2362	24161
sévers	4	0	severs	4	878	878	24162
sí	4	227882	si	1	1723485	1951367	24163
sílur	4	1	silur	4	103	104	24164
sílurs	4	0	silurs	4	71	71	24165
síncope	4	101	sincope	2	2	103	24166
síncopes	4	52	sincopes	2	1	53	24167
síndic	4	9013	sindic	2	130	9143	24168
síndica	4	790	sindica	2	44	834	24169
síndiques	4	58	sindiques	2	3	61	24170
sís	4	114	sis	4	104027	104141	24171
sòl	4	31806	sol	4	169390	201196	24172
sòlid	0	9511	solid	2	1137	10648	24173
sòlida	0	10807	solida	2	217	11024	24174
sòlides	0	3097	solides	2	66	3163	24175
sòls	4	6721	sols	4	148210	154931	24176
sòtil	4	61	sotil	0	70	131	24177
sòtils	4	14	sotils	0	14	28	24178
sòviet	4	9	soviet	4	751	760	24179
sòviets	4	24	soviets	4	877	901	24180
sóc	2	81522	soc	2	17567	99089	24181
són	2	1308553	son	3	115259	1423812	24182
súper	0	7727	super	2	12302	20029	24183
súpera	0	4	supera	2	14443	14447	24184
súperes	0	0	superes	2	248	248	24185
súplica	4	441	suplica	2	206	647	24186
súpliques	4	284	supliques	2	33	317	24187
tabaquejàrem	2	1	tabaquejarem	2	0	1	24188
tabularà	2	1	tabulara	2	0	1	24189
tabulà	2	1	tabula	2	324	325	24190
tabulés	2	3	tabules	2	4	7	24191
tacarà	2	29	tacara	2	5	34	24192
taconejà	2	0	taconeja	2	1	1	24193
tacà	2	7	taca	4	4303	4310	24194
tacàrem	2	0	tacarem	2	4	4	24195
tacó	4	308	taco	2	226	534	24196
tafanegés	2	3	tafaneges	2	1	4	24197
tafanegí	2	0	tafanegi	2	9	9	24198
tafanejarà	2	2	tafanejara	2	0	2	24199
tafanejà	2	0	tafaneja	2	55	55	24200
tafanejàrem	2	0	tafanejarem	2	5	5	24201
tafarrejàreu	2	0	tafarrejareu	2	1	1	24202
talarà	2	7	talara	2	7	14	24203
talaverà	0	1	talavera	4	714	715	24204
tallantés	2	0	tallantes	4	1	1	24205
tallantó	4	3	tallanto	2	0	3	24206
tallarà	2	894	tallara	2	22	916	24207
tallà	2	217	talla	4	13295	13512	24208
tallàrem	2	5	tallarem	2	795	800	24209
tallàreu	2	0	tallareu	2	40	40	24210
tallés	2	166	talles	4	2512	2678	24211
tallí	2	1	talli	2	477	478	24212
talonejà	2	0	taloneja	2	3	3	24213
talonejàrem	2	1	talonejarem	2	0	1	24214
talonà	2	0	talona	2	5	5	24215
talonés	2	0	talones	2	37	37	24216
taloní	2	0	taloni	2	1	1	24217
tal·lí	0	0	tal·li	4	78	78	24218
talà	2	11	tala	4	1811	1822	24219
talàrem	2	0	talarem	2	1	1	24220
talés	2	3	tales	4	1284	1287	24221
talí	2	5	tali	2	77	82	24222
talís	4	0	talis	2	65	65	24223
tamborinejà	2	0	tamborineja	2	5	5	24224
tamborinà	2	3	tamborina	2	1	4	24225
tamboriní	2	0	tamborini	2	14	14	24226
tamisarà	2	1	tamisara	2	0	1	24227
tamisà	2	0	tamisa	2	42	42	24228
tamisàrem	2	0	tamisarem	2	13	13	24229
tamisí	2	0	tamisi	2	1	1	24230
tamponàrem	2	0	tamponarem	2	2	2	24231
tancarà	2	6312	tancara	2	82	6394	24232
tancà	2	870	tanca	4	25922	26792	24233
tancàrem	2	24	tancarem	2	794	818	24234
tancàreu	2	0	tancareu	2	22	22	24235
tancó	4	6	tanco	2	1430	1436	24236
tangó	4	9	tango	4	2062	2071	24237
tanqués	2	540	tanques	4	6108	6648	24238
tanquí	2	6	tanqui	2	1785	1791	24239
tantalitzés	2	1	tantalitzes	2	0	1	24240
tantegés	2	0	tanteges	2	1	1	24241
tantejà	2	1	tanteja	2	7	8	24242
tanyàrem	2	0	tanyarem	2	1	1	24243
tanyés	2	0	tanyes	2	3	3	24244
tanyí	2	0	tanyi	2	1	1	24245
taparà	2	133	tapara	2	8	141	24246
tapiarà	2	5	tapiara	2	0	5	24247
tapià	2	16	tapia	2	424	440	24248
tapiàreu	2	1	tapiareu	2	0	1	24249
tapiés	2	0	tapies	2	88	88	24250
tapií	2	0	tapii	2	1	1	24251
tapió	4	2	tapio	2	17	19	24252
taponarà	2	1	taponara	2	0	1	24253
taponà	2	1	tapona	2	32	33	24254
taponés	2	0	tapones	2	14	14	24255
taponí	2	0	taponi	2	5	5	24256
tapussà	2	0	tapussa	2	2	2	24257
tapà	2	48	tapa	4	11591	11639	24258
tapàrem	2	1	taparem	2	208	209	24259
tapàreu	2	0	tapareu	2	14	14	24260
tapés	2	56	tapes	4	10620	10676	24261
tapí	2	4	tapi	2	292	296	24262
tapís	4	1551	tapis	4	274	1825	24263
taquigrafià	2	0	taquigrafia	4	111	111	24264
taqués	2	19	taques	4	6067	6086	24265
taquí	2	3	taqui	2	77	80	24266
taquín	2	0	taquin	2	53	53	24267
taral·larejarà	2	1	taral·larejara	2	0	1	24268
taral·larejà	2	2	taral·lareja	2	4	6	24269
taral·legés	2	2	taral·leges	2	3	5	24270
taral·lejà	2	2	taral·leja	2	35	37	24271
tararà	2	6	tarara	2	41	47	24272
tardarà	2	545	tardara	2	22	567	24273
tardàrem	2	7	tardarem	2	298	305	24274
tardàreu	2	1	tardareu	2	46	47	24275
tardés	2	38	tardes	4	7092	7130	24276
tardí	2	11	tardi	2	251	262	24277
tarifarà	2	2	tarifara	2	0	2	24278
tarifà	2	0	tarifa	4	7989	7989	24279
tarifària	0	520	tarifaria	2	39	559	24280
tarifàries	0	303	tarifaries	2	12	315	24281
tarifés	2	2	tarifes	4	9419	9421	24282
tarifí	2	0	tarifi	2	1	1	24283
tartamudegés	2	1	tartamudeges	2	2	3	24284
tartamudejà	2	1	tartamudeja	2	28	29	24285
tartamudejàrem	2	3	tartamudejarem	2	0	3	24286
tartarí	0	8	tartari	0	11	19	24287
tarà	2	16	tara	4	763	779	24288
tarós	0	0	taros	4	4	4	24289
tascà	2	2	tasca	4	93418	93420	24290
tascó	4	203	tasco	2	16	219	24291
tasqués	2	0	tasques	4	57623	57623	24292
tastanejà	2	0	tastaneja	2	1	1	24293
tastarà	2	70	tastara	2	2	72	24294
tastà	2	26	tasta	2	1326	1352	24295
tastàrem	2	22	tastarem	2	423	445	24296
tastàreu	2	0	tastareu	2	106	106	24297
tastés	2	40	tastes	2	180	220	24298
tastí	2	0	tasti	2	86	86	24299
tatuarà	2	4	tatuara	2	0	4	24300
tatuà	2	1	tatua	2	29	30	24301
tatuàrem	2	0	tatuarem	2	3	3	24302
tatuàreu	2	1	tatuareu	2	0	1	24303
tatués	2	4	tatues	2	1	5	24304
tatxà	2	1	tatxa	4	86	87	24305
tatxés	2	0	tatxes	4	145	145	24306
tatxí	2	3	tatxi	2	5	8	24307
tatxó	4	7	tatxo	2	94	101	24308
tatà	4	4	tata	4	704	708	24309
taulà	2	2	taula	4	112180	112182	24310
taulés	2	1	taules	4	30913	30914	24311
taurí	0	517	tauri	0	98	615	24312
tavellà	2	0	tavella	4	208	208	24313
tavellés	2	0	tavelles	4	79	79	24314
taxarà	2	3	taxara	2	0	3	24315
taxà	2	1	taxa	4	30228	30229	24316
taxàrem	2	0	taxarem	2	1	1	24317
taxés	2	4	taxes	4	15932	15936	24318
taxí	2	6	taxi	2	7010	7016	24319
taxó	4	88	taxo	2	174	262	24320
teatralitzarà	2	0	teatralitzara	2	1	1	24321
teatralitzà	2	0	teatralitza	2	26	26	24322
teatralitzàrem	2	0	teatralitzarem	2	1	1	24323
teatralitzés	2	0	teatralitzes	2	1	1	24324
tebà	0	68	teba	0	67	135	24325
teclegés	2	2	tecleges	2	26	28	24326
teclegí	2	0	teclegi	2	15	15	24327
teclejarà	2	2	teclejara	2	1	3	24328
teclejà	2	0	tecleja	2	116	116	24329
teclejàrem	2	0	teclejarem	2	2	2	24330
teclejàreu	2	0	teclejareu	2	1	1	24331
tecnificà	2	0	tecnifica	2	10	10	24332
teginí	2	0	tegini	2	1	1	24333
teixirà	2	30	teixira	2	2	32	24334
teixírem	2	3	teixirem	2	35	38	24335
teixíreu	2	2	teixireu	2	2	4	24336
telarà	2	0	telara	2	2	2	24337
telecomandà	2	0	telecomanda	4	6	6	24338
telecomandés	2	0	telecomandes	4	3	3	24339
telefonarà	2	26	telefonara	2	3	29	24340
telefonà	2	34	telefona	2	190	224	24341
telefonàrem	2	0	telefonarem	2	8	8	24342
telefonàreu	2	1	telefonareu	2	1	2	24343
telefonés	2	11	telefones	2	26	37	24344
telefoní	2	2	telefoni	2	35	37	24345
telegrafià	2	12	telegrafia	4	326	338	24346
telegrafiés	2	0	telegrafies	4	8	8	24347
telegrafií	2	1	telegrafii	2	0	1	24348
teleportà	2	1	teleporta	2	11	12	24349
teletreballés	2	0	teletreballes	2	1	1	24350
teletreballí	2	0	teletreballi	2	1	1	24351
televisarà	2	12	televisara	2	0	12	24352
televisà	2	0	televisa	2	73	73	24353
televisés	2	0	televises	2	1	1	24354
televisí	2	1	televisi	2	25	26	24355
telonejarà	2	1	telonejara	2	0	1	24356
telonejà	2	0	teloneja	2	1	1	24357
telonejàrem	2	0	telonejarem	2	1	1	24358
telà	2	1	tela	4	10499	10500	24359
telèfon	4	51047	telefon	2	655	51702	24360
telés	2	1	teles	4	5239	5240	24361
telí	2	0	teli	2	5	5	24362
teló	4	4436	telo	2	34	4470	24363
tematitzarà	2	5	tematitzara	2	0	5	24364
tematitzà	2	0	tematitza	2	14	14	24365
tematitzés	2	1	tematitzes	2	0	1	24366
tematitzí	2	0	tematitzi	2	2	2	24367
temerà	2	5	temera	2	2	7	24368
temperarà	2	2	temperara	2	0	2	24369
temperà	2	5	tempera	2	152	157	24370
temperàrem	2	2	temperarem	2	1	3	24371
temperàreu	2	0	temperareu	2	1	1	24372
temperés	2	1	temperes	2	42	43	24373
temperí	2	0	temperi	2	52	52	24374
tempestejà	2	0	tempesteja	2	1	1	24375
temporalitzà	2	0	temporalitza	2	7	7	24376
temporitzà	2	0	temporitza	2	4	4	24377
temporitzí	2	0	temporitzi	2	1	1	24378
temprà	2	1	tempra	2	8	9	24379
tempràrem	2	1	temprarem	2	0	1	24380
tempràreu	2	1	temprareu	2	0	1	24381
temprés	2	0	tempres	2	2	2	24382
temptarà	2	3	temptara	2	1	4	24383
temptegés	2	1	tempteges	2	0	1	24384
temptegí	2	0	temptegi	2	1	1	24385
temptejarà	2	1	temptejara	2	0	1	24386
temptejà	2	10	tempteja	2	35	45	24387
temptà	2	28	tempta	2	226	254	24388
temptàrem	2	0	temptarem	2	2	2	24389
temptés	2	9	temptes	2	12	21	24390
temptí	2	0	tempti	2	22	22	24391
temérem	2	3	temerem	2	3	6	24392
teméreu	2	0	temereu	2	1	1	24393
temés	2	63	temes	4	118685	118748	24394
temí	2	4	temi	2	110	114	24395
tenallà	2	1	tenalla	4	267	268	24396
tenallés	2	3	tenalles	4	308	311	24397
tenallí	2	0	tenalli	2	2	2	24398
tendirà	2	445	tendira	2	7	452	24399
tendrejarà	2	0	tendrejara	2	1	1	24400
tendrà	2	1923	tendra	0	3935	5858	24401
tendré	2	89	tendre	0	3536	3625	24402
tendírem	2	0	tendirem	2	40	40	24403
tengués	2	294	tengues	2	20	314	24404
tenguí	2	2	tengui	2	4430	4432	24405
tensarà	2	24	tensara	2	0	24	24406
tensà	2	10	tensa	0	1671	1681	24407
tensàrem	2	0	tensarem	2	1	1	24408
tensés	2	1	tenses	0	519	520	24409
tensí	2	1	tensi	2	53	54	24410
tentinegí	2	0	tentinegi	2	1	1	24411
tentinejà	2	0	tentineja	2	10	10	24412
tenyirà	2	82	tenyira	2	1	83	24413
tenyírem	2	0	tenyirem	2	16	16	24414
tenyíreu	2	0	tenyireu	2	2	2	24415
teologitzí	2	1	teologitzi	2	0	1	24416
teoritzarà	2	4	teoritzara	2	0	4	24417
teoritzà	2	50	teoritza	2	184	234	24418
teoritzàrem	2	0	teoritzarem	2	2	2	24419
teoritzés	2	3	teoritzes	2	2	5	24420
teoritzí	2	0	teoritzi	2	2	2	24421
terbolinà	2	0	terbolina	4	2	2	24422
tercés	2	1	terces	0	24	25	24423
tercí	2	0	terci	2	21	21	24424
teresà	0	2	teresa	4	25609	25611	24425
tergiversarà	2	3	tergiversara	2	0	3	24426
tergiversà	2	0	tergiversa	2	134	134	24427
tergiversés	2	1	tergiverses	2	4	5	24428
tergiversí	2	0	tergiversi	2	20	20	24429
termenejà	2	0	termeneja	2	46	46	24430
termenejàrem	2	0	termenejarem	2	1	1	24431
termenà	2	0	termena	2	11	11	24432
termenés	2	1	termenes	2	2	3	24433
termení	2	0	termeni	2	3	3	24434
terminarà	2	22	terminara	2	4	26	24435
terminà	2	18	termina	2	248	266	24436
terminàrem	2	2	terminarem	2	7	9	24437
terminés	2	5	termines	2	7	12	24438
terminí	2	0	termini	4	95581	95581	24439
termometrés	2	0	termometres	2	7	7	24440
termòmetre	4	2108	termometre	2	22	2130	24441
termòmetres	4	844	termometres	2	7	851	24442
terrabastejarà	2	0	terrabastejara	2	1	1	24443
terraplenà	2	2	terraplena	2	1	3	24444
terrassà	4	1	terrassa	4	66702	66703	24445
terrejà	2	0	terreja	2	5	5	24446
terrejàrem	2	0	terrejarem	2	1	1	24447
terrejàreu	2	1	terrejareu	2	0	1	24448
terrenyà	2	0	terrenya	2	1	1	24449
terrenyí	2	0	terrenyi	2	3	3	24450
territorialitzà	2	0	territorialitza	2	12	12	24451
territorialitzí	2	0	territorialitzi	2	2	2	24452
terrolà	4	0	terrola	4	13	13	24453
terroritzarà	2	1	terroritzara	2	0	1	24454
terroritzà	2	3	terroritza	2	89	92	24455
terroritzés	2	0	terroritzes	2	3	3	24456
terroritzí	2	0	terroritzi	2	3	3	24457
terrossós	0	1	terrossos	4	209	210	24458
terrà	2	17	terra	4	176807	176824	24459
terrè	0	48	terre	2	648	696	24460
terré	0	181	terre	2	648	829	24461
terrés	2	77	terres	4	70816	70893	24462
terrí	2	0	terri	4	938	938	24463
terçà	2	0	terça	4	86	86	24464
terçàrem	2	0	terçarem	2	1	1	24465
terçó	0	56	terço	2	6	62	24466
testamentària	0	178	testamentaria	4	20	198	24467
testamentàries	0	117	testamentaries	4	12	129	24468
testarà	2	14	testara	2	0	14	24469
testegí	2	0	testegi	2	3	3	24470
testejarà	2	8	testejara	2	0	8	24471
testejà	2	0	testeja	2	12	12	24472
testejàrem	2	0	testejarem	2	3	3	24473
testificarà	2	17	testificara	2	0	17	24474
testificà	2	24	testifica	2	263	287	24475
testificàrem	2	0	testificarem	2	1	1	24476
testifiqués	2	14	testifiques	2	3	17	24477
testifiquí	2	0	testifiqui	2	17	17	24478
testimoniarà	2	13	testimoniara	2	0	13	24479
testimoniejà	2	0	testimonieja	2	5	5	24480
testimonià	2	29	testimonia	2	606	635	24481
testimoniàrem	2	1	testimoniarem	2	1	2	24482
testimoniés	2	1	testimonies	2	16	17	24483
testimonií	2	0	testimonii	2	1	1	24484
testà	2	41	testa	0	662	703	24485
testàrem	2	0	testarem	2	2	2	24486
testés	2	2	testes	0	140	142	24487
testí	2	0	testi	2	46	46	24488
testó	4	0	testo	2	39	39	24489
tesés	2	0	teses	0	16	16	24490
tesí	2	6	tesi	2	17558	17564	24491
tetanitzà	2	0	tetanitza	2	1	1	24492
tetràedre	4	132	tetraedre	4	116	248	24493
tetràedres	4	36	tetraedres	4	42	78	24494
teulà	2	5	teula	4	1858	1863	24495
teulàreu	2	1	teulareu	2	0	1	24496
teulés	2	0	teules	4	1851	1851	24497
texturitzà	2	0	texturitza	2	5	5	24498
texturà	2	0	textura	4	11128	11128	24499
texturés	2	0	textures	4	6377	6377	24500
tibarà	2	2	tibara	2	0	2	24501
tiberí	0	2	tiberi	4	968	970	24502
tibà	2	8	tiba	2	196	204	24503
tibàrem	2	0	tibarem	2	3	3	24504
tibés	2	8	tibes	2	15	23	24505
tibí	2	0	tibi	4	493	493	24506
tigré	4	29	tigre	4	3843	3872	24507
tigrés	4	0	tigres	4	1163	1163	24508
timbalejà	2	0	timbaleja	2	1	1	24509
timbrarà	2	2	timbrara	2	0	2	24510
timbrà	2	0	timbra	2	12	12	24511
timbràreu	2	1	timbrareu	2	0	1	24512
timbrés	2	0	timbres	2	521	521	24513
timonejà	2	1	timoneja	2	1	2	24514
tindré	2	3268	tindre	2	28497	31765	24515
tingués	2	12613	tingues	2	3181	15794	24516
tinguí	2	42	tingui	2	61152	61194	24517
tintarà	2	1	tintara	2	1	2	24518
tintà	2	0	tinta	4	8905	8905	24519
tintàrem	2	1	tintarem	2	1	2	24520
tintàreu	2	0	tintareu	2	1	1	24521
tintés	2	1	tintes	4	2345	2346	24522
tintí	2	0	tinti	2	12	12	24523
tinyà	2	0	tinya	2	98	98	24524
tinyés	2	0	tinyes	2	10	10	24525
tinyí	2	0	tinyi	2	1	1	24526
tipificarà	2	6	tipificara	2	0	6	24527
tipificà	2	3	tipifica	2	220	223	24528
tipifiqués	2	3	tipifiques	2	0	3	24529
tipifiquí	2	0	tipifiqui	2	19	19	24530
tiranitzarà	2	1	tiranitzara	2	0	1	24531
tiranitzà	2	0	tiranitza	2	23	23	24532
tiranitzí	2	0	tiranitzi	2	2	2	24533
tirarà	2	738	tirara	2	49	787	24534
tirassés	2	0	tirasses	2	1	1	24535
tirotegés	2	1	tiroteges	2	0	1	24536
tirotegí	2	0	tirotegi	2	1	1	24537
tirotejà	2	0	tiroteja	2	5	5	24538
tirotejàrem	2	0	tirotejarem	2	2	2	24539
tirà	2	1185	tira	4	8231	9416	24540
tiràrem	2	24	tirarem	2	804	828	24541
tiràreu	2	0	tirareu	2	26	26	24542
tirés	2	466	tires	4	4664	5130	24543
tirí	2	0	tiri	2	1747	1747	24544
tiró	4	71	tiro	2	1217	1288	24545
titarà	2	1	titara	2	0	1	24546
titil·là	2	0	titil·la	2	9	9	24547
titllarà	2	17	titllara	2	2	19	24548
titllà	2	57	titlla	4	964	1021	24549
titllàrem	2	0	titllarem	2	3	3	24550
titllàreu	2	0	titllareu	2	6	6	24551
titllés	2	37	titlles	4	33	70	24552
titllí	2	0	titlli	2	92	92	24553
titlà	2	0	titla	4	18	18	24554
titlés	2	0	titles	4	72	72	24555
titlí	2	0	titli	2	1	1	24556
titubarà	2	0	titubara	2	1	1	24557
titubegés	2	0	titubeges	2	1	1	24558
titubegí	2	0	titubegi	2	2	2	24559
titubejà	2	1	titubeja	2	38	39	24560
titubà	2	0	tituba	2	19	19	24561
titubàreu	2	1	titubareu	2	0	1	24562
titularà	2	208	titulara	2	5	213	24563
titulitzà	2	0	titulitza	2	1	1	24564
titulà	2	171	titula	2	3676	3847	24565
titulàrem	2	7	titularem	2	8	15	24566
titulés	2	34	titules	2	6	40	24567
titulí	2	0	tituli	2	45	45	24568
tità	2	699	tita	4	322	1021	24569
tités	2	0	tites	4	72	72	24570
tití	2	108	titi	2	142	250	24571
titís	4	41	titis	2	17	58	24572
tivissà	0	10	tivissa	4	1603	1613	24573
tocarà	2	3535	tocara	2	115	3650	24574
tocà	2	720	toca	4	38830	39550	24575
tocàrem	2	31	tocarem	2	404	435	24576
tocàreu	2	0	tocareu	2	27	27	24577
todolellà	0	0	todolella	4	154	154	24578
toflà	2	0	tofla	2	10	10	24579
togà	0	1	toga	4	425	426	24580
toixà	0	0	toixa	4	37	37	24581
toldré	2	1	toldre	2	6	7	24582
tolerarà	2	207	tolerara	2	1	208	24583
tolerà	2	21	tolera	2	1156	1177	24584
toleràrem	2	0	tolerarem	2	175	175	24585
toleràreu	2	0	tolerareu	2	3	3	24586
tolerés	2	19	toleres	2	19	38	24587
tolerí	2	0	toleri	2	139	139	24588
tolguí	2	0	tolgui	2	1	1	24589
tolús	4	1	tolus	4	0	1	24590
tomarà	2	3	tomara	2	19	22	24591
tomballejà	2	0	tomballeja	2	2	2	24592
tombarà	2	64	tombara	2	8	72	24593
tombassejàrem	2	0	tombassejarem	2	1	1	24594
tombà	2	67	tomba	4	8647	8714	24595
tombàrem	2	3	tombarem	2	97	100	24596
tombàreu	2	0	tombareu	2	12	12	24597
tombés	2	63	tombes	4	4542	4605	24598
tombí	2	1	tombi	2	99	100	24599
tomà	2	23	toma	2	700	723	24600
tomés	2	2	tomes	4	174	176	24601
tomí	2	1	tomi	2	125	126	24602
tondosà	2	0	tondosa	4	1	1	24603
tondré	2	0	tondre	2	31	31	24604
tondòs	2	0	tondos	4	15	15	24605
tongués	2	1	tongues	2	32	33	24606
tonguí	2	0	tongui	2	2	2	24607
tonificarà	2	5	tonificara	2	0	5	24608
tonificà	2	0	tonifica	2	285	285	24609
tonificàrem	2	0	tonificarem	2	3	3	24610
tonificàreu	2	0	tonificareu	2	1	1	24611
tonifiqués	2	0	tonifiques	2	6	6	24612
tonifiquí	2	0	tonifiqui	2	3	3	24613
tonsurà	2	1	tonsura	4	65	66	24614
tonyarà	2	0	tonyara	2	1	1	24615
tonyés	2	0	tonyes	4	11	11	24616
tonyí	2	1	tonyi	2	71	72	24617
toparà	2	172	topara	2	0	172	24618
topà	2	220	topa	2	1288	1508	24619
topàrem	2	16	toparem	2	131	147	24620
topàreu	2	1	topareu	2	33	34	24621
topés	2	52	topes	2	241	293	24622
topí	2	11	topi	2	115	126	24623
toquejà	2	0	toqueja	2	2	2	24624
toquerejàrem	2	0	toquerejarem	2	1	1	24625
toqués	2	814	toques	4	800	1614	24626
toquí	2	4	toqui	2	2817	2821	24627
torbarà	2	23	torbara	2	0	23	24628
torbà	2	19	torba	4	614	633	24629
torbàrem	2	0	torbarem	2	23	23	24630
torbàreu	2	1	torbareu	2	56	57	24631
torbés	2	5	torbes	4	52	57	24632
torbí	2	0	torbi	2	14	14	24633
torcarà	2	1	torcara	2	0	1	24634
torcejà	2	0	torceja	2	1	1	24635
torcerà	2	2	torcera	2	1	3	24636
torcà	2	0	torca	2	79	79	24637
torcé	2	1	torce	2	2	3	24638
torcérem	2	1	torcerem	2	5	6	24639
torcés	2	4	torces	2	6	10	24640
torcí	2	0	torci	2	31	31	24641
toregés	2	2	toreges	2	0	2	24642
toregí	2	0	toregi	2	2	2	24643
torejarà	2	12	torejara	2	0	12	24644
torejà	2	1	toreja	2	24	25	24645
torejàreu	2	1	torejareu	2	0	1	24646
tornarà	2	19436	tornara	2	402	19838	24647
tornegés	2	0	torneges	2	1	1	24648
tornegí	2	0	tornegi	2	3	3	24649
tornejarà	2	1	tornejara	2	0	1	24650
tornejà	2	1	torneja	2	11	12	24651
tornejàrem	2	0	tornejarem	2	2	2	24652
torniolà	2	0	torniola	2	15	15	24653
tornà	2	7048	torna	4	68037	75085	24654
tornàrem	2	278	tornarem	2	9755	10033	24655
tornàreu	2	2	tornareu	2	482	484	24656
tornària	0	0	tornaria	2	4677	4677	24657
tornàries	0	0	tornaries	2	107	107	24658
tornàveu	2	5	tornaveu	4	155	160	24659
tornès	0	54	tornes	4	2695	2749	24660
tornés	2	3315	tornes	4	2695	6010	24661
torní	2	25	torni	2	13658	13683	24662
torpedejà	2	1	torpedeja	2	1	2	24663
torpedinarà	2	2	torpedinara	2	0	2	24664
torpedinà	2	1	torpedina	2	37	38	24665
torpedinàrem	2	0	torpedinarem	2	1	1	24666
torpedinés	2	1	torpedines	2	0	1	24667
torpediní	2	0	torpedini	2	4	4	24668
torqués	2	0	torques	4	24	24	24669
torrarà	2	8	torrara	2	1	9	24670
torrejà	2	0	torreja	2	5	5	24671
torrejàreu	2	0	torrejareu	2	1	1	24672
torretà	0	2	torreta	4	1987	1989	24673
torroellès	0	0	torroelles	4	12	12	24674
torroellés	0	0	torroelles	4	12	12	24675
torrojà	0	0	torroja	4	1027	1027	24676
torrà	2	91	torra	4	14423	14514	24677
torràrem	2	1	torrarem	2	51	52	24678
torràreu	2	0	torrareu	2	1	1	24679
torrés	2	4	torres	4	33974	33978	24680
torrí	2	0	torri	2	148	148	24681
torturarà	2	12	torturara	2	0	12	24682
torturà	2	14	tortura	4	5815	5829	24683
torturàrem	2	0	torturarem	2	3	3	24684
torturàreu	2	0	torturareu	2	1	1	24685
torturés	2	14	tortures	4	2663	2677	24686
torturí	2	0	torturi	2	33	33	24687
torçarà	2	6	torçara	2	0	6	24688
torçà	2	7	torça	2	218	225	24689
torçàrem	2	0	torçarem	2	3	3	24690
torçó	4	3	torço	2	14	17	24691
toró	4	7	toro	4	4869	4876	24692
toscà	2	370	tosca	0	2179	2549	24693
toscós	0	0	toscos	0	44	44	24694
tosquejà	2	0	tosqueja	2	1	1	24695
tosqués	2	0	tosques	0	230	230	24696
tossirà	2	4	tossira	2	0	4	24697
tossà	2	2	tossa	4	6268	6270	24698
tossés	2	0	tosses	4	124	124	24699
tossí	2	3	tossi	2	4	7	24700
tossíreu	2	0	tossireu	2	2	2	24701
tossís	2	1	tossis	2	0	1	24702
tosà	0	0	tosa	4	564	564	24703
totalitzarà	2	5	totalitzara	2	0	5	24704
totalitzà	2	5	totalitza	2	77	82	24705
totalitzí	2	0	totalitzi	2	2	2	24706
tovà	2	6	tova	0	2883	2889	24707
tovàreu	2	0	tovareu	2	1	1	24708
tovés	2	0	toves	0	1449	1449	24709
toví	2	0	tovi	2	8	8	24710
trabocà	2	0	traboca	2	2	2	24711
trabucarà	2	1	trabucara	2	0	1	24712
trabucà	2	5	trabuca	2	16	21	24713
trabuqués	2	0	trabuques	2	1	1	24714
trabuquí	2	0	trabuqui	2	2	2	24715
tracalejàrem	2	1	tracalejarem	2	0	1	24716
tracalejàreu	2	0	tracalejareu	2	1	1	24717
tractarà	2	5877	tractara	2	459	6336	24718
tractejarà	2	1	tractejara	2	0	1	24719
tractà	2	777	tracta	2	223051	223828	24720
tractàrem	2	56	tractarem	2	2416	2472	24721
tractàreu	2	2	tractareu	2	14	16	24722
tractés	2	5305	tractes	2	2428	7733	24723
tractí	2	15	tracti	2	7556	7571	24724
tracés	2	37	traces	4	3052	3089	24725
trací	2	0	traci	0	224	224	24726
traduírem	2	4	traduirem	2	47	51	24727
traduíreu	2	1	traduireu	2	4	5	24728
trafeguejà	2	0	trafegueja	2	2	2	24729
trafegués	2	0	trafegues	2	1	1	24730
trafegà	2	0	trafega	2	6	6	24731
traficarà	2	1	traficara	2	0	1	24732
traficà	2	4	trafica	4	154	158	24733
traficàrem	2	0	traficarem	2	2	2	24734
trafiquejà	2	0	trafiqueja	2	7	7	24735
trafiqués	2	4	trafiques	4	6	10	24736
trafiquí	2	0	trafiqui	2	15	15	24737
tragarà	2	2	tragara	2	2	4	24738
tragellàreu	2	1	tragellareu	2	0	1	24739
tragellés	2	0	tragelles	4	2	2	24740
traginarà	2	1	traginara	2	0	1	24741
traginà	2	2	tragina	4	104	106	24742
traginàrem	2	0	traginarem	2	1	1	24743
traginés	2	4	tragines	4	13	17	24744
traginí	2	0	tragini	2	3	3	24745
tragirarà	2	1	tragirara	2	0	1	24746
tragirà	2	0	tragira	2	2	2	24747
traguejarà	2	1	traguejara	2	0	1	24748
tragué	2	430	trague	2	19	449	24749
tragués	2	359	tragues	2	45	404	24750
traguí	2	4	tragui	2	7	11	24751
tragà	2	1	traga	2	171	172	24752
tragàrem	2	0	tragarem	2	4	4	24753
tragí	4	131	tragi	4	5	136	24754
trairà	2	73	traira	2	1	74	24755
trairé	2	16	traire	2	2	18	24756
trametré	2	1	trametre	2	1689	1690	24757
trametés	2	15	trametes	2	10	25	24758
trametí	2	0	trameti	2	149	149	24759
tramitarà	2	658	tramitara	2	6	664	24760
tramità	2	24	tramita	2	1219	1243	24761
tramitàrem	2	1	tramitarem	2	100	101	24762
tramitàreu	2	1	tramitareu	2	6	7	24763
tramités	2	45	tramites	2	16	61	24764
tramití	2	0	tramiti	2	373	373	24765
trampegí	2	0	trampegi	2	1	1	24766
trampejarà	2	1	trampejara	2	0	1	24767
trampejà	2	1	trampeja	2	20	21	24768
trampejàrem	2	0	trampejarem	2	2	2	24769
tramuntà	2	5	tramunta	2	17	22	24770
tramuntàrem	2	4	tramuntarem	2	0	4	24771
tramuntí	2	0	tramunti	2	3	3	24772
tramà	2	6	trama	4	17041	17047	24773
tramès	2	642	trames	4	2498	3140	24774
tramés	2	143	trames	4	2498	2641	24775
tramí	2	0	trami	2	6	6	24776
tranquil·litzarà	2	26	tranquil·litzara	2	0	26	24777
tranquil·litzà	2	22	tranquil·litza	2	543	565	24778
tranquil·litzàrem	2	0	tranquil·litzarem	2	5	5	24779
tranquil·litzàreu	2	0	tranquil·litzareu	2	1	1	24780
tranquil·litzés	2	24	tranquil·litzes	2	5	29	24781
tranquil·litzí	2	0	tranquil·litzi	2	96	96	24782
transaccionà	2	0	transacciona	2	5	5	24783
transaccionés	2	0	transacciones	2	11	11	24784
transaccioní	2	0	transaccioni	2	1	1	24785
transbordarà	2	1	transbordara	2	0	1	24786
transbordàrem	2	0	transbordarem	2	2	2	24787
transcendirà	2	34	transcendira	2	9	43	24788
transcendírem	2	0	transcendirem	2	4	4	24789
transcodificà	2	0	transcodifica	2	21	21	24790
transcrigués	2	1	transcrigues	2	1	2	24791
transcriguí	2	0	transcrigui	2	33	33	24792
transcriuré	2	54	transcriure	2	1067	1121	24793
transferirà	2	216	transferira	2	2	218	24794
transferírem	2	0	transferirem	2	20	20	24795
transferíreu	2	0	transferireu	2	4	4	24796
transfigurarà	2	4	transfigurara	2	0	4	24797
transfigurà	2	33	transfigura	2	77	110	24798
transfigurés	2	2	transfigures	2	1	3	24799
transfigurí	2	0	transfiguri	2	5	5	24800
transfondré	2	0	transfondre	2	41	41	24801
transformarà	2	1215	transformara	2	12	1227	24802
transformà	2	762	transforma	2	8776	9538	24803
transformàrem	2	4	transformarem	2	137	141	24804
transformàreu	2	0	transformareu	2	8	8	24805
transformés	2	171	transformes	2	56	227	24806
transformí	2	1	transformi	2	769	770	24807
transgredirà	2	3	transgredira	2	0	3	24808
transgredírem	2	0	transgredirem	2	1	1	24809
transhumà	2	5	transhuma	2	3	8	24810
transigirà	2	4	transigira	2	0	4	24811
transigírem	2	0	transigirem	2	4	4	24812
transitarà	2	64	transitara	2	4	68	24813
transità	2	15	transita	2	1292	1307	24814
transitàrem	2	2	transitarem	2	62	64	24815
transitàreu	2	0	transitareu	2	1	1	24816
transitària	0	6	transitaria	2	13	19	24817
transitàries	0	10	transitaries	2	0	10	24818
transités	2	9	transites	2	14	23	24819
transití	2	0	transiti	2	102	102	24820
transliterà	2	0	translitera	2	12	12	24821
transliterés	2	1	transliteres	2	0	1	24822
transmetré	2	328	transmetre	2	27518	27846	24823
transmetés	2	203	transmetes	2	2	205	24824
transmetí	2	5	transmeti	2	1186	1191	24825
transmigrà	2	0	transmigra	2	6	6	24826
transmigràrem	2	1	transmigrarem	2	0	1	24827
transmigrés	2	1	transmigres	2	0	1	24828
transmutarà	2	6	transmutara	2	0	6	24829
transmutà	2	6	transmuta	2	120	126	24830
transmutés	2	1	transmutes	2	1	2	24831
transmutí	2	0	transmuti	2	14	14	24832
transparentarà	2	2	transparentara	2	0	2	24833
transparentà	2	0	transparenta	2	84	84	24834
transparentàrem	2	0	transparentarem	2	1	1	24835
transparentés	2	2	transparentes	2	24	26	24836
transparentí	2	0	transparenti	2	34	34	24837
transpirarà	2	1	transpirara	2	0	1	24838
transpirà	2	0	transpira	2	186	186	24839
transpirés	2	4	transpires	2	4	8	24840
transpirí	2	0	transpiri	2	23	23	24841
transportarà	2	609	transportara	2	10	619	24842
transportà	2	68	transporta	2	3868	3936	24843
transportàrem	2	2	transportarem	2	44	46	24844
transportàreu	2	1	transportareu	2	3	4	24845
transportés	2	57	transportes	2	292	349	24846
transportí	2	77	transporti	2	213	290	24847
transposarà	2	15	transposara	2	0	15	24848
transposà	2	3	transposa	2	211	214	24849
transposàrem	2	0	transposarem	2	1	1	24850
transposés	2	2	transposes	2	2	4	24851
transposí	2	0	transposi	2	57	57	24852
transposó	4	23	transposo	2	1	24	24853
transsubstancià	2	0	transsubstancia	2	1	1	24854
transsudàreu	2	0	transsudareu	2	1	1	24855
transvasarà	2	3	transvasara	2	0	3	24856
transvasà	2	3	transvasa	2	26	29	24857
transvasés	2	1	transvases	2	1	2	24858
transvasí	2	0	transvasi	2	6	6	24859
transvestirà	2	1	transvestira	2	0	1	24860
tranuità	2	0	tranuita	2	7	7	24861
tranuités	2	0	tranuites	2	14	14	24862
trapezòedre	4	1	trapezoedre	4	3	4	24863
trapezòedres	4	3	trapezoedres	4	1	4	24864
trasbalsarà	2	45	trasbalsara	2	0	45	24865
trasbalsà	2	35	trasbalsa	2	336	371	24866
trasbalsés	2	12	trasbalses	2	1	13	24867
trasbalsí	2	0	trasbalsi	2	12	12	24868
trascamà	2	2	trascama	2	1	3	24869
trascamàreu	2	1	trascamareu	2	0	1	24870
trascolà	2	0	trascola	2	5	5	24871
traslladarà	2	2397	traslladara	2	29	2426	24872
traslladà	2	3004	trasllada	2	7341	10345	24873
traslladàrem	2	32	traslladarem	2	700	732	24874
traslladàreu	2	0	traslladareu	2	11	11	24875
traslladés	2	357	trasllades	2	111	468	24876
traslladí	2	1	traslladi	2	726	727	24877
trasmudarà	2	1	trasmudara	2	0	1	24878
trasmudà	2	6	trasmuda	2	13	19	24879
traspaperà	2	0	traspapera	2	1	1	24880
traspassarà	2	147	traspassara	2	4	151	24881
traspassà	2	192	traspassa	2	1394	1586	24882
traspassàrem	2	2	traspassarem	2	26	28	24883
traspassàreu	2	0	traspassareu	2	1	1	24884
traspassés	2	77	traspasses	2	37	114	24885
traspassí	2	1	traspassi	2	229	230	24886
trasplantarà	2	5	trasplantara	2	0	5	24887
trasplantà	2	2	trasplanta	2	42	44	24888
trasplantàrem	2	1	trasplantarem	2	17	18	24889
trasplantés	2	2	trasplantes	2	15	17	24890
trasplantí	2	0	trasplanti	2	5	5	24891
traspondré	2	0	traspondre	2	1	1	24892
traspostà	2	0	trasposta	2	6	6	24893
traspuarà	2	4	traspuara	2	0	4	24894
traspuntà	2	0	traspunta	2	2	2	24895
traspuà	2	3	traspua	2	1030	1033	24896
traspués	2	11	traspues	2	3	14	24897
trasquiló	4	1	trasquilo	2	0	1	24898
trastegés	2	0	trasteges	2	1	1	24899
trastegí	2	0	trastegi	2	1	1	24900
trastejarà	2	1	trastejara	2	0	1	24901
trastejà	2	0	trasteja	2	10	10	24902
trastejàrem	2	0	trastejarem	2	2	2	24903
trastejàreu	2	1	trastejareu	2	0	1	24904
trastocarà	2	35	trastocara	2	0	35	24905
trastocà	2	10	trastoca	2	186	196	24906
trastocàrem	2	0	trastocarem	2	1	1	24907
trastoqués	2	2	trastoques	2	1	3	24908
trastoquí	2	0	trastoqui	2	9	9	24909
trastornarà	2	5	trastornara	2	0	5	24910
trastornà	2	7	trastorna	2	52	59	24911
trastornés	2	0	trastornes	2	1	1	24912
trastorní	2	0	trastorni	2	4	4	24913
traucà	2	0	trauca	2	1	1	24914
traumatitzarà	2	3	traumatitzara	2	0	3	24915
traumatitzà	2	3	traumatitza	2	24	27	24916
traumatitzàreu	2	0	traumatitzareu	2	2	2	24917
traumatitzí	2	0	traumatitzi	2	7	7	24918
trauré	2	316	traure	2	4393	4709	24919
travarà	2	2	travara	2	1	3	24920
travelà	2	3	travela	2	6	9	24921
travessarà	2	333	travessara	2	18	351	24922
travessà	2	315	travessa	4	14510	14825	24923
travessàrem	2	46	travessarem	2	788	834	24924
travessàreu	2	0	travessareu	2	122	122	24925
travessés	2	97	travesses	2	1641	1738	24926
travessí	2	4	travessi	2	265	269	24927
travessós	0	6	travessos	4	13	19	24928
travestí	0	18	travesti	0	72	90	24929
travestís	0	6	travestis	0	98	104	24930
travà	2	25	trava	4	471	496	24931
travàrem	2	0	travarem	2	2	2	24932
travàreu	2	0	travareu	2	3	3	24933
travès	2	913	traves	4	5568	6481	24934
través	2	353881	traves	4	5568	359449	24935
travéssem	2	0	travessem	2	2996	2996	24936
travésseu	2	0	travesseu	2	226	226	24937
traví	2	1	travi	2	96	97	24938
travó	4	1	travo	2	0	1	24939
traçarà	2	73	traçara	2	1	74	24940
traçà	2	57	traça	4	4973	5030	24941
traçàrem	2	3	traçarem	2	34	37	24942
traçós	0	2	traços	4	1706	1708	24943
traíem	2	6	traiem	2	3317	3323	24944
traíeu	2	2	traieu	2	958	960	24945
traírem	2	0	trairem	2	15	15	24946
traíreu	2	0	traireu	2	7	7	24947
treballarà	2	5123	treballara	2	61	5184	24948
treballuscà	2	1	treballusca	2	0	1	24949
treballà	2	4256	treballa	2	55984	60240	24950
treballàrem	2	58	treballarem	2	5078	5136	24951
treballàreu	2	2	treballareu	2	83	85	24952
treballés	2	538	treballes	2	1829	2367	24953
treballí	2	6	treballi	2	3160	3166	24954
tremolarà	2	56	tremolara	2	6	62	24955
tremolà	2	19	tremola	2	703	722	24956
tremolàrem	2	1	tremolarem	2	2	3	24957
tremolàreu	2	0	tremolareu	2	1	1	24958
tremolés	2	26	tremoles	2	27	53	24959
tremolí	2	25	tremoli	2	138	163	24960
tremoló	4	4	tremolo	2	170	174	24961
tremparà	2	1	trempara	2	0	1	24962
trempà	2	1	trempa	4	42	43	24963
trempàrem	2	0	tremparem	2	8	8	24964
trempàreu	2	0	trempareu	2	1	1	24965
trempés	2	3	trempes	4	5	8	24966
trempí	2	0	trempi	2	3	3	24967
trempó	4	121	trempo	2	7	128	24968
tremà	2	0	trema	4	22	22	24969
tremàrem	2	1	tremarem	2	0	1	24970
tremé	2	24	treme	2	90	114	24971
tremés	2	0	tremes	4	9	9	24972
tremí	2	0	tremi	2	1	1	24973
tremís	2	6	tremis	2	0	6	24974
trenarà	2	2	trenara	2	0	2	24975
trencarà	2	668	trencara	2	46	714	24976
trencà	2	653	trenca	4	8989	9642	24977
trencàrem	2	8	trencarem	2	250	258	24978
trencàreu	2	2	trencareu	2	9	11	24979
trenqués	2	463	trenques	4	227	690	24980
trenquí	2	0	trenqui	2	1500	1500	24981
trenta-quatrè	0	24	trenta-quatre	3	521	545	24982
trenta-quatré	0	0	trenta-quatre	3	521	521	24983
trentejà	2	0	trenteja	2	1	1	24984
trenà	2	0	trena	4	671	671	24985
trenàrem	2	0	trenarem	2	1	1	24986
trenés	2	1	trenes	4	693	694	24987
trení	2	0	treni	2	15	15	24988
trepanarà	2	2	trepanara	2	0	2	24989
trepanà	2	0	trepana	2	6	6	24990
trepanàreu	2	0	trepanareu	2	1	1	24991
trepaní	2	0	trepani	2	4	4	24992
trepidà	2	0	trepida	2	3	3	24993
trepidés	2	0	trepides	2	1	1	24994
trepitgés	2	63	trepitges	2	154	217	24995
trepitgí	2	0	trepitgi	2	155	155	24996
trepitjarà	2	115	trepitjara	2	6	121	24997
trepitjà	2	32	trepitja	2	1151	1183	24998
trepitjàrem	2	9	trepitjarem	2	97	106	24999
trepitjàreu	2	0	trepitjareu	2	10	10	25000
trepà	2	6	trepa	4	371	377	25001
trepés	2	0	trepes	4	93	93	25002
trepí	2	0	trepi	2	4	4	25003
trepó	4	11	trepo	2	2	13	25004
trescanà	2	0	trescana	2	1	1	25005
trescarà	2	1	trescara	2	0	1	25006
trescà	2	2	tresca	4	380	382	25007
trescàrem	2	4	trescarem	2	4	8	25008
tresorejà	2	0	tresoreja	2	8	8	25009
trespolàreu	2	1	trespolareu	2	0	1	25010
tresqués	2	0	tresques	4	16	16	25011
tresquí	2	1	tresqui	2	3	4	25012
tresà	2	4	tresa	2	83	87	25013
tresè	0	3	trese	2	2	5	25014
tresé	0	0	trese	2	2	2	25015
tresí	2	0	tresi	2	2	2	25016
tretzè	0	673	tretze	3	10232	10905	25017
tretzé	0	21	tretze	3	10232	10253	25018
triangularà	2	0	triangulara	2	2	2	25019
triangulà	2	0	triangula	2	19	19	25020
triangulés	2	0	triangules	2	1	1	25021
triangulí	2	0	trianguli	2	28	28	25022
triarà	2	926	triara	2	39	965	25023
tribanà	2	0	tribana	4	10	10	25024
tribanés	2	0	tribanes	4	3	3	25025
tribulà	2	0	tribula	2	2	2	25026
tributarà	2	73	tributara	2	2	75	25027
tributà	2	18	tributa	2	208	226	25028
tributàrem	2	0	tributarem	2	4	4	25029
tributària	0	8001	tributaria	2	444	8445	25030
tributàries	0	1761	tributaries	2	69	1830	25031
tributés	2	4	tributes	2	11	15	25032
tributí	2	0	tributi	2	41	41	25033
tribú	4	327	tribu	4	9604	9931	25034
tricotà	2	0	tricota	2	1	1	25035
trifurcà	2	0	trifurca	2	19	19	25036
trifurqués	2	0	trifurques	2	18	18	25037
trigarà	2	1364	trigara	2	8	1372	25038
trigués	2	78	trigues	4	192	270	25039
triguí	2	0	trigui	2	417	417	25040
trigà	2	252	triga	4	3842	4094	25041
trigàrem	2	8	trigarem	2	562	570	25042
trigàreu	2	0	trigareu	2	99	99	25043
trillarà	2	1	trillara	2	0	1	25044
trillés	2	0	trilles	4	193	193	25045
trillí	2	0	trilli	2	1	1	25046
trincarà	2	1	trincara	2	0	1	25047
trincà	2	0	trinca	4	1108	1108	25048
trincó	4	0	trinco	2	40	40	25049
trinqués	2	0	trinques	4	2	2	25050
trinquí	2	0	trinqui	2	2	2	25051
trinxarà	2	12	trinxara	2	1	13	25052
trinxà	2	4	trinxa	4	154	158	25053
trinxàrem	2	0	trinxarem	2	19	19	25054
trinxàreu	2	0	trinxareu	2	1	1	25055
trinxés	2	3	trinxes	4	31	34	25056
trinxí	2	0	trinxi	2	11	11	25057
trinà	2	0	trina	0	169	169	25058
trinés	2	0	trines	0	2	2	25059
triní	2	0	trini	2	998	998	25060
triomfarà	2	206	triomfara	2	6	212	25061
triomfà	2	144	triomfa	2	1405	1549	25062
triomfàrem	2	0	triomfarem	2	25	25	25063
triomfàreu	2	0	triomfareu	2	66	66	25064
triomfés	2	84	triomfes	2	47	131	25065
triomfí	2	0	triomfi	2	255	255	25066
triplicarà	2	96	triplicara	2	2	98	25067
triplicà	2	31	triplica	2	546	577	25068
triplicàrem	2	0	triplicarem	2	4	4	25069
triplicàreu	2	1	triplicareu	2	0	1	25070
tripliqués	2	6	tripliques	2	1	7	25071
tripliquí	2	0	tripliqui	2	53	53	25072
triplà	4	17	tripla	0	6	23	25073
tripulà	2	1	tripula	2	34	35	25074
tripulí	2	0	tripuli	2	1	1	25075
triscà	2	0	trisca	2	18	18	25076
trisecà	2	0	triseca	2	1	1	25077
trisquí	2	0	trisqui	2	1	1	25078
tritllejà	2	0	tritlleja	2	3	3	25079
tritllà	2	0	tritlla	2	1	1	25080
triturarà	2	8	triturara	2	0	8	25081
triturà	2	2	tritura	2	407	409	25082
trituràrem	2	0	triturarem	2	133	133	25083
trituràreu	2	0	triturareu	2	5	5	25084
triturés	2	10	tritures	2	19	29	25085
triturí	2	1	trituri	2	13	14	25086
trivialitzarà	2	1	trivialitzara	2	0	1	25087
trivialitzà	2	1	trivialitza	2	19	20	25088
trivialitzés	2	1	trivialitzes	2	0	1	25089
trivialitzí	2	0	trivialitzi	2	7	7	25090
trià	2	202	tria	4	19007	19209	25091
triàrem	2	17	triarem	2	384	401	25092
triàreu	2	3	triareu	2	39	42	25093
triés	2	229	tries	4	1767	1996	25094
trií	2	12	trii	2	121	133	25095
trobarà	2	10292	trobara	2	163	10455	25096
trobà	2	3046	troba	4	160053	163099	25097
trobàrem	2	503	trobarem	2	19658	20161	25098
trobàreu	2	19	trobareu	2	51445	51464	25099
trobés	2	1698	trobes	4	10369	12067	25100
trobí	2	70	trobi	2	9526	9596	25101
troià	0	364	troia	4	2095	2459	25102
trolegés	2	1	troleges	2	0	1	25103
trolejà	2	0	troleja	2	4	4	25104
trompejarà	2	0	trompejara	2	2	2	25105
trompetejà	2	0	trompeteja	2	2	2	25106
trompà	2	1	trompa	0	1427	1428	25107
trompés	2	2	trompes	0	712	714	25108
trompí	2	0	trompi	2	3	3	25109
tronarà	2	14	tronara	2	1	15	25110
troncà	2	0	tronca	4	47	47	25111
tronqués	2	0	tronques	4	5	5	25112
tronquí	2	0	tronqui	2	3	3	25113
trontollarà	2	27	trontollara	2	0	27	25114
trontollejà	2	0	trontolleja	2	1	1	25115
trontollà	2	14	trontolla	2	543	557	25116
trontollàreu	2	0	trontollareu	2	1	1	25117
trontollés	2	22	trontolles	2	6	28	25118
trontollí	2	0	trontolli	2	80	80	25119
tronà	2	13	trona	4	1085	1098	25120
tronàrem	2	0	tronarem	2	14	14	25121
tronàreu	2	0	tronareu	2	4	4	25122
tronés	2	1	trones	4	277	278	25123
troní	2	0	troni	2	20	20	25124
tropà	4	1	tropa	4	2215	2216	25125
trossegés	2	1	trosseges	2	3	4	25126
trossegí	2	0	trossegi	2	6	6	25127
trossejarà	2	5	trossejara	2	0	5	25128
trossejà	2	1	trosseja	2	121	122	25129
trossejàrem	2	3	trossejarem	2	18	21	25130
trossà	2	0	trossa	4	31	31	25131
trossés	2	1	trosses	4	13	14	25132
trossí	2	0	trossi	2	1	1	25133
trotà	2	1	trota	2	94	95	25134
trotàrem	2	0	trotarem	2	3	3	25135
trotés	2	0	trotes	2	21	21	25136
trotí	2	0	troti	2	1	1	25137
trotó	4	2	troto	2	12	14	25138
trucarà	2	213	trucara	2	4	217	25139
trucà	2	109	truca	4	3877	3986	25140
trucàrem	2	3	trucarem	2	177	180	25141
trucàreu	2	0	trucareu	2	5	5	25142
trufegés	2	0	trufeges	2	1	1	25143
trufà	2	1	trufa	4	928	929	25144
trufés	2	0	trufes	4	449	449	25145
trufí	2	0	trufi	2	5	5	25146
trullà	2	11	trulla	4	8	19	25147
trullés	2	1	trulles	2	2	3	25148
trullí	2	0	trulli	2	62	62	25149
trumfarà	2	3	trumfara	2	0	3	25150
trumfà	2	0	trumfa	4	139	139	25151
trumfés	2	0	trumfes	4	113	113	25152
truncarà	2	9	truncara	2	2	11	25153
truncà	2	42	trunca	2	79	121	25154
truncàrem	2	0	truncarem	2	1	1	25155
trunqués	2	4	trunques	2	0	4	25156
trunquí	2	0	trunqui	2	3	3	25157
truqués	2	165	truques	4	283	448	25158
truquí	2	1	truqui	2	859	860	25159
tràfic	4	17071	trafic	2	147	17218	25160
tràmit	4	14930	tramit	2	91	15021	25161
trànsit	4	47986	transit	2	1461	49447	25162
trànsits	4	498	transits	2	19	517	25163
trèmol	0	80	tremol	2	16	96	25164
trèmolo	4	92	tremolo	2	170	262	25165
trémolo	4	37	tremolo	2	170	207	25166
tríada	4	534	triada	4	3479	4013	25167
tríades	4	115	triades	4	1628	1743	25168
tríedre	4	1	triedre	4	7	8	25169
tríedres	4	2	triedres	4	1	3	25170
trígam	0	2	trigam	2	1	3	25171
tríplica	4	0	triplica	2	546	546	25172
trípliques	4	0	tripliques	2	1	1	25173
trítons	4	5	tritons	4	276	281	25174
tuberculitzés	2	1	tuberculitzes	2	0	1	25175
tudarà	2	2	tudara	2	0	2	25176
tudà	2	0	tuda	2	9	9	25177
tudí	2	0	tudi	2	94	94	25178
tufarà	2	0	tufara	2	2	2	25179
tufegés	2	1	tufeges	2	0	1	25180
tufegí	2	0	tufegi	2	3	3	25181
tufejà	2	0	tufeja	2	4	4	25182
tufà	2	0	tufa	2	21	21	25183
tufés	2	0	tufes	2	1	1	25184
tuità	2	0	tuita	2	10	10	25185
tuití	2	0	tuiti	2	2	2	25186
tunegés	2	2	tuneges	2	0	2	25187
tunegí	2	0	tunegi	2	1	1	25188
tunejà	2	0	tuneja	2	20	20	25189
tunejàrem	2	0	tunejarem	2	3	3	25190
tunelés	2	0	tuneles	2	1	1	25191
tuparà	2	0	tupara	2	1	1	25192
tupà	2	0	tupa	2	22	22	25193
tupè	4	73	tupe	2	5	78	25194
tupès	4	7	tupes	2	6	13	25195
tupé	4	45	tupe	2	5	50	25196
tupés	2	20	tupes	2	6	26	25197
tupí	2	316	tupi	2	47	363	25198
tupís	4	6	tupis	2	11	17	25199
turbinà	2	0	turbina	4	1096	1096	25200
turbinés	2	0	turbines	4	903	903	25201
turbiní	2	0	turbini	2	7	7	25202
turmentarà	2	9	turmentara	2	0	9	25203
turmentà	2	8	turmenta	2	294	302	25204
turmentàrem	2	0	turmentarem	2	1	1	25205
turmentés	2	3	turmentes	2	62	65	25206
turmentí	2	0	turmenti	2	5	5	25207
turquès	0	38	turques	0	1534	1572	25208
turqués	0	0	turques	0	1534	1534	25209
tussà	2	0	tussa	2	1	1	25210
tussés	2	0	tusses	2	5	5	25211
tussí	2	4	tussi	2	18	22	25212
tustà	2	4	tusta	4	17	21	25213
tustés	2	0	tustes	4	3	3	25214
tustí	2	0	tusti	2	2	2	25215
tutegés	2	1	tuteges	2	3	4	25216
tutegí	2	0	tutegi	2	5	5	25217
tutejà	2	0	tuteja	2	16	16	25218
tutelarà	2	28	tutelara	2	0	28	25219
tutelà	2	7	tutela	4	4503	4510	25220
tutelés	2	3	tuteles	4	186	189	25221
tutelí	2	0	tuteli	2	18	18	25222
tutoritzarà	2	21	tutoritzara	2	0	21	25223
tutoritzà	2	0	tutoritza	2	70	70	25224
tutoritzàrem	2	0	tutoritzarem	2	1	1	25225
tutoritzí	2	0	tutoritzi	2	5	5	25226
tuàreg	0	4	tuareg	0	329	333	25227
tuàregs	0	0	tuaregs	0	286	286	25228
tàbac	4	20	tabac	4	14419	14439	25229
tàbacs	4	4	tabacs	4	241	245	25230
tàlem	4	288	talem	2	18	306	25231
tàler	4	14	taler	0	27	41	25232
tàlers	4	12	talers	0	13	25	25233
tàmara	4	7	tamara	4	1076	1083	25234
tàpara	4	0	tapara	2	8	8	25235
tàpares	4	10	tapares	2	4	14	25236
tàper	4	259	taper	0	204	463	25237
tàpera	4	59	tapera	0	37	96	25238
tàperes	4	387	taperes	0	20	407	25239
tàpers	4	99	tapers	0	168	267	25240
tàxons	4	628	taxons	4	153	781	25241
tènder	4	14	tender	4	144	158	25242
tènders	4	1	tenders	4	55	56	25243
tènia	4	219	tenia	2	188977	189196	25244
tènies	4	19	tenies	2	2729	2748	25245
tèster	4	0	tester	4	202	202	25246
tèsters	4	0	testers	4	130	130	25247
té	2	768545	te	4	68575	837120	25248
ténia	4	10	tenia	2	188977	188987	25249
ténies	4	0	tenies	2	2729	2729	25250
tíl·ler	4	0	til·ler	4	286	286	25251
tíl·lers	4	1	til·lers	4	459	460	25252
tòs	4	17	tos	4	3146	3163	25253
tòt	4	4	tot	3	1839350	1839354	25254
tòts	4	0	tots	3	1034276	1034276	25255
túber	4	2	tuber	4	159	161	25256
túbers	4	0	tubers	4	4	4	25257
túnel	4	12177	tunel	2	437	12614	25258
túrons	0	0	turons	4	4986	4986	25259
ubicarà	2	1434	ubicara	2	10	1444	25260
ubicà	2	120	ubica	2	3467	3587	25261
ubicàrem	2	1	ubicarem	2	43	44	25262
ubicàreu	2	0	ubicareu	2	3	3	25263
ubiqués	2	39	ubiques	2	22	61	25264
ubiquí	2	0	ubiqui	2	178	178	25265
ucà	2	0	uca	2	324	324	25266
udolarà	2	6	udolara	2	1	7	25267
udolà	2	9	udola	2	74	83	25268
udolàrem	2	0	udolarem	2	2	2	25269
ufanegí	2	0	ufanegi	2	1	1	25270
ufanejà	2	0	ufaneja	2	2	2	25271
ufanà	2	0	ufana	4	191	191	25272
ufanés	2	0	ufanes	4	111	111	25273
ufà	0	55	ufa	4	125	180	25274
ugí	2	0	ugi	2	11	11	25275
ujà	2	0	uja	2	29	29	25276
ujàrem	2	0	ujarem	2	1	1	25277
ulcerarà	2	1	ulcerara	2	0	1	25278
ulcerà	2	0	ulcera	2	16	16	25279
ulcerés	2	0	ulceres	2	32	32	25280
ullés	2	48	ulles	2	13	61	25281
ullí	2	0	ulli	2	18	18	25282
ultimarà	2	16	ultimara	2	0	16	25283
ultimà	2	6	ultima	2	3684	3690	25284
ultimàrem	2	1	ultimarem	2	9	10	25285
ultimés	2	2	ultimes	2	961	963	25286
ultimí	2	0	ultimi	2	30	30	25287
ultracongelà	2	0	ultracongela	2	2	2	25288
ultradretà	0	597	ultradreta	4	2060	2657	25289
ultraesquerrà	0	15	ultraesquerra	4	40	55	25290
ultrapassarà	2	20	ultrapassara	2	1	21	25291
ultrapassà	2	27	ultrapassa	2	429	456	25292
ultrapassés	2	7	ultrapasses	2	3	10	25293
ultrapassí	2	0	ultrapassi	2	55	55	25294
ultratgés	2	2	ultratges	4	107	109	25295
ultratgí	2	0	ultratgi	2	5	5	25296
ultratjà	2	1	ultratja	2	15	16	25297
ultrà	2	0	ultra	0	6202	6202	25298
ultrés	2	0	ultres	0	1425	1425	25299
ululà	2	1	ulula	2	3	4	25300
unflà	2	2	unfla	2	24	26	25301
unflàrem	2	2	unflarem	2	1	3	25302
unflés	2	0	unfles	2	1	1	25303
ungirà	2	2	ungira	2	0	2	25304
unglejà	2	0	ungleja	2	1	1	25305
unglà	2	0	ungla	4	714	714	25306
unglés	2	1	ungles	4	3765	3766	25307
ungírem	2	1	ungirem	2	2	3	25308
unificarà	2	87	unificara	2	8	95	25309
unificà	2	93	unifica	2	720	813	25310
unificàrem	2	0	unificarem	2	18	18	25311
unifiqués	2	34	unifiques	2	4	38	25312
unifiquí	2	0	unifiqui	2	115	115	25313
uniformarà	2	3	uniformara	2	0	3	25314
uniformitzarà	2	1	uniformitzara	2	1	2	25315
uniformitzà	2	0	uniformitza	2	60	60	25316
uniformitzàrem	2	1	uniformitzarem	2	0	1	25317
uniformitzés	2	1	uniformitzes	2	0	1	25318
uniformitzí	2	0	uniformitzi	2	7	7	25319
uniformà	2	2	uniforma	2	36	38	25320
uniformés	2	0	uniformes	2	3141	3141	25321
uniformí	2	0	uniformi	2	3	3	25322
unirà	2	1452	unira	2	22	1474	25323
universalitzarà	2	2	universalitzara	2	0	2	25324
universalitzà	2	3	universalitza	2	56	59	25325
universalitzàrem	2	0	universalitzarem	2	3	3	25326
universalitzés	2	6	universalitzes	2	0	6	25327
universalitzí	2	0	universalitzi	2	6	6	25328
untarà	2	1	untara	2	0	1	25329
untà	2	5	unta	2	254	259	25330
untàrem	2	1	untarem	2	81	82	25331
untàreu	2	0	untareu	2	2	2	25332
untés	2	3	untes	2	22	25	25333
untí	2	4	unti	2	5	9	25334
untó	4	0	unto	2	46	46	25335
unè	0	4	une	4	2773	2777	25336
uné	0	2	une	4	2773	2775	25337
unírem	2	8	unirem	2	179	187	25338
uníreu	2	0	unireu	2	10	10	25339
uqués	2	0	uques	2	1	1	25340
uquí	2	0	uqui	2	1	1	25341
urbanitzarà	2	68	urbanitzara	2	2	70	25342
urbanitzà	2	53	urbanitza	2	104	157	25343
urbanitzàrem	2	0	urbanitzarem	2	5	5	25344
urbanitzés	2	10	urbanitzes	2	0	10	25345
urbanitzí	2	0	urbanitzi	2	32	32	25346
urgirà	2	0	urgira	2	2	2	25347
urpejarà	2	1	urpejara	2	0	1	25348
urpà	2	0	urpa	4	363	363	25349
urpés	2	0	urpes	4	1602	1602	25350
urpí	2	227	urpi	2	42	269	25351
urpís	2	0	urpis	2	2	2	25352
usarà	2	775	usara	2	28	803	25353
usdefruità	2	1	usdefruita	2	0	1	25354
usufructuarà	2	0	usufructuara	2	1	1	25355
usufructuà	2	1	usufructua	2	6	7	25356
usufructuària	0	78	usufructuaria	2	10	88	25357
usufructuàries	0	19	usufructuaries	2	0	19	25358
usurparà	2	4	usurpara	2	5	9	25359
usurpà	2	24	usurpa	2	82	106	25360
usurpàrem	2	0	usurparem	2	1	1	25361
usurpés	2	9	usurpes	2	3	12	25362
usurpí	2	0	usurpi	2	19	19	25363
usà	2	294	usa	2	15387	15681	25364
usàrem	2	2	usarem	2	211	213	25365
usàreu	2	0	usareu	2	27	27	25366
usés	2	134	uses	2	383	517	25367
usí	2	1	usi	2	868	869	25368
utilitzarà	2	5247	utilitzara	2	54	5301	25369
utilitzà	2	1153	utilitza	2	62453	63606	25370
utilitzàrem	2	17	utilitzarem	2	2514	2531	25371
utilitzàreu	2	0	utilitzareu	2	169	169	25372
utilitzés	2	556	utilitzes	2	1247	1803	25373
utilitzí	2	2	utilitzi	2	5316	5318	25374
vaccinarà	2	0	vaccinara	2	1	1	25375
vaccinà	2	0	vaccina	2	4	4	25376
vaccinés	2	0	vaccines	2	45	45	25377
vacil·larà	2	19	vacil·lara	2	0	19	25378
vacil·là	2	28	vacil·la	2	142	170	25379
vacil·làrem	2	0	vacil·larem	2	13	13	25380
vacil·lés	2	3	vacil·les	2	1	4	25381
vacil·lí	2	0	vacil·li	2	14	14	25382
vacunarà	2	12	vacunara	2	0	12	25383
vacunà	2	3	vacuna	4	4289	4292	25384
vacunàrem	2	0	vacunarem	2	2	2	25385
vacunàreu	2	0	vacunareu	2	1	1	25386
vacunés	2	4	vacunes	4	3751	3755	25387
vacuní	2	0	vacuni	2	21	21	25388
vacà	2	0	vaca	4	6510	6510	25389
vacària	4	1	vacaria	2	5	6	25390
vagabundegí	2	0	vagabundegi	2	1	1	25391
vagabundejà	2	2	vagabundeja	2	6	8	25392
vagaregés	2	0	vagareges	2	1	1	25393
vagaregí	2	0	vagaregi	2	1	1	25394
vagarejarà	2	1	vagarejara	2	0	1	25395
vagarejà	2	2	vagareja	2	66	68	25396
vagarejàrem	2	1	vagarejarem	2	0	1	25397
vagarà	2	24	vagara	2	2	26	25398
vaguejà	2	0	vagueja	2	4	4	25399
vagués	2	6	vagues	4	4980	4986	25400
vaguí	2	2	vagui	2	92	94	25401
vagà	2	16	vaga	4	36507	36523	25402
vagàrem	2	1	vagarem	2	5	6	25403
vagàreu	2	0	vagareu	2	3	3	25404
vagó	4	1955	vago	2	198	2153	25405
valdré	2	28	valdre	2	2273	2301	25406
valencianitzà	2	0	valencianitza	2	4	4	25407
valentinés	0	0	valentines	4	67	67	25408
valgués	2	181	valgues	2	4	185	25409
valguí	2	0	valgui	2	2043	2043	25410
validarà	2	240	validara	2	0	240	25411
validà	2	4	valida	2	827	831	25412
validàrem	2	0	validarem	2	27	27	25413
validàreu	2	0	validareu	2	2	2	25414
validés	2	25	valides	2	96	121	25415
validí	2	0	validi	2	164	164	25416
vallejà	2	0	valleja	2	1	1	25417
valletà	0	0	valleta	4	280	280	25418
valljunquerà	0	0	valljunquera	4	86	86	25419
vallromanès	0	8	vallromanes	4	1661	1669	25420
vallromanés	0	1	vallromanes	4	1661	1662	25421
valorarà	2	3584	valorara	2	21	3605	25422
valoritzarà	2	9	valoritzara	2	0	9	25423
valoritzà	2	0	valoritza	2	66	66	25424
valoritzàrem	2	0	valoritzarem	2	1	1	25425
valoritzés	2	1	valoritzes	2	1	2	25426
valoritzí	2	0	valoritzi	2	13	13	25427
valorà	2	172	valora	2	11313	11485	25428
valoràrem	2	12	valorarem	2	531	543	25429
valoràreu	2	0	valorareu	2	25	25	25430
valorés	2	199	valores	2	793	992	25431
valorí	2	1	valori	2	1400	1401	25432
valsà	2	0	valsa	2	7	7	25433
valsés	2	0	valses	2	26	26	25434
vampiritzà	2	0	vampiritza	2	11	11	25435
vampiritzí	2	0	vampiritzi	2	2	2	25436
vanagloriegí	2	1	vanagloriegi	2	0	1	25437
vanagloriejà	2	0	vanaglorieja	2	1	1	25438
vanaglorià	2	2	vanagloria	2	59	61	25439
vanagloriés	2	1	vanaglories	2	0	1	25440
vanaglorií	2	0	vanaglorii	2	1	1	25441
vanaglòria	4	96	vanagloria	2	59	155	25442
vanaglòries	4	4	vanaglories	2	0	4	25443
vanarà	2	0	vanara	2	1	1	25444
vantà	2	5	vanta	2	202	207	25445
vantés	2	6	vantes	2	1	7	25446
vantí	2	2	vanti	2	22	24	25447
vanà	2	1	vana	0	390	391	25448
vanés	2	0	vanes	0	174	174	25449
vaní	2	0	vani	2	7	7	25450
vaporitzarà	2	1	vaporitzara	2	0	1	25451
vaporitzà	2	0	vaporitza	2	54	54	25452
vaporitzàrem	2	0	vaporitzarem	2	2	2	25453
vaporitzí	2	0	vaporitzi	2	3	3	25454
vaporà	2	0	vapora	2	1	1	25455
vaporés	2	0	vapores	2	8	8	25456
vaqués	2	4	vaques	4	6949	6953	25457
vaquí	2	147	vaqui	2	3	150	25458
varegés	2	0	vareges	2	1	1	25459
varejà	2	0	vareja	2	3	3	25460
variarà	2	892	variara	2	5	897	25461
variolà	2	0	variola	4	18	18	25462
varià	2	63	varia	2	7385	7448	25463
variàrem	2	0	variarem	2	16	16	25464
variàreu	2	0	variareu	2	1	1	25465
variés	2	22	varies	2	6605	6627	25466
varií	2	6	varii	2	22	28	25467
varà	2	47	vara	0	1719	1766	25468
varés	2	49	vares	2	1328	1377	25469
varí	2	1	vari	2	90	91	25470
vaticinarà	2	1	vaticinara	2	0	1	25471
vaticinà	2	11	vaticina	2	241	252	25472
vaticinàrem	2	3	vaticinarem	2	0	3	25473
vaticinés	2	3	vaticines	2	2	5	25474
vaticiní	2	0	vaticini	2	108	108	25475
vectoritzà	2	0	vectoritza	2	10	10	25476
vedarà	2	1	vedara	2	0	1	25477
vedellà	2	0	vedella	4	4668	4668	25478
vedellés	2	0	vedelles	4	267	267	25479
vedà	2	3	veda	4	719	722	25480
vedés	2	1	vedes	4	227	228	25481
vedí	2	0	vedi	2	17	17	25482
vegetarià	0	1034	vegetaria	2	29	1063	25483
vegetarà	2	1	vegetara	2	0	1	25484
vegetà	2	1	vegeta	2	849	850	25485
vegetàreu	2	1	vegetareu	2	0	1	25486
vegetés	2	0	vegetes	2	5	5	25487
vegà	0	678	vega	4	5185	5863	25488
vehicularà	2	74	vehiculara	2	2	76	25489
vehiculà	2	10	vehicula	2	440	450	25490
vehiculàrem	2	0	vehicularem	2	3	3	25491
vehiculés	2	7	vehicules	2	3	10	25492
vehiculí	2	0	vehiculi	2	48	48	25493
veiés	2	2307	veies	2	881	3188	25494
velaritzà	2	0	velaritza	2	1	1	25495
velarà	2	10	velara	2	1	11	25496
velegí	2	1	velegi	2	0	1	25497
velejà	2	0	veleja	2	1	1	25498
velà	2	4	vela	4	13302	13306	25499
velàrem	2	0	velarem	2	1	1	25500
velés	2	1	veles	4	2352	2353	25501
velí	2	0	veli	2	34	34	25502
vencerà	2	121	vencera	2	2	123	25503
vencilló	4	5	vencillo	2	0	5	25504
vencérem	2	1	vencerem	2	119	120	25505
vencéreu	2	0	vencereu	2	12	12	25506
vencés	2	60	vences	2	10	70	25507
vencí	2	6	venci	2	198	204	25508
vendré	2	92	vendre	2	32671	32763	25509
venerarà	2	8	venerara	2	0	8	25510
venerà	2	16	venera	4	874	890	25511
veneràrem	2	0	venerarem	2	5	5	25512
venerés	2	7	veneres	4	23	30	25513
venerí	2	0	veneri	2	38	38	25514
vengués	2	259	vengues	2	11	270	25515
venguí	2	5	vengui	2	937	942	25516
venguís	4	0	venguis	2	93	93	25517
vengés	2	12	venges	4	7	19	25518
vengí	2	0	vengi	2	80	80	25519
venjarà	2	34	venjara	2	2	36	25520
venjà	2	20	venja	4	218	238	25521
venjàrem	2	0	venjarem	2	16	16	25522
ventallà	2	0	ventalla	4	13	13	25523
ventallés	2	0	ventalles	4	63	63	25524
ventarà	2	3	ventara	2	0	3	25525
ventegés	2	0	venteges	2	4	4	25526
ventejà	2	0	venteja	2	6	6	25527
ventilarà	2	8	ventilara	2	0	8	25528
ventilà	2	2	ventila	2	119	121	25529
ventilàrem	2	0	ventilarem	2	3	3	25530
ventilés	2	8	ventiles	2	7	15	25531
ventilí	2	0	ventili	2	35	35	25532
ventà	2	8	venta	2	4462	4470	25533
ventàrem	2	0	ventarem	2	1	1	25534
ventés	2	8	ventes	2	682	690	25535
ventí	2	1	venti	2	33	34	25536
vençó	4	2	venço	2	6	8	25537
verbalitzarà	2	1	verbalitzara	2	0	1	25538
verbalitzà	2	4	verbalitza	2	113	117	25539
verbalitzàrem	2	0	verbalitzarem	2	2	2	25540
verbalitzés	2	3	verbalitzes	2	7	10	25541
verbalitzí	2	0	verbalitzi	2	18	18	25542
verberà	2	0	verbera	2	1	1	25543
verdegí	2	0	verdegi	2	1	1	25544
verdejà	2	0	verdeja	2	37	37	25545
veremarà	2	8	veremara	2	0	8	25546
veremà	2	1	verema	4	4747	4748	25547
veremàrem	2	3	veremarem	2	4	7	25548
veremàreu	2	0	veremareu	2	1	1	25549
veremés	2	0	veremes	4	222	222	25550
veremí	2	0	veremi	2	3	3	25551
vergassejarà	2	1	vergassejara	2	0	1	25552
vergonyés	2	0	vergonyes	4	1128	1128	25553
verguejà	2	0	vergueja	2	1	1	25554
verificarà	2	242	verificara	2	2	244	25555
verificà	2	17	verifica	2	1292	1309	25556
verificàrem	2	0	verificarem	2	70	70	25557
verificàreu	2	0	verificareu	2	7	7	25558
verifiqués	2	29	verifiques	2	7	36	25559
verifiquí	2	0	verifiqui	2	310	310	25560
verinà	2	0	verina	2	5	5	25561
verinés	2	0	verines	2	11	11	25562
veriní	2	0	verini	2	2	2	25563
vermellejà	2	0	vermelleja	2	4	4	25564
verolarà	2	1	verolara	2	0	1	25565
verolà	2	0	verola	4	777	777	25566
verolés	2	0	veroles	4	6	6	25567
verolí	2	0	veroli	4	2	2	25568
versallès	0	3	versalles	4	1460	1463	25569
versallés	0	0	versalles	4	1460	1460	25570
versarà	2	528	versara	2	0	528	25571
versejarà	2	1	versejara	2	0	1	25572
versejà	2	0	verseja	2	3	3	25573
versificà	2	2	versifica	2	17	19	25574
versificàrem	2	0	versificarem	2	1	1	25575
versionarà	2	17	versionara	2	0	17	25576
versionà	2	19	versiona	2	258	277	25577
versionàrem	2	1	versionarem	2	5	6	25578
versionés	2	2	versiones	2	74	76	25579
versioní	2	0	versioni	2	6	6	25580
versà	2	62	versa	2	968	1030	25581
versés	2	8	verses	2	43	51	25582
versí	2	0	versi	2	78	78	25583
vertebrarà	2	87	vertebrara	2	2	89	25584
vertebrà	2	15	vertebra	2	809	824	25585
vertebràrem	2	0	vertebrarem	2	4	4	25586
vertebrés	2	11	vertebres	2	57	68	25587
vertebrí	2	0	vertebri	2	67	67	25588
verticalitzà	2	1	verticalitza	2	3	4	25589
vertisòl	4	1	vertisol	4	19	20	25590
vertisòls	4	3	vertisols	4	0	3	25591
verí	4	2758	veri	4	209	2967	25592
vesarà	2	2	vesara	2	0	2	25593
vescós	0	0	vescos	4	1	1	25594
vespregés	2	1	vespreges	2	0	1	25595
vespregí	2	0	vespregi	2	3	3	25596
vesprejarà	2	1	vesprejara	2	0	1	25597
vesprejà	2	0	vespreja	2	6	6	25598
vessarà	2	56	vessara	2	2	58	25599
vessà	2	48	vessa	4	863	911	25600
vessàrem	2	0	vessarem	2	9	9	25601
vessàreu	2	1	vessareu	2	7	8	25602
vessés	2	22	vesses	2	32	54	25603
vessí	2	1	vessi	2	128	129	25604
vestirà	2	365	vestira	2	8	373	25605
vestírem	2	9	vestirem	2	78	87	25606
vestíreu	2	0	vestireu	2	3	3	25607
vesà	2	1	vesa	2	65	66	25608
vesàreu	2	0	vesareu	2	4	4	25609
vesés	2	2	veses	2	28	30	25610
vesí	2	45	vesi	2	12	57	25611
vetarà	2	73	vetara	2	4	77	25612
veterà	0	5271	vetera	4	71	5342	25613
vetlarà	2	98	vetlara	2	2	100	25614
vetllarà	2	1348	vetllara	2	6	1354	25615
vetllà	2	32	vetlla	4	5164	5196	25616
vetllàrem	2	0	vetllarem	2	324	324	25617
vetllàreu	2	0	vetllareu	2	1	1	25618
vetllés	2	82	vetlles	4	221	303	25619
vetllí	2	0	vetlli	2	824	824	25620
vetlà	2	1	vetla	4	203	204	25621
vetlàrem	2	0	vetlarem	2	6	6	25622
vetlés	2	1	vetles	4	11	12	25623
vetlí	2	0	vetli	2	6	6	25624
vetà	2	20	veta	4	847	867	25625
vetàrem	2	0	vetarem	2	7	7	25626
vetés	2	39	vetes	4	913	952	25627
vetí	2	0	veti	2	53	53	25628
vetó	4	0	veto	2	2217	2217	25629
veuré	2	945	veure	2	509741	510686	25630
vexà	2	2	vexa	2	32	34	25631
vexí	2	0	vexi	2	5	5	25632
viarà	2	0	viara	2	1	1	25633
viatgés	2	192	viatges	4	37878	38070	25634
viatgí	2	2	viatgi	2	463	465	25635
viaticà	2	1	viatica	2	17	18	25636
viatjarà	2	1563	viatjara	2	8	1571	25637
viatjà	2	1122	viatja	2	6702	7824	25638
viatjàrem	2	21	viatjarem	2	600	621	25639
viatjàreu	2	0	viatjareu	2	63	63	25640
vibrarà	2	56	vibrara	2	1	57	25641
vibrà	2	7	vibra	4	627	634	25642
vibràrem	2	0	vibrarem	2	9	9	25643
vibràreu	2	0	vibrareu	2	3	3	25644
vibrés	2	12	vibres	4	20	32	25645
vibrí	2	0	vibri	2	63	63	25646
vicesecretària	4	282	vicesecretaria	4	111	393	25647
vicesecretàries	4	2	vicesecretaries	4	12	14	25648
viciarà	2	0	viciara	2	1	1	25649
vicià	2	2	vicia	2	72	74	25650
viciés	2	1	vicies	2	2	3	25651
vicií	2	0	vicii	2	1	1	25652
victimitzarà	2	1	victimitzara	2	0	1	25653
victimitzà	2	0	victimitza	2	18	18	25654
victimitzés	2	0	victimitzes	2	1	1	25655
victimitzí	2	0	victimitzi	2	4	4	25656
victoregí	2	0	victoregi	2	2	2	25657
victorejà	2	3	victoreja	2	5	8	25658
victorejàreu	2	0	victorejareu	2	1	1	25659
vicària	0	40	vicaria	4	230	270	25660
vicàries	0	5	vicaries	4	16	21	25661
vidrià	2	0	vidria	2	1	1	25662
vidriés	2	0	vidries	2	2	2	25663
vidrés	2	0	vidres	2	6579	6579	25664
vidrí	2	0	vidri	2	11	11	25665
vigilarà	2	279	vigilara	2	5	284	25666
vigilà	2	9	vigila	2	2228	2237	25667
vigilàrem	2	0	vigilarem	2	142	142	25668
vigilàreu	2	0	vigilareu	2	6	6	25669
vigilés	2	106	vigiles	2	75	181	25670
vigilí	2	0	vigili	2	410	410	25671
vigirà	2	7	vigira	2	0	7	25672
vigoritzarà	2	2	vigoritzara	2	0	2	25673
vigoritzà	2	5	vigoritza	2	27	32	25674
vigoritzí	2	0	vigoritzi	2	3	3	25675
vila-secà	4	58	vila-seca	4	5511	5569	25676
vilatà	0	283	vilata	4	14	297	25677
vilavellà	0	0	vilavella	4	430	430	25678
vilellà	0	0	vilella	4	2049	2049	25679
vilipendià	2	2	vilipendia	2	8	10	25680
vil·là	4	42	vil·la	4	4726	4768	25681
vilà	0	3708	vila	4	84842	88550	25682
vinclarà	2	1	vinclara	2	0	1	25683
vinclà	2	4	vincla	2	55	59	25684
vinclàrem	2	0	vinclarem	2	2	2	25685
vinclés	2	1	vincles	2	14158	14159	25686
vinclí	2	0	vincli	2	3	3	25687
vincularà	2	210	vinculara	2	3	213	25688
vinculà	2	124	vincula	2	3091	3215	25689
vinculàrem	2	1	vincularem	2	22	23	25690
vinculés	2	72	vincules	2	23	95	25691
vinculí	2	0	vinculi	2	367	367	25692
vindicarà	2	3	vindicara	2	0	3	25693
vindicà	2	9	vindica	2	68	77	25694
vindicàrem	2	0	vindicarem	2	3	3	25695
vindiquí	2	0	vindiqui	2	5	5	25696
vindré	2	548	vindre	2	4223	4771	25697
vingués	2	1694	vingues	2	118	1812	25698
vinguí	2	9	vingui	2	8342	8351	25699
vinificarà	2	2	vinificara	2	0	2	25700
vinificà	2	3	vinifica	2	43	46	25701
vinificàrem	2	0	vinificarem	2	2	2	25702
vinifiqués	2	0	vinifiques	2	1	1	25703
vinifiquí	2	0	vinifiqui	2	2	2	25704
vint-i-quatrè	0	48	vint-i-quatre	3	2960	3008	25705
vint-i-quatré	0	1	vint-i-quatre	3	2960	2961	25706
vintenegí	2	0	vintenegi	2	1	1	25707
vinyetà	2	0	vinyeta	4	1872	1872	25708
vinyetés	2	0	vinyetes	4	2112	2112	25709
violarà	2	27	violara	2	3	30	25710
violentarà	2	2	violentara	2	0	2	25711
violentà	2	0	violenta	0	6113	6113	25712
violentàrem	2	0	violentarem	2	2	2	25713
violentés	2	2	violentes	0	3046	3048	25714
violentí	2	10	violenti	2	16	26	25715
violà	2	21	viola	4	4209	4230	25716
violàrem	2	0	violarem	2	5	5	25717
violàreu	2	0	violareu	2	1	1	25718
violés	2	31	violes	4	938	969	25719
violí	2	7940	violi	2	302	8242	25720
violó	4	22	violo	2	8	30	25721
vionà	2	0	viona	2	2	2	25722
vionés	2	0	viones	2	1	1	25723
viralitzarà	2	2	viralitzara	2	0	2	25724
viralitzà	2	3	viralitza	2	19	22	25725
viralitzés	2	2	viralitzes	2	0	2	25726
viralitzí	2	0	viralitzi	2	2	2	25727
virarà	2	9	virara	2	0	9	25728
virilitzarà	2	1	virilitzara	2	0	1	25729
virolà	2	0	virola	2	16	16	25730
virolés	2	3	viroles	2	3	6	25731
virolí	2	0	viroli	2	12	12	25732
virtualitzarà	2	2	virtualitzara	2	0	2	25733
virtualitzà	2	0	virtualitza	2	35	35	25734
virtualitzés	2	0	virtualitzes	2	1	1	25735
virtualitzí	2	0	virtualitzi	2	3	3	25736
viràrem	2	0	virarem	2	4	4	25737
virés	2	2	vires	4	26	28	25738
virí	2	0	viri	2	63	63	25739
viró	0	2	viro	2	28	30	25740
visarà	2	1	visara	2	0	1	25741
viscós	0	229	viscos	4	14	243	25742
visibilitzarà	2	37	visibilitzara	2	4	41	25743
visibilitzà	2	5	visibilitza	2	301	306	25744
visibilitzàrem	2	1	visibilitzarem	2	10	11	25745
visibilitzés	2	9	visibilitzes	2	0	9	25746
visibilitzí	2	0	visibilitzi	2	54	54	25747
visionarà	2	49	visionara	2	0	49	25748
visionà	2	4	visiona	2	68	72	25749
visionàrem	2	2	visionarem	2	67	69	25750
visionàreu	2	0	visionareu	2	1	1	25751
visionària	0	292	visionaria	2	40	332	25752
visionàries	0	86	visionaries	2	7	93	25753
visionés	2	1	visiones	2	73	74	25754
visioní	2	0	visioni	2	14	14	25755
visitarà	2	3448	visitara	2	35	3483	25756
visità	2	1036	visita	4	125132	126168	25757
visitàrem	2	242	visitarem	2	5241	5483	25758
visitàreu	2	1	visitareu	2	267	268	25759
visités	2	257	visites	4	49684	49941	25760
visití	2	3	visiti	2	1897	1900	25761
visqués	2	694	visques	4	189	883	25762
visquí	2	6	visqui	2	2499	2505	25763
vistabellà	0	1	vistabella	4	1044	1045	25764
vistós	0	1397	vistos	2	3817	5214	25765
visualitzarà	2	230	visualitzara	2	2	232	25766
visualitzà	2	16	visualitza	2	2766	2782	25767
visualitzàrem	2	2	visualitzarem	2	78	80	25768
visualitzàreu	2	0	visualitzareu	2	48	48	25769
visualitzés	2	44	visualitzes	2	60	104	25770
visualitzí	2	0	visualitzi	2	369	369	25771
visurà	2	1	visura	4	38	39	25772
visurés	2	1	visures	4	18	19	25773
visés	2	0	vises	2	40	40	25774
visí	2	1	visi	2	96	97	25775
visó	4	273	viso	2	150	423	25776
vitalitzà	2	0	vitalitza	2	22	22	25777
vitalitzí	2	0	vitalitzi	2	1	1	25778
vitel·lí	0	28	vitel·li	4	80	108	25779
vitrificà	2	0	vitrifica	2	2	2	25780
vitrifiqués	2	0	vitrifiques	2	1	1	25781
vituperà	2	1	vitupera	2	2	3	25782
vituperí	2	0	vituperi	2	11	11	25783
viuré	2	282	viure	4	132295	132577	25784
vivenciarà	2	2	vivenciara	2	0	2	25785
vivencià	2	0	vivencia	2	38	38	25786
vivenciàrem	2	0	vivenciarem	2	9	9	25787
vivenciés	2	0	vivencies	2	107	107	25788
vivencií	2	0	vivencii	2	1	1	25789
vivificarà	2	2	vivificara	2	0	2	25790
vivificà	2	0	vivifica	2	91	91	25791
vivifiquí	2	0	vivifiqui	2	7	7	25792
vivència	4	5092	vivencia	2	38	5130	25793
vivències	4	13155	vivencies	2	107	13262	25794
vivífic	0	1	vivific	2	0	1	25795
vivífica	0	1	vivifica	2	91	92	25796
viàrem	2	2	viarem	2	0	2	25797
viària	0	10265	viaria	2	277	10542	25798
viàries	0	1500	viaries	2	40	1540	25799
viàtic	4	103	viatic	2	0	103	25800
viés	2	3	vies	4	43318	43321	25801
vií	2	0	vii	2	11072	11072	25802
vió	4	37	vio	2	70	107	25803
vocalitzà	2	3	vocalitza	2	38	41	25804
vocalitzàrem	2	0	vocalitzarem	2	3	3	25805
vocalitzí	2	0	vocalitzi	2	2	2	25806
vociferarà	2	1	vociferara	2	0	1	25807
vociferà	2	3	vocifera	2	25	28	25808
vociferés	2	0	vociferes	2	2	2	25809
vociferí	2	0	vociferi	2	3	3	25810
vogarà	2	0	vogara	2	1	1	25811
vogués	2	2	vogues	4	7	9	25812
voguí	2	0	vogui	2	3	3	25813
vogà	2	0	voga	4	402	402	25814
vogí	2	0	vogi	4	11	11	25815
vogís	2	0	vogis	4	1	1	25816
volarà	2	178	volara	2	4	182	25817
volatilitzà	2	2	volatilitza	2	30	32	25818
volatilitzàrem	2	0	volatilitzarem	2	1	1	25819
volatilitzés	2	1	volatilitzes	2	0	1	25820
volatilitzí	2	0	volatilitzi	2	5	5	25821
volcà	4	5646	volca	0	165	5811	25822
voleiarà	2	3	voleiara	2	0	3	25823
voleià	2	5	voleia	2	61	66	25824
voleiés	2	0	voleies	2	2	2	25825
voletegí	2	0	voletegi	2	1	1	25826
voletejà	2	0	voleteja	2	12	12	25827
voletejàrem	2	1	voletejarem	2	0	1	25828
voletejàreu	2	0	voletejareu	2	1	1	25829
voleí	2	2	volei	2	1236	1238	25830
voltarà	2	96	voltara	2	2	98	25831
voltegés	2	0	volteges	2	4	4	25832
voltegí	2	0	voltegi	2	2	2	25833
voltejarà	2	12	voltejara	2	10	22	25834
voltejà	2	6	volteja	2	166	172	25835
voltejàrem	2	1	voltejarem	2	4	5	25836
voltà	2	82	volta	4	57883	57965	25837
voltàrem	2	3	voltarem	2	85	88	25838
voltàreu	2	0	voltareu	2	25	25	25839
voltés	2	12	voltes	4	23095	23107	25840
voltí	2	2	volti	2	57	59	25841
volà	2	125	vola	4	2350	2475	25842
volàrem	2	3	volarem	2	127	130	25843
volàreu	2	0	volareu	2	20	20	25844
volés	2	133	voles	2	133	266	25845
volí	2	7	voli	2	214	221	25846
vomitarà	2	5	vomitara	2	0	5	25847
vomità	2	3	vomita	2	193	196	25848
vomités	2	12	vomites	2	28	40	25849
vomití	2	0	vomiti	2	12	12	25850
voregés	2	4	voreges	2	17	21	25851
voregí	2	0	voregi	2	17	17	25852
vorejarà	2	23	vorejara	2	0	23	25853
vorejà	2	6	voreja	2	1937	1943	25854
vorejàrem	2	5	vorejarem	2	116	121	25855
vorejàreu	2	0	vorejareu	2	10	10	25856
voretà	2	0	voreta	4	136	136	25857
voretés	2	0	voretes	4	5	5	25858
vorà	2	170	vora	4	33092	33262	25859
voré	2	29	vore	2	9647	9676	25860
votarà	2	2599	votara	2	50	2649	25861
votà	2	334	vota	2	3807	4141	25862
votàrem	2	73	votarem	2	2821	2894	25863
votàreu	2	4	votareu	2	42	46	25864
votés	2	606	votes	2	271	877	25865
votí	2	2	voti	2	1910	1912	25866
vuitanta-quatrè	0	8	vuitanta-quatre	3	147	155	25867
vuitanta-quatré	0	0	vuitanta-quatre	3	147	147	25868
vuitantejà	2	0	vuitanteja	2	1	1	25869
vulcanitzà	2	1	vulcanitza	2	1	2	25870
vulgaritzà	2	2	vulgaritza	2	16	18	25871
vulgaritzés	2	1	vulgaritzes	2	0	1	25872
vulgaritzí	2	0	vulgaritzi	2	1	1	25873
vulnerarà	2	30	vulnerara	2	0	30	25874
vulnerà	2	6	vulnera	2	1950	1956	25875
vulnerària	0	20	vulneraria	2	76	96	25876
vulneràries	0	6	vulneraries	2	3	9	25877
vulnerés	2	29	vulneres	2	3	32	25878
vulnerí	2	0	vulneri	2	531	531	25879
vàgara	4	0	vagara	2	2	2	25880
vàlid	0	10153	valid	2	199	10352	25881
vàlida	0	8466	valida	2	827	9293	25882
vàlides	0	3313	valides	2	96	3409	25883
vàrem	2	34814	varem	2	18461	53275	25884
vàreu	2	1928	vareu	2	1135	3063	25885
vària	0	133	varia	2	7385	7518	25886
vàries	0	8425	varies	2	6605	15030	25887
vèiem	2	1741	veiem	2	44340	46081	25888
vèieu	2	43	veieu	2	10905	10948	25889
vènia	4	137	venia	2	16590	16727	25890
vènies	4	5	venies	2	134	139	25891
vèrtebra	4	253	vertebra	2	809	1062	25892
vèrtebres	4	780	vertebres	2	57	837	25893
véiem	2	92	veiem	2	44340	44432	25894
véieu	2	0	veieu	2	10905	10905	25895
véllor	4	0	vellor	4	11	11	25896
véllors	4	0	vellors	4	2	2	25897
vénc	2	33	venc	2	832	865	25898
vénda	4	58	venda	4	63235	63293	25899
véndes	4	15	vendes	4	20941	20956	25900
vénen	2	14736	venen	2	25462	40198	25901
véngui	2	41	vengui	2	937	978	25902
vénguin	2	56	venguin	2	1049	1105	25903
vénguis	2	3	venguis	2	93	96	25904
véns	2	806	vens	2	1654	2460	25905
vérem	2	150	verem	2	74	224	25906
vés	2	5654	ves	2	7115	12769	25907
véu	2	49	veu	4	167403	167452	25908
vígil	0	1	vigil	2	117	118	25909
vòlei	4	2340	volei	2	1236	3576	25910
vòmit	4	467	vomit	2	8	475	25911
vós	5	3775	vos	4	19293	23068	25912
xacarà	2	0	xacara	2	1	1	25913
xacà	2	0	xaca	2	5	5	25914
xacó	4	76	xaco	2	12	88	25915
xafardegés	2	1	xafardeges	2	0	1	25916
xafardegí	2	0	xafardegi	2	4	4	25917
xafardejà	2	0	xafardeja	2	18	18	25918
xafardejàrem	2	0	xafardejarem	2	1	1	25919
xafarà	2	7	xafara	2	2	9	25920
xafigà	2	192	xafiga	2	1	193	25921
xafigàrem	2	1	xafigarem	2	0	1	25922
xafà	2	13	xafa	2	103	116	25923
xafàrem	2	4	xafarem	2	21	25	25924
xafàreu	2	0	xafareu	2	1	1	25925
xafés	2	6	xafes	4	30	36	25926
xafí	2	1	xafi	2	3	4	25927
xafó	4	0	xafo	2	12	12	25928
xaià	2	0	xaia	4	4	4	25929
xaiés	2	0	xaies	4	2	2	25930
xalarà	2	8	xalara	2	0	8	25931
xalà	2	1	xala	4	209	210	25932
xalàrem	2	0	xalarem	2	25	25	25933
xalàreu	2	0	xalareu	2	28	28	25934
xalés	2	7	xales	4	15	22	25935
xalí	2	1	xali	2	5	6	25936
xampurregí	2	0	xampurregi	2	3	3	25937
xampurrejà	2	2	xampurreja	2	17	19	25938
xampurràrem	2	1	xampurrarem	2	0	1	25939
xamà	2	16	xama	2	7	23	25940
xamí	2	4	xami	2	1	5	25941
xaparà	2	5	xapara	2	0	5	25942
xapotejà	2	0	xapoteja	2	3	3	25943
xapà	2	1	xapa	4	2773	2774	25944
xapàrem	2	0	xaparem	2	2	2	25945
xapés	2	0	xapes	4	1914	1914	25946
xapó	4	47	xapo	2	112	159	25947
xapós	4	0	xapos	4	10	10	25948
xaqués	2	3	xaques	2	2	5	25949
xaquí	2	1	xaqui	2	5	6	25950
xaragallí	2	0	xaragalli	2	1	1	25951
xarbotà	2	0	xarbota	2	6	6	25952
xarbotí	2	0	xarboti	2	2	2	25953
xarpà	2	0	xarpa	4	16	16	25954
xarpés	2	0	xarpes	4	3	3	25955
xarpó	4	0	xarpo	2	3	3	25956
xarrarà	2	6	xarrara	2	0	6	25957
xarrupà	2	1	xarrupa	2	24	25	25958
xarrupàrem	2	0	xarruparem	2	2	2	25959
xarrupàreu	2	0	xarrupareu	2	1	1	25960
xarrupés	2	3	xarrupes	2	2	5	25961
xarrupí	2	0	xarrupi	2	5	5	25962
xarrà	2	2	xarra	2	42	44	25963
xarràrem	2	5	xarrarem	2	23	28	25964
xarrés	2	1	xarres	2	7	8	25965
xarugués	2	0	xarugues	0	3	3	25966
xarugà	2	0	xaruga	0	45	45	25967
xaró	0	86	xaro	4	297	383	25968
xategés	2	0	xateges	2	10	10	25969
xategí	2	0	xategi	2	2	2	25970
xatejarà	2	1	xatejara	2	0	1	25971
xatejà	2	0	xateja	2	45	45	25972
xatejàreu	2	0	xatejareu	2	1	1	25973
xatonà	2	0	xatona	2	1	1	25974
xató	4	1355	xato	0	293	1648	25975
xauxinarà	2	1	xauxinara	2	0	1	25976
xaí	2	0	xai	4	3241	3241	25977
xelvà	0	0	xelva	4	120	120	25978
xemicarà	2	1	xemicara	2	0	1	25979
xemiqués	2	0	xemiques	2	1	1	25980
xeresà	0	6	xeresa	4	407	413	25981
xericà	2	0	xerica	2	1	1	25982
xeringués	2	0	xeringues	4	568	568	25983
xeringà	2	0	xeringa	4	525	525	25984
xeriqués	2	1	xeriques	2	0	1	25985
xerocopià	2	0	xerocopia	2	1	1	25986
xerocopiés	2	0	xerocopies	2	1	1	25987
xerocòpia	4	1	xerocopia	2	1	2	25988
xerocòpies	4	4	xerocopies	2	1	5	25989
xerografià	2	0	xerografia	4	4	4	25990
xerrarà	2	51	xerrara	2	0	51	25991
xerricà	2	0	xerrica	2	25	25	25992
xerriqués	2	0	xerriques	2	2	2	25993
xerriquí	2	0	xerriqui	2	4	4	25994
xerrotejà	2	0	xerroteja	2	4	4	25995
xerrà	2	12	xerra	4	692	704	25996
xerràrem	2	17	xerrarem	2	160	177	25997
xerràreu	2	0	xerrareu	2	2	2	25998
xerrés	2	14	xerres	4	88	102	25999
xerrí	2	0	xerri	4	135	135	26000
xerà	0	2	xera	4	116	118	26001
xerès	4	530	xeres	4	28	558	26002
xerés	4	31	xeres	4	28	59	26003
xifrarà	2	11	xifrara	2	0	11	26004
xifrà	2	19	xifra	4	33221	33240	26005
xifràrem	2	0	xifrarem	2	3	3	26006
xifrés	2	6	xifres	4	27661	27667	26007
xifrí	2	0	xifri	2	23	23	26008
xilografià	2	1	xilografia	4	357	358	26009
xilografiés	2	0	xilografies	4	303	303	26010
xilè	0	1541	xile	4	9203	10744	26011
xilé	0	55	xile	4	9203	9258	26012
xilòfon	4	236	xilofon	4	12	248	26013
xilòfons	4	82	xilofons	4	4	86	26014
xinxollarà	2	1	xinxollara	2	0	1	26015
xinxollà	2	0	xinxolla	2	3	3	26016
xinxollàrem	2	0	xinxollarem	2	1	1	26017
xinà	2	0	xina	4	43773	43773	26018
xinès	0	13519	xines	4	194	13713	26019
xiné	4	4	xine	2	14	18	26020
xinés	2	891	xines	4	194	1085	26021
xiní	2	0	xini	2	10	10	26022
xipollegés	2	1	xipolleges	2	5	6	26023
xipollejà	2	0	xipolleja	2	23	23	26024
xipollà	2	0	xipolla	2	2	2	26025
xirivellà	0	0	xirivella	4	1130	1130	26026
xisclarà	2	1	xisclara	2	0	1	26027
xisclà	2	4	xiscla	2	91	95	26028
xisclàreu	2	0	xisclareu	2	1	1	26029
xisclés	2	2	xiscles	2	243	245	26030
xisclí	2	0	xiscli	2	7	7	26031
xiscló	0	1	xisclo	2	4	5	26032
xità	2	1	xita	2	32	33	26033
xités	2	0	xites	2	1	1	26034
xití	2	0	xiti	2	4	4	26035
xiularà	2	31	xiulara	2	3	34	26036
xiulà	2	29	xiula	2	592	621	26037
xiulàrem	2	2	xiularem	2	3	5	26038
xiulàreu	2	0	xiulareu	2	2	2	26039
xiulés	2	41	xiules	2	12	53	26040
xiulí	2	0	xiuli	2	67	67	26041
xiuxiuegés	2	7	xiuxiueges	2	9	16	26042
xiuxiuegí	2	0	xiuxiuegi	2	12	12	26043
xiuxiuejarà	2	2	xiuxiuejara	2	1	3	26044
xiuxiuejà	2	19	xiuxiueja	2	216	235	26045
xiuxiuà	2	2	xiuxiua	2	1	3	26046
xivarà	2	1	xivara	2	0	1	26047
xivatà	2	0	xivata	2	7	7	26048
xivatés	2	0	xivates	2	2	2	26049
xivà	2	2	xiva	4	760	762	26050
xivàrem	2	0	xivarem	2	1	1	26051
xivés	2	1	xives	2	7	8	26052
xiví	2	1	xivi	2	9	10	26053
xocarà	2	54	xocara	2	2	56	26054
xocà	2	51	xoca	2	1481	1532	26055
xocàrem	2	0	xocarem	2	7	7	26056
xocàreu	2	0	xocareu	2	1	1	26057
xollà	2	0	xolla	0	34	34	26058
xollí	2	0	xolli	2	1	1	26059
xoparà	2	1	xopara	2	0	1	26060
xopà	2	24	xopa	0	308	332	26061
xopàrem	2	0	xoparem	2	1	1	26062
xopés	2	0	xopes	0	122	122	26063
xopí	2	0	xopi	2	17	17	26064
xoqués	2	51	xoques	2	33	84	26065
xoquí	2	3	xoqui	2	61	64	26066
xorrarà	2	0	xorrara	2	1	1	26067
xorrà	2	1	xorra	4	53	54	26068
xorrés	2	0	xorres	4	43	43	26069
xorrí	2	2	xorri	2	2	4	26070
xuclarà	2	18	xuclara	2	2	20	26071
xuclà	2	672	xucla	4	446	1118	26072
xuclàrem	2	0	xuclarem	2	4	4	26073
xuclàreu	2	0	xuclareu	2	1	1	26074
xuclés	2	26	xucles	4	21	47	26075
xuclí	2	0	xucli	2	50	50	26076
xuixés	2	0	xuixes	2	1	1	26077
xulillà	0	0	xulilla	4	49	49	26078
xumà	2	1	xuma	2	13	14	26079
xumàreu	2	1	xumareu	2	0	1	26080
xumí	2	3	xumi	2	42	45	26081
xuplarà	2	1	xuplara	2	2	3	26082
xuplà	2	3	xupla	2	13	16	26083
xuplàrem	2	0	xuplarem	2	1	1	26084
xuplàreu	2	0	xuplareu	2	1	1	26085
xuplés	2	0	xuples	2	1	1	26086
xuplí	2	2	xupli	2	1	3	26087
xupló	4	11	xuplo	2	0	11	26088
xurmà	2	0	xurma	4	44	44	26089
xurmés	2	0	xurmes	4	1	1	26090
xutarà	2	7	xutara	2	0	7	26091
xutà	2	18	xuta	4	240	258	26092
xutés	2	16	xutes	4	20	36	26093
xutí	2	0	xuti	2	16	16	26094
xèric	0	4	xeric	4	6	10	26095
xèrics	0	8	xerics	4	5	13	26096
xèrif	4	792	xerif	4	91	883	26097
xèrifs	4	43	xerifs	4	28	71	26098
xèriques	0	2	xeriques	2	0	2	26099
xòfer	4	271	xofer	4	1299	1570	26100
xòfera	4	0	xofera	4	4	4	26101
xòferes	4	0	xoferes	4	1	1	26102
xòfers	4	62	xofers	4	311	373	26103
zairès	0	38	zaires	4	2	40	26104
zairés	0	0	zaires	4	2	2	26105
zamorà	0	17	zamora	4	2451	2468	26106
zefirà	2	0	zefira	2	1	1	26107
zefirí	2	0	zefiri	2	1	1	26108
zelà	2	0	zela	2	17	17	26109
zelés	2	0	zeles	2	1	1	26110
zelí	2	0	zeli	2	1	1	26111
zigzaguejà	2	0	zigzagueja	2	46	46	26112
zincà	2	0	zinca	2	11	11	26113
zinquí	2	0	zinqui	2	1	1	26114
zonificà	2	0	zonifica	2	7	7	26115
zonificàrem	2	0	zonificarem	2	1	1	26116
zonifiquí	2	0	zonifiqui	2	1	1	26117
zulú	0	103	zulu	0	443	546	26118
zulús	0	17	zulus	0	123	140	26119
zumzegí	2	0	zumzegi	2	1	1	26120
zumzejà	2	3	zumzeja	2	1	4	26121
zèfir	4	131	zefir	2	2	133	26122
àfrica	4	31921	africa	2	1580	33501	26123
àfriques	4	14	afriques	2	2	16	26124
àlaba	4	661	alaba	2	117	778	26125
àlan	4	33	alan	4	3547	3580	26126
àlana	4	0	alana	4	71	71	26127
àlida	4	2	alida	0	56	58	26128
àneu	4	2937	aneu	2	14041	16978	26129
ànimes	4	5383	animes	2	1439	6822	26130
àpia	4	47	apia	4	120	167	26131
àrreu	4	131	arreu	4	85271	85402	26132
àrtemis	4	312	artemis	4	225	537	26133
àstrid	4	145	astrid	4	712	857	26134
àvila	4	1425	avila	2	247	1672	26135
èdgar	4	59	edgar	4	3403	3462	26136
èlia	4	796	elia	4	634	1430	26137
èlies	4	4	elies	4	2033	2037	26138
èric	4	1667	eric	4	5746	7413	26139
èsquil	4	307	esquil	2	38	345	26140
énguera	4	149	enguera	4	165	314	26141
épila	4	27	epila	2	3	30	26142
íngrid	4	445	ingrid	4	1165	1610	26143
íria	4	96	iria	2	250	346	26144
òlt	4	167	olt	4	108	275	26145
òscar	4	7917	oscar	4	9597	17514	26146
òscars	4	367	oscars	4	1342	1709	26147
óros	4	0	oros	4	348	348	26148
úbeda	4	705	ubeda	4	64	769	26149
àcar	4	86	acar	2	29	115	26150
àcid	0	12866	acid	2	413	13279	26151
àcida	0	1657	acida	2	30	1687	26152
àcides	0	588	acides	2	18	606	26153
àfon	0	0	afon	2	18	18	26154
àfona	0	1	afona	2	65	66	26155
àfones	0	1	afones	2	3	4	26156
àgama	0	6	agama	4	82	88	26157
àgames	0	0	agames	4	2	2	26158
àgape	4	159	agape	4	28	187	26159
àgapes	4	10	agapes	4	1	11	26160
àgnat	0	0	agnat	4	3	3	26161
àgnats	0	24	agnats	4	16	40	26162
àlans	4	1	alans	4	283	284	26163
àlep	4	15	alep	4	892	907	26164
àlger	0	4	alger	4	1410	1414	26165
àlien	4	131	alien	2	1175	1306	26166
àliens	4	44	aliens	0	4645	4689	26167
àlies	4	2337	alies	2	225	2562	26168
àmel	0	0	amel	2	38	38	26169
àmela	0	0	amela	2	507	507	26170
àmeles	0	0	ameles	2	7	7	26171
àmplia	0	43837	amplia	2	13568	57405	26172
àmplies	0	6041	amplies	2	625	6666	26173
àncora	4	1187	ancora	2	375	1562	26174
àncores	4	348	ancores	2	29	377	26175
ànega	4	40	anega	2	5	45	26176
ànegues	4	9	anegues	2	0	9	26177
ànet	4	2	anet	4	296	298	26178
ànets	4	2	anets	4	3	5	26179
àngstrom	4	13	angstrom	4	24	37	26180
àngstroms	4	15	angstroms	4	4	19	26181
ànim	4	26628	anim	2	408	27036	26182
ànima	4	27539	anima	2	9655	37194	26183
ànnera	4	38	annera	0	0	38	26184
ànneres	4	54	anneres	0	2	56	26185
ànsia	4	2014	ansia	2	115	2129	26186
ànsies	4	1573	ansies	2	73	1646	26187
àpoca	4	58	apoca	2	46	104	26188
àpoques	4	41	apoques	2	4	45	26189
àrbitra	4	80	arbitra	2	70	150	26190
àrbitre	4	6259	arbitre	2	355	6614	26191
àrbitres	4	2896	arbitres	2	236	3132	26192
àrcades	4	1	arcades	4	1955	1956	26193
àrides	0	577	arides	4	6	583	26194
àrtic	0	3159	artic	2	241	3400	26195
àscons	4	0	ascons	4	9	9	26196
àspia	4	0	aspia	2	1	1	26197
àspies	4	0	aspies	2	11	11	26198
àster	4	62	aster	4	272	334	26199
àsters	4	5	asters	4	1	6	26200
àstur	0	7	astur	0	51	58	26201
àsturs	0	24	asturs	0	58	82	26202
àt	7	6	at	4	9429	9435	26203
àtac	4	23	atac	4	37756	37779	26204
àtacs	4	4	atacs	4	23451	23455	26205
àtropa	0	0	atropa	2	18	18	26206
àugur	4	43	augur	2	30	73	26207
àurica	0	11	aurica	4	19	30	26208
àuriques	0	0	auriques	4	1	1	26209
àusona	0	0	ausona	4	58	58	26210
àvar	0	54	avar	0	343	397	26211
àvara	0	4	avara	0	88	92	26212
àvares	0	1	avares	0	8	9	26213
àvars	0	143	avars	0	151	294	26214
àvia	4	11063	avia	2	1283	12346	26215
àvid	0	509	avid	2	113	622	26216
àvida	0	313	avida	2	32	345	26217
àvides	0	108	avides	2	3	111	26218
àvies	4	3735	avies	2	276	4011	26219
àxons	4	17	axons	4	136	153	26220
èfedra	4	0	efedra	4	26	26	26221
èfedres	4	0	efedres	4	3	3	26222
èmbol	4	199	embol	2	4	203	26223
èmul	4	32	emul	2	4	36	26224
èmula	4	2	emula	2	259	261	26225
èmules	4	1	emules	2	5	6	26226
èntom	4	0	entom	2	25	25	26227
èster	4	153	ester	4	5750	5903	26228
èsters	4	232	esters	4	14	246	26229
èxplicit	4	39	explicit	2	109	148	26230
émbol	4	4	embol	2	4	8	26231
és	2	5659017	es	4	5490180	11149197	26232
ésser	2	48686	esser	4	5067	53753	26233
éssers	4	24349	essers	4	727	25076	26234
íncub	4	6	incub	2	0	6	26235
íncube	4	10	incube	2	6	16	26236
íncubes	4	12	incubes	2	0	12	26237
índex	4	20407	index	2	2148	22555	26238
índic	0	1550	indic	2	72	1622	26239
índica	0	104	indica	2	37064	37168	26240
índiques	0	29	indiques	2	192	221	26241
ínsula	4	62	insula	4	88	150	26242
íntegra	0	2722	integra	2	8111	10833	26243
íntegre	0	3552	integre	2	227	3779	26244
íntegres	0	851	integres	2	90	941	26245
íntim	0	6696	intim	2	111	6807	26246
íntima	0	5185	intima	4	243	5428	26247
íntimes	0	1757	intimes	4	118	1875	26248
írrit	0	2	irrit	2	1	3	26249
írrita	0	0	irrita	2	486	486	26250
írrites	0	1	irrites	2	5	6	26251
òbvia	0	1624	obvia	2	898	2522	26252
òbvies	0	1136	obvies	2	246	1382	26253
òliba	4	454	oliba	4	2137	2591	26254
òlibes	4	211	olibes	4	0	211	26255
òpera	4	24036	opera	2	7608	31644	26256
òperes	4	3772	operes	2	110	3882	26257
òptim	0	6697	optim	2	94	6791	26258
òptima	0	5644	optima	2	258	5902	26259
òptimes	0	3066	optimes	2	71	3137	26260
òrbita	4	6702	orbita	2	560	7262	26261
òrbites	4	1466	orbites	2	36	1502	26262
òrtic	0	1	ortic	2	0	1	26263
òvul	4	663	ovul	2	14	677	26264
òxford	4	69	oxford	4	3753	3822	26265
òxid	4	2180	oxid	2	35	2215	26266
ós	4	5933	os	4	12605	18538	26267
óssa	4	676	ossa	4	775	1451	26268
ósses	4	64	osses	4	48	112	26269
óssos	4	2178	ossos	4	9616	11794	26270
úlcera	4	402	ulcera	2	16	418	26271
úlceres	4	786	ulceres	2	32	818	26272
últim	0	118569	ultim	2	2017	120586	26273
última	0	92357	ultima	2	3684	96041	26274
últimes	0	39183	ultimes	2	961	40144	26275
ús	2	255410	us	5	438770	694180	26276
