diacritic_word	diacritic_pos	diacritic_freq	no_diacritic_word	no_diacritic_pos	no_diacritic_freq	total_freq
abellà	4	0	abella	4	158	158
adrià	4	228	adria	4	11	239
agàtocles	4	17	agatocles	4	3	20
aidí	4	0	aidi	2	2	2
ainès	4	0	aines	4	5	5
ainés	4	0	aines	4	5	5
aiòder	4	4	aioder	0	0	4
alabès	4	1	alabes	2	1	2
albanès	4	367	albanes	4	0	367
albertí	4	13	alberti	4	45	58
alberí	4	0	alberi	4	1	1
albà	4	11	alba	4	846	857
albí	4	35	albi	4	33	68
alcàsser	4	18	alcasser	0	0	18
alegrí	4	0	alegri	2	28	28
alfés	4	2	alfes	4	3	5
alió	4	3	alio	2	1	4
almúnia	4	5	almunia	4	353	358
altés	4	1	altes	0	2832	2833
alès	4	9	ales	4	986	995
alés	4	0	ales	4	986	986
alí	4	146	ali	2	893	1039
amargó	4	0	amargo	2	2	2
amarí	4	0	amari	2	14	14
ambrosià	4	9	ambrosia	4	18	27
ambròsia	4	0	ambrosia	4	18	18
amigó	4	9	amigo	2	4	13
amín	4	3	amin	2	80	83
amó	4	0	amo	2	624	624
amós	4	7	amos	4	521	528
andorrà	4	21	andorra	4	327	348
anglès	4	12094	angles	4	723	12817
angèlic	4	7	angelic	2	3	10
angèlica	4	28	angelica	2	43	71
ansó	4	4	anso	2	0	4
antoní	4	44	antoni	4	504	548
apià	4	34	apia	4	32	66
apol·ló	4	2	apol·lo	4	278	280
argentó	4	0	argento	2	8	8
aristòbul	4	7	aristobul	4	0	7
armadà	4	0	armada	4	1671	1671
arnó	4	0	arno	4	41	41
arpí	4	0	arpi	2	1	1
arrià	4	32	arria	2	6	38
arró	4	0	arro	4	1	1
artà	4	7	arta	4	22	29
arís	4	0	aris	0	39	39
ascós	4	0	ascos	4	1	1
aspró	4	0	aspro	2	2	2
audí	4	0	audi	4	37	37
ausà	4	0	ausa	4	4	4
avilés	4	122	aviles	2	3	125
avià	4	6	avia	2	34	40
aín	4	5	ain	4	116	121
badés	4	0	bades	4	9	9
badó	4	3	bado	2	1	4
bagà	4	5	baga	4	11	16
baixés	4	27	baixes	0	2834	2861
baiés	4	0	baies	4	197	197
balbí	4	1	balbi	2	9	10
baldé	4	9	balde	2	1	10
baldí	4	0	baldi	2	70	70
baldó	4	1	baldo	2	1	2
ballarà	4	2	ballara	2	0	2
balàfia	4	1	balafia	2	24	25
barberà	4	20	barbera	4	12	32
barcelonès	4	28	barcelones	4	0	28
barravés	4	3	barraves	2	0	3
barà	4	0	bara	4	12	12
barés	4	1	bares	0	2	3
bascó	4	0	basco	2	5	5
bascós	4	0	bascos	0	178	178
bastià	4	1	bastia	2	20	21
begudà	4	0	beguda	4	576	576
bellveí	4	0	bellvei	4	2	2
belló	4	0	bello	4	67	67
belém	4	21	belem	2	4	25
benés	4	0	benes	4	60	60
bernabéu	4	11	bernabeu	4	6	17
besòs	4	18	besos	4	5	23
bodí	4	0	bodi	4	16	16
bolló	4	0	bollo	2	1	1
bolòs	4	6	bolos	4	5	11
borgonyà	4	1	borgonya	4	278	279
bornís	4	0	bornis	2	1	1
borrassà	4	7	borrassa	4	0	7
borén	4	6	boren	2	13	19
borés	4	0	bores	4	5	5
boscà	4	6	bosca	2	4	10
bossòst	4	0	bossost	4	1	1
boí	4	12	boi	4	29	41
brió	4	2	brio	4	5	7
brocà	4	1	broca	4	19	20
brotó	4	0	broto	2	7	7
budó	4	0	budo	4	3	3
buscó	4	0	busco	2	139	139
bàrbara	4	245	barbara	2	474	719
bàrbares	4	82	barbares	2	3	85
bàscara	4	2	bascara	2	0	2
béja	4	3	beja	4	16	19
bòrdes	4	1	bordes	4	23	24
cabó	4	3	cabo	2	88	91
cadí	4	6	cadi	4	24	30
cairó	4	0	cairo	2	75	75
callís	4	1	callis	2	27	28
calló	4	0	callo	2	5	5
calmó	4	0	calmo	2	3	3
calví	4	40	calvi	4	15	55
campanyà	4	1	campanya	4	7742	7743
campà	4	0	campa	0	17	17
campí	4	0	campi	2	12	12
camús	4	4	camus	4	51	55
canadà	4	4744	canada	4	253	4997
cantí	4	1	canti	2	35	36
cantó	4	711	canto	2	89	800
canà	4	7	cana	4	15	22
capellà	4	298	capella	4	1361	1659
capó	4	44	capo	2	45	89
cardó	4	2	cardo	2	13	15
cardós	4	4	cardos	4	2	6
carrascó	4	0	carrasco	4	35	35
carròs	4	3	carros	4	239	242
carrós	4	0	carros	4	239	239
cassà	4	2	cassa	4	7	9
castellà	4	1153	castella	4	559	1712
castilló	4	0	castillo	4	100	100
casòs	4	0	casos	4	17468	17468
casó	4	0	caso	2	139	139
casós	4	0	casos	4	17468	17468
causà	4	153	causa	4	27552	27705
censà	4	1	censa	2	2	3
cervià	4	4	cervia	4	3	7
ceró	4	0	cero	4	33	33
cirà	4	0	cira	4	4	4
cisó	4	0	ciso	2	3	3
ció	4	0	cio	2	9	9
clarà	4	7	clara	4	10134	10141
clarís	4	0	claris	4	39	39
claudí	4	0	claudi	4	245	245
codí	4	1	codi	4	11790	11791
coixós	4	0	coixos	0	5	5
colón	4	122	colon	4	75	197
colúmbia	4	458	columbia	4	742	1200
comí	4	21	comi	2	10	31
comín	4	4	comin	2	4	8
coralí	4	1	corali	2	1	2
corberà	4	2	corbera	4	17	19
corbí	4	0	corbi	2	6	6
corcó	4	2	corco	2	5	7
cornellà	4	30	cornella	4	5	35
corró	4	41	corro	2	25	66
coró	4	0	coro	4	17	17
costejà	4	0	costeja	2	4	4
costerà	4	0	costera	4	50	50
crespí	4	10	crespi	2	1	11
crispí	4	6	crispi	2	4	10
cuixà	4	6	cuixa	4	68	74
cuscó	4	0	cusco	4	49	49
custòdia	4	470	custodia	2	33	503
càceres	4	31	caceres	4	35	66
càndia	4	17	candia	2	7	24
càndida	4	17	candida	2	21	38
càndides	4	3	candides	2	1	4
càndies	4	0	candies	2	2	2
cànoes	4	0	canoes	4	102	102
cària	4	25	caria	2	2	27
càstor	4	11	castor	4	222	233
càstors	4	0	castors	4	162	162
cóll	4	0	coll	4	1374	1374
cós	4	5	cos	4	9581	9586
dagà	4	0	daga	4	99	99
darién	4	13	darien	2	7	20
daurí	4	0	dauri	2	2	2
deià	4	8	deia	2	3906	3914
demètria	4	4	demetria	2	0	4
demètries	4	5	demetries	2	0	5
diamantí	4	0	diamanti	2	2	2
donís	4	1	donis	2	224	225
dragó	4	74	drago	2	4	78
duró	4	0	duro	2	51	51
dària	4	3	daria	4	22	25
dèlia	4	3	delia	2	37	40
déu	4	7362	deu	4	15766	23128
elià	4	6	elia	4	41	47
eloí	4	0	eloi	4	13	13
elí	4	2	eli	4	134	136
eriçó	4	54	eriço	2	0	54
ermità	4	64	ermita	4	210	274
escaró	4	1	escaro	2	0	1
escolà	4	17	escola	4	10498	10515
escós	4	1	escos	4	0	1
espadà	4	6	espada	2	9	15
espanyó	4	0	espanyo	2	1	1
espigó	4	14	espigo	2	0	14
espirà	4	0	espira	4	21	21
espígol	4	17	espigol	2	0	17
espòrades	4	4	esporades	4	0	4
esquerrà	4	121	esquerra	4	8807	8928
esquèrda	4	0	esquerda	4	151	151
esquís	4	70	esquis	2	0	70
estaís	4	0	estais	4	1	1
estellés	4	3	estelles	4	25	28
fadó	4	0	fado	2	9	9
falcó	4	168	falco	2	23	191
favà	4	0	fava	4	265	265
fermí	4	1	fermi	2	130	131
ferrà	4	1	ferra	2	1	2
ferrís	4	0	ferris	2	99	99
ferró	4	0	ferro	4	2539	2539
filó	4	62	filo	2	12	74
fintà	4	0	finta	4	24	24
fitó	4	2	fito	2	9	11
florià	4	3	floria	2	11	14
fluixà	4	1	fluixa	0	78	79
fondó	4	4	fondo	4	44	48
forès	4	2	fores	2	20	22
fotí	4	1	foti	2	31	32
francí	4	1	franci	4	20	21
franquès	4	1	franques	0	64	65
fullà	4	0	fulla	4	824	824
fòssa	4	0	fossa	4	305	305
gabí	4	0	gabi	2	4	4
gaietà	4	13	gaieta	4	0	13
gaià	4	9	gaia	4	49	58
gal·lès	4	426	gal·les	4	1721	2147
gargallà	4	1	gargalla	4	0	1
gaspé	4	7	gaspe	2	1	8
gastí	4	0	gasti	2	135	135
gastó	4	26	gasto	2	11	37
gasà	4	0	gasa	4	17	17
gaudí	4	147	gaudi	4	290	437
gavarró	4	2	gavarro	4	0	2
generés	4	15	generes	2	8	23
generó	4	0	genero	2	2	2
genís	4	7	genis	4	56	63
germània	4	50	germania	4	37	87
gestí	4	0	gesti	2	1	1
girés	4	26	gires	4	361	387
giró	4	5	giro	4	101	106
glòria	4	446	gloria	2	173	619
glòries	4	40	glories	2	0	40
godés	4	0	godes	4	4	4
gracià	4	24	gracia	2	18	42
grogués	4	0	grogues	0	214	214
gràcia	4	726	gracia	2	18	744
gràcies	4	33338	gracies	2	101	33439
grífols	4	0	grifols	4	2	2
guardí	4	0	guardi	2	91	91
guifré	4	24	guifre	4	0	24
guillé	4	0	guille	2	2	2
guixà	4	0	guixa	4	8	8
gurí	4	1	guri	4	5	6
gustà	4	1	gusta	2	2	3
guàlter	4	0	gualter	4	3	3
gàtova	4	3	gatova	4	0	3
gèrs	4	1	gers	4	3	4
gòrgona	4	1	gorgona	4	8	9
gòrgones	4	3	gorgones	4	1	4
helí	4	0	heli	4	378	378
herbés	4	0	herbes	4	416	416
herédia	4	0	heredia	4	28	28
humilià	4	2	humilia	2	24	26
huíla	4	8	huila	4	12	20
jalón	4	4	jalon	2	1	5
jofré	4	15	jofre	4	17	32
juià	4	2	juia	4	0	2
justí	4	24	justi	2	0	24
justó	4	0	justo	2	26	26
jóc	4	7	joc	4	12212	12219
khàrkiv	4	88	kharkiv	4	16	104
lladró	4	4	lladro	2	0	4
llançà	4	212	llança	4	1013	1225
llaurí	4	3	llauri	2	126	129
llauró	4	2	llauro	2	1	3
lleixà	4	0	lleixa	4	18	18
lletjós	4	0	lletjos	0	23	23
llinyà	4	0	llinya	4	2	2
lliterà	4	0	llitera	4	54	54
lliçà	4	7	lliça	4	26	33
llucí	4	0	lluci	4	9	9
lluçà	4	4	lluça	4	1	5
lídia	4	88	lidia	2	19	107
lídies	4	1	lidies	2	0	1
maià	4	4	maia	4	273	277
maldà	4	5	malda	2	9	14
mallén	4	0	mallen	2	1	1
maltés	4	4	maltes	4	1	5
mamés	4	8	mames	4	28	36
manassès	4	9	manasses	2	5	14
manassés	4	0	manasses	2	5	5
manyà	4	2	manya	4	19	21
marcià	4	72	marcia	2	43	115
marcó	4	2	marco	2	622	624
marià	4	36	maria	4	3250	3286
marquès	4	445	marques	4	2402	2847
marqués	4	43	marques	4	2402	2445
marró	4	1088	marro	2	12	1100
marès	4	20	mares	4	1063	1083
mascaró	4	12	mascaro	2	1	13
masdéu	4	3	masdeu	4	0	3
mató	4	4	mato	2	109	113
maurí	4	0	mauri	2	26	26
maó	4	366	mao	4	309	675
merlès	4	6	merles	4	12	18
merlí	4	56	merli	4	20	76
mesopotàmia	4	281	mesopotamia	4	9	290
micó	4	19	mico	4	261	280
millà	4	0	milla	4	296	296
milà	4	1059	mila	4	25	1084
miró	4	181	miro	2	274	455
mitjà	4	14161	mitja	0	1864	16025
moianès	4	3	moianes	4	0	3
mollà	4	2	molla	4	97	99
molès	4	0	moles	4	25	25
molí	4	444	moli	2	5	449
mont-ròs	4	0	mont-ros	4	1	1
montalbà	4	1	montalba	4	1	2
monòver	4	3	monover	0	0	3
morellà	4	0	morella	4	21	21
moró	4	4	moro	2	1042	1046
mundó	4	0	mundo	4	78	78
muntanyà	4	0	muntanya	4	3654	3654
muntó	4	12	munto	2	4	16
mànega	4	178	manega	2	9	187
màrcia	4	11	marcia	2	43	54
mèdia	4	153	media	2	698	851
míriam	4	25	miriam	4	85	110
móra	4	26	mora	4	146	172
múnia	4	1	munia	2	2	3
múnter	4	0	munter	4	1	1
natjà	4	0	natja	4	7	7
neró	4	126	nero	4	45	171
nevà	4	2	neva	4	58	60
nicòstrat	4	1	nicostrat	4	0	1
nogués	4	8	nogues	4	0	8
norís	4	2	noris	4	0	2
nàquera	4	2	naquera	4	0	2
nét	4	567	net	0	1664	2231
obís	4	0	obis	4	1	1
odí	4	21	odi	4	1203	1224
olivó	4	0	olivo	2	4	4
olià	4	3	olia	2	2	5
olió	4	0	olio	2	1	1
oncés	4	0	onces	4	1	1
ondí	4	0	ondi	2	1	1
orbí	4	0	orbi	2	10	10
orellà	4	0	orella	4	651	651
orà	4	28	ora	4	71	99
orís	4	3	oris	2	4	7
oró	4	3	oro	2	67	70
orós	4	0	oros	4	10	10
pacífic	4	2632	pacific	2	283	2915
pagà	4	165	paga	4	1501	1666
paisà	4	34	paisa	4	2	36
pallarès	4	5	pallares	2	0	5
pallejà	4	4	palleja	2	0	4
pallí	4	1	palli	2	3	4
pal·ladí	4	0	pal·ladi	4	44	44
parlavà	4	2	parlava	2	1205	1207
parés	4	78	pares	2	5577	5655
parís	4	5866	paris	4	582	6448
pascó	4	0	pasco	4	14	14
pedró	4	3	pedro	4	851	854
peixó	4	0	peixo	2	1	1
pelló	4	0	pello	2	6	6
penedès	4	53	penedes	4	0	53
pequín	4	1220	pequin	2	7	1227
perpètua	4	316	perpetua	2	61	377
perpètues	4	23	perpetues	2	1	24
petrús	4	0	petrus	4	86	86
petén	4	22	peten	2	2	24
picassó	4	0	picasso	4	251	251
picó	4	2	pico	2	63	65
pinós	4	12	pinos	4	8	20
pisà	4	5	pisa	4	209	214
pià	4	1	pia	4	59	60
planès	4	0	planes	4	861	861
polpís	4	2	polpis	2	0	2
pontí	4	0	ponti	2	10	10
ponçà	4	0	ponça	4	5	5
portè	4	1	porte	2	50	51
premià	4	19	premia	2	71	90
privàs	4	1	privas	4	2	3
progrés	4	7074	progres	0	7	7081
pròsper	4	396	prosper	2	31	427
pròspera	4	501	prospera	2	82	583
pugès	4	0	puges	4	11	11
pujò	4	0	pujo	2	18	18
pujó	4	0	pujo	2	18	18
pullès	4	0	pulles	4	3	3
pàrtia	4	52	partia	2	65	117
pàtrocle	4	23	patrocle	4	7	30
pécs	4	15	pecs	0	0	15
píram	4	4	piram	2	0	4
pòlit	4	0	polit	4	80	80
queró	4	0	quero	2	6	6
quintà	4	0	quinta	0	109	109
quintí	4	15	quinti	2	7	22
rabadà	4	0	rabada	4	8	8
rabós	4	3	rabos	4	0	3
rafí	4	1	rafi	4	26	27
ralló	4	0	rallo	2	2	2
redovà	4	2	redova	4	0	2
regí	4	7	regi	0	45	52
remolí	4	115	remoli	2	0	115
rifà	4	1	rifa	4	6	7
rifé	4	3	rife	2	3	6
rià	4	0	ria	4	71	71
rodès	4	2	rodes	4	1192	1194
rodés	4	11	rodes	4	1192	1203
rodó	4	189	rodo	2	9	198
romanyà	4	1	romanya	4	16	17
romà	4	2464	roma	4	5769	8233
romània	4	0	romania	4	5435	5435
rotllà	4	1	rotlla	2	0	1
rovelló	4	9	rovello	2	0	9
rubió	4	24	rubio	4	29	53
rufà	4	0	rufa	4	4	4
rupià	4	2	rupia	4	65	67
rués	4	0	rues	4	7	7
règul	4	21	regul	2	0	21
règula	4	0	regula	2	710	710
rúbies	4	0	rubies	4	5	5
sabà	4	12	saba	4	168	180
sagristà	4	13	sagrista	4	0	13
salamí	4	0	salami	4	26	26
salarí	4	0	salari	4	1337	1337
saldó	4	0	saldo	2	429	429
salvà	4	40	salva	0	259	299
salví	4	0	salvi	4	107	107
salvó	4	0	salvo	2	20	20
salé	4	10	sale	4	40	50
salí	4	24	sali	2	131	155
samsó	4	39	samso	4	0	39
samària	4	6	samaria	4	61	67
sansà	4	0	sansa	4	197	197
santamaría	4	8	santamaria	4	5	13
sapés	4	0	sapes	4	1	1
saturní	4	11	saturni	0	2	13
saurí	4	6	sauri	0	7	13
savellà	4	0	savella	4	1	1
sebastòpol	4	59	sebastopol	4	23	82
secundí	4	2	secundi	2	318	320
sedó	4	1	sedo	2	1	2
seguí	4	294	segui	2	81	375
segòvia	4	42	segovia	2	16	58
sentís	4	73	sentis	2	60	133
senès	4	2	senes	4	12	14
serralló	4	0	serrallo	4	1	1
serrà	4	2	serra	4	572	574
servià	4	0	servia	2	404	404
servós	4	0	servos	4	3	3
sigués	4	8	sigues	2	275	283
silvà	4	6	silva	4	444	450
silví	4	0	silvi	4	5	5
solà	4	18	sola	0	5893	5911
soló	4	20	solo	2	800	820
sorà	4	12	sora	4	19	31
suró	4	0	suro	2	101	101
surós	4	0	suros	4	5	5
sèrvia	4	6	servia	2	404	410
sònia	4	13	sonia	4	84	97
talló	4	1	tallo	2	21	22
taló	4	146	talo	2	2	148
tanyà	4	0	tanya	2	21	21
tardà	4	581	tarda	4	4975	5556
tarés	4	0	tares	4	17	17
tauló	4	20	taulo	2	0	20
taís	4	1	tais	4	10	11
taús	4	1	taus	4	4	5
teià	4	3	teia	4	13	16
termenès	4	1	termenes	2	0	1
termòpiles	4	24	termopiles	4	3	27
tesà	4	0	tesa	0	4	4
thaís	4	1	thais	4	2	3
tintín	4	159	tintin	2	21	180
titó	4	3	tito	2	151	154
tió	4	17	tio	4	215	232
tolosà	4	1	tolosa	4	366	367
tolós	4	0	tolos	4	5	5
tomé	4	415	tome	2	22	437
tonyà	4	0	tonya	4	4	4
torrellà	4	0	torrella	4	3	3
torró	4	9	torro	2	1	10
tortellà	4	2	tortella	4	1	3
torà	4	248	tora	4	20	268
torí	4	448	tori	4	84	532
torís	4	3	toris	4	0	3
trillà	4	0	trilla	4	6	6
trilló	4	0	trillo	4	3	3
trulló	4	0	trullo	2	3	3
tucà	4	7	tuca	4	0	7
tudó	4	5	tudo	2	0	5
turbó	4	0	turbo	4	64	64
turà	4	1	tura	4	23	24
turó	4	1031	turo	4	4	1035
tuvà	4	13	tuva	0	25	38
tànger	4	57	tanger	4	0	57
tàpia	4	15	tapia	2	11	26
tàpies	4	27	tapies	2	0	27
tíber	4	55	tiber	0	6	61
ullà	4	5	ulla	4	33	38
ursicí	4	1	ursici	4	1	2
usès	4	2	uses	2	24	26
valentinès	4	0	valentines	4	1	1
ventalló	4	4	ventallo	2	0	4
vergonyà	4	0	vergonya	4	1248	1248
victorí	4	9	victori	4	0	9
vidrà	4	4	vidra	2	0	4
viladà	4	0	vilada	4	2	2
vinçà	4	3	vinça	4	0	3
virà	4	12	vira	4	31	43
visà	4	0	visa	4	100	100
visé	4	2	vise	2	6	8
vitalí	4	0	vitali	4	64	64
vitré	4	10	vitre	4	0	10
vivià	4	0	vivia	2	1106	1106
vià	4	0	via	4	7368	7368
voló	4	4	volo	2	22	26
wílson	4	0	wilson	4	1083	1083
xaló	4	6	xalo	2	0	6
xapí	4	0	xapi	2	3	3
xifró	4	0	xifro	2	2	2
xèrica	4	5	xerica	2	0	5
zoè	4	12	zoe	4	76	88
zoé	4	3	zoe	4	76	79
abaixarà	2	4	abaixara	2	0	4
abaixà	2	1	abaixa	2	124	125
abaixàrem	2	0	abaixarem	2	1	1
abaixés	2	6	abaixes	2	1	7
abaixí	2	0	abaixi	2	7	7
abalancés	2	1	abalances	2	0	1
abalançà	2	0	abalança	2	3	3
abalisà	2	0	abalisa	2	1	1
abanderà	2	0	abandera	2	5	5
abanderí	2	0	abanderi	2	3	3
abandonarà	2	65	abandonara	2	6	71
abandonà	2	302	abandona	2	420	722
abandonàrem	2	0	abandonarem	2	32	32
abandonàreu	2	0	abandonareu	2	6	6
abandonés	2	163	abandones	2	11	174
abandoní	2	0	abandoni	2	307	307
abaratirà	2	9	abaratira	2	0	9
abastarà	2	129	abastara	2	0	129
abastirà	2	3	abastira	2	0	3
abastà	2	14	abasta	2	1665	1679
abastàrem	2	0	abastarem	2	1	1
abastés	2	40	abastes	2	0	40
abastí	2	1	abasti	2	419	420
abatré	2	1	abatre	2	202	203
abatés	2	1	abates	2	0	1
abatí	2	0	abati	2	6	6
abdicarà	2	1	abdicara	2	0	1
abdicà	2	21	abdica	2	9	30
abdicàrem	2	0	abdicarem	2	1	1
abdiqués	2	11	abdiques	2	0	11
abdiquí	2	0	abdiqui	2	4	4
abismà	2	0	abisma	2	1	1
abismés	2	0	abismes	2	28	28
abjurà	2	1	abjura	2	0	1
abocarà	2	8	abocara	2	0	8
abocà	2	7	aboca	2	97	104
abocàrem	2	0	abocarem	2	1	1
abolirà	2	11	abolira	2	1	12
abominà	2	0	abomina	2	3	3
abonarà	2	15	abonara	2	0	15
abonyegà	2	0	abonyega	2	2	2
abonà	2	0	abona	2	32	32
abonàrem	2	0	abonarem	2	2	2
abonés	2	3	abones	2	0	3
aboní	2	0	aboni	2	18	18
aboqués	2	1	aboques	2	1	2
aboquí	2	0	aboqui	2	9	9
abordarà	2	280	abordara	2	0	280
abordà	2	5	aborda	2	1620	1625
abordàrem	2	0	abordarem	2	141	141
abordés	2	85	abordes	2	1	86
abordí	2	0	abordi	2	637	637
abracés	2	3	abraces	2	2	5
abrací	2	0	abraci	2	9	9
abraonà	2	0	abraona	2	1	1
abrasà	2	0	abrasa	2	1	1
abraçarà	2	5	abraçara	2	1	6
abraçà	2	13	abraça	2	98	111
abreugí	2	0	abreugi	2	4	4
abreujà	2	0	abreuja	2	23	23
abrevià	2	0	abrevia	2	5	5
abrigallà	2	0	abrigalla	2	1	1
abrigallí	2	0	abrigalli	2	1	1
abriguí	2	0	abrigui	2	12	12
abrigà	2	0	abriga	2	24	24
abrilejà	2	0	abrileja	2	7	7
abriní	2	0	abrini	2	2	2
absentà	2	0	absenta	4	16	16
absentés	2	2	absentes	4	0	2
absentí	2	0	absenti	2	6	6
absoldré	2	0	absoldre	2	60	60
absolgués	2	3	absolgues	2	0	3
absolguí	2	0	absolgui	2	1	1
absolutitzà	2	0	absolutitza	2	1	1
absorbirà	2	16	absorbira	2	0	16
abstenguí	2	0	abstengui	2	1	1
abstindré	2	104	abstindre	2	1	105
abstingués	2	32	abstingues	2	0	32
abstinguí	2	0	abstingui	2	71	71
abstrauré	2	0	abstraure	2	5	5
abundarà	2	1	abundara	2	0	1
abundà	2	0	abunda	2	73	73
abundàrem	2	0	abundarem	2	1	1
abundí	2	0	abundi	4	6	6
aburgesàrem	2	0	aburgesarem	2	1	1
abusarà	2	3	abusara	2	0	3
abusà	2	1	abusa	2	107	108
abusés	2	7	abuses	2	1	8
abusí	2	0	abusi	2	75	75
acabarà	2	775	acabara	2	15	790
acabà	2	684	acaba	2	8265	8949
acabàrem	2	0	acabarem	2	256	256
acabàreu	2	0	acabareu	2	14	14
acabés	2	303	acabes	2	204	507
acabí	2	0	acabi	2	1398	1398
acací	2	0	acaci	4	7	7
acalorí	2	0	acalori	2	1	1
acalà	2	0	acala	2	1	1
acampà	2	8	acampa	2	2	10
acampàrem	2	0	acamparem	2	2	2
acampés	2	1	acampes	2	0	1
acantonà	2	0	acantona	2	1	1
acaparà	2	3	acapara	2	27	30
acaparés	2	1	acapares	2	1	2
acaparí	2	0	acapari	2	3	3
acaptés	2	0	acaptes	2	1	1
acararà	2	2	acarara	2	0	2
acariciarà	2	1	acariciara	2	0	1
acaricià	2	0	acaricia	2	8	8
acariciés	2	3	acaricies	2	1	4
acarnissà	2	0	acarnissa	2	6	6
acarnissés	2	0	acarnisses	2	1	1
acaronà	2	0	acarona	2	11	11
acaronés	2	1	acarones	2	4	5
acaroní	2	0	acaroni	2	1	1
acarà	2	0	acara	2	3	3
acarí	2	0	acari	4	2	2
acatarà	2	4	acatara	2	0	4
acatxà	2	0	acatxa	2	1	1
acatà	2	0	acata	2	22	22
acatàrem	2	0	acatarem	2	6	6
acatés	2	2	acates	2	1	3
acatí	2	0	acati	2	21	21
accedirà	2	37	accedira	2	0	37
accedírem	2	0	accedirem	2	4	4
accedíreu	2	0	accedireu	2	4	4
accelerarà	2	110	accelerara	2	0	110
accelerà	2	22	accelera	2	170	192
acceleràrem	2	0	accelerarem	2	5	5
accelerés	2	19	acceleres	2	0	19
accelerí	2	0	acceleri	2	193	193
accentuarà	2	21	accentuara	2	0	21
accentuà	2	3	accentua	2	112	115
accentués	2	1	accentues	2	0	1
acceptarà	2	299	acceptara	2	4	303
acceptà	2	205	accepta	2	2622	2827
acceptàrem	2	1	acceptarem	2	188	189
acceptàreu	2	0	acceptareu	2	5	5
acceptés	2	286	acceptes	2	43	329
acceptí	2	0	accepti	2	1011	1011
accidentà	2	2	accidenta	2	0	2
accidentés	2	0	accidentes	2	2	2
accidentí	2	0	accidenti	2	4	4
accionarà	2	4	accionara	2	0	4
accionà	2	1	acciona	2	20	21
accionària	4	2	accionaria	2	1	3
accionàries	4	1	accionaries	2	0	1
accionés	2	0	acciones	2	8	8
accioní	2	0	accioni	2	2	2
acerà	2	0	acera	2	2	2
aceró	4	1	acero	2	1	2
acetilè	4	32	acetile	2	0	32
acidificà	2	0	acidifica	2	2	2
acidifiquí	2	0	acidifiqui	2	1	1
acidulà	2	0	acidula	2	2	2
acilí	2	0	acili	2	4	4
acivadà	2	0	acivada	2	1	1
aclamarà	2	1	aclamara	2	0	1
aclamà	2	6	aclama	2	12	18
aclamés	2	1	aclames	2	0	1
aclamí	2	0	aclami	2	2	2
aclapararà	2	2	aclaparara	2	0	2
aclaparà	2	0	aclapara	2	11	11
aclaparí	2	0	aclapari	2	3	3
aclarirà	2	77	aclarira	2	0	77
aclarírem	2	0	aclarirem	2	18	18
aclucà	2	0	acluca	2	1	1
acoblarà	2	3	acoblara	2	0	3
acoblà	2	0	acobla	2	44	44
acoblés	2	1	acobles	2	0	1
acoblí	2	0	acobli	2	6	6
acollirà	2	75	acollira	2	0	75
acollí	2	23	acolli	2	0	23
acollírem	2	0	acollirem	2	19	19
acollís	2	14	acollis	2	1	15
acolorirà	2	7	acolorira	2	0	7
acolorí	2	1	acolori	2	0	1
acolorís	2	1	acoloris	2	0	1
acomiadarà	2	7	acomiadara	2	0	7
acomiadà	2	6	acomiada	2	76	82
acomiadàrem	2	0	acomiadarem	2	2	2
acomiadés	2	9	acomiades	2	3	12
acomiadí	2	0	acomiadi	2	12	12
acomodarà	2	2	acomodara	2	0	2
acomodà	2	0	acomoda	2	12	12
acomodàrem	2	0	acomodarem	2	1	1
acomodés	2	1	acomodes	2	0	1
acomodí	2	0	acomodi	2	3	3
acompanyarà	2	65	acompanyara	2	4	69
acompanyà	2	77	acompanya	2	525	602
acompanyàrem	2	0	acompanyarem	2	10	10
acompanyés	2	30	acompanyes	2	9	39
acompanyí	2	0	acompanyi	2	146	146
acomplexí	2	0	acomplexi	2	1	1
acomplirà	2	3	acomplira	2	0	3
aconseguirà	2	1273	aconseguira	2	4	1277
aconseguírem	2	0	aconseguirem	2	1554	1554
aconseguíreu	2	1	aconseguireu	2	21	22
aconsellarà	2	9	aconsellara	2	0	9
aconsellà	2	34	aconsella	2	166	200
aconsellàrem	2	0	aconsellarem	2	3	3
aconsellàreu	2	0	aconsellareu	2	1	1
aconsellés	2	7	aconselles	2	2	9
aconsellí	2	0	aconselli	2	14	14
aconsolà	2	0	aconsola	2	2	2
acontentarà	2	8	acontentara	2	0	8
acontentà	2	1	acontenta	2	59	60
acontentàrem	2	0	acontentarem	2	9	9
acontentés	2	2	acontentes	2	0	2
acontentí	2	0	acontenti	2	18	18
acoquiní	2	0	acoquini	2	2	2
acordarà	2	40	acordara	2	1	41
acordà	2	81	acorda	2	112	193
acordàrem	2	0	acordarem	2	14	14
acordés	2	55	acordes	2	5	60
acordí	2	0	acordi	2	106	106
acorralà	2	0	acorrala	2	1	1
acorralés	2	1	acorrales	2	1	2
acorralí	2	0	acorrali	2	1	1
acorés	2	0	acores	2	1	1
acostarà	2	75	acostara	2	1	76
acostumarà	2	9	acostumara	2	1	10
acostumà	2	1	acostuma	2	445	446
acostumàrem	2	1	acostumarem	2	1	2
acostumés	2	2	acostumes	2	22	24
acostumí	2	0	acostumi	2	10	10
acostà	2	12	acosta	2	732	744
acostàrem	2	0	acostarem	2	18	18
acostàreu	2	0	acostareu	2	1	1
acostés	2	22	acostes	2	16	38
acostí	2	0	acosti	2	156	156
acotxà	2	0	acotxa	2	2	2
acotà	2	0	acota	2	3	3
acovardirà	2	1	acovardira	2	0	1
acreditarà	2	6	acreditara	2	0	6
acredità	2	4	acredita	2	100	104
acredités	2	5	acredites	2	0	5
acredití	2	0	acrediti	2	30	30
acreixérem	2	0	acreixerem	2	1	1
acreixí	2	0	acreixi	2	5	5
acretà	2	0	acreta	2	3	3
activarà	2	156	activara	2	0	156
activà	2	1	activa	0	8002	8003
activàrem	2	0	activarem	2	2	2
activàreu	2	0	activareu	2	11	11
activés	2	10	actives	0	1171	1181
activí	2	0	activi	2	160	160
actualitzarà	2	173	actualitzara	2	0	173
actualitzà	2	2	actualitza	2	1771	1773
actualitzàrem	2	0	actualitzarem	2	9	9
actualitzàreu	2	0	actualitzareu	2	3	3
actualitzés	2	7	actualitzes	2	7	14
actualitzí	2	0	actualitzi	2	117	117
actuarà	2	294	actuara	2	3	297
actuà	2	137	actua	2	1770	1907
actuàrem	2	0	actuarem	2	95	95
actuària	4	0	actuaria	2	78	78
actuàries	4	0	actuaries	2	1	1
actués	2	141	actues	2	13	154
acubés	2	0	acubes	2	1	1
acudirà	2	45	acudira	2	0	45
acudí	2	9	acudi	2	0	9
acudírem	2	0	acudirem	2	17	17
acudís	2	25	acudis	2	0	25
acuità	2	0	acuita	2	5	5
acumularà	2	8	acumulara	2	0	8
acumulà	2	13	acumula	2	152	165
acumulàrem	2	0	acumularem	2	4	4
acumulés	2	6	acumules	2	0	6
acumulí	2	0	acumuli	2	14	14
acurtarà	2	1	acurtara	2	0	1
acurtà	2	0	acurta	2	2	2
acurtés	2	1	acurtes	2	0	1
acusarà	2	13	acusara	2	0	13
acusà	2	59	acusa	2	425	484
acusàrem	2	0	acusarem	2	1	1
acusés	2	13	acuses	2	7	20
acusí	2	0	acusi	2	58	58
acídula	0	0	acidula	2	2	2
adaptarà	2	49	adaptara	2	0	49
adaptà	2	26	adapta	2	382	408
adaptàrem	2	0	adaptarem	2	12	12
adaptés	2	20	adaptes	2	2	22
adaptí	2	0	adapti	2	251	251
adargà	2	0	adarga	4	1	1
addicionà	2	0	addiciona	2	7	7
addicioní	2	0	addicioni	2	1	1
adequarà	2	8	adequara	2	0	8
adequà	2	0	adequa	2	65	65
adeqüés	2	4	adeqües	2	1	5
adeqüí	2	0	adeqüi	2	38	38
adherirà	2	23	adherira	2	0	23
adherírem	2	0	adherirem	2	4	4
adigués	2	4	adigues	2	0	4
adiguí	2	0	adigui	2	1	1
adjectivà	2	0	adjectiva	0	4	4
adjectivés	2	0	adjectives	0	5	5
adjudicarà	2	5	adjudicara	2	0	5
adjudicà	2	4	adjudica	2	33	37
adjudicàrem	2	0	adjudicarem	2	1	1
adjudiqués	2	5	adjudiques	2	1	6
adjudiquí	2	0	adjudiqui	2	14	14
adjuntarà	2	26	adjuntara	2	0	26
adjuntà	2	0	adjunta	0	492	492
adjuntés	2	6	adjuntes	0	51	57
adjuntí	2	0	adjunti	2	17	17
admetré	2	24	admetre	2	2284	2308
admetés	2	29	admetes	2	0	29
admetí	2	1	admeti	2	140	141
administrarà	2	13	administrara	2	0	13
administrà	2	8	administra	2	295	303
administrés	2	3	administres	2	4	7
administrí	2	0	administri	2	29	29
admirà	2	4	admira	2	44	48
admiràrem	2	0	admirarem	2	1	1
admirés	2	0	admires	2	6	6
admirí	2	0	admiri	2	3	3
adobà	2	0	adoba	2	13	13
adobí	2	0	adobi	2	2	2
adoctrinà	2	0	adoctrina	2	1	1
adonarà	2	72	adonara	2	2	74
adonà	2	90	adona	2	438	528
adonàrem	2	1	adonarem	2	47	48
adonàreu	2	0	adonareu	2	24	24
adonés	2	51	adones	2	114	165
adoní	2	0	adoni	4	143	143
adoptarà	2	719	adoptara	2	0	719
adoptà	2	180	adopta	2	1178	1358
adoptàrem	2	0	adoptarem	2	188	188
adoptàreu	2	0	adoptareu	2	1	1
adoptés	2	423	adoptes	2	1	424
adoptí	2	0	adopti	2	2131	2131
adorarà	2	2	adorara	2	0	2
adormirà	2	1	adormira	2	0	1
adormí	2	2	adormi	2	9	11
adormírem	2	0	adormirem	2	3	3
adormís	2	0	adormis	2	4	4
adornarà	2	1	adornara	2	0	1
adornà	2	1	adorna	2	21	22
adornés	2	1	adornes	2	1	2
adorní	2	0	adorni	2	3	3
adorà	2	1	adora	2	47	48
adoràreu	2	0	adorareu	2	1	1
adorés	2	3	adores	2	5	8
adorí	2	0	adori	2	2	2
adossà	2	1	adossa	2	7	8
adquirirà	2	81	adquirira	2	1	82
adquirírem	2	0	adquirirem	2	8	8
adquiríreu	2	0	adquirireu	2	1	1
adrecés	2	1	adreces	4	3093	3094
adrecí	2	0	adreci	2	1	1
adreçarà	2	1	adreçara	2	0	1
adreçà	2	7	adreça	4	6100	6107
adreçàrem	2	0	adreçarem	2	1	1
adreçàreu	2	0	adreçareu	2	1	1
adscriguí	2	0	adscrigui	2	1	1
adscriuré	2	0	adscriure	2	14	14
adulterarà	2	1	adulterara	2	0	1
adulterà	2	0	adultera	2	4	4
adulterí	2	0	adulteri	2	139	139
adulà	2	0	adula	4	2	2
adulària	4	1	adularia	2	0	1
adunà	2	0	aduna	2	3	3
aduní	2	0	aduni	2	1	1
advertirà	2	17	advertira	2	1	18
advertírem	2	0	advertirem	2	1	1
advertíreu	2	0	advertireu	2	1	1
advocarà	2	18	advocara	2	0	18
advocà	2	14	advoca	2	577	591
advocàrem	2	0	advocarem	2	6	6
advoqués	2	5	advoques	2	0	5
advoquí	2	0	advoqui	2	43	43
adès	2	6	ades	4	13	19
adés	6	18	ades	4	13	31
adéu	7	682	adeu	7	29	711
adéu-siau	7	7	adeu-siau	7	0	7
adéus	4	7	adeus	4	1	8
adúlter	0	5	adulter	2	0	5
adúltera	0	14	adultera	2	4	18
adúlteres	0	8	adulteres	2	0	8
aerotransportí	2	0	aerotransporti	2	2	2
afaità	2	0	afaita	2	20	20
afaités	2	3	afaites	2	2	5
afalagarà	2	1	afalagara	2	0	1
afalagà	2	0	afalaga	2	10	10
afamà	2	0	afama	2	2	2
afanyarà	2	4	afanyara	2	1	5
afanyà	2	5	afanya	2	129	134
afanyàrem	2	0	afanyarem	2	1	1
afanyés	2	3	afanyes	2	2	5
afanyí	2	0	afanyi	2	28	28
afanà	2	0	afana	2	1	1
afartà	2	1	afarta	2	1	2
afartés	2	0	afartes	2	1	1
afartí	2	0	afarti	2	3	3
afavorirà	2	195	afavorira	2	0	195
afavorírem	2	0	afavorirem	2	9	9
afeblirà	2	80	afeblira	2	0	80
afeblírem	2	0	afeblirem	2	11	11
afeccionà	2	1	afecciona	2	0	1
afectarà	2	746	afectara	2	0	746
afectà	2	54	afecta	2	5730	5784
afectés	2	55	afectes	2	45	100
afectí	2	0	afecti	2	410	410
afegirà	2	432	afegira	2	4	436
afegírem	2	0	afegirem	2	49	49
afegíreu	2	0	afegireu	2	10	10
afermarà	2	12	afermara	2	0	12
afermà	2	0	aferma	2	22	22
afermés	2	2	afermes	2	0	2
afermí	2	0	afermi	2	7	7
aferrarà	2	7	aferrara	2	0	7
aferrissà	2	0	aferrissa	2	1	1
aferrà	2	2	aferra	2	58	60
aferràrem	2	0	aferrarem	2	3	3
aferrés	2	1	aferres	2	4	5
aferrí	2	0	aferri	2	7	7
aferrís	2	0	aferris	2	1	1
afganès	0	364	afganes	4	7	371
afganés	0	1	afganes	4	7	8
aficionà	2	2	aficiona	2	0	2
afigurà	2	0	afigura	2	2	2
afiliarà	2	1	afiliara	2	0	1
afilià	2	28	afilia	2	3	31
afilà	2	0	afila	2	9	9
afilés	2	0	afiles	2	1	1
afinarà	2	1	afinara	2	0	1
afinà	2	0	afina	2	25	25
afinàreu	2	0	afinareu	2	1	1
afinés	2	2	afines	2	2	4
afiní	2	0	afini	2	4	4
afirmarà	2	14	afirmara	2	1	15
afirmà	2	433	afirma	2	4081	4514
afirmàrem	2	0	afirmarem	2	3	3
afirmés	2	23	afirmes	2	0	23
afirmí	2	0	afirmi	2	148	148
afixà	2	0	afixa	0	2	2
afixés	2	0	afixes	0	2	2
aflorarà	2	1	aflorara	2	0	1
aflorà	2	2	aflora	2	17	19
aflorí	2	1	aflori	2	3	4
afluixarà	2	2	afluixara	2	0	2
afluixà	2	1	afluixa	2	23	24
afluixàrem	2	0	afluixarem	2	1	1
afluixés	2	0	afluixes	2	7	7
afluixí	2	0	afluixi	2	5	5
afonà	2	1	afona	2	3	4
aforà	2	0	afora	2	23	23
aforés	2	0	afores	2	612	612
africà	2	1305	africa	2	182	1487
afrontarà	2	41	afrontara	2	0	41
afrontà	2	0	afronta	2	397	397
afrontàrem	2	0	afrontarem	2	38	38
afrontés	2	10	afrontes	2	1	11
afrontí	2	0	afronti	2	100	100
afusellà	2	3	afusella	2	2	5
afusellàrem	2	0	afusellarem	2	1	1
afuà	2	0	afua	2	2	2
agafarà	2	62	agafara	2	4	66
agafà	2	32	agafa	2	1000	1032
agafàrem	2	0	agafarem	2	39	39
agafàreu	2	0	agafareu	2	5	5
agafés	2	32	agafes	2	68	100
agafí	2	0	agafi	2	129	129
agarrà	2	0	agarra	2	3	3
agarrés	2	0	agarres	2	2	2
agarrí	2	0	agarri	2	11	11
agencià	2	0	agencia	2	37	37
agenciés	2	0	agencies	2	18	18
agencés	2	0	agences	2	1	1
agenollà	2	1	agenolla	2	48	49
agenollés	2	0	agenolles	2	1	1
agenollí	2	0	agenolli	2	6	6
agermanà	2	1	agermana	2	1	2
agilitarà	2	16	agilitara	2	0	16
agilitzà	2	0	agilitza	2	2	2
agilità	2	0	agilita	2	23	23
agilití	2	0	agiliti	2	33	33
agitarà	2	1	agitara	2	0	1
agità	2	1	agita	2	42	43
agités	2	0	agites	2	1	1
agití	2	0	agiti	2	2	2
aglutinarà	2	1	aglutinara	2	0	1
aglutinà	2	1	aglutina	2	17	18
aglutinés	2	1	aglutines	2	0	1
agonitzà	2	0	agonitza	2	10	10
agostà	2	0	agosta	2	2	2
agostí	2	0	agosti	2	3	3
agotzonà	2	0	agotzona	2	1	1
agracià	2	0	agracia	2	1	1
agraciés	2	0	agracies	2	1	1
agradarà	2	157	agradara	2	2	159
agradà	2	13	agrada	2	3542	3555
agradés	2	43	agrades	2	83	126
agradí	2	0	agradi	2	439	439
agranà	2	0	agrana	2	3	3
agraírem	2	0	agrairem	2	17	17
agraíreu	2	0	agraireu	2	1	1
agregarà	2	3	agregara	2	0	3
agregués	2	2	agregues	2	1	3
agreguí	2	0	agregui	2	4	4
agregà	2	2	agrega	2	49	51
agreugés	2	5	agreuges	2	0	5
agreugí	2	0	agreugi	2	40	40
agreujarà	2	80	agreujara	2	0	80
agreujà	2	9	agreuja	2	252	261
agreujàrem	2	0	agreujarem	2	3	3
agruparà	2	13	agrupara	2	0	13
agrupà	2	6	agrupa	2	367	373
agrupàrem	2	0	agruparem	2	3	3
agrupés	2	7	agrupes	2	0	7
agrupí	2	0	agrupi	2	27	27
aguaità	2	0	aguaita	2	43	43
aguaití	2	0	aguaiti	2	2	2
aguaitó	4	0	aguaito	2	6	6
aguantarà	2	18	aguantara	2	1	19
aguantà	2	7	aguanta	2	224	231
aguantàrem	2	0	aguantarem	2	6	6
aguantés	2	5	aguantes	2	13	18
aguantí	2	0	aguanti	2	19	19
aguditzarà	2	21	aguditzara	2	0	21
aguditzà	2	0	aguditza	2	55	55
aguditzés	2	1	aguditzes	2	0	1
aguditzí	2	0	aguditzi	2	10	10
agullonarà	2	1	agullonara	2	0	1
agullonà	2	0	agullona	2	1	1
agusarà	2	1	agusara	2	0	1
agència	4	7826	agencia	2	37	7863
agències	4	4013	agencies	2	18	4031
agènesi	4	9	agenesi	4	0	9
aidà	2	1	aida	4	88	89
aidés	2	0	aides	4	3	3
aiguavivà	0	0	aiguaviva	4	2	2
airegí	2	0	airegi	2	1	1
airejarà	2	1	airejara	2	0	1
airejà	2	0	aireja	2	3	3
aixadà	2	0	aixada	4	16	16
aixadés	2	0	aixades	4	2	2
aixafarà	2	7	aixafara	2	0	7
aixafà	2	7	aixafa	2	30	37
aixafàrem	2	0	aixafarem	2	1	1
aixafés	2	3	aixafes	2	0	3
aixafí	2	0	aixafi	2	5	5
aixafín	2	0	aixafin	2	7	7
aixamfranà	2	0	aixamfrana	2	1	1
aixecarà	2	55	aixecara	2	0	55
aixecà	2	38	aixeca	2	919	957
aixecàrem	2	0	aixecarem	2	11	11
aixecàreu	2	0	aixecareu	2	3	3
aixequés	2	56	aixeques	2	15	71
aixequí	2	0	aixequi	2	163	163
aixoplugués	2	0	aixoplugues	2	1	1
aixoplugà	2	1	aixopluga	2	4	5
aixà	2	3	aixa	4	22	25
així	2	97091	aixi	2	42	97133
això	5	280892	aixo	2	36	280928
ajagués	2	1	ajagues	2	0	1
ajauré	2	0	ajaure	2	1	1
ajocà	2	0	ajoca	2	2	2
ajornarà	2	21	ajornara	2	0	21
ajornà	2	4	ajorna	2	113	117
ajornàrem	2	0	ajornarem	2	5	5
ajornés	2	44	ajornes	2	0	44
ajorní	2	0	ajorni	2	198	198
ajudarà	2	1852	ajudara	2	9	1861
ajudà	2	230	ajuda	4	35355	35585
ajudàrem	2	0	ajudarem	2	151	151
ajudàreu	2	0	ajudareu	2	13	13
ajudés	2	179	ajudes	4	9178	9357
ajudí	2	0	ajudi	2	1168	1168
ajuntarà	2	3	ajuntara	2	0	3
ajuntà	2	11	ajunta	2	61	72
ajuntàrem	2	0	ajuntarem	2	4	4
ajuntés	2	3	ajuntes	2	7	10
ajuntí	2	0	ajunti	2	4	4
ajupí	2	1	ajupi	2	2	3
ajupís	2	0	ajupis	2	3	3
ajustarà	2	95	ajustara	2	1	96
ajusticià	2	1	ajusticia	2	0	1
ajustà	2	2	ajusta	2	1826	1828
ajustàrem	2	0	ajustarem	2	11	11
ajustàreu	2	0	ajustareu	2	2	2
ajustés	2	21	ajustes	2	6	27
ajustí	2	1	ajusti	2	272	273
alabà	2	2	alaba	2	15	17
alabés	2	0	alabes	2	1	1
alabí	2	0	alabi	2	2	2
alarmà	2	4	alarma	4	1686	1690
alarmàrem	2	0	alarmarem	2	1	1
alarmés	2	0	alarmes	4	626	626
alarmí	2	0	alarmi	2	2	2
alarà	2	0	alara	2	7	7
albanés	0	1	albanes	4	0	1
albardà	2	0	albarda	4	4	4
albardés	2	0	albardes	4	2	2
albardí	2	0	albardi	2	1	1
albaterà	0	0	albatera	4	4	4
albeldà	0	0	albelda	4	14	14
albergarà	2	10	albergara	2	0	10
albergués	2	4	albergues	4	0	4
alberguí	2	0	albergui	2	6	6
albergà	2	2	alberga	4	507	509
albergàrem	2	0	albergarem	2	2	2
albesà	0	0	albesa	4	2	2
albirà	2	10	albira	2	86	96
albiràrem	2	0	albirarem	2	1	1
albirí	2	0	albiri	2	15	15
alcançà	2	0	alcança	2	2	2
alcolejà	0	0	alcoleja	4	3	3
alcorà	4	252	alcora	4	15	267
alcàssers	4	1	alcassers	0	0	1
alcés	2	8	alces	4	26	34
alcí	2	0	alci	2	30	30
aldeà	4	0	aldea	4	71	71
aldrín	4	5	aldrin	4	35	40
aleatoritzà	2	0	aleatoritza	2	12	12
alegrarà	2	39	alegrara	2	0	39
alegrà	2	2	alegra	2	2259	2261
alegràrem	2	1	alegrarem	2	10	11
alegrés	2	4	alegres	2	96	100
alentirà	2	14	alentira	2	0	14
alentírem	2	0	alentirem	2	1	1
alenà	2	1	alena	4	14	15
alertarà	2	10	alertara	2	0	10
alertà	2	6	alerta	4	1477	1483
alertàrem	2	0	alertarem	2	2	2
alertés	2	3	alertes	4	289	292
alertí	2	0	alerti	2	8	8
aletejà	2	0	aleteja	2	1	1
algerí	0	0	algeri	4	7	7
alicatés	2	0	alicates	2	9	9
alienarà	2	1	alienara	2	0	1
alienà	2	4	aliena	2	173	177
alienés	2	1	alienes	2	200	201
aliení	2	0	alieni	2	2	2
alimentarà	2	20	alimentara	2	0	20
alimentà	2	10	alimenta	2	546	556
alimentàrem	2	0	alimentarem	2	5	5
alimentàreu	2	0	alimentareu	2	3	3
alimentària	0	5677	alimentaria	2	21	5698
alimentàries	0	463	alimentaries	2	2	465
alimentés	2	8	alimentes	2	26	34
alimentí	2	0	alimenti	2	37	37
alinearà	2	20	alineara	2	1	21
alineà	2	10	alinea	2	443	453
alineàrem	2	0	alinearem	2	1	1
alineés	2	1	alinees	2	0	1
alineí	2	0	alinei	2	6	6
alià	2	32	alia	2	43	75
aliè	0	196	alie	2	1	197
alièn	2	0	alien	2	99	99
alié	0	0	alie	2	1	1
aliés	2	3	alies	2	9	12
alií	2	0	alii	2	4	4
allargarà	2	17	allargara	2	0	17
allargués	2	9	allargues	2	2	11
allarguí	2	0	allargui	2	15	15
allargà	2	20	allarga	2	92	112
allegés	2	0	alleges	2	1	1
alletà	2	0	alleta	2	4	4
alleugerirà	2	5	alleugerira	2	0	5
alleugerà	2	0	alleugera	2	2	2
alleugerírem	2	0	alleugerirem	2	1	1
alleugerís	2	1	alleugeris	2	0	1
alleugés	2	6	alleuges	2	1	7
alleugí	2	0	alleugi	2	21	21
alleujarà	2	29	alleujara	2	0	29
alleujà	2	1	alleuja	2	54	55
alleujàrem	2	0	alleujarem	2	3	3
alleví	2	0	allevi	2	1	1
alliberarà	2	72	alliberara	2	0	72
alliberà	2	41	allibera	2	445	486
alliberàrem	2	0	alliberarem	2	14	14
alliberàreu	2	0	alliberareu	2	5	5
alliberés	2	50	alliberes	2	0	50
alliberí	2	0	alliberi	2	208	208
allistà	2	33	allista	2	10	43
allistés	2	1	allistes	2	0	1
allisà	2	0	allisa	2	3	3
allisó	4	0	alliso	2	1	1
alliçonà	2	0	alliçona	2	4	4
alliçonés	2	0	alliçones	2	1	1
alliçoní	2	0	alliçoni	2	1	1
allotgés	2	7	allotges	2	1	8
allotgí	2	0	allotgi	2	4	4
allotjarà	2	5	allotjara	2	0	5
allotjà	2	18	allotja	2	248	266
allunarà	2	1	allunara	2	0	1
allunyarà	2	31	allunyara	2	0	31
allunyà	2	14	allunya	2	414	428
allunyàrem	2	0	allunyarem	2	11	11
allunyàreu	2	0	allunyareu	2	1	1
allunyés	2	18	allunyes	2	6	24
allunyí	2	0	allunyi	2	85	85
allunà	2	0	alluna	2	3	3
allèn	6	40	allen	4	606	646
allén	6	2	allen	4	606	608
almoinà	2	0	almoina	4	74	74
almoinés	2	0	almoines	4	43	43
almívar	4	4	almivar	2	0	4
almón	6	0	almon	6	2	2
alquenà	2	0	alquena	4	2	2
alquenés	2	0	alquenes	4	2	2
alquerià	0	0	alqueria	4	15	15
alterarà	2	26	alterara	2	0	26
alternarà	2	16	alternara	2	0	16
alternà	2	2	alterna	0	225	227
alternàrem	2	0	alternarem	2	1	1
alternàreu	2	0	alternareu	2	1	1
alternària	4	1	alternaria	2	6	7
alternés	2	0	alternes	0	43	43
alterní	2	0	alterni	2	3	3
alterà	2	8	altera	4	207	215
alteràrem	2	0	alterarem	2	1	1
alterés	2	7	alteres	4	0	7
alterí	2	0	alteri	2	39	39
alteró	4	0	altero	2	2	2
alteà	0	0	altea	4	7	7
altivà	2	0	altiva	0	12	12
altivés	2	0	altives	0	2	2
alturà	0	0	altura	4	2498	2498
alumà	2	1	aluma	2	0	1
alumés	2	0	alumes	2	1	1
alzinà	2	0	alzina	4	30	30
alzinés	2	0	alzines	4	18	18
al·legarà	2	2	al·legara	2	0	2
al·legués	2	2	al·legues	2	0	2
al·leguí	2	0	al·legui	2	12	12
al·legà	2	12	al·lega	2	144	156
al·literés	2	1	al·literes	2	0	1
al·lucinà	2	0	al·lucina	2	3	3
alà	2	39	ala	4	1245	1284
alçarà	2	13	alçara	2	0	13
alçà	2	19	alça	7	584	603
alçàrem	2	0	alçarem	2	2	2
alçària	4	114	alçaria	2	9	123
alçàries	4	10	alçaries	2	1	11
alè	4	313	ale	4	67	380
alèn	2	0	alen	2	5	5
alé	4	7	ale	4	67	74
alís	0	1	alis	2	4	5
aló	4	2	alo	2	7	9
amagarà	2	22	amagara	2	1	23
amagués	2	5	amagues	2	34	39
amaguí	2	0	amagui	2	46	46
amagà	2	17	amaga	2	1298	1315
amagàrem	2	0	amagarem	2	6	6
amainarà	2	1	amainara	2	0	1
amainà	2	0	amaina	2	4	4
amainés	2	1	amaines	2	0	1
amainí	2	0	amaini	2	6	6
amalgamà	2	0	amalgama	4	127	127
amalgamés	2	0	amalgames	4	38	38
amanerà	2	0	amanera	2	1	1
amansà	2	0	amansa	2	1	1
amantí	2	0	amanti	2	3	3
amargantejà	2	0	amarganteja	2	1	1
amargarà	2	1	amargara	2	0	1
amargués	2	0	amargues	0	64	64
amarguí	2	0	amargui	2	1	1
amargà	2	0	amarga	0	194	194
amarrà	2	0	amarra	4	2	2
amarrés	2	0	amarres	4	10	10
amarrí	2	0	amarri	2	1	1
amartellà	2	0	amartella	2	1	1
amarà	2	1	amara	4	39	40
amaré	2	0	amare	2	2	2
amarés	2	1	amares	2	0	1
amarín	2	0	amarin	2	1	1
amassà	2	3	amassa	2	4	7
ambicionà	2	0	ambiciona	2	26	26
ambicionés	2	0	ambiciones	2	1	1
ambicioní	2	0	ambicioni	2	2	2
ambientà	2	2	ambienta	2	13	15
ambientés	2	0	ambientes	2	1	1
ambientí	2	0	ambienti	2	17	17
ambigú	4	0	ambigu	0	230	230
ambigús	4	0	ambigus	0	90	90
amblà	2	0	ambla	2	4	4
amblés	2	0	ambles	2	2	2
ambulà	2	0	ambula	2	1	1
ambó	4	1	ambo	4	4	5
amelà	2	0	amela	2	2	2
amelí	2	0	ameli	2	1	1
amenacés	2	24	amenaces	4	2652	2676
amenací	2	0	amenaci	2	65	65
amenaçarà	2	19	amenaçara	2	0	19
amenaçà	2	41	amenaça	4	6951	6992
amenaçàrem	2	0	amenaçarem	2	2	2
amenitzà	2	0	amenitza	2	1	1
amenitzí	2	0	amenitzi	2	1	1
americanitzà	2	0	americanitza	2	1	1
americanitzés	2	1	americanitzes	2	0	1
amerà	2	0	amera	2	1	1
amidarà	2	1	amidara	2	0	1
amidà	2	3	amida	4	60	63
amidés	2	1	amides	4	19	20
amigués	2	0	amigues	0	204	204
amigà	2	0	amiga	0	991	991
amistancés	2	2	amistances	4	0	2
amistançà	2	0	amistança	4	1	1
amistà	2	0	amista	2	1	1
amnistià	2	0	amnistia	4	802	802
amnistiés	2	1	amnisties	4	14	15
amollà	2	0	amolla	2	9	9
amollés	2	0	amolles	2	1	1
amolí	2	0	amoli	2	2	2
amonedà	2	0	amoneda	2	1	1
amonestarà	2	2	amonestara	2	0	2
amonestà	2	0	amonesta	2	6	6
amonestí	2	0	amonesti	2	5	5
amortallà	2	0	amortalla	2	6	6
amortitzarà	2	1	amortitzara	2	0	1
amortitzà	2	0	amortitza	2	5	5
amorà	2	0	amora	2	2	2
amorés	2	0	amores	2	19	19
amorí	2	0	amori	2	2	2
amotinà	2	1	amotina	2	1	2
amoïnarà	2	1	amoïnara	2	0	1
amoïnà	2	0	amoïna	2	37	37
amoïnàrem	2	0	amoïnarem	2	1	1
amoïnés	2	0	amoïnes	2	4	4
amoïní	2	0	amoïni	2	14	14
ampliarà	2	224	ampliara	2	1	225
amplificarà	2	6	amplificara	2	0	6
amplificà	2	0	amplifica	2	45	45
amplificàrem	2	0	amplificarem	2	1	1
amplifiquí	2	0	amplifiqui	2	2	2
amplià	2	57	amplia	2	935	992
ampliàrem	2	1	ampliarem	2	19	20
ampliés	2	87	amplies	2	6	93
amprà	2	0	ampra	2	2	2
amputarà	2	1	amputara	2	0	1
amputà	2	1	amputa	2	4	5
amputés	2	1	amputes	2	0	1
amunteguí	2	0	amuntegui	2	3	3
amuntegà	2	0	amuntega	2	11	11
amurà	2	0	amura	4	5	5
amà	2	0	ama	4	67	67
amè	0	4	ame	2	12	16
amé	0	0	ame	2	12	12
amén	7	78	amen	2	34	112
amés	2	7	ames	4	98	105
amí	2	1	ami	2	244	245
analitzarà	2	152	analitzara	2	2	154
analitzà	2	19	analitza	2	681	700
analitzàrem	2	0	analitzarem	2	101	101
analitzés	2	40	analitzes	2	2	42
analitzí	2	0	analitzi	2	235	235
anastomosà	2	0	anastomosa	2	1	1
anastomosí	2	0	anastomosi	2	12	12
ancorarà	2	2	ancorara	2	0	2
ancorà	2	4	ancora	2	99	103
ancorés	2	0	ancores	2	3	3
andalusià	0	0	andalusia	4	371	371
andanà	2	0	andana	4	80	80
andanés	2	0	andanes	4	101	101
andillà	0	0	andilla	4	4	4
andà	4	0	anda	4	11	11
anellà	2	0	anella	4	54	54
anellés	2	0	anelles	4	48	48
anellí	2	0	anelli	2	1	1
anestesià	2	0	anestesia	2	2	2
anestèsia	4	90	anestesia	2	2	92
anestèsies	4	1	anestesies	2	0	1
angelicà	2	0	angelica	2	43	43
anglés	0	54	angles	4	723	777
angoixà	2	0	angoixa	4	371	371
angoixés	2	0	angoixes	4	24	24
anguillà	0	0	anguilla	4	18	18
angèliques	0	3	angeliques	2	0	3
angúnia	4	8	angunia	2	0	8
angúnies	4	1	angunies	2	0	1
anhelà	2	0	anhela	2	45	45
anhelàrem	2	0	anhelarem	2	1	1
anhelés	2	0	anheles	2	1	1
anihilà	2	2	anihila	2	4	6
anihilés	2	1	anihiles	2	0	1
animarà	2	96	animara	2	0	96
animà	2	18	anima	2	605	623
animàrem	2	0	animarem	2	14	14
animés	2	19	animes	2	15	34
animí	2	0	animi	2	126	126
aniquilarà	2	3	aniquilara	2	0	3
aniquilà	2	2	aniquila	2	10	12
aniquilàrem	2	0	aniquilarem	2	1	1
aniquilí	2	0	aniquili	2	3	3
anisí	2	0	anisi	2	1	1
anivellarà	2	2	anivellara	2	0	2
anivellà	2	0	anivella	2	13	13
anivellí	2	0	anivelli	2	1	1
annexarà	2	8	annexara	2	0	8
annexionarà	2	5	annexionara	2	0	5
annexionà	2	12	annexiona	2	8	20
annexionés	2	6	annexiones	2	0	6
annexioní	2	0	annexioni	2	2	2
annexà	2	10	annexa	0	235	245
annexés	2	1	annexes	0	67	68
annexí	2	0	annexi	2	7	7
anomenarà	2	32	anomenara	2	1	33
anomenà	2	281	anomena	2	3109	3390
anomenàrem	2	0	anomenarem	2	30	30
anomenàreu	2	0	anomenareu	2	2	2
anomenés	2	24	anomenes	2	20	44
anomení	2	0	anomeni	2	31	31
anonimitzà	2	0	anonimitza	2	7	7
anorreà	2	0	anorrea	2	1	1
anotarà	2	11	anotara	2	0	11
anotà	2	26	anota	2	92	118
anotàrem	2	0	anotarem	2	2	2
anotàreu	2	0	anotareu	2	2	2
anotés	2	7	anotes	2	0	7
anotí	2	0	anoti	2	9	9
ansarà	2	0	ansara	2	2	2
ansià	2	0	ansia	2	2	2
ansà	2	0	ansa	4	55	55
ansés	2	0	anses	4	74	74
ansí	2	0	ansi	4	103	103
antellà	0	0	antella	4	2	2
anteposarà	2	2	anteposara	2	0	2
anteposà	2	0	anteposa	2	60	60
anteposàrem	2	0	anteposarem	2	1	1
anteposés	2	2	anteposes	2	0	2
anteposí	2	0	anteposi	2	20	20
anticiparà	2	3	anticipara	2	0	3
anticipà	2	5	anticipa	2	103	108
anticipàrem	2	0	anticiparem	2	2	2
anticipés	2	6	anticipes	2	0	6
anticipí	2	0	anticipi	2	21	21
antropomorfitzà	2	0	antropomorfitza	2	1	1
antrè	4	0	antre	4	7	7
antré	4	0	antre	4	7	7
antullà	2	0	antulla	2	97	97
antullí	2	0	antulli	2	5	5
antílop	4	54	antilop	4	0	54
antílops	4	42	antilops	4	0	42
anul·larà	2	28	anul·lara	2	1	29
anul·là	2	15	anul·la	2	227	242
anul·làrem	2	0	anul·larem	2	1	1
anul·lés	2	12	anul·les	2	0	12
anul·lí	2	0	anul·li	2	60	60
anunciarà	2	54	anunciara	2	6	60
anuncià	2	323	anuncia	2	627	950
anunciàrem	2	0	anunciarem	2	11	11
anunciés	2	67	anuncies	2	2	69
anuncií	2	0	anuncii	2	1	1
anyellà	2	0	anyella	4	1	1
anàstasi	4	0	anastasi	4	26	26
anés	2	860	anes	4	4	864
aní	2	4	ani	4	57	61
anòmia	4	0	anomia	4	4	4
aombrarà	2	2	aombrara	2	0	2
aombrà	2	0	aombra	2	20	20
aombrés	2	3	aombres	2	0	3
aombrí	2	0	aombri	2	4	4
apadrinà	2	0	apadrina	2	2	2
apadriní	2	0	apadrini	2	1	1
apagarà	2	28	apagara	2	0	28
apagués	2	5	apagues	2	9	14
apaguí	2	0	apagui	2	38	38
apagà	2	1	apaga	2	282	283
apagàrem	2	0	apagarem	2	3	3
apaivagarà	2	1	apaivagara	2	0	1
apaivagués	2	1	apaivagues	2	0	1
apaivaguí	2	0	apaivagui	2	3	3
apaivagà	2	2	apaivaga	2	5	7
apaivagàreu	2	0	apaivagareu	2	1	1
apalancà	2	0	apalanca	2	1	1
apallissà	2	1	apallissa	2	6	7
apallissàrem	2	0	apallissarem	2	1	1
apallissés	2	1	apallisses	2	0	1
apamà	2	0	apama	2	4	4
apanyarà	2	0	apanyara	2	1	1
apanyà	2	0	apanya	2	4	4
apanyàrem	2	0	apanyarem	2	5	5
apanyàreu	2	0	apanyareu	2	3	3
apanyés	2	0	apanyes	2	1	1
apanyí	2	0	apanyi	2	2	2
apanà	2	0	apana	2	1	1
aparaulí	2	0	aparauli	2	1	1
aparcà	2	0	aparca	2	21	21
aparedí	2	0	aparedi	2	1	1
aparegués	2	100	aparegues	2	0	100
apareguí	2	0	aparegui	2	500	500
aparellarà	2	4	aparellara	2	0	4
aparellà	2	0	aparella	2	40	40
aparellí	2	0	aparelli	2	3	3
aparencés	2	0	aparences	4	163	163
aparentarà	2	2	aparentara	2	0	2
aparentà	2	0	aparenta	2	52	52
aparentés	2	0	aparentes	2	1	1
aparentí	2	0	aparenti	2	1	1
aparençarà	2	0	aparençara	2	1	1
aparençà	2	0	aparença	4	1815	1815
aparià	2	0	aparia	2	5	5
aparqués	2	2	aparques	2	2	4
aparquí	2	0	aparqui	2	3	3
apartarà	2	7	apartara	2	0	7
apartà	2	6	aparta	2	192	198
apartàrem	2	0	apartarem	2	2	2
apartés	2	12	apartes	2	3	15
apartí	2	0	aparti	2	38	38
apassionarà	2	1	apassionara	2	0	1
apassionà	2	0	apassiona	2	27	27
apassioní	2	0	apassioni	2	4	4
apedací	2	0	apedaci	2	1	1
apedaçarà	2	1	apedaçara	2	0	1
apedaçà	2	0	apedaça	2	1	1
apedreguí	2	0	apedregui	2	1	1
apedregà	2	0	apedrega	2	1	1
apegarà	2	1	apegara	2	0	1
apegà	2	0	apega	2	3	3
apellés	2	0	apelles	2	1	1
apel·larà	2	5	apel·lara	2	0	5
apel·là	2	9	apel·la	4	170	179
apel·làrem	2	0	apel·larem	2	6	6
apel·lés	2	3	apel·les	4	4	7
apel·lí	2	0	apel·li	2	16	16
apenà	2	0	apena	2	1	1
apenés	2	0	apenes	2	1	1
apesararà	2	1	apesarara	2	0	1
apesarà	2	0	apesara	2	33	33
apiadà	2	0	apiada	2	1	1
apiadí	2	0	apiadi	2	5	5
apianà	2	0	apiana	2	3	3
apilà	2	0	apila	2	34	34
apilàrem	2	0	apilarem	2	1	1
apilés	2	0	apiles	2	1	1
apilí	2	0	apili	2	2	2
aplacà	2	1	aplaca	2	2	3
aplanarà	2	37	aplanara	2	0	37
aplanà	2	3	aplana	2	124	127
aplanàrem	2	0	aplanarem	2	3	3
aplanés	2	1	aplanes	2	0	1
aplaní	2	0	aplani	2	32	32
aplaquí	2	0	aplaqui	2	2	2
aplaudirà	2	3	aplaudira	2	1	4
aplaudírem	2	0	aplaudirem	2	4	4
aplaçarà	2	1	aplaçara	2	0	1
aplegarà	2	3	aplegara	2	0	3
aplegués	2	3	aplegues	4	0	3
aplegà	2	19	aplega	4	63	82
aplicarà	2	1029	aplicara	2	0	1029
aplicà	2	40	aplica	2	5517	5557
aplicàrem	2	0	aplicarem	2	83	83
aplicàreu	2	0	aplicareu	2	1	1
apliqués	2	248	apliques	2	7	255
apliquí	2	0	apliqui	2	1718	1718
aplomà	2	0	aploma	2	1	1
apocopà	2	0	apocopa	2	1	1
apoderarà	2	2	apoderara	2	0	2
apoderà	2	11	apodera	2	31	42
apoderàrem	2	0	apoderarem	2	1	1
apoderés	2	11	apoderes	2	0	11
apoderí	2	0	apoderi	2	11	11
aportarà	2	405	aportara	2	0	405
aportà	2	27	aporta	2	1270	1297
aportàrem	2	0	aportarem	2	23	23
aportés	2	43	aportes	2	2	45
aportí	2	0	aporti	2	251	251
aposentà	2	0	aposenta	2	1	1
apostarà	2	4	apostara	2	0	4
apostatés	2	0	apostates	2	2	2
apostrofà	2	0	apostrofa	2	1	1
apostà	2	2	aposta	4	640	642
apostàrem	2	0	apostarem	2	5	5
apostés	2	5	apostes	4	293	298
apostí	2	0	aposti	2	51	51
apotecària	4	1	apotecaria	4	1	2
apreciarà	2	24	apreciara	2	1	25
aprecià	2	4	aprecia	2	383	387
apreciàrem	2	0	apreciarem	2	10	10
apreciàreu	2	0	apreciareu	2	4	4
apreciés	2	7	aprecies	2	3	10
aprehendré	2	0	aprehendre	2	16	16
aprendré	2	10	aprendre	2	4330	4340
aprengués	2	19	aprengues	2	2	21
aprenguí	2	0	aprengui	2	82	82
apressà	2	2	apressa	2	12	14
apressí	2	0	apressi	2	1	1
aprestà	2	0	apresta	2	7	7
aprestés	2	1	aprestes	2	0	1
aprestí	2	0	apresti	2	2	2
apretarà	2	1	apretara	2	0	1
apretà	2	0	apreta	2	4	4
apretés	2	0	apretes	2	2	2
apretí	2	0	apreti	2	1	1
apreuà	2	0	apreua	2	1	1
aprimà	2	1	aprima	2	12	13
aprimàrem	2	0	aprimarem	2	1	1
aprofitarà	2	78	aprofitara	2	1	79
aprofità	2	44	aprofita	2	275	319
aprofitàrem	2	0	aprofitarem	2	59	59
aprofitàreu	2	0	aprofitareu	2	1	1
aprofités	2	52	aprofites	2	1	53
aprofití	2	0	aprofiti	2	309	309
aprofitó	4	0	aprofito	2	520	520
aprofundirà	2	16	aprofundira	2	0	16
aprofundírem	2	0	aprofundirem	2	15	15
aproparà	2	10	apropara	2	0	10
apropiarà	2	2	apropiara	2	0	2
apropià	2	2	apropia	2	11	13
apropiés	2	1	apropies	2	0	1
apropà	2	25	apropa	2	252	277
apropàrem	2	0	aproparem	2	1	1
apropés	2	16	apropes	2	6	22
apropí	2	0	apropi	2	22	22
aprovarà	2	494	aprovara	2	1	495
aprovisionà	2	0	aprovisiona	2	8	8
aprovà	2	136	aprova	2	1662	1798
aprovàrem	2	0	aprovarem	2	341	341
aprovés	2	455	aproves	2	3	458
aproví	2	0	aprovi	2	1734	1734
aproximarà	2	19	aproximara	2	0	19
aproximà	2	7	aproxima	2	296	303
aproximàrem	2	0	aproximarem	2	1	1
aproximés	2	5	aproximes	2	0	5
aproximí	2	0	aproximi	2	63	63
apugés	2	2	apuges	2	0	2
apugí	2	0	apugi	2	1	1
apujà	2	2	apuja	2	53	55
apuntalarà	2	5	apuntalara	2	0	5
apuntalà	2	0	apuntala	2	9	9
apuntalí	2	0	apuntali	2	5	5
apuntarà	2	20	apuntara	2	0	20
apuntà	2	11	apunta	2	1052	1063
apuntàrem	2	0	apuntarem	2	1	1
apuntàreu	2	0	apuntareu	2	1	1
apuntés	2	7	apuntes	2	14	21
apuntí	2	0	apunti	2	62	62
apunyalarà	2	3	apunyalara	2	0	3
apunyalà	2	2	apunyala	2	26	28
apunyalés	2	0	apunyales	2	1	1
apunyalí	2	0	apunyali	2	1	1
apurà	2	0	apura	2	3	3
apòcope	4	2	apocope	2	0	2
apòria	4	0	aporia	4	3	3
apòstata	0	26	apostata	2	0	26
apòstates	0	14	apostates	2	2	16
apòstrof	4	43	apostrof	2	0	43
apòstrofe	4	1	apostrofe	2	0	1
aquarterà	2	1	aquartera	2	2	3
aquedà	2	0	aqueda	2	1	1
aquós	0	33	aquos	4	1	34
arabitzà	2	1	arabitza	2	0	1
araucà	0	0	arauca	4	5	5
arbitrarà	2	3	arbitrara	2	0	3
arbitrà	2	2	arbitra	2	4	6
arbitrària	0	492	arbitraria	2	9	501
arbitràries	0	294	arbitraries	2	0	294
arbitrés	2	2	arbitres	2	0	2
arbitrí	2	0	arbitri	2	83	83
arborà	2	0	arbora	2	5	5
arborés	2	0	arbores	2	1	1
arborí	2	0	arbori	2	39	39
arbrés	2	0	arbres	2	2324	2324
arcà	2	6	arca	4	117	123
arengués	2	0	arengues	4	7	7
arenguí	2	0	arengui	2	1	1
arengà	2	0	arenga	4	9	9
arenà	2	0	arena	4	335	335
arenària	4	0	arenaria	2	4	4
arenés	2	0	arenes	4	52	52
argeletà	0	0	argeleta	4	2	2
argentà	2	0	argenta	4	2	2
argentí	2	325	argenti	2	0	325
argilà	2	0	argila	4	367	367
argilés	2	0	argiles	4	38	38
argollà	2	0	argolla	4	4	4
argumentarà	2	2	argumentara	2	0	2
argumentà	2	50	argumenta	2	482	532
argumentés	2	1	argumentes	2	0	1
argumentí	2	0	argumenti	2	12	12
arlès	0	0	arles	4	44	44
arlés	0	2	arles	4	44	46
armarà	2	5	armara	2	1	6
armà	2	3	arma	4	2035	2038
armèria	4	0	armeria	4	44	44
armèries	4	0	armeries	4	8	8
armés	2	4	armes	4	11196	11200
armí	2	0	armi	2	18	18
armó	4	0	armo	2	2	2
arnià	2	0	arnia	2	1	1
arnà	2	0	arna	4	55	55
arnès	4	48	arnes	4	104	152
arnés	2	8	arnes	4	104	112
arní	2	0	arni	2	2	2
aromatitzà	2	0	aromatitza	2	2	2
aromà	2	0	aroma	4	133	133
aromés	2	0	aromes	4	118	118
arpegí	2	0	arpegi	4	18	18
arpellà	2	0	arpella	4	5	5
arpillerà	2	0	arpillera	4	7	7
arpillerés	2	0	arpilleres	4	1	1
arpà	2	0	arpa	4	220	220
arpés	2	0	arpes	4	87	87
arpó	4	17	arpo	2	0	17
arquegés	2	1	arqueges	2	2	3
arquegí	2	0	arquegi	2	1	1
arquejà	2	0	arqueja	2	10	10
arqués	2	0	arques	4	206	206
arrabassarà	2	1	arrabassara	2	0	1
arrabassà	2	4	arrabassa	2	21	25
arrabassàrem	2	0	arrabassarem	2	1	1
arrabassés	2	4	arrabasses	2	0	4
arrabassí	2	0	arrabassi	2	8	8
arraconarà	2	1	arraconara	2	0	1
arraconà	2	0	arracona	2	2	2
arraconí	2	0	arraconi	2	1	1
arrambàrem	2	0	arrambarem	2	1	1
arrancarà	2	1	arrancara	2	0	1
arrancà	2	0	arranca	2	14	14
arrancàreu	2	0	arrancareu	2	1	1
arrangés	2	2	arranges	2	0	2
arrangí	2	0	arrangi	2	1	1
arranjà	2	13	arranja	2	69	82
arranjàreu	2	0	arranjareu	2	1	1
arranqués	2	1	arranques	2	1	2
arranquí	2	0	arranqui	2	2	2
arrapà	2	1	arrapa	2	1	2
arrasarà	2	2	arrasara	2	0	2
arrastrà	2	0	arrastra	2	2	2
arrasà	2	4	arrasa	2	25	29
arrasàrem	2	0	arrasarem	2	2	2
arrasés	2	2	arrases	2	0	2
arrasí	2	0	arrasi	2	3	3
arravatés	2	1	arravates	2	0	1
arrecerà	2	0	arrecera	2	2	2
arredonirà	2	1	arredonira	2	0	1
arreglarà	2	57	arreglara	2	0	57
arreglà	2	5	arregla	2	123	128
arreglàrem	2	0	arreglarem	2	37	37
arreglés	2	10	arregles	2	9	19
arreglí	2	0	arregli	2	53	53
arrelarà	2	6	arrelara	2	0	6
arrelà	2	0	arrela	2	17	17
arrelés	2	6	arreles	2	0	6
arrelí	2	0	arreli	2	22	22
arremetré	2	0	arremetre	2	27	27
arremetí	2	0	arremeti	2	3	3
arremolinà	2	0	arremolina	2	1	1
arrencarà	2	19	arrencara	2	0	19
arrencà	2	5	arrenca	2	131	136
arrencàrem	2	0	arrencarem	2	1	1
arrendà	2	2	arrenda	2	3	5
arrendí	2	0	arrendi	2	2	2
arrenglerà	2	1	arrenglera	2	0	1
arrenqués	2	5	arrenques	2	2	7
arrenquí	2	0	arrenqui	2	29	29
arrepenjà	2	0	arrepenja	2	5	5
arreplegarà	2	2	arreplegara	2	0	2
arreplegués	2	1	arreplegues	4	1	2
arrepleguí	2	0	arreplegui	2	6	6
arreplegà	2	3	arreplega	4	16	19
arreplegàrem	2	0	arreplegarem	2	2	2
arrestarà	2	2	arrestara	2	0	2
arrestà	2	11	arresta	2	24	35
arrestàrem	2	0	arrestarem	2	1	1
arrestàreu	2	0	arrestareu	2	1	1
arrestés	2	7	arrestes	2	4	11
arrestí	2	0	arresti	2	16	16
arreí	2	0	arrei	4	1	1
arribarà	2	843	arribara	2	7	850
arribà	2	933	arriba	2	4253	5186
arribàrem	2	2	arribarem	2	343	345
arribàreu	2	0	arribareu	2	11	11
arribés	2	632	arribes	2	93	725
arribí	2	0	arribi	2	2386	2386
arrimarà	2	0	arrimara	2	1	1
arrimà	2	0	arrima	2	6	6
arriscarà	2	13	arriscara	2	0	13
arriscà	2	2	arrisca	2	89	91
arriscàrem	2	0	arriscarem	2	8	8
arrisqués	2	6	arrisques	2	14	20
arrisquí	2	0	arrisqui	2	13	13
arrissà	2	0	arrissa	2	4	4
arrissí	2	0	arrissi	2	13	13
arriés	2	1	arries	2	0	1
arrodonirà	2	10	arrodonira	2	0	10
arrogués	2	2	arrogues	2	0	2
arroguí	2	0	arrogui	2	9	9
arrogà	2	2	arroga	2	17	19
arromangués	2	0	arromangues	2	1	1
arromanguí	2	0	arromangui	2	2	2
arromangàrem	2	0	arromangarem	2	1	1
arronsà	2	3	arronsa	2	37	40
arronsés	2	1	arronses	2	1	2
arrossegarà	2	9	arrossegara	2	0	9
arrossegués	2	3	arrossegues	2	8	11
arrosseguí	2	0	arrossegui	2	26	26
arrossegà	2	7	arrossega	2	614	621
arrossegàrem	2	0	arrossegarem	2	2	2
arrufà	2	0	arrufa	2	7	7
arrufí	2	1	arrufi	2	2	3
arrugués	2	0	arrugues	4	66	66
arruguí	2	0	arrugui	2	1	1
arrugà	2	0	arruga	4	17	17
arruïnarà	2	17	arruïnara	2	1	18
arruïnà	2	6	arruïna	2	42	48
arruïnàrem	2	0	arruïnarem	2	7	7
arruïnés	2	6	arruïnes	2	1	7
arruïní	2	0	arruïni	2	22	22
arsènic	0	177	arsenic	2	6	183
artesà	0	98	artesa	4	31	129
articularà	2	10	articulara	2	0	10
articulà	2	3	articula	2	94	97
articulàrem	2	0	articularem	2	1	1
articulés	2	1	articules	2	1	2
articulí	2	0	articuli	2	16	16
artigués	2	0	artigues	4	1	1
artigà	2	0	artiga	4	4	4
artigàs	2	0	artigas	4	54	54
artèria	4	124	arteria	4	15	139
artèries	4	143	arteries	4	5	148
arxivarà	2	10	arxivara	2	0	10
arxivà	2	2	arxiva	2	97	99
arxivés	2	1	arxives	2	1	2
arxiví	2	0	arxivi	2	6	6
arè	4	3	are	4	202	205
aré	4	0	are	4	202	202
ascendirà	2	66	ascendira	2	1	67
ascendírem	2	0	ascendirem	2	2	2
asclà	2	0	ascla	4	5	5
asclés	2	0	ascles	4	12	12
asfaltà	2	1	asfalta	2	0	1
asfaltè	4	1	asfalte	2	0	1
asfixiarà	2	4	asfixiara	2	0	4
asfixià	2	1	asfixia	2	18	19
asfixiés	2	0	asfixies	2	2	2
asfíxia	4	87	asfixia	2	18	105
asfíxies	4	1	asfixies	2	2	3
asilà	2	2	asila	2	0	2
asilàrem	2	0	asilarem	2	1	1
asilí	2	0	asili	2	4	4
aspirarà	2	2	aspirara	2	0	2
aspirà	2	2	aspira	2	453	455
aspiràrem	2	0	aspirarem	2	1	1
aspirés	2	5	aspires	2	1	6
aspirí	2	0	aspiri	2	32	32
aspiés	2	0	aspies	2	7	7
asprà	2	0	aspra	2	48	48
asprés	2	0	aspres	2	45	45
assabentarà	2	12	assabentara	2	1	13
assabentà	2	44	assabenta	2	146	190
assabentàrem	2	1	assabentarem	2	7	8
assabentés	2	15	assabentes	2	4	19
assabentí	2	0	assabenti	2	41	41
assaborirà	2	1	assaborira	2	0	1
assacià	2	0	assacia	2	1	1
assagés	2	2	assages	2	1	3
assagí	2	0	assagi	2	4	4
assajarà	2	1	assajara	2	0	1
assajà	2	5	assaja	2	17	22
assajàrem	2	0	assajarem	2	2	2
assaltà	2	12	assalta	2	11	23
assaltàrem	2	0	assaltarem	2	2	2
assaltàreu	2	0	assaltareu	2	1	1
assaltés	2	2	assaltes	2	1	3
assaltí	2	0	assalti	2	2	2
assaonà	2	0	assaona	2	2	2
assassinarà	2	4	assassinara	2	0	4
assassinà	2	17	assassina	2	203	220
assassinés	2	19	assassines	2	37	56
assassiní	2	0	assassini	2	7	7
assecarà	2	2	assecara	2	0	2
assecà	2	0	asseca	2	52	52
assegurarà	2	273	assegurara	2	1	274
assegurà	2	69	assegura	2	1046	1115
asseguràrem	2	0	assegurarem	2	152	152
asseguràreu	2	0	assegurareu	2	9	9
assegurés	2	86	assegures	2	3	89
assegurí	2	0	asseguri	2	608	608
assegués	2	20	assegues	2	0	20
asseguí	2	0	assegui	2	95	95
assemblarà	2	10	assemblara	2	0	10
assemblà	2	2	assembla	2	787	789
assemblés	2	20	assembles	2	17	37
assemblí	2	0	assembli	2	30	30
assentarà	2	7	assentara	2	0	7
assentà	2	26	assenta	2	60	86
assentàrem	2	0	assentarem	2	1	1
assentés	2	2	assentes	2	1	3
assentí	2	2	assenti	2	40	42
assentís	2	1	assentis	2	2	3
assenyalarà	2	16	assenyalara	2	0	16
assenyalà	2	72	assenyala	2	2921	2993
assenyalàrem	2	0	assenyalarem	2	11	11
assenyalés	2	25	assenyales	2	8	33
assenyalí	2	0	assenyali	2	166	166
assequés	2	4	asseques	2	1	5
assequí	2	0	assequi	2	11	11
asserenarà	2	1	asserenara	2	0	1
asserenà	2	0	asserena	2	1	1
asserení	2	0	assereni	2	2	2
assessorarà	2	8	assessorara	2	0	8
assessorà	2	2	assessora	0	177	179
assessorés	2	7	assessores	0	5	12
assessorí	2	0	assessori	2	15	15
assestarà	2	4	assestara	2	0	4
assestà	2	0	assesta	2	11	11
assestés	2	1	assestes	2	0	1
assetgés	2	3	assetges	2	2	5
assetgí	2	0	assetgi	2	9	9
assetià	2	0	assetia	2	1	1
assetjarà	2	1	assetjara	2	0	1
assetjà	2	26	assetja	2	42	68
assetjàrem	2	0	assetjarem	2	1	1
asseuré	2	17	asseure	2	624	641
asseverà	2	1	assevera	2	9	10
asseverés	2	1	asseveres	2	0	1
asseverí	2	0	asseveri	2	1	1
assignarà	2	130	assignara	2	0	130
assignà	2	67	assigna	2	926	993
assignàrem	2	0	assignarem	2	20	20
assignàreu	2	0	assignareu	2	2	2
assignés	2	23	assignes	2	1	24
assigní	2	0	assigni	2	141	141
assimilarà	2	1	assimilara	2	0	1
assimilà	2	1	assimila	2	26	27
assimilés	2	3	assimiles	2	0	3
assimilí	2	0	assimili	2	7	7
assistirà	2	97	assistira	2	0	97
assistírem	2	0	assistirem	2	77	77
assistíreu	2	0	assistireu	2	6	6
assitià	2	0	assitia	2	1	1
associarà	2	30	associara	2	0	30
associà	2	14	associa	2	661	675
associàrem	2	0	associarem	2	2	2
associàreu	2	0	associareu	2	1	1
associés	2	13	associes	2	3	16
assolellà	2	0	assolella	2	1	1
assolirà	2	12	assolira	2	0	12
assolà	2	9	assola	2	47	56
assolés	2	1	assoles	2	0	1
assolí	2	184	assoli	2	4	188
assolírem	2	0	assolirem	2	2	2
assolís	2	22	assolis	2	0	22
assoní	2	0	assoni	2	1	1
assortirà	2	14	assortira	2	0	14
assosseguí	2	0	assossegui	2	1	1
assossegà	2	0	assossega	2	3	3
assotà	2	0	assota	2	45	45
assotí	2	0	assoti	2	3	3
assumirà	2	273	assumira	2	0	273
assumírem	2	0	assumirem	2	36	36
assumíreu	2	0	assumireu	2	1	1
assèiem	2	4	asseiem	2	48	52
assèieu	2	0	asseieu	2	5	5
asséiem	2	0	asseiem	2	48	48
asséieu	2	0	asseieu	2	5	5
astorí	2	0	astori	2	1	1
atabalarà	2	1	atabalara	2	0	1
atabalà	2	0	atabala	2	5	5
atabalés	2	1	atabales	2	1	2
atabalí	2	0	atabali	2	1	1
atacarà	2	19	atacara	2	1	20
ataconà	2	0	atacona	2	1	1
atacà	2	158	ataca	2	421	579
atacàrem	2	0	atacarem	2	23	23
atacàreu	2	0	atacareu	2	1	1
atalaià	2	0	atalaia	2	3	3
atallarà	2	4	atallara	2	0	4
atallà	2	0	atalla	2	11	11
atallàrem	2	0	atallarem	2	1	1
atallés	2	2	atalles	2	0	2
atallí	2	0	atalli	2	9	9
atansarà	2	0	atansara	2	2	2
atansà	2	0	atansa	2	6	6
atansés	2	1	atanses	2	1	2
ataqués	2	58	ataques	2	4	62
ataquí	2	0	ataqui	2	43	43
ataquín	2	0	ataquin	2	42	42
atemorirà	2	1	atemorira	2	0	1
atemptarà	2	4	atemptara	2	0	4
atemptà	2	0	atempta	2	148	148
atemptés	2	2	atemptes	2	0	2
atemptí	2	0	atempti	2	32	32
atendré	2	10	atendre	2	1114	1124
atengués	2	9	atengues	2	0	9
atenguí	2	0	atengui	2	100	100
atenuarà	2	6	atenuara	2	0	6
atenuà	2	0	atenua	2	31	31
atenès	0	29	atenes	4	1388	1417
atenés	0	0	atenes	4	1388	1388
aterrarà	2	7	aterrara	2	0	7
aterrirà	2	1	aterrira	2	0	1
aterrà	2	26	aterra	2	36	62
aterràrem	2	0	aterrarem	2	3	3
aterrés	2	15	aterres	2	1	16
aterrí	2	1	aterri	2	18	19
aterrís	2	0	aterris	2	2	2
atestarà	2	1	atestara	2	0	1
atestà	2	0	atesta	2	13	13
atestí	2	0	atesti	2	4	4
atiarà	2	2	atiara	2	0	2
atindré	2	13	atindre	2	1	14
atingués	2	7	atingues	2	0	7
atinguí	2	0	atingui	2	72	72
atipà	2	0	atipa	2	2	2
atià	2	0	atia	2	8	8
atií	2	0	atii	2	1	1
atomitzà	2	0	atomitza	2	1	1
atonyinés	2	1	atonyines	2	1	2
atorgarà	2	94	atorgara	2	1	95
atorgués	2	42	atorgues	2	1	43
atorguí	2	0	atorgui	2	232	232
atorgà	2	95	atorga	2	1159	1254
atorgàrem	2	0	atorgarem	2	15	15
atracarà	2	1	atracara	2	0	1
atracà	2	1	atraca	2	8	9
atragués	2	11	atragues	2	0	11
atraparà	2	4	atrapara	2	1	5
atrapà	2	3	atrapa	2	74	77
atrapàrem	2	0	atraparem	2	13	13
atrapés	2	6	atrapes	2	5	11
atrapí	2	0	atrapi	2	11	11
atraqués	2	2	atraques	2	1	3
atraquí	2	0	atraqui	2	1	1
atrauré	2	2	atraure	2	394	396
atresorà	2	0	atresora	2	9	9
atresorés	2	2	atresores	2	0	2
atresorí	2	0	atresori	2	1	1
atrevirà	2	16	atrevira	2	2	18
atrevírem	2	0	atrevirem	2	1	1
atribuírem	2	0	atribuirem	2	5	5
atrinxerà	2	2	atrinxera	2	0	2
atrinxerí	2	0	atrinxeri	2	2	2
atrofià	2	0	atrofia	2	4	4
atropellarà	2	1	atropellara	2	0	1
atropellà	2	0	atropella	2	13	13
atropellés	2	1	atropelles	2	1	2
atropellí	2	0	atropelli	2	3	3
atropà	2	0	atropa	2	6	6
atròfia	4	30	atrofia	2	4	34
aturarà	2	149	aturara	2	0	149
aturà	2	80	atura	4	1074	1154
aturàrem	2	0	aturarem	2	9	9
aturàreu	2	0	aturareu	2	4	4
aturés	2	56	atures	4	17	73
aturí	2	0	aturi	2	116	116
atès	2	8370	ates	4	5	8375
atés	2	13	ates	4	5	18
atònit	0	32	atonit	2	0	32
atònits	0	25	atonits	2	0	25
audità	2	0	audita	2	11	11
audités	2	1	audites	2	1	2
audití	2	0	auditi	2	6	6
augmentarà	2	971	augmentara	2	0	971
augmentà	2	120	augmenta	2	2788	2908
augmentàrem	2	0	augmentarem	2	40	40
augmentàreu	2	0	augmentareu	2	1	1
augmentés	2	81	augmentes	2	4	85
augmentí	2	0	augmenti	2	781	781
augurà	2	0	augura	2	65	65
augurés	2	0	augures	2	2	2
augurí	2	1	auguri	4	138	139
aureolà	2	0	aureola	2	3	3
aurèola	4	27	aureola	2	3	30
aurèoles	4	2	aureoles	2	0	2
auscultà	2	0	ausculta	2	2	2
autenticarà	2	1	autenticara	2	0	1
autenticà	2	0	autentica	2	32	32
autentificà	2	0	autentifica	2	2	2
autentifiquí	2	0	autentifiqui	2	1	1
autentiquí	2	0	autentiqui	2	5	5
autoajudà	2	0	autoajuda	4	59	59
autoanomenà	2	2	autoanomena	2	7	9
autoassignà	2	0	autoassigna	2	1	1
autocensurà	2	0	autocensura	4	55	55
autocontrolà	2	0	autocontrola	2	1	1
autocrític	0	12	autocritic	2	0	12
autocrítica	0	144	autocritica	2	0	144
autocrítiques	0	1	autocritiques	2	0	1
autodenominà	2	0	autodenomina	2	11	11
autodenominí	2	0	autodenomini	2	1	1
autodestruírem	2	0	autodestruirem	2	1	1
autodeterminà	2	0	autodetermina	2	1	1
autodissoldré	2	0	autodissoldre	2	2	2
autoestimulà	2	0	autoestimula	2	2	2
autoexclogués	2	1	autoexclogues	2	0	1
autoexcloguí	2	0	autoexclogui	2	2	2
autoexclouré	2	0	autoexcloure	2	9	9
autoexilià	2	1	autoexilia	2	0	1
autofinancí	2	0	autofinanci	2	2	2
autofinançà	2	0	autofinança	2	5	5
autoimposés	2	1	autoimposes	2	0	1
autoimposí	2	0	autoimposi	2	1	1
automarginí	2	0	automargini	2	1	1
automatitzà	2	0	automatitza	2	10	10
automatitzí	2	0	automatitzi	2	1	1
autoproclamarà	2	1	autoproclamara	2	0	1
autoproclamà	2	7	autoproclama	2	10	17
autoproclamés	2	1	autoproclames	2	0	1
autoproclamí	2	0	autoproclami	2	1	1
autoqualificà	2	0	autoqualifica	2	2	2
autoregulà	2	0	autoregula	2	3	3
autoregulí	2	0	autoreguli	2	6	6
autoritzarà	2	35	autoritzara	2	1	36
autoritzà	2	42	autoritza	2	413	455
autoritzàrem	2	0	autoritzarem	2	6	6
autoritzés	2	40	autoritzes	2	3	43
autoritzí	2	0	autoritzi	2	160	160
autèntic	0	1901	autentic	2	1	1902
autèntica	0	2249	autentica	2	32	2281
autèntiques	0	416	autentiques	2	0	416
auxiliarà	2	2	auxiliara	2	0	2
auxilià	2	0	auxilia	2	2	2
avalarà	2	1	avalara	2	0	1
avaluarà	2	193	avaluara	2	0	193
avaluà	2	3	avalua	2	402	405
avaluàrem	2	0	avaluarem	2	70	70
avalués	2	41	avalues	2	0	41
avalà	2	0	avala	2	52	52
avalés	2	8	avales	2	0	8
avalí	2	0	avali	2	16	16
avancé	4	0	avance	2	2	2
avancés	2	93	avances	2	2	95
avancí	2	0	avanci	2	749	749
avantatgés	2	1	avantatges	4	3900	3901
avantatjà	2	1	avantatja	2	10	11
avantposà	2	0	avantposa	2	4	4
avançarà	2	112	avançara	2	0	112
avançà	2	105	avança	2	1062	1167
avançàrem	2	0	avançarem	2	116	116
avançàreu	2	0	avançareu	2	2	2
avarià	2	0	avaria	4	88	88
avariés	2	0	avaries	4	46	46
avarà	2	2	avara	0	17	19
avarés	2	0	avares	0	1	1
avassallà	2	0	avassalla	2	1	1
aventurà	2	2	aventura	4	740	742
aventurés	2	0	aventures	4	556	556
aventurí	2	0	aventuri	2	8	8
avençà	2	0	avença	2	2	2
avergonyirà	2	3	avergonyira	2	0	3
avergonyírem	2	0	avergonyirem	2	2	2
averà	2	0	avera	2	1	1
avesarà	2	1	avesara	2	0	1
aveïnà	2	0	aveïna	2	62	62
aveïní	2	0	aveïni	2	1	1
aviarà	2	0	aviara	2	1	1
aviciés	2	0	avicies	2	1	1
avicií	2	0	avicii	2	4	4
avidà	2	0	avida	2	3	3
avidí	2	0	avidi	2	6	6
avilà	2	0	avila	2	9	9
avilès	0	1	aviles	2	3	4
avinencés	2	0	avinences	4	1	1
avinençà	2	0	avinença	4	15	15
avingués	2	7	avingues	2	0	7
avinguí	2	0	avingui	2	11	11
avisarà	2	42	avisara	2	0	42
avisà	2	11	avisa	2	224	235
avisàrem	2	0	avisarem	2	7	7
avisés	2	12	avises	2	4	16
avisí	2	0	avisi	2	43	43
avivarà	2	8	avivara	2	0	8
avivà	2	0	aviva	2	32	32
aviví	2	0	avivi	2	2	2
aviària	0	325	aviaria	2	2	327
aviàries	0	4	aviaries	2	1	5
avió	4	2965	avio	2	8	2973
avocà	2	0	avoca	2	11	11
avortarà	2	11	avortara	2	0	11
avortà	2	5	avorta	2	47	52
avortés	2	1	avortes	2	0	1
avortí	2	0	avorti	2	3	3
avortó	4	0	avorto	2	2	2
avé	2	19	ave	4	65	84
avís	2	1981	avis	4	326	2307
aïllarà	2	2	aïllara	2	0	2
aïllà	2	14	aïlla	2	61	75
aïllàrem	2	0	aïllarem	2	4	4
aïllés	2	1	aïlles	2	0	1
aïllí	2	1	aïlli	2	19	20
aïnà	2	0	aïna	4	1	1
aïnés	2	0	aïnes	4	1	1
badallà	2	0	badalla	2	3	3
badarià	0	1	badaria	2	0	1
badarà	2	0	badara	2	5	5
badà	2	1	bada	4	17	18
badès	0	0	bades	4	9	9
badí	2	0	badi	2	13	13
baixarà	2	74	baixara	2	1	75
baixà	2	28	baixa	0	7862	7890
baixàrem	2	0	baixarem	2	19	19
baixàreu	2	0	baixareu	2	1	1
baixí	2	0	baixi	2	104	104
baixó	4	3	baixo	2	31	34
baià	2	0	baia	0	82	82
bajà	0	0	baja	4	39	39
balafiarà	2	3	balafiara	2	0	3
balafià	2	0	balafia	2	24	24
balafiés	2	1	balafies	2	0	1
balancejà	2	0	balanceja	2	24	24
balancé	4	0	balance	2	18	18
balancés	4	0	balances	4	99	99
balancí	4	16	balanci	2	0	16
balandrejà	2	0	balandreja	2	1	1
balançà	2	0	balança	4	509	509
balbotejà	2	0	balboteja	2	4	4
balbucegés	2	0	balbuceges	2	1	1
balbucejà	2	0	balbuceja	2	1	1
balbés	2	0	balbes	0	2	2
balcà	2	1	balca	4	1	2
balcó	4	184	balco	2	3	187
baldà	2	0	balda	4	6	6
baldés	2	0	baldes	4	3	3
ballà	2	6	balla	4	171	177
ballàrem	2	0	ballarem	2	3	3
ballés	2	3	balles	4	7	10
ballí	2	0	balli	2	14	14
balmà	2	0	balma	4	6	6
balmés	2	0	balmes	4	12	12
balès	0	0	bales	4	375	375
balés	0	0	bales	4	375	375
balí	2	3	bali	4	498	501
bambarà	2	0	bambara	2	36	36
bambà	2	0	bamba	4	38	38
bambés	2	0	bambes	4	2	2
bambí	2	0	bambi	2	27	27
banalitzarà	2	1	banalitzara	2	0	1
banalitzà	2	0	banalitza	2	6	6
banalitzí	2	0	banalitzi	2	1	1
bancà	2	0	banca	4	480	480
bancària	0	496	bancaria	2	7	503
bancàries	0	428	bancaries	2	3	431
bandegés	2	0	bandeges	2	1	1
bandegí	2	0	bandegi	2	5	5
bandejarà	2	1	bandejara	2	0	1
bandejà	2	2	bandeja	2	5	7
banqués	2	0	banques	4	15	15
bantú	0	12	bantu	0	110	122
bantús	0	5	bantus	0	146	151
banyarà	2	2	banyara	2	0	2
banyà	2	0	banya	4	406	406
banyés	2	1	banyes	4	319	320
banyí	2	0	banyi	2	3	3
banyó	4	0	banyo	2	13	13
barallarà	2	3	barallara	2	0	3
barallà	2	0	baralla	4	621	621
barallàrem	2	0	barallarem	2	3	3
barallés	2	0	baralles	4	233	233
barallí	2	0	baralli	2	1	1
baratarà	2	1	baratara	2	0	1
baratà	2	0	barata	0	768	768
baratés	2	0	barates	0	322	322
barbaritzà	2	1	barbaritza	2	0	1
barbarà	2	1	barbara	2	474	475
barbà	2	0	barba	4	251	251
barbàries	4	3	barbaries	2	0	3
barbés	2	1	barbes	4	42	43
barbó	4	0	barbo	2	3	3
barrarà	2	3	barrara	2	0	3
barregés	2	3	barreges	4	62	65
barregí	2	0	barregi	2	25	25
barrejarà	2	21	barrejara	2	0	21
barrejà	2	2	barreja	4	1608	1610
barrigà	2	0	barriga	2	2	2
barrinà	2	0	barrina	4	6	6
barrà	2	0	barra	4	7281	7281
barrés	2	0	barres	4	1558	1558
barrí	2	0	barri	4	1796	1796
barró	4	0	barro	2	9	9
barxetà	0	0	barxeta	4	3	3
basarà	2	199	basara	2	8	207
basculà	2	0	bascula	2	4	4
basculés	2	2	bascules	2	0	2
bascà	2	0	basca	0	225	225
basqués	2	0	basques	0	37	37
bastarà	2	148	bastara	2	0	148
bastirà	2	2	bastira	2	0	2
bastonejà	2	0	bastoneja	2	3	3
bastà	2	0	basta	0	1027	1027
bastés	2	22	bastes	0	23	45
bastí	2	9	basti	2	145	154
bastís	2	1	bastis	2	0	1
bastó	4	263	basto	2	0	263
basà	2	41	basa	4	5153	5194
basàrem	2	0	basarem	2	26	26
basés	2	36	bases	4	4918	4954
basí	2	0	basi	2	585	585
batallarà	2	1	batallara	2	0	1
batallà	2	2	batalla	4	9736	9738
batallés	2	0	batalles	4	1163	1163
batallí	2	0	batalli	2	1	1
batalló	4	929	batallo	2	0	929
batanà	2	0	batana	2	1	1
batanés	2	0	batanes	2	1	1
bategués	2	1	bategues	4	0	1
bateguí	2	0	bategui	2	7	7
bategà	2	0	batega	4	53	53
bategés	2	5	bateges	2	0	5
bategí	2	0	bategi	2	4	4
batejarà	2	4	batejara	2	0	4
batejà	2	31	bateja	2	17	48
batejàrem	2	0	batejarem	2	1	1
bateà	0	0	batea	4	3	3
batià	2	0	batia	2	11	11
batollà	2	0	batolla	4	6	6
batollés	2	0	batolles	4	1	1
batré	2	2	batre	2	225	227
batussà	2	0	batussa	4	19	19
batussés	2	0	batusses	4	17	17
batà	4	1	bata	4	74	75
batés	2	0	bates	4	149	149
batí	2	2	bati	2	4	6
bavarès	0	103	bavares	2	0	103
bavegés	2	0	baveges	2	1	1
bavà	2	0	bava	4	35	35
baí	2	0	bai	0	151	151
beatificà	2	0	beatifica	2	1	1
beatífic	0	2	beatific	2	0	2
beatífica	0	4	beatifica	2	1	5
becà	2	0	beca	4	642	642
becària	0	16	becaria	2	1	17
befà	2	0	befa	4	10	10
begués	2	2	begues	4	4	6
beguí	0	0	begui	2	27	27
bellugués	2	0	bellugues	4	1	1
belluguí	2	0	bellugui	2	5	5
bellugà	2	0	belluga	4	13	13
bellugó	4	0	bellugo	2	1	1
belà	2	0	bela	4	44	44
belés	2	0	beles	2	1	1
belí	2	0	beli	2	45	45
beneficiarà	2	628	beneficiara	2	1	629
beneficià	2	10	beneficia	2	1084	1094
beneficiàrem	2	0	beneficiarem	2	33	33
beneficiàreu	2	0	beneficiareu	2	2	2
beneficiària	0	44	beneficiaria	2	257	301
beneficiàries	0	90	beneficiaries	2	0	90
beneficiés	2	24	beneficies	2	1	25
beneficà	2	0	benefica	2	1	1
benferrí	0	0	benferri	4	2	2
beniferrí	0	0	beniferri	4	1	1
benimelí	0	0	benimeli	4	2	2
benissodà	0	0	benissoda	4	2	2
benissuerà	0	0	benissuera	4	2	2
benèfic	0	98	benefic	2	1	99
benèfica	0	160	benefica	2	1	161
benèfiques	0	158	benefiques	2	0	158
bequés	2	0	beques	4	472	472
berenà	2	0	berena	4	2	2
berlinès	0	20	berlines	4	5	25
berlinés	0	1	berlines	4	5	6
besarà	2	1	besara	2	0	1
bescanvià	2	2	bescanvia	2	5	7
besnét	4	65	besnet	4	14	79
besnéta	4	19	besneta	4	2	21
besnétes	4	3	besnetes	4	1	4
besnéts	4	22	besnets	4	6	28
bessonà	2	0	bessona	2	70	70
bessonés	2	0	bessones	2	189	189
besà	2	2	besa	2	41	43
besàrem	2	0	besarem	2	1	1
besés	2	1	beses	2	1	2
besí	2	0	besi	2	5	5
betés	4	1	betes	4	7	8
beuré	2	18	beure	4	822	840
bifurcarà	2	1	bifurcara	2	0	1
bifurcà	2	0	bifurca	2	19	19
biguetà	0	0	bigueta	4	1	1
binà	2	0	bina	2	11	11
binària	0	282	binaria	2	14	296
binàries	0	199	binaries	2	1	200
biní	2	0	bini	2	23	23
bioacumulà	2	0	bioacumula	2	2	2
biografià	2	0	biografia	4	622	622
biografiés	2	0	biografies	4	181	181
bioscà	0	0	biosca	4	6	6
biosintetitzà	2	0	biosintetitza	2	3	3
birbà	2	0	birba	2	1	1
birlà	2	0	birla	4	2	2
bisecarà	2	1	bisecara	2	0	1
bisecà	2	0	biseca	2	2	2
bisellà	2	0	bisella	2	2	2
bisà	2	0	bisa	4	6	6
bisí	2	0	bisi	2	11	11
bisó	4	61	biso	2	3	64
bitllà	2	0	bitlla	4	5	5
bitllés	2	0	bitlles	4	102	102
bità	2	0	bita	4	1	1
bitè	4	0	bite	2	4	4
bité	4	0	bite	2	4	4
bités	2	0	bites	4	11	11
bitò	4	1	bito	2	1	2
bitó	4	4	bito	2	1	5
blandà	2	0	blanda	2	5	5
blanquegí	2	0	blanquegi	2	2	2
blanquejà	2	0	blanqueja	2	4	4
blasfemà	2	0	blasfema	0	4	4
blasfemés	2	0	blasfemes	0	2	2
blasmés	2	0	blasmes	2	1	1
blasonà	2	0	blasona	2	1	1
blastomà	2	0	blastoma	4	1	1
bledà	0	0	bleda	4	38	38
bleguí	2	0	blegui	2	1	1
blegà	2	0	blega	2	5	5
blindarà	2	1	blindara	2	0	1
blindà	2	0	blinda	2	1	1
blindés	2	1	blindes	2	0	1
blocarà	2	12	blocara	2	0	12
blocà	2	0	bloca	2	234	234
bloquegés	2	12	bloqueges	2	2	14
bloquegí	2	0	bloquegi	2	78	78
bloquejarà	2	58	bloquejara	2	0	58
bloquejà	2	9	bloqueja	2	589	598
bloquejàrem	2	0	bloquejarem	2	5	5
bloquejàreu	2	0	bloquejareu	2	1	1
bloquí	2	0	bloqui	2	1	1
bobinà	2	0	bobina	4	101	101
bobinés	2	0	bobines	4	62	62
bobò	4	0	bobo	0	17	17
bocí	4	31	boci	2	0	31
bogejà	2	0	bogeja	2	9	9
bogués	2	0	bogues	4	5	5
bogà	2	0	boga	4	12	12
boiarà	2	0	boiara	2	1	1
boicotegés	2	2	boicoteges	2	1	3
boicotegí	2	0	boicotegi	2	4	4
boicotejarà	2	2	boicotejara	2	0	2
boicotejà	2	3	boicoteja	2	10	13
boirà	2	0	boira	4	491	491
boirés	2	0	boires	4	35	35
boixà	2	0	boixa	4	6	6
boixés	2	0	boixes	4	3	3
boià	2	0	boia	4	17	17
boiés	2	0	boies	4	27	27
bolcarà	2	4	bolcara	2	0	4
bolcà	2	3	bolca	4	76	79
bollà	2	0	bolla	4	1	1
bollés	2	0	bolles	4	5	5
bollí	2	0	bolli	2	1	1
bolqués	2	2	bolques	4	0	2
bolquí	2	0	bolqui	2	3	3
boló	4	0	bolo	4	11	11
bombardegés	2	3	bombardeges	2	1	4
bombardegí	2	0	bombardegi	2	8	8
bombardejarà	2	2	bombardejara	2	0	2
bombardejà	2	11	bombardeja	2	32	43
bombardejàrem	2	0	bombardejarem	2	4	4
bombarà	2	1	bombara	2	0	1
bombejà	2	0	bombeja	2	8	8
bombollà	2	0	bombolla	4	290	290
bombollés	2	0	bombolles	4	267	267
bombà	2	0	bomba	4	1397	1397
bombés	2	0	bombes	4	1262	1262
bombí	2	3	bombi	2	1	4
bombó	4	14	bombo	2	96	110
bonegó	4	1	bonego	2	0	1
bongós	4	1	bongos	4	18	19
bonificarà	2	1	bonificara	2	0	1
bonyigués	2	0	bonyigues	4	1	1
bonyigà	2	0	bonyiga	4	1	1
bonó	4	0	bono	4	129	129
boquejà	2	0	boqueja	2	2	2
borbollejà	2	0	borbolleja	2	1	1
borbollà	2	0	borbolla	2	2	2
bordegí	2	0	bordegi	2	1	1
bordejà	2	0	bordeja	2	6	6
bordoní	2	0	bordoni	2	5	5
bordà	2	0	borda	0	171	171
bordés	2	0	bordes	4	23	23
bordí	2	0	bordi	2	2	2
bordó	4	15	bordo	2	3	18
borinà	2	0	borina	4	1	1
borlà	2	0	borla	4	9	9
borlés	2	0	borles	4	16	16
bornà	2	0	borna	2	2	2
bornés	2	0	bornes	2	3	3
borní	2	0	borni	2	35	35
borronés	2	0	borrones	2	2	2
borà	2	2	bora	4	36	38
borí	2	0	bori	4	4	4
borís	2	225	boris	4	279	504
boscós	0	29	boscos	4	3490	3519
bosquetà	0	1	bosqueta	4	0	1
bossellí	2	0	bosselli	2	2	2
botarà	2	1	botara	2	0	1
botonés	2	0	botones	2	1	1
botré	2	0	botre	2	1	1
botzinà	2	0	botzina	4	28	28
botzinés	2	0	botzines	4	5	5
botà	2	0	bota	4	91	91
boté	2	0	bote	2	4	4
botés	2	1	botes	4	232	233
botí	2	245	boti	2	3	248
botó	4	8093	boto	2	12	8105
boxejà	2	0	boxeja	2	1	1
boxà	2	0	boxa	4	231	231
boxés	2	0	boxes	4	33	33
boà	4	1	boa	4	80	81
bramulà	2	0	bramula	2	1	1
bramà	2	0	brama	4	32	32
bramí	2	0	brami	2	2	2
brancà	2	0	branca	4	2149	2149
brancó	4	0	branco	2	23	23
brandarà	2	1	brandara	2	0	1
brandà	2	1	branda	4	11	12
brandés	2	0	brandes	4	4	4
brandí	2	0	brandi	2	45	45
brandís	2	0	brandis	2	5	5
brandó	4	0	brando	2	21	21
branqués	2	0	branques	4	1366	1366
bregués	2	1	bregues	4	1	2
bregà	2	0	brega	4	35	35
bregàreu	2	0	bregareu	2	1	1
brescà	2	0	bresca	4	13	13
bresqués	2	0	bresques	4	6	6
bressolà	2	0	bressola	4	9	9
bressolés	2	0	bressoles	4	1	1
bresés	2	0	breses	4	1	1
bresí	2	0	bresi	2	1	1
brillarà	2	12	brillara	2	0	12
brillà	2	0	brilla	4	151	151
brillés	2	4	brilles	4	0	4
brillí	2	0	brilli	2	26	26
brilló	4	0	brillo	2	3	3
brindarà	2	251	brindara	2	0	251
brindà	2	3	brinda	2	1085	1088
brindàrem	2	0	brindarem	2	21	21
brindés	2	19	brindes	2	0	19
brindí	2	0	brindi	2	164	164
brisà	2	0	brisa	4	195	195
brisés	2	0	brises	4	13	13
brodarà	2	2	brodara	2	0	2
brodà	2	0	broda	2	4	4
brodés	2	0	brodes	2	1	1
brodí	2	0	brodi	2	4	4
brollarà	2	1	brollara	2	0	1
brollà	2	0	brolla	4	27	27
brollés	2	1	brolles	4	3	4
brollí	2	0	brolli	2	3	3
bromegí	2	0	bromegi	2	1	1
bromejà	2	0	bromeja	2	6	6
bromà	2	0	broma	4	778	778
bromés	2	0	bromes	4	198	198
bronzà	2	0	bronza	2	1	1
bronzés	2	0	bronzes	2	55	55
broqués	2	0	broques	4	7	7
brossà	2	0	brossa	4	661	661
brossés	2	0	brosses	4	6	6
brostà	2	0	brosta	4	1	1
brotarà	2	1	brotara	2	0	1
brotxà	2	0	brotxa	4	15	15
brotxés	2	0	brotxes	4	4	4
brotà	2	0	brota	2	3	3
bruixà	2	0	bruixa	4	291	291
bruixés	2	0	bruixes	4	357	357
brussel·lès	0	7	brussel·les	4	6217	6224
brussel·lés	0	0	brussel·les	4	6217	6217
bubà	2	0	buba	4	12	12
bubí	2	1	bubi	2	32	33
bubó	4	0	bubo	2	10	10
bufarà	2	2	bufara	2	0	2
bufetejà	2	1	bufeteja	2	6	7
bufà	2	1	bufa	0	147	148
bufés	2	4	bufes	0	6	10
bufí	2	0	bufi	2	5	5
bufó	0	79	bufo	2	42	121
buidarà	2	18	buidara	2	0	18
buidà	2	1	buida	4	1770	1771
buidàrem	2	1	buidarem	2	0	1
buidàreu	2	0	buidareu	2	1	1
buidés	2	9	buides	4	813	822
buidí	2	0	buidi	2	37	37
buixardà	2	0	buixarda	4	1	1
bullirà	2	1	bullira	2	0	1
bullí	2	1	bulli	2	8	9
bullírem	2	0	bullirem	2	1	1
bullís	2	0	bullis	2	3	3
burgès	0	58	burges	4	3	61
burgés	0	4	burges	4	3	7
burgí	2	0	burgi	2	1	1
burlarà	2	1	burlara	2	0	1
burlà	2	2	burla	4	242	244
burlés	2	1	burles	4	57	58
burlí	2	0	burli	2	7	7
burocratitzí	2	0	burocratitzi	2	1	1
burxà	2	0	burxa	4	1	1
burxés	2	1	burxes	4	0	1
buscarà	2	85	buscara	2	1	86
buscà	2	26	busca	4	1401	1427
buscàrem	2	1	buscarem	2	70	71
busqués	2	47	busques	4	100	147
busquí	2	0	busqui	2	268	268
bussejà	2	0	busseja	2	1	1
bustià	2	0	bustia	2	7	7
butllà	2	0	butlla	4	217	217
butllés	2	0	butlles	4	25	25
bàbol	4	1	babol	4	0	1
bàner	4	96	baner	4	3	99
bàners	4	21	baners	4	0	21
bàrbar	0	137	barbar	2	2	139
bàscula	4	17	bascula	2	4	21
bàscules	4	7	bascules	2	0	7
bàsquet	4	639	basquet	4	9	648
bàsquets	4	3	basquets	4	0	3
bàtec	4	0	batec	4	60	60
bàtecs	4	0	batecs	4	28	28
bàvar	0	2	bavar	2	0	2
bàvara	0	4	bavara	2	0	4
bèlit	4	0	belit	4	2	2
bèstia	0	233	bestia	4	9	242
bèsties	0	135	besties	4	2	137
bé	1	48132	be	4	628	48760
béns	4	3645	bens	4	49	3694
bígam	0	1	bigam	4	2	3
bòfega	4	1	bofega	2	0	1
bòston	4	7	boston	4	1086	1093
bóta	4	40	bota	4	91	131
bótes	4	22	botes	4	232	254
bústia	4	521	bustia	2	7	528
bústies	4	149	busties	2	0	149
cabdellà	2	0	cabdella	4	7	7
cabecés	2	0	cabeces	4	1	1
cabestrés	2	0	cabestres	4	2	2
cabeçà	2	0	cabeça	4	2	2
cablés	2	0	cables	2	537	537
cabrejà	2	0	cabreja	2	1	1
cabriolà	2	0	cabriola	4	3	3
cabriolé	4	3	cabriole	2	0	3
cabriolés	2	2	cabrioles	4	7	9
cabrà	2	7	cabra	4	287	294
cabré	2	5	cabre	2	49	54
cabussó	4	5	cabusso	2	0	5
cacés	2	2	caces	4	531	533
cací	2	0	caci	2	12	12
cadellà	2	0	cadella	0	1	1
cadenà	2	0	cadena	4	6638	6638
cadenés	2	0	cadenes	4	2086	2086
caducarà	2	24	caducara	2	0	24
caducà	2	0	caduca	0	136	136
caduqués	2	4	caduques	0	13	17
caduquí	2	0	caduqui	2	22	22
cagués	2	3	cagues	2	8	11
caguí	2	0	cagui	2	3	3
cagà	2	1	caga	2	24	25
cagàrem	2	0	cagarem	2	2	2
cagó	0	0	cago	2	38	38
caigués	2	120	caigues	2	0	120
caiguí	2	2	caigui	2	253	255
cairés	2	0	caires	2	5	5
caixó	4	1	caixo	4	0	1
calabrès	0	6	calabres	4	0	6
calandrà	2	0	calandra	4	2	2
calarà	2	6	calara	2	0	6
calcarí	0	0	calcari	0	18	18
calciguí	2	0	calcigui	2	10	10
calcigà	2	0	calciga	2	58	58
calcinarà	2	0	calcinara	2	1	1
calcinà	2	0	calcina	4	2	2
calcularà	2	83	calculara	2	1	84
calculà	2	21	calcula	2	1648	1669
calculàrem	2	0	calcularem	2	1	1
calculàreu	2	0	calculareu	2	1	1
calculés	2	1	calcules	2	1	2
calculí	2	0	calculi	2	33	33
calcà	2	0	calca	4	3	3
calcària	0	342	calcaria	2	0	342
calcàries	0	62	calcaries	2	0	62
calcès	0	0	calces	4	33	33
calcés	0	0	calces	4	33	33
calcí	2	0	calci	4	471	471
calcín	2	0	calcin	2	1	1
caldegí	2	0	caldegi	2	1	1
caldejà	2	0	caldeja	2	1	1
caldós	0	3	caldos	4	2	5
calfà	2	0	calfa	2	3	3
calfó	4	0	calfo	2	1	1
calibrarà	2	2	calibrara	2	0	2
calibrà	2	0	calibra	2	25	25
calibrés	2	2	calibres	2	29	31
calibrí	2	0	calibri	2	8	8
callarà	2	3	callara	2	0	3
callà	2	0	calla	2	330	330
callàrem	2	0	callarem	2	1	1
callés	2	8	calles	4	21	29
callí	2	0	calli	2	56	56
calmarà	2	11	calmara	2	0	11
calmà	2	2	calma	0	856	858
calmàrem	2	0	calmarem	2	2	2
calmés	2	4	calmes	0	9	13
calmí	2	0	calmi	2	52	52
calqués	2	0	calques	4	1	1
calumnià	2	1	calumnia	2	7	8
calumniés	2	0	calumnies	2	4	4
cal·ligrafià	2	0	cal·ligrafia	4	171	171
cal·ligrafiés	2	0	cal·ligrafies	4	2	2
calà	2	9	cala	4	83	92
calçà	2	0	calça	4	9	9
calè	0	0	cale	2	18	18
calé	0	6	cale	2	18	24
calés	2	82	cales	4	20	102
calí	2	0	cali	4	51	51
calís	4	0	calis	2	1	1
caló	4	6	calo	2	2	8
calúmnia	4	48	calumnia	2	7	55
calúmnies	4	42	calumnies	2	4	46
cambodjà	0	112	cambodja	4	1068	1180
camelès	0	0	cameles	4	1	1
camelés	0	0	cameles	4	1	1
caminarà	2	10	caminara	2	0	10
caminà	2	5	camina	2	558	563
caminàrem	2	0	caminarem	2	12	12
caminàreu	2	0	caminareu	2	1	1
caminés	2	7	camines	2	24	31
caminí	2	0	camini	2	41	41
camparà	2	1	campara	2	0	1
campejà	2	0	campeja	2	1	1
camuflà	2	0	camufla	2	7	7
camuflàrem	2	0	camuflarem	2	1	1
camuflí	2	0	camufli	2	3	3
canalitzarà	2	16	canalitzara	2	0	16
canalitzà	2	0	canalitza	2	56	56
canalitzàrem	2	0	canalitzarem	2	3	3
canalitzés	2	3	canalitzes	2	0	3
canalitzí	2	0	canalitzi	2	36	36
cancel·larà	2	48	cancel·lara	2	0	48
cancel·là	2	18	cancel·la	2	623	641
cancel·làrem	2	1	cancel·larem	2	4	5
cancel·lés	2	32	cancel·les	2	3	35
cancel·lí	2	0	cancel·li	2	43	43
candí	2	0	candi	4	9	9
candís	2	0	candis	0	3	3
canonitzarà	2	1	canonitzara	2	0	1
canonitzà	2	5	canonitza	2	1	6
canonitzàrem	2	0	canonitzarem	2	1	1
canonés	2	0	canones	2	2	2
cansarà	2	6	cansara	2	1	7
cansà	2	2	cansa	2	35	37
cansàrem	2	0	cansarem	2	20	20
cansàreu	2	0	cansareu	2	1	1
cansés	2	0	canses	2	6	6
cansí	2	0	cansi	2	4	4
cantarà	2	12	cantara	2	1	13
cantà	2	46	canta	2	490	536
cantàrem	2	0	cantarem	2	2	2
cantàreu	2	0	cantareu	2	6	6
cantés	2	12	cantes	2	17	29
canviarà	2	915	canviara	2	1	916
canvià	2	313	canvia	2	5265	5578
canviàrem	2	1	canviarem	2	63	64
canviàreu	2	0	canviareu	2	13	13
canviària	0	28	canviaria	2	185	213
canviàries	0	15	canviaries	2	3	18
canviés	2	165	canvies	2	44	209
canvií	2	0	canvii	2	9	9
capacitarà	2	3	capacitara	2	0	3
capacità	2	0	capacita	2	28	28
capacitàrem	2	0	capacitarem	2	1	1
capacités	2	2	capacites	2	0	2
capacití	2	0	capaciti	2	11	11
caparró	4	7	caparro	4	0	7
caparrós	4	7	caparros	4	0	7
capbussà	2	0	capbussa	2	7	7
capbussés	2	0	capbusses	2	1	1
capbussí	2	0	capbussi	2	1	1
capbussó	4	8	capbusso	2	0	8
capegés	2	1	capeges	2	0	1
capejà	2	0	capeja	2	3	3
capellés	2	0	capelles	4	219	219
capellí	2	0	capelli	2	7	7
capficà	2	0	capfica	2	1	1
capficó	4	0	capfico	2	1	1
capgirà	2	0	capgira	2	114	114
capgirés	2	2	capgires	2	1	3
capgirí	2	0	capgiri	2	1	1
capitalitzà	2	1	capitalitza	2	6	7
capitalitzí	2	0	capitalitzi	2	3	3
capitanegés	2	1	capitaneges	2	0	1
capitanejà	2	2	capitaneja	2	2	4
capitolí	0	18	capitoli	4	107	125
capitulà	2	6	capitula	2	12	18
capitulés	2	1	capitules	2	0	1
capitulí	2	0	capituli	2	2	2
caplletrà	2	0	caplletra	4	2	2
caplletrés	2	0	caplletres	4	5	5
caponí	2	0	caponi	2	2	2
capotà	2	0	capota	4	7	7
capritxós	0	18	capritxos	4	69	87
caprí	0	112	capri	4	71	183
captarà	2	5	captara	2	0	5
captivà	2	2	captiva	0	37	39
captivés	2	0	captives	0	24	24
captiví	2	0	captivi	2	1	1
capturarà	2	26	capturara	2	2	28
capturà	2	106	captura	4	3634	3740
capturàrem	2	0	capturarem	2	3	3
capturés	2	19	captures	4	1415	1434
capturí	2	0	capturi	2	20	20
captà	2	4	capta	4	59	63
captàrem	2	1	captarem	2	2	3
captén	2	0	capten	2	23	23
captés	2	2	captes	4	5	7
captí	2	0	capti	2	12	12
captín	2	0	captin	2	13	13
capà	2	0	capa	4	6605	6605
capçà	2	0	capça	4	1	1
capés	2	0	capes	4	3161	3161
capí	2	0	capi	2	8	8
capís	2	1	capis	2	2	3
capítula	4	0	capitula	2	12	12
caracteritzarà	2	23	caracteritzara	2	0	23
caracteritzà	2	29	caracteritza	2	1339	1368
caracteritzés	2	3	caracteritzes	2	0	3
caracteritzí	2	0	caracteritzi	2	48	48
caragolà	2	0	caragola	4	3	3
carbonarà	2	0	carbonara	4	2	2
carbonatà	2	0	carbonata	2	1	1
carbonà	2	0	carbona	2	1	1
carboní	2	0	carboni	2	3648	3648
cardà	2	0	carda	4	6	6
cardàrem	2	0	cardarem	2	3	3
cardés	2	1	cardes	4	7	8
cardí	2	0	cardi	2	3	3
carenà	2	0	carena	4	91	91
carenés	2	0	carenes	4	26	26
cargolà	2	0	cargola	4	9	9
cargolí	2	1	cargoli	2	0	1
caricaturitzà	2	0	caricaturitza	2	2	2
caricaturitzí	2	0	caricaturitzi	2	1	1
caricaturà	2	0	caricatura	4	131	131
caricaturés	2	0	caricatures	4	173	173
carinà	2	0	carina	4	19	19
cariní	2	0	carini	2	2	2
carià	2	2	caria	2	2	4
cariés	2	0	caries	2	2	2
carlà	4	0	carla	4	75	75
carmelità	0	2	carmelita	4	24	26
carmenà	2	0	carmena	2	7	7
carpetà	0	0	carpeta	4	6116	6116
carpià	0	13	carpia	2	0	13
carpí	2	4	carpi	4	15	19
carrarà	2	0	carrara	4	39	39
carregarà	2	116	carregara	2	0	116
carregués	2	8	carregues	2	14	22
carreguí	2	1	carregui	2	110	111
carregà	2	16	carrega	2	1201	1217
carregàrem	2	0	carregarem	2	10	10
carregàreu	2	1	carregareu	2	1	2
carregí	2	0	carregi	2	3	3
carrà	2	3	carra	2	0	3
carrés	2	0	carres	2	3	3
carrí	2	0	carri	2	1	1
carró	4	1	carro	2	439	440
cartejà	2	1	carteja	2	2	3
cartografià	2	5	cartografia	4	150	155
cartografiés	2	0	cartografies	4	4	4
cartoixà	0	20	cartoixa	4	23	43
carà	4	1	cara	0	8196	8197
carés	4	0	cares	0	1512	1512
casarà	2	43	casara	2	3	46
cascà	2	0	casca	4	3	3
cascàrem	2	0	cascarem	2	1	1
casqués	2	0	casques	4	1	1
casquí	2	0	casqui	2	3	3
cassarà	2	1	cassara	2	0	1
cassàreu	2	1	cassareu	2	0	1
cassí	2	0	cassi	4	50	50
cassís	4	1	cassis	2	16	17
cassó	4	10	casso	2	1	11
castellanès	0	0	castellanes	0	27	27
castellanés	0	0	castellanes	0	27	27
castigarà	2	30	castigara	2	0	30
castigués	2	13	castigues	2	1	14
castiguí	2	0	castigui	2	82	82
castigà	2	3	castiga	2	188	191
castigàrem	2	0	castigarem	2	5	5
castigàreu	2	0	castigareu	2	1	1
castrà	2	0	castra	2	9	9
castrés	2	0	castres	4	34	34
castrí	2	0	castri	2	1	1
casà	2	415	casa	4	17131	17546
casàrem	2	0	casarem	2	16	16
casàreu	2	0	casareu	2	8	8
casés	2	45	cases	4	3321	3366
casí	2	0	casi	4	155	155
catabolitzà	2	0	catabolitza	2	2	2
catalitzarà	2	1	catalitzara	2	0	1
catalitzà	2	0	catalitza	2	78	78
catalitzí	2	0	catalitzi	2	4	4
cataloguí	2	0	catalogui	2	3	3
catalogà	2	5	cataloga	2	30	35
catapultà	2	1	catapulta	4	38	39
catapultés	2	0	catapultes	4	38	38
catarrós	0	0	catarros	4	2	2
categoritzà	2	3	categoritza	2	20	23
categoritzés	2	0	categoritzes	2	1	1
categoritzí	2	0	categoritzi	2	1	1
catequitzà	2	1	catequitza	2	0	1
catorzè	0	68	catorze	3	961	1029
catorzé	0	1	catorze	3	961	962
catxà	2	0	catxa	4	10	10
catxés	2	1	catxes	4	0	1
cauré	2	15	caure	2	3422	3437
causarà	2	209	causara	2	0	209
causàrem	2	0	causarem	2	8	8
causés	2	29	causes	4	3827	3856
causí	2	0	causi	2	88	88
cauteritzés	2	1	cauteritzes	2	0	1
cavalcarà	2	3	cavalcara	2	0	3
cavalcà	2	4	cavalca	2	40	44
cavalcàrem	2	0	cavalcarem	2	6	6
cavalcàreu	2	0	cavalcareu	2	3	3
cavallà	2	0	cavalla	4	2	2
cavallí	2	0	cavalli	2	16	16
cavalló	4	1	cavallo	2	9	10
cavalqués	2	0	cavalques	2	2	2
cavalquí	2	0	cavalqui	2	2	2
cavarà	2	1	cavara	2	1	2
cavà	2	0	cava	4	95	95
cavàrem	2	0	cavarem	2	1	1
cavés	2	1	caves	0	16	17
caví	2	0	cavi	2	4	4
cavó	4	0	cavo	2	1	1
caçarà	2	1	caçara	2	1	2
caçà	2	1	caça	4	2148	2149
caçàreu	2	0	caçareu	2	1	1
caçó	4	0	caço	2	1	1
caús	2	0	caus	4	158	158
cedirà	2	43	cedira	2	1	44
cedírem	2	0	cedirem	2	28	28
cegarà	2	0	cegara	2	1	1
cegués	2	0	cegues	0	243	243
cegà	2	0	cega	0	321	321
cegó	4	0	cego	2	2	2
celebrarà	2	1948	celebrara	2	2	1950
celebrà	2	182	celebra	2	1629	1811
celebràrem	2	0	celebrarem	2	333	333
celebràreu	2	0	celebrareu	2	1	1
celebrés	2	142	celebres	2	4	146
celebrí	2	0	celebri	2	644	644
celà	2	0	cela	2	13	13
celés	2	0	celes	2	1	1
celí	2	0	celi	2	7	7
cendrà	2	0	cendra	4	283	283
cendrés	2	0	cendres	4	493	493
censurarà	2	1	censurara	2	0	1
censurà	2	3	censura	4	1611	1614
censuràrem	2	0	censurarem	2	1	1
censurés	2	3	censures	4	16	19
censurí	2	0	censuri	2	7	7
centellejà	2	0	centelleja	2	3	3
centralitzarà	2	2	centralitzara	2	0	2
centralitzà	2	0	centralitza	2	16	16
centralitzés	2	1	centralitzes	2	0	1
centralitzí	2	0	centralitzi	2	8	8
centrarà	2	283	centrara	2	0	283
centrifugués	2	0	centrifugues	2	3	3
centrifugà	2	0	centrifuga	2	7	7
centrà	2	48	centra	2	2231	2279
centràrem	2	0	centrarem	2	76	76
centrés	2	75	centres	2	4672	4747
centrí	2	0	centri	2	455	455
centrífug	0	11	centrifug	2	0	11
centrífuga	0	43	centrifuga	2	7	50
centrífugues	0	18	centrifugues	2	3	21
centó	4	2	cento	4	3	5
cenyirà	2	3	cenyira	2	0	3
cenyírem	2	0	cenyirem	2	7	7
cercarà	2	129	cercara	2	1	130
cerciorarà	2	2	cerciorara	2	0	2
cerciorà	2	0	cerciora	2	2	2
cercioràrem	2	0	cerciorarem	2	4	4
cerciorí	2	0	cerciori	2	12	12
cerclés	2	0	cercles	2	1081	1081
cercà	2	27	cerca	4	10418	10445
cercàrem	2	0	cercarem	2	5	5
cercàreu	2	0	cercareu	2	5	5
cercària	4	1	cercaria	2	7	8
ceretà	0	1	cereta	4	3	4
cerqués	2	6	cerques	4	580	586
cerquí	2	0	cerqui	2	38	38
certificarà	2	7	certificara	2	0	7
certificà	2	5	certifica	2	43	48
certificàrem	2	0	certificarem	2	1	1
certifiqués	2	6	certifiques	2	0	6
certifiquí	2	0	certifiqui	2	19	19
cerós	0	4	ceros	4	1	5
cessarà	2	30	cessara	2	0	30
cessà	2	28	cessa	2	89	117
cessàrem	2	0	cessarem	2	7	7
cessés	2	66	cesses	2	0	66
cessí	2	0	cessi	2	69	69
ciarà	2	0	ciara	4	4	4
cicatritzà	2	0	cicatritza	2	11	11
cicatritzí	2	0	cicatritzi	2	1	1
ciclitzà	2	0	ciclitza	2	1	1
ciclòpia	0	3	ciclopia	4	1	4
ciclòpies	0	2	ciclopies	4	0	2
cigonyà	2	0	cigonya	4	20	20
cigonyés	2	0	cigonyes	4	15	15
cilindrés	2	0	cilindres	2	267	267
cimentà	2	4	cimenta	2	0	4
cimentés	2	1	cimentes	2	0	1
cimentí	2	0	cimenti	2	1	1
cimà	2	0	cima	4	44	44
cimè	4	1	cime	2	4	5
cimé	4	0	cime	2	4	4
cimés	2	0	cimes	4	10	10
cimí	2	1	cimi	2	4	5
cinematografià	2	0	cinematografia	4	83	83
cinematografiés	2	0	cinematografies	4	1	1
cinglà	2	0	cingla	4	2	2
cinglés	2	0	cingles	4	21	21
cinquanta-quatrè	0	0	cinquanta-quatre	3	32	32
cinquanta-quatré	0	0	cinquanta-quatre	3	32	32
cintrà	2	0	cintra	4	4	4
cinturà	2	0	cintura	4	136	136
cinturés	2	0	cintures	4	8	8
cinturó	4	844	cinturo	2	2	846
cintà	2	0	cinta	4	965	965
cintés	2	0	cintes	4	322	322
cintí	2	0	cinti	2	2	2
cintó	4	0	cinto	4	4	4
circularitzarà	2	1	circularitzara	2	0	1
circularitzí	2	0	circularitzi	2	1	1
circularà	2	8	circulara	2	0	8
circulà	2	8	circula	2	224	232
circulàrem	2	0	circularem	2	1	1
circulés	2	7	circules	2	0	7
circulí	2	0	circuli	2	34	34
circumcidà	2	1	circumcida	2	0	1
circumcidí	2	0	circumcidi	2	1	1
circumdà	2	0	circumda	2	13	13
circumnavegà	2	2	circumnavega	2	1	3
circumscriguí	2	0	circumscrigui	2	2	2
circumscriuré	2	3	circumscriure	2	60	63
circumstancià	2	0	circumstancia	2	1	1
circumstanciés	2	0	circumstancies	2	11	11
circumstància	4	1169	circumstancia	2	1	1170
circumstàncies	4	5837	circumstancies	2	11	5848
circumval·larà	2	2	circumval·lara	2	0	2
circumval·là	2	1	circumval·la	2	6	7
cirurgià	4	303	cirurgia	4	676	979
cisallà	2	0	cisalla	4	27	27
cisallés	2	0	cisalles	4	3	3
cisà	2	0	cisa	4	2	2
cisés	2	0	cises	4	1	1
cisí	2	0	cisi	2	1	1
citarà	2	9	citara	2	0	9
cità	2	27	cita	4	2126	2153
citàrem	2	0	citarem	2	3	3
cités	2	12	cites	4	817	829
cití	2	0	citi	2	96	96
cià	2	0	cia	4	783	783
ciés	2	0	cies	4	8	8
cií	2	0	cii	2	1	1
clacà	2	0	claca	4	6	6
clamarà	2	1	clamara	2	0	1
clamà	2	1	clama	2	36	37
clamàrem	2	0	clamarem	2	1	1
clamí	2	0	clami	2	1	1
clapà	2	0	clapa	4	2	2
clapés	2	0	clapes	4	14	14
claqué	4	17	claque	2	2	19
claqués	2	0	claques	4	2	2
claregí	2	0	claregi	2	1	1
clarejà	2	0	clareja	2	1	1
clarificarà	2	1	clarificara	2	0	1
clarificà	2	3	clarifica	2	11	14
classificarà	2	12	classificara	2	0	12
classificà	2	46	classifica	2	354	400
classifiqués	2	8	classifiques	2	1	9
classifiquí	2	0	classifiqui	2	21	21
claudicarà	2	1	claudicara	2	0	1
claudicà	2	0	claudica	2	1	1
claudiquí	2	0	claudiqui	2	1	1
clausurarà	2	4	clausurara	2	0	4
clausurà	2	5	clausura	4	324	329
clausuràrem	2	0	clausurarem	2	1	1
clausurés	2	1	clausures	4	3	4
clausurí	2	0	clausuri	2	5	5
clavarà	2	5	clavara	2	0	5
clavillà	2	0	clavilla	4	17	17
clavillés	2	0	clavilles	4	33	33
clavà	2	3	clava	4	39	42
clavàrem	2	0	clavarem	2	2	2
clavàreu	2	1	clavareu	2	0	1
clavària	4	0	clavaria	2	5	5
clavés	2	2	claves	4	11	13
claví	2	0	clavi	2	3	3
clavó	4	0	clavo	2	3	3
clenxà	2	0	clenxa	4	4	4
clevillà	2	0	clevilla	2	1	1
clicà	2	0	clica	2	110	110
clipí	2	0	clipi	2	5	5
cliqués	2	0	cliques	2	3	3
cliquí	2	0	cliqui	2	38	38
clivellà	2	0	clivella	4	3	3
clivellés	2	0	clivelles	4	5	5
clonarà	2	5	clonara	2	0	5
clonà	2	0	clona	2	140	140
clonàrem	2	0	clonarem	2	3	3
clonés	2	1	clones	2	13	14
cloní	2	0	cloni	2	2	2
clorí	2	0	clori	2	1	1
closcà	2	0	closca	4	276	276
closqués	2	0	closques	4	138	138
clotà	2	0	clota	4	1	1
clouré	2	0	cloure	2	5	5
clusteritzà	2	0	clusteritza	2	1	1
coaccionarà	2	1	coaccionara	2	0	1
coaccionà	2	0	coacciona	2	5	5
coaccioní	2	0	coaccioni	2	3	3
coadjuvarà	2	2	coadjuvara	2	0	2
coadjuvà	2	0	coadjuva	2	2	2
coadjuví	2	0	coadjuvi	2	2	2
coagulà	2	0	coagula	2	1	1
coagulí	2	0	coaguli	2	2	2
coartarà	2	1	coartara	2	0	1
coartà	2	0	coarta	2	8	8
coartí	2	0	coarti	2	4	4
cobdicià	2	0	cobdicia	2	2	2
cobdícia	4	154	cobdicia	2	2	156
cobdícies	4	3	cobdicies	2	0	3
cobejà	2	0	cobeja	2	5	5
cobrarà	2	47	cobrara	2	0	47
cobrirà	2	94	cobrira	2	0	94
cobrà	2	4	cobra	4	362	366
cobràrem	2	0	cobrarem	2	2	2
cobràreu	2	0	cobrareu	2	1	1
cobrés	2	9	cobres	4	24	33
cobrí	2	16	cobri	2	31	47
cobrírem	2	0	cobrirem	2	9	9
cobrís	2	23	cobris	2	0	23
cocó	4	5	coco	4	239	244
codesenvolupà	2	1	codesenvolupa	2	0	1
codicil·lí	2	0	codicil·li	2	1	1
codificarà	2	4	codificara	2	0	4
codificà	2	7	codifica	2	220	227
codifiqués	2	3	codifiques	2	0	3
codifiquí	2	0	codifiqui	2	17	17
codís	4	0	codis	4	1783	1783
coedità	2	1	coedita	2	0	1
coescriuré	2	0	coescriure	2	48	48
coexistirà	2	4	coexistira	2	0	4
coexistírem	2	0	coexistirem	2	1	1
cofinancés	2	3	cofinances	2	0	3
cofinancí	2	0	cofinanci	2	8	8
cofinançarà	2	3	cofinançara	2	0	3
cofinançà	2	0	cofinança	2	25	25
cofinançàrem	2	0	cofinançarem	2	2	2
cofundà	2	12	cofunda	2	2	14
cofà	2	0	cofa	4	11	11
cofés	2	0	cofes	4	1	1
cofí	2	0	cofi	2	2	2
cognomenà	2	0	cognomena	2	1	1
cognominà	2	0	cognomina	2	6	6
coguí	2	0	cogui	2	4	4
cohabità	2	0	cohabita	2	2	2
cohabití	2	0	cohabiti	2	1	1
cohesioní	2	0	cohesioni	2	1	1
cohonestà	2	0	cohonesta	2	1	1
coincidirà	2	148	coincidira	2	0	148
coincidírem	2	0	coincidirem	2	12	12
coixejarà	2	2	coixejara	2	0	2
coixejà	2	0	coixeja	2	15	15
colarà	2	2	colara	2	0	2
colcà	2	0	colca	2	5	5
colgués	2	0	colgues	4	1	1
colgà	2	0	colga	4	6	6
colgàrem	2	0	colgarem	2	1	1
coliderí	2	0	colideri	2	1	1
collegés	2	0	colleges	2	25	25
collegí	2	0	collegi	2	3	3
collirà	2	8	collira	2	1	9
collà	2	0	colla	4	273	273
collés	2	0	colles	4	63	63
collí	2	0	colli	2	8	8
collírem	2	0	collirem	2	4	4
collís	2	0	collis	2	5	5
colló	4	1	collo	2	1	2
colonitzà	2	2	colonitza	2	12	14
colonitzés	2	2	colonitzes	2	0	2
colorà	2	0	colora	2	3	3
colorés	2	0	colores	2	6	6
colorí	2	0	colori	2	2	2
colpegés	2	11	colpeges	2	6	17
colpegí	2	0	colpegi	2	16	16
colpejarà	2	5	colpejara	2	0	5
colpejà	2	23	colpeja	2	177	200
colpejàrem	2	0	colpejarem	2	4	4
colzà	2	0	colza	4	75	75
colzés	2	0	colzes	4	33	33
col·laborarà	2	45	col·laborara	2	1	46
col·laborà	2	116	col·labora	2	306	422
col·laboràrem	2	0	col·laborarem	2	50	50
col·laboràreu	2	0	col·laborareu	2	1	1
col·laborés	2	21	col·labores	2	0	21
col·laborí	2	0	col·labori	2	124	124
col·lapsarà	2	13	col·lapsara	2	0	13
col·lapsà	2	15	col·lapsa	2	51	66
col·lapsés	2	11	col·lapses	2	25	36
col·lapsí	2	0	col·lapsi	2	8	8
col·leccionarà	2	1	col·leccionara	2	0	1
col·leccionà	2	4	col·lecciona	2	16	20
col·leccionés	2	2	col·lecciones	2	1	3
col·leccioní	2	0	col·leccioni	2	1	1
col·lectà	2	0	col·lecta	4	28	28
col·lectés	2	0	col·lectes	4	3	3
col·legià	2	0	col·legia	2	2	2
col·legí	2	0	col·legi	4	2198	2198
col·legís	2	0	col·legis	4	658	658
col·lidirà	2	1	col·lidira	2	0	1
col·lisionà	2	0	col·lisiona	2	1	1
col·lisioní	2	0	col·lisioni	2	5	5
col·locarà	2	65	col·locara	2	0	65
col·locà	2	31	col·loca	2	811	842
col·locàrem	2	0	col·locarem	2	10	10
col·locàreu	2	0	col·locareu	2	2	2
col·loqués	2	15	col·loques	2	5	20
col·loquí	2	0	col·loqui	2	138	138
colà	2	1	cola	4	307	308
colàrem	2	0	colarem	2	1	1
colés	2	1	coles	4	87	88
colí	2	0	coli	4	163	163
colíder	4	8	colider	2	0	8
colís	0	0	colis	2	1	1
comandarà	2	2	comandara	2	0	2
comandità	2	0	comandita	4	2	2
comanditària	0	1	comanditaria	2	0	1
comanditàries	0	4	comanditaries	2	0	4
comandà	2	142	comanda	4	1019	1161
comandés	2	9	comandes	4	708	717
comandí	2	0	comandi	2	1	1
comanà	2	0	comana	4	1	1
comarcà	0	0	comarca	4	403	403
comaré	2	0	comare	4	1	1
combatré	2	3	combatre	2	6112	6115
combatés	2	6	combates	2	0	6
combatí	2	3	combati	2	60	63
combinarà	2	34	combinara	2	0	34
combinà	2	24	combina	2	936	960
combinàrem	2	0	combinarem	2	5	5
combinés	2	23	combines	2	6	29
combiní	2	0	combini	2	89	89
comboí	2	0	comboi	4	259	259
combregà	2	0	combrega	2	5	5
combés	4	0	combes	4	10	10
comencés	2	339	comences	2	110	449
comencí	2	3	comenci	2	1209	1212
comentarà	2	20	comentara	2	0	20
comentà	2	80	comenta	2	306	386
comentàrem	2	0	comentarem	2	7	7
comentés	2	37	comentes	2	3	40
comentí	2	0	comenti	2	99	99
començarà	2	670	començara	2	14	684
començà	2	1654	comença	2	5207	6861
començàrem	2	4	començarem	2	271	275
començàreu	2	0	començareu	2	14	14
comercialitzarà	2	4	comercialitzara	2	0	4
comercialitzà	2	10	comercialitza	2	143	153
comercialitzés	2	1	comercialitzes	2	0	1
comercialitzí	2	0	comercialitzi	2	19	19
comerciarà	2	2	comerciara	2	0	2
comercià	2	0	comercia	2	48	48
comerciàrem	2	0	comerciarem	2	1	1
comerciés	2	3	comercies	2	1	4
cometré	2	7	cometre	2	1420	1427
cometés	2	15	cometes	4	862	877
cometí	2	0	cometi	2	73	73
comissarià	2	0	comissaria	2	207	207
comissariés	2	0	comissaries	2	61	61
comissionarà	2	1	comissionara	2	0	1
comissionà	2	2	comissiona	2	1	3
comissària	4	12694	comissaria	2	207	12901
comissàries	4	60	comissaries	2	61	121
commemorarà	2	11	commemorara	2	0	11
commemorà	2	2	commemora	2	236	238
commemoràrem	2	0	commemorarem	2	11	11
commemorés	2	2	commemores	2	0	2
commemorí	2	0	commemori	2	4	4
comminà	2	0	commina	2	4	4
comminés	2	0	commines	2	1	1
comminí	2	0	commini	2	3	3
commocionarà	2	1	commocionara	2	0	1
commocionà	2	1	commociona	2	6	7
commocionés	2	1	commociones	2	0	1
commoguí	2	0	commogui	2	2	2
commouré	2	0	commoure	2	65	65
commutarà	2	13	commutara	2	0	13
commutà	2	2	commuta	2	1119	1121
commutàreu	2	0	commutareu	2	2	2
commutés	2	6	commutes	2	0	6
commutí	2	0	commuti	2	20	20
compactarà	2	1	compactara	2	0	1
compactà	2	1	compacta	2	315	316
compactés	2	0	compactes	2	271	271
compaginarà	2	2	compaginara	2	0	2
compaginà	2	3	compagina	2	15	18
compaginí	2	0	compagini	2	1	1
compararà	2	22	comparara	2	0	22
comparegués	2	13	comparegues	2	0	13
compareguí	2	0	comparegui	2	55	55
compartirà	2	69	compartira	2	1	70
compartírem	2	0	compartirem	2	32	32
compartíreu	2	0	compartireu	2	2	2
comparà	2	25	compara	2	686	711
comparàrem	2	0	compararem	2	3	3
comparés	2	7	compares	2	9	16
comparí	2	0	compari	2	42	42
compassà	2	0	compassa	2	2	2
compatibilitzà	2	1	compatibilitza	2	4	5
compatibilitzí	2	0	compatibilitzi	2	4	4
compendià	2	0	compendia	2	4	4
compenetrà	2	1	compenetra	2	0	1
compensarà	2	40	compensara	2	0	40
compensà	2	1	compensa	2	139	140
compensàrem	2	0	compensarem	2	3	3
compensés	2	10	compenses	2	0	10
compensí	2	0	compensi	2	54	54
competirà	2	22	competira	2	1	23
competírem	2	0	competirem	2	14	14
compilarà	2	8	compilara	2	0	8
compilà	2	21	compila	2	81	102
compilàrem	2	0	compilarem	2	1	1
compilés	2	2	compiles	2	1	3
compilí	2	0	compili	2	12	12
complaguí	2	0	complagui	2	12	12
complauré	2	0	complaure	2	248	248
complementarà	2	56	complementara	2	0	56
complementà	2	5	complementa	2	288	293
complementàrem	2	0	complementarem	2	1	1
complementària	0	1162	complementaria	2	21	1183
complementàries	0	989	complementaries	2	0	989
complementés	2	6	complementes	2	0	6
complementí	2	0	complementi	2	85	85
completarà	2	128	completara	2	1	129
completà	2	131	completa	0	6503	6634
completàrem	2	0	completarem	2	8	8
completàreu	2	0	completareu	2	3	3
completés	2	75	completes	0	624	699
completí	2	0	completi	2	229	229
complexà	2	0	complexa	0	2008	2008
complexés	2	0	complexes	0	1336	1336
complicarà	2	26	complicara	2	0	26
complicà	2	7	complica	2	177	184
complicàrem	2	0	complicarem	2	2	2
complimentà	2	0	complimenta	2	1	1
compliqués	2	1	compliques	2	1	2
compliquí	2	0	compliqui	2	21	21
complirà	2	276	complira	2	0	276
complírem	2	0	complirem	2	92	92
compondré	2	0	compondre	2	1239	1239
compongués	2	17	compongues	2	0	17
componguí	2	0	compongui	2	20	20
comportarà	2	355	comportara	2	0	355
comportà	2	101	comporta	4	2600	2701
comportàrem	2	0	comportarem	2	4	4
comportàreu	2	0	comportareu	2	1	1
comportés	2	22	comportes	4	69	91
comportí	2	0	comporti	2	234	234
compostel·là	0	0	compostel·la	4	81	81
compostà	2	0	composta	2	1510	1510
compostés	2	0	compostes	2	423	423
composà	2	0	composa	2	19	19
comprarà	2	40	comprara	2	3	43
comprendré	2	3	comprendre	2	3058	3061
comprengués	2	47	comprengues	2	0	47
comprenguí	2	0	comprengui	2	354	354
comprimirà	2	11	comprimira	2	0	11
comprometré	2	9	comprometre	2	2670	2679
comprometés	2	57	comprometes	2	0	57
comprometí	2	1	comprometi	2	298	299
comprovarà	2	141	comprovara	2	2	143
comprovà	2	9	comprova	2	1468	1477
comprovàrem	2	0	comprovarem	2	109	109
comprovàreu	2	0	comprovareu	2	2	2
comprovés	2	45	comproves	2	3	48
comproví	2	0	comprovi	2	208	208
comprà	2	58	compra	4	2252	2310
compràrem	2	1	comprarem	2	21	22
comprèn	2	1643	compren	2	504	2147
comprès	2	967	compres	4	753	1720
comprén	2	15	compren	2	504	519
comprés	2	42	compres	4	753	795
compréssiu	2	0	compressiu	0	1	1
comprí	2	0	compri	2	91	91
comptabilitzarà	2	3	comptabilitzara	2	0	3
comptabilitzà	2	2	comptabilitza	2	28	30
comptabilitzés	2	1	comptabilitzes	2	0	1
comptabilitzí	2	0	comptabilitzi	2	3	3
comptarà	2	397	comptara	2	3	400
comptà	2	32	compta	2	4603	4635
comptàrem	2	1	comptarem	2	159	160
comptés	2	84	comptes	2	13346	13430
comptí	2	1	compti	2	609	610
compulsà	2	0	compulsa	4	2	2
computarà	2	9	computara	2	0	9
computà	2	0	computa	2	40	40
computí	2	0	computi	2	3	3
comunicarà	2	59	comunicara	2	0	59
comunicà	2	16	comunica	2	337	353
comunicàrem	2	0	comunicarem	2	31	31
comunicàreu	2	0	comunicareu	2	2	2
comuniqués	2	51	comuniques	2	3	54
comuniquí	2	0	comuniqui	2	184	184
comunès	4	0	comunes	4	4543	4543
comunés	4	0	comunes	4	4543	4543
comà	2	0	coma	4	1057	1057
comès	2	1426	comes	4	590	2016
comés	2	29	comes	4	590	619
comís	2	1	comis	2	0	1
concatenarà	2	2	concatenara	2	0	2
concatenà	2	0	concatena	2	13	13
concebré	2	0	concebre	2	698	698
concebés	2	2	concebes	2	0	2
concebí	2	0	concebi	2	23	23
concedirà	2	236	concedira	2	5	241
concedírem	2	0	concedirem	2	43	43
concedíreu	2	0	concedireu	2	1	1
concelebrà	2	1	concelebra	2	0	1
concelebrí	2	0	concelebri	2	1	1
concentrarà	2	41	concentrara	2	1	42
concentrà	2	31	concentra	2	462	493
concentràrem	2	0	concentrarem	2	11	11
concentrés	2	42	concentres	2	4	46
concentrí	2	0	concentri	2	140	140
conceptualitzà	2	1	conceptualitza	2	4	5
concernirà	2	5	concernira	2	0	5
concertarà	2	3	concertara	2	0	3
concertà	2	1	concerta	2	9	10
concertàrem	2	0	concertarem	2	1	1
concertés	2	1	concertes	2	2	3
concertí	2	0	concerti	2	23	23
conciliarà	2	1	conciliara	2	0	1
concilià	2	0	concilia	2	39	39
conciliés	2	1	concilies	2	1	2
concilií	2	0	concilii	2	2	2
concitarà	2	1	concitara	2	0	1
concità	2	0	concita	2	10	10
concití	2	0	conciti	2	2	2
conclogués	2	50	conclogues	2	0	50
concloguí	2	0	conclogui	2	404	404
conclouré	2	251	concloure	2	5229	5480
concordarà	2	2	concordara	2	0	2
concordà	2	1	concorda	2	609	610
concordés	2	0	concordes	2	159	159
concordí	2	0	concordi	4	71	71
concretarà	2	27	concretara	2	0	27
concretà	2	8	concreta	0	3427	3435
concretàrem	2	0	concretarem	2	2	2
concretés	2	11	concretes	0	5176	5187
concretí	2	0	concreti	2	72	72
conculcà	2	0	conculca	2	10	10
conculquí	2	0	conculqui	2	1	1
concursà	2	0	concursa	2	1	1
condecorà	2	10	condecora	2	1	11
condemnarà	2	28	condemnara	2	1	29
condemnà	2	60	condemna	4	2512	2572
condemnàrem	2	0	condemnarem	2	21	21
condemnés	2	28	condemnes	4	429	457
condemní	2	0	condemni	2	132	132
condensarà	2	2	condensara	2	0	2
condensà	2	1	condensa	2	45	46
condensés	2	1	condenses	2	0	1
condensí	2	0	condensi	2	5	5
condicionarà	2	21	condicionara	2	0	21
condicionà	2	2	condiciona	2	90	92
condicionàrem	2	0	condicionarem	2	1	1
condicionés	2	3	condiciones	2	5	8
condicioní	2	0	condicioni	2	25	25
condimentà	2	0	condimenta	2	5	5
condimentí	2	0	condimenti	2	1	1
condirà	2	6	condira	2	0	6
condonarà	2	2	condonara	2	0	2
condonà	2	0	condona	2	3	3
condonés	2	1	condones	2	0	1
condoní	2	0	condoni	2	4	4
conduírem	2	0	conduirem	2	6	6
conegués	2	82	conegues	2	7	89
coneguí	2	0	conegui	2	300	300
confeccionarà	2	3	confeccionara	2	0	3
confeccionà	2	3	confecciona	2	14	17
confeccionàrem	2	0	confeccionarem	2	1	1
confeccionés	2	2	confecciones	2	0	2
confeccioní	2	0	confeccioni	2	10	10
conferencià	2	0	conferencia	2	34	34
conferenciés	2	0	conferencies	2	8	8
conferirà	2	27	conferira	2	0	27
conferència	4	14107	conferencia	2	34	14141
conferències	4	1791	conferencies	2	8	1799
conferírem	2	0	conferirem	2	1	1
confessarà	2	2	confessara	2	0	2
confessà	2	17	confessa	2	85	102
confessàrem	2	0	confessarem	2	1	1
confessàreu	2	0	confessareu	2	1	1
confessés	2	5	confesses	2	0	5
confessí	2	0	confessi	2	9	9
confiarà	2	31	confiara	2	0	31
configurarà	2	41	configurara	2	0	41
configurà	2	3	configura	2	1824	1827
configuràrem	2	0	configurarem	2	4	4
configuràreu	2	0	configurareu	2	3	3
configurés	2	2	configures	2	4	6
configurí	2	0	configuri	2	47	47
confinà	2	0	confina	2	17	17
confinés	2	1	confines	2	0	1
confiní	2	0	confini	2	4	4
confirmarà	2	94	confirmara	2	0	94
confirmà	2	113	confirma	2	1616	1729
confirmàrem	2	0	confirmarem	2	17	17
confirmàreu	2	0	confirmareu	2	1	1
confirmés	2	147	confirmes	2	324	471
confirmí	2	0	confirmi	2	326	326
confiscà	2	11	confisca	2	10	21
confisqués	2	6	confisques	2	0	6
confisquí	2	0	confisqui	2	5	5
confià	2	29	confia	2	582	611
confiàrem	2	1	confiarem	2	12	13
confiàreu	2	0	confiareu	2	1	1
confiés	2	15	confies	2	49	64
confií	2	2	confii	2	3	5
confondré	2	0	confondre	2	1043	1043
confongués	2	7	confongues	2	1	8
confonguí	2	0	confongui	2	47	47
conformarà	2	12	conformara	2	0	12
conformà	2	5	conforma	2	150	155
conformàrem	2	0	conformarem	2	9	9
conformés	2	2	conformes	2	261	263
conformí	2	0	conformi	2	10	10
confortarà	2	2	confortara	2	0	2
confortà	2	0	conforta	2	12	12
confortí	2	0	conforti	2	3	3
confrontarà	2	2	confrontara	2	0	2
confrontà	2	2	confronta	4	24	26
confrontàrem	2	0	confrontarem	2	2	2
confrontés	2	0	confrontes	4	1	1
confrontí	2	0	confronti	2	3	3
congelarà	2	8	congelara	2	0	8
congelà	2	2	congela	2	74	76
congelàrem	2	0	congelarem	2	6	6
congelàreu	2	0	congelareu	2	1	1
congelés	2	11	congeles	2	1	12
congelí	2	0	congeli	2	24	24
congenià	2	0	congenia	2	1	1
congestionà	2	0	congestiona	2	4	4
congoixà	2	0	congoixa	4	1	1
congoixés	2	0	congoixes	4	1	1
congratulà	2	1	congratula	2	196	197
congratulàrem	2	0	congratularem	2	1	1
congratulí	2	0	congratuli	2	7	7
congregarà	2	2	congregara	2	0	2
congregués	2	1	congregues	2	0	1
congreguí	2	0	congregui	2	1	1
congregà	2	2	congrega	2	12	14
congrés	4	4144	congres	4	2	4146
conillà	2	0	conilla	0	1	1
conjecturà	2	3	conjectura	4	256	259
conjecturés	2	0	conjectures	4	112	112
conjugués	2	0	conjugues	2	1	1
conjuguí	2	0	conjugui	2	8	8
conjugà	2	0	conjuga	2	34	34
conjuminarà	2	6	conjuminara	2	0	6
conjuminà	2	0	conjumina	2	41	41
conjuminàrem	2	0	conjuminarem	2	2	2
conjuminí	2	0	conjumini	2	26	26
conjuntà	2	0	conjunta	0	4004	4004
conjuntés	2	0	conjuntes	0	900	900
conjurà	2	0	conjura	4	20	20
conjurés	2	0	conjures	4	1	1
conjurí	2	0	conjuri	2	1	1
connectarà	2	97	connectara	2	0	97
connectà	2	10	connecta	2	1362	1372
connectàrem	2	0	connectarem	2	8	8
connectàreu	2	0	connectareu	2	6	6
connectés	2	9	connectes	2	18	27
connectí	2	0	connecti	2	135	135
connotà	2	0	connota	2	7	7
conquerirà	2	1	conquerira	2	1	2
conquerírem	2	0	conquerirem	2	3	3
conqueríreu	2	0	conquerireu	2	1	1
conquistarà	2	3	conquistara	2	0	3
conquistà	2	3	conquista	4	28	31
conquistàrem	2	0	conquistarem	2	6	6
conquistés	2	3	conquistes	4	3	6
conquistí	2	0	conquisti	2	4	4
conquès	0	0	conques	4	382	382
conqués	0	0	conques	4	382	382
conrearà	2	4	conreara	2	0	4
conreà	2	5	conrea	2	133	138
conreàrem	2	0	conrearem	2	2	2
conreés	2	4	conrees	2	0	4
conrà	2	0	conra	2	1	1
consagrarà	2	22	consagrara	2	0	22
consagrà	2	23	consagra	2	216	239
consagràrem	2	0	consagrarem	2	1	1
consagrés	2	8	consagres	2	0	8
consagrí	2	0	consagri	2	42	42
conscienciarà	2	1	conscienciara	2	0	1
consciencià	2	0	consciencia	2	19	19
conscienciés	2	1	consciencies	2	0	1
consciència	4	3806	consciencia	2	19	3825
consciències	4	144	consciencies	2	0	144
consensuà	2	0	consensua	2	1	1
consensuàrem	2	0	consensuarem	2	1	1
consensués	2	1	consensues	2	0	1
consentirà	2	14	consentira	2	0	14
consentí	2	2	consenti	2	11	13
consentírem	2	0	consentirem	2	9	9
consentís	2	5	consentis	2	0	5
conservarà	2	89	conservara	2	1	90
conservà	2	41	conserva	4	1488	1529
conservàrem	2	0	conservarem	2	14	14
conservés	2	21	conserves	4	109	130
conserví	2	0	conservi	2	150	150
considerarà	2	306	considerara	2	5	311
considerà	2	169	considera	2	9741	9910
consideràrem	2	0	considerarem	2	101	101
consideràreu	2	0	considerareu	2	1	1
considerés	2	233	consideres	2	24	257
considerí	2	0	consideri	2	1341	1341
consignarà	2	7	consignara	2	0	7
consignà	2	0	consigna	4	158	158
consignés	2	2	consignes	4	117	119
consigní	2	0	consigni	2	8	8
consistirà	2	198	consistira	2	0	198
consolarà	2	2	consolara	2	0	2
consolidarà	2	61	consolidara	2	0	61
consolidà	2	35	consolida	2	153	188
consolidàrem	2	0	consolidarem	2	6	6
consolidés	2	15	consolides	2	1	16
consolidí	2	0	consolidi	2	127	127
consolà	2	0	consola	4	1044	1044
consolés	2	0	consoles	4	197	197
consolí	2	0	consoli	2	2	2
consonantés	2	0	consonantes	2	2	2
consoní	2	0	consoni	2	1	1
conspirarà	2	1	conspirara	2	0	1
conspirà	2	8	conspira	2	25	33
conspirés	2	0	conspires	2	1	1
constantà	4	7	constanta	4	5	12
constarà	2	69	constara	2	2	71
constatarà	2	7	constatara	2	0	7
constatà	2	13	constata	2	365	378
constatàrem	2	0	constatarem	2	8	8
constatés	2	9	constates	2	0	9
constatí	2	0	constati	2	25	25
consternà	2	0	consterna	2	20	20
constiparà	2	1	constipara	2	0	1
constipà	2	0	constipa	2	2	2
constitucionalitzarà	2	1	constitucionalitzara	2	0	1
constitucionalitzà	2	0	constitucionalitza	2	2	2
constitucionalitzí	2	0	constitucionalitzi	2	1	1
constituírem	2	0	constituirem	2	3	3
constituíreu	2	0	constituireu	2	1	1
constrenyérem	2	0	constrenyerem	2	1	1
constrenyí	2	0	constrenyi	2	6	6
construírem	2	0	construirem	2	60	60
construíreu	2	0	construireu	2	6	6
constà	2	4	consta	2	2124	2128
constés	2	77	constes	2	0	77
constí	2	0	consti	2	280	280
consultarà	2	75	consultara	2	0	75
consultà	2	5	consulta	4	5304	5309
consultàrem	2	0	consultarem	2	26	26
consultés	2	40	consultes	4	2336	2376
consultí	2	0	consulti	2	223	223
consumirà	2	19	consumira	2	1	20
consumà	2	0	consuma	2	4	4
consumés	2	2	consumes	2	0	2
consumí	2	3	consumi	2	12	15
consumírem	2	0	consumirem	2	2	2
consumíreu	2	0	consumireu	2	1	1
consumís	2	4	consumis	2	0	4
contactarà	2	8	contactara	2	0	8
contactà	2	36	contacta	2	139	175
contactàrem	2	0	contactarem	2	6	6
contactés	2	9	contactes	2	4256	4265
contactí	2	0	contacti	2	40	40
contagià	2	0	contagia	2	8	8
contagiés	2	1	contagies	2	0	1
contagió	4	0	contagio	2	1	1
contaminarà	2	6	contaminara	2	0	6
contaminà	2	3	contamina	2	525	528
contaminés	2	4	contamines	2	1	5
contaminí	2	0	contamini	2	23	23
contarà	2	9	contara	2	1	10
contemplarà	2	30	contemplara	2	0	30
contemplà	2	9	contempla	2	1515	1524
contemplàrem	2	0	contemplarem	2	8	8
contemplés	2	33	contemples	2	0	33
contemplí	2	0	contempli	2	330	330
contendré	2	0	contendre	2	4	4
contenguí	2	0	contengui	2	2	2
contestarà	2	80	contestara	2	0	80
contestà	2	15	contesta	4	206	221
contestàrem	2	0	contestarem	2	8	8
contestés	2	42	contestes	4	10	52
contestí	2	0	contesti	2	142	142
contextualitzà	2	0	contextualitza	2	5	5
contextualitzí	2	0	contextualitzi	2	1	1
contindré	2	4	contindre	2	15	19
contingués	2	41	contingues	2	1	42
continguí	2	0	contingui	2	749	749
continuarà	2	3628	continuara	2	7	3635
continuà	2	650	continua	2	13895	14545
continuàrem	2	1	continuarem	2	1648	1649
continuàreu	2	0	continuareu	2	7	7
continués	2	331	continues	2	88	419
contornejà	2	0	contorneja	2	2	2
contraatacarà	2	1	contraatacara	2	0	1
contraatacà	2	9	contraataca	2	40	49
contraataqués	2	1	contraataques	2	1	2
contractarà	2	18	contractara	2	0	18
contractà	2	30	contracta	4	97	127
contractàrem	2	0	contractarem	2	3	3
contractés	2	17	contractes	4	3035	3052
contractí	2	0	contracti	2	39	39
contradigués	2	2	contradigues	2	0	2
contradiguí	2	0	contradigui	2	34	34
contrafirmà	2	0	contrafirma	4	2	2
contragués	2	9	contragues	2	0	9
contramarxà	2	0	contramarxa	4	1	1
contraminés	2	0	contramines	4	1	1
contrapesà	2	0	contrapesa	2	2	2
contraposà	2	0	contraposa	2	30	30
contraposàrem	2	0	contraposarem	2	1	1
contraposés	2	1	contraposes	2	1	2
contraposí	2	0	contraposi	2	7	7
contrarestarà	2	13	contrarestara	2	0	13
contrarestà	2	0	contraresta	2	40	40
contrarestàrem	2	0	contrarestarem	2	4	4
contrarestés	2	3	contrarestes	2	1	4
contrarestí	2	0	contraresti	2	22	22
contrarià	2	0	contraria	2	22	22
contrariés	2	0	contraries	2	1	1
contrastarà	2	4	contrastara	2	0	4
contrastà	2	2	contrasta	2	362	364
contrastàrem	2	1	contrastarem	2	0	1
contrastés	2	0	contrastes	2	1	1
contrastí	2	0	contrasti	2	3	3
contrauré	2	0	contraure	2	166	166
contravingués	2	2	contravingues	2	0	2
contravinguí	2	0	contravingui	2	13	13
contribuírem	2	0	contribuirem	2	119	119
contribuíreu	2	0	contribuireu	2	2	2
contristà	2	0	contrista	2	1	1
controlarà	2	107	controlara	2	1	108
controlà	2	15	controla	2	1515	1530
controlàrem	2	0	controlarem	2	30	30
controlàreu	2	0	controlareu	2	4	4
controlés	2	36	controles	2	17	53
controlí	2	0	controli	2	287	287
contrària	0	1182	contraria	2	22	1204
contràries	0	523	contraries	2	1	524
contà	2	5	conta	2	189	194
contàrem	2	0	contarem	2	5	5
contàreu	2	0	contareu	2	1	1
contès	2	1	contes	2	775	776
conté	2	12805	conte	2	668	13473
contén	2	2	conten	2	71	73
contés	2	7	contes	2	775	782
contí	2	0	conti	2	72	72
contín	2	0	contin	2	1	1
contínua	0	2327	continua	2	13895	16222
contínues	0	658	continues	2	88	746
convalidà	2	1	convalida	2	2	3
convalidí	2	0	convalidi	2	2	2
convencerà	2	43	convencera	2	0	43
convencérem	2	0	convencerem	2	9	9
convencéreu	2	0	convencereu	2	1	1
convencés	2	20	convences	2	1	21
convencí	2	0	convenci	2	73	73
convergirà	2	3	convergira	2	0	3
conversarà	2	1	conversara	2	0	1
conversà	2	0	conversa	0	1436	1436
conversàrem	2	0	conversarem	2	3	3
conversés	2	1	converses	0	4335	4336
conversí	2	0	conversi	2	2	2
convertirà	2	822	convertira	2	9	831
convertírem	2	1	convertirem	2	56	57
convertíreu	2	0	convertireu	2	5	5
convidarà	2	54	convidara	2	0	54
convidà	2	47	convida	2	691	738
convidàrem	2	0	convidarem	2	16	16
convidés	2	32	convides	2	24	56
convidí	2	0	convidi	2	125	125
convingués	2	8	convingues	2	0	8
convinguí	2	0	convingui	2	135	135
convisquí	2	0	convisqui	2	7	7
conviuré	2	0	conviure	2	233	233
convocarà	2	36	convocara	2	0	36
convocà	2	48	convoca	2	94	142
convocàrem	2	0	convocarem	2	9	9
convoqués	2	29	convoques	2	0	29
convoquí	2	0	convoqui	2	83	83
convulsionarà	2	1	convulsionara	2	0	1
convulsioní	2	0	convulsioni	2	1	1
convulsà	2	0	convulsa	0	8	8
convulsés	2	0	convulses	0	2	2
conxorxà	2	0	conxorxa	4	10	10
conxorxés	2	0	conxorxes	4	4	4
conxorxí	2	0	conxorxi	2	1	1
conxà	2	0	conxa	4	2	2
conxés	2	0	conxes	4	2	2
cooperarà	2	37	cooperara	2	1	38
cooperà	2	4	coopera	2	110	114
cooperàrem	2	0	cooperarem	2	32	32
cooperés	2	34	cooperes	2	6	40
cooperí	2	0	cooperi	2	150	150
cooptà	2	1	coopta	2	0	1
coordinarà	2	48	coordinara	2	0	48
coordinà	2	15	coordina	2	238	253
coordinàrem	2	0	coordinarem	2	1	1
coordinés	2	15	coordines	2	0	15
coordiní	2	0	coordini	2	139	139
coparà	2	1	copara	2	0	1
copegés	2	1	copeges	2	1	2
copegí	2	0	copegi	2	5	5
copejarà	2	1	copejara	2	0	1
copejà	2	2	copeja	2	21	23
copiarà	2	101	copiara	2	1	102
copià	2	8	copia	2	1601	1609
copiàrem	2	0	copiarem	2	1	1
copiés	2	3	copies	2	38	41
copió	4	0	copio	2	7	7
copsà	2	0	copsa	2	2	2
copulà	2	0	copula	2	5	5
copà	2	2	copa	4	2614	2616
copés	2	0	copes	4	262	262
copí	2	0	copi	2	3	3
copó	4	2	copo	2	0	2
coquetegés	2	0	coqueteges	2	1	1
coquetejà	2	0	coqueteja	2	6	6
coquetó	0	0	coqueto	0	1	1
coquitzí	2	0	coquitzi	2	1	1
corbarà	2	9	corbara	2	0	9
corbà	2	0	corba	0	2156	2156
corbés	2	0	corbes	0	831	831
corcà	2	0	corca	2	19	19
cordellà	2	0	cordella	2	1	1
cordellés	2	0	cordelles	4	7	7
cordà	2	3	corda	4	1167	1170
cordés	2	0	cordes	4	741	741
cordí	2	0	cordi	2	2	2
cordó	4	216	cordo	2	1	217
coregés	2	1	coreges	2	0	1
corejà	2	0	coreja	2	8	8
coreografià	2	3	coreografia	4	137	140
coreografiés	2	0	coreografies	4	24	24
coreà	0	409	corea	4	4081	4490
corfà	2	0	corfa	4	11	11
corfés	2	0	corfes	4	2	2
cornuà	2	0	cornua	2	1	1
corní	2	0	corni	2	7	7
coronarà	2	5	coronara	2	0	5
coronà	2	20	corona	4	2071	2091
coronària	0	26	coronaria	2	8	34
coronàries	0	42	coronaries	2	0	42
coronés	2	2	corones	4	331	333
coroní	2	0	coroni	2	5	5
corprendré	2	0	corprendre	2	1	1
corprenguí	2	0	corprengui	2	4	4
corregirà	2	64	corregira	2	0	64
corregírem	2	0	corregirem	2	31	31
correlacionarà	2	1	correlacionara	2	0	1
correlacionà	2	0	correlaciona	2	39	39
correlacioní	2	0	correlacioni	2	2	2
correrà	2	72	correra	4	1	73
correspondré	2	0	correspondre	2	407	407
correspongués	2	25	correspongues	2	0	25
corresponguí	2	0	correspongui	2	396	396
corresponsabilitzarà	2	1	corresponsabilitzara	2	0	1
corresponsabilitzà	2	0	corresponsabilitza	2	1	1
corroborarà	2	1	corroborara	2	0	1
corroborà	2	2	corrobora	2	49	51
corroborés	2	4	corrobores	2	0	4
corroborí	2	0	corrobori	2	6	6
corrompré	2	0	corrompre	2	72	72
corrompés	2	1	corrompes	2	0	1
corrompí	2	0	corrompi	2	8	8
cortegí	2	0	cortegi	2	2	2
cortejà	2	0	corteja	2	4	4
cortesà	0	56	cortesa	0	31	87
cosirà	2	0	cosira	2	1	1
cossà	2	0	cossa	4	18	18
cossés	2	0	cosses	4	4	4
costarà	2	372	costara	2	3	375
costejarà	2	3	costejara	2	0	3
costojà	0	0	costoja	4	2	2
costà	2	31	costa	4	10741	10772
costés	2	7	costes	4	1475	1482
costí	2	0	costi	2	913	913
costós	0	432	costos	4	10043	10475
cotilèdons	4	8	cotiledons	4	2	10
cotitzarà	2	1	cotitzara	2	0	1
cotitzà	2	0	cotitza	2	33	33
cotitzés	2	1	cotitzes	2	0	1
cotitzí	2	0	cotitzi	2	3	3
cotà	2	0	cota	0	155	155
cotés	2	0	cotes	4	120	120
cotí	2	0	coti	2	2	2
cotó	4	959	coto	2	3	962
courà	2	4	coura	2	0	4
couré	2	0	coure	2	1038	1038
courés	2	0	coures	2	2	2
covà	2	0	cova	4	725	725
covés	2	0	coves	4	508	508
coàgul	4	15	coagul	2	0	15
cranés	2	0	cranes	2	1	1
craní	2	0	crani	2	590	590
crearà	2	1240	creara	2	4	1244
cregués	2	47	cregues	2	6	53
creguí	2	0	cregui	2	399	399
creixérem	2	0	creixerem	2	9	9
creixés	2	29	creixes	4	6	35
creixí	2	0	creixi	2	191	191
cremarà	2	25	cremara	2	2	27
cremà	2	21	crema	4	679	700
cremàrem	2	1	cremarem	2	11	12
cremàreu	2	0	cremareu	2	1	1
cremés	2	26	cremes	4	55	81
cremí	2	0	cremi	2	36	36
creosotà	2	0	creosota	4	7	7
crepè	4	0	crepe	2	1	1
crepès	4	0	crepes	2	1	1
crepé	4	0	crepe	2	1	1
crepés	2	0	crepes	2	1	1
crespà	2	0	crespa	0	1	1
crespó	4	1	crespo	4	474	475
cresqués	2	1	cresques	2	24	25
cresquí	2	0	cresqui	2	1	1
crestà	2	0	cresta	4	407	407
crestés	2	0	crestes	4	220	220
crestó	4	1	cresto	2	0	1
cretès	0	0	cretes	4	1	1
cretés	0	0	cretes	4	1	1
creuarà	2	12	creuara	2	1	13
creuré	2	15	creure	2	3465	3480
creuà	2	21	creua	2	352	373
creuàrem	2	0	creuarem	2	9	9
creuàreu	2	0	creuareu	2	1	1
creués	2	15	creues	2	4	19
creuí	2	0	creui	2	20	20
creà	2	422	crea	2	7183	7605
creàrem	2	1	crearem	2	151	152
creàreu	2	0	creareu	2	31	31
creés	2	196	crees	2	34	230
creí	2	0	crei	2	22	22
criarà	2	2	criara	2	0	2
cridarà	2	50	cridara	2	3	53
cridà	2	53	crida	4	6265	6318
cridàrem	2	0	cridarem	2	18	18
cridàreu	2	0	cridareu	2	3	3
cridés	2	37	crides	4	1007	1044
cridí	2	0	cridi	2	170	170
criminalitzarà	2	2	criminalitzara	2	0	2
criminalitzà	2	2	criminalitza	2	32	34
criminalitzés	2	1	criminalitzes	2	0	1
criminalitzí	2	0	criminalitzi	2	7	7
criptografià	2	0	criptografia	4	217	217
crismà	2	0	crisma	4	5	5
crismó	4	12	crismo	2	0	12
crispà	2	0	crispa	4	1	1
cristal·litzarà	2	3	cristal·litzara	2	0	3
cristal·litzà	2	3	cristal·litza	2	52	55
cristal·litzí	2	0	cristal·litzi	2	5	5
cristianitzà	2	1	cristianitza	2	0	1
cristianà	2	0	cristiana	4	1688	1688
cristianés	2	0	cristianes	2	815	815
cristianí	2	0	cristiani	2	3	3
crisòtil	4	12	crisotil	4	1	13
criticarà	2	12	criticara	2	0	12
criticà	2	65	critica	2	500	565
criticàrem	2	0	criticarem	2	7	7
critiqués	2	19	critiques	2	14	33
critiquí	2	0	critiqui	2	59	59
crivellà	2	0	crivella	2	1	1
crivellí	2	0	crivelli	2	10	10
crià	2	18	cria	4	1124	1142
criàrem	2	0	criarem	2	1	1
criés	2	1	cries	4	343	344
cromà	2	0	croma	4	71	71
cromós	0	1	cromos	4	31	32
cronometrà	2	0	cronometra	2	4	4
cronometrés	2	0	cronometres	2	1	1
cronòmetre	4	129	cronometre	2	0	129
cronòmetres	4	30	cronometres	2	1	31
croquís	2	0	croquis	4	54	54
crucificarà	2	2	crucificara	2	0	2
crucificà	2	0	crucifica	2	1	1
crucifiquí	2	0	crucifiqui	2	1	1
cruixí	2	0	cruixi	2	1	1
cruspírem	2	0	cruspirem	2	1	1
cruí	2	0	crui	4	1	1
cràter	4	2300	crater	4	60	2360
cràters	4	927	craters	4	15	942
crèiem	2	161	creiem	2	6402	6563
crèieu	2	0	creieu	2	267	267
créiem	2	0	creiem	2	6402	6402
créieu	2	0	creieu	2	267	267
crémor	4	0	cremor	4	36	36
crémors	4	0	cremors	4	2	2
crític	0	2699	critic	2	11	2710
crítica	0	5230	critica	2	500	5730
crítiques	0	4565	critiques	2	14	4579
crúor	4	1	cruor	4	0	1
cubellès	0	0	cubelles	4	5	5
cubellés	0	0	cubelles	4	5	5
cubiqués	2	0	cubiques	2	1	1
cubooctàedre	4	0	cubooctaedre	4	1	1
cubà	0	480	cuba	4	2776	3256
cucà	2	0	cuca	4	42	42
cuejà	2	0	cueja	2	1	1
cuidarà	2	28	cuidara	2	2	30
cuidà	2	2	cuida	2	163	165
cuidàrem	2	0	cuidarem	2	15	15
cuidés	2	13	cuides	2	7	20
cuidí	2	0	cuidi	2	39	39
cuinarà	2	4	cuinara	2	0	4
cuinà	2	1	cuina	4	1186	1187
cuinàrem	2	0	cuinarem	2	4	4
cuinés	2	4	cuines	4	117	121
cuiní	2	0	cuini	2	7	7
cuirassà	2	0	cuirassa	4	57	57
cuirassés	2	0	cuirasses	4	11	11
cuità	2	0	cuita	2	51	51
cuités	2	0	cuites	2	24	24
cullerà	0	0	cullera	4	91	91
cullà	0	0	culla	4	4	4
culminarà	2	39	culminara	2	0	39
culminà	2	31	culmina	2	102	133
culminàrem	2	0	culminarem	2	4	4
culminés	2	4	culmines	2	0	4
culminí	2	0	culmini	2	47	47
culpabilitzà	2	0	culpabilitza	2	4	4
culpabilitzí	2	0	culpabilitzi	2	1	1
culparà	2	6	culpara	2	0	6
culpà	2	12	culpa	4	2821	2833
culpàrem	2	0	culparem	2	3	3
culpàreu	2	0	culpareu	2	1	1
culpés	2	4	culpes	4	82	86
culpí	2	0	culpi	2	10	10
cultivà	2	9	cultiva	4	120	129
cultivés	2	0	cultives	4	1	1
cultiví	2	0	cultivi	2	1	1
culà	2	0	cula	2	1	1
cuqués	2	0	cuques	4	39	39
curarà	2	22	curara	2	0	22
curaré	2	7	curare	4	18	25
cursà	2	20	cursa	4	1490	1510
cursés	2	3	curses	4	694	697
cursí	2	0	cursi	2	22	22
curtcircuità	2	1	curtcircuita	2	0	1
curullà	2	0	curulla	0	2	2
curullés	2	0	curulles	0	5	5
curà	2	4	cura	4	3178	3182
curàrem	2	0	curarem	2	7	7
curés	2	4	cures	4	574	578
curí	2	0	curi	2	35	35
curós	0	22	curos	4	2	24
custodiarà	2	2	custodiara	2	0	2
custodià	2	0	custodia	2	33	33
custodiés	2	1	custodies	2	0	1
custodí	2	0	custodi	4	27	27
custodíem	2	0	custodiem	2	1	1
custodís	2	0	custodis	0	31	31
custòdies	0	4	custodies	2	0	4
càbria	4	0	cabria	2	16	16
càbries	4	3	cabries	2	0	3
càlam	4	3	calam	2	0	3
càlat	4	0	calat	2	144	144
càlats	4	0	calats	2	6	6
càlcic	0	3	calcic	2	0	3
càlcul	4	3001	calcul	2	3	3004
càmfora	4	13	camfora	2	0	13
càmper	4	1	camper	4	18	19
càmpers	4	0	campers	4	1	1
cànon	4	275	canon	2	262	537
cànons	4	202	canons	4	995	1197
càntar	4	0	cantar	2	1294	1294
càntera	4	0	cantera	4	8	8
cànteres	4	1	canteres	4	6	7
càpia	2	1	capia	2	0	1
càpien	2	1	capien	2	0	1
càries	0	31	caries	2	2	33
càrrega	4	7618	carrega	2	1201	8819
càrregues	4	2182	carregues	2	14	2196
càrter	4	7	carter	4	450	457
càrters	4	1	carters	4	13	14
cèlebre	0	395	celebre	2	6	401
cèlebres	0	121	celebres	2	4	125
cèrcol	4	105	cercol	2	0	105
cèrvia	4	0	cervia	4	3	3
cíat	4	0	ciat	2	11	11
cínamom	4	0	cinamom	4	2	2
cítara	4	24	citara	2	0	24
cítares	4	4	citares	2	0	4
còlera	4	371	colera	4	7	378
còleres	4	1	coleres	0	0	1
còlon	4	87	colon	4	75	162
còlons	4	2	colons	4	1449	1451
còmput	4	133	comput	2	1	134
cònsol	4	425	consol	4	201	626
cònsols	4	90	consols	4	3	93
còpia	4	4344	copia	2	1601	5945
còpies	4	2141	copies	2	38	2179
còpula	4	40	copula	2	5	45
còpules	4	2	copules	2	0	2
còtons	4	0	cotons	4	2	2
cóc	4	3	coc	4	63	66
cócs	4	0	cocs	4	7	7
cóm	4	54	com	1	481264	481318
cóms	4	1	coms	4	5	6
cóp	4	0	cop	4	11975	11975
cóps	4	0	cops	4	1693	1693
córner	4	13	corner	4	62	75
córners	4	0	corners	4	31	31
cóssos	4	3	cossos	4	2386	2389
cúbic	0	170	cubic	2	2	172
cúbica	0	180	cubica	2	0	180
cúbiques	0	61	cubiques	2	1	62
cúries	4	11	curies	4	2	13
dadà	0	13	dada	4	900	913
dallà	2	0	dalla	4	29	29
dallàs	2	0	dallas	4	401	401
dallés	2	0	dalles	4	19	19
dallí	2	1	dalli	2	114	115
damasquinés	2	0	damasquines	4	1	1
damnificà	2	0	damnifica	2	1	1
damnà	2	1	damna	2	0	1
damà	4	2	dama	4	1031	1033
damàs	4	1	damas	4	26	27
dansà	2	1	dansa	4	887	888
dansés	2	0	danses	4	226	226
dansí	2	0	dansi	2	5	5
danyarà	2	20	danyara	2	0	20
danyà	2	13	danya	2	176	189
danyàrem	2	0	danyarem	2	2	2
danyés	2	12	danyes	2	2	14
danyí	2	3	danyi	2	32	35
dardà	2	0	darda	2	1	1
dardés	2	0	dardes	2	1	1
darrerà	0	0	darrera	0	2371	2371
darà	2	1	dara	2	43	44
datà	2	1	data	4	13511	13512
datés	2	0	dates	4	2165	2165
datí	2	1	dati	2	43	44
daurà	2	0	daura	4	15	15
davallà	2	4	davalla	2	13	17
deambulà	2	0	deambula	2	3	3
debanà	2	0	debana	2	1	1
debatré	2	16	debatre	2	5185	5201
debatés	2	63	debates	2	3	66
debatí	2	0	debati	2	289	289
debilitarà	2	5	debilitara	2	0	5
debilità	2	10	debilita	2	27	37
debilitàrem	2	0	debilitarem	2	1	1
debilités	2	1	debilites	2	0	1
debilití	2	0	debiliti	2	1	1
debutarà	2	1	debutara	2	0	1
debutà	2	90	debuta	2	27	117
decaigués	2	6	decaigues	2	0	6
decaiguí	2	0	decaigui	2	20	20
decalarà	2	1	decalara	2	0	1
decalà	2	0	decala	2	1	1
decantà	2	2	decanta	2	27	29
decantàrem	2	0	decantarem	2	1	1
decantés	2	0	decantes	2	1	1
decantí	2	0	decanti	2	4	4
decapitarà	2	1	decapitara	2	0	1
decapità	2	2	decapita	2	4	6
decapités	2	1	decapites	2	1	2
decapití	2	0	decapiti	2	1	1
decauré	2	0	decaure	2	135	135
decebré	2	16	decebre	2	166	182
decebí	2	0	decebi	2	15	15
decepcionà	2	0	decepciona	2	2	2
decepcionés	2	0	decepciones	2	1	1
decidirà	2	489	decidira	2	7	496
decidírem	2	2	decidirem	2	112	114
decidíreu	2	0	decidireu	2	4	4
declamà	2	1	declama	2	3	4
declararà	2	34	declarara	2	1	35
declarà	2	293	declara	2	1059	1352
declaràrem	2	0	declararem	2	9	9
declarés	2	100	declares	2	4	104
declarí	2	0	declari	2	223	223
declinarà	2	1	declinara	2	0	1
declinà	2	57	declina	2	36	93
declinàrem	2	0	declinarem	2	1	1
declinés	2	3	declines	2	0	3
decliní	2	0	declini	2	10	10
decolorà	2	0	decolora	2	2	2
decomissà	2	0	decomissa	2	1	1
decomissés	2	1	decomisses	2	0	1
decorà	2	6	decora	2	32	38
decorés	2	3	decores	2	1	4
decorí	2	0	decori	2	2	2
decretarà	2	2	decretara	2	0	2
decretà	2	26	decreta	2	36	62
decretés	2	8	decretes	2	1	9
decretí	2	0	decreti	2	10	10
decrèpit	0	9	decrepit	2	0	9
decrèpita	0	6	decrepita	2	0	6
decrèpites	0	2	decrepites	2	0	2
dedicarà	2	113	dedicara	2	1	114
dedicà	2	223	dedica	2	789	1012
dedicàrem	2	0	dedicarem	2	55	55
dedicàreu	2	0	dedicareu	2	1	1
dediqués	2	52	dediques	2	24	76
dediquí	2	0	dediqui	2	261	261
deduírem	2	0	deduirem	2	1	1
defallirà	2	2	defallira	2	0	2
defecà	2	0	defeca	2	2	2
defendré	2	2	defendre	2	68	70
defensarà	2	122	defensara	2	0	122
defensà	2	134	defensa	4	15270	15404
defensàrem	2	0	defensarem	2	100	100
defensés	2	41	defenses	4	724	765
defensí	2	0	defensi	2	373	373
defequí	2	0	defequi	2	1	1
definirà	2	117	definira	2	0	117
definírem	2	0	definirem	2	19	19
definíreu	2	0	definireu	2	4	4
defolià	2	0	defolia	2	1	1
deformà	2	0	deforma	2	50	50
deformés	2	1	deformes	2	15	16
deformí	2	0	deformi	2	6	6
defraudarà	2	3	defraudara	2	0	3
defraudà	2	0	defrauda	2	35	35
defraudàrem	2	0	defraudarem	2	9	9
defraudés	2	3	defraudes	2	1	4
defraudí	2	0	defraudi	2	12	12
defugirà	2	3	defugira	2	0	3
defugí	2	0	defugi	4	3	3
defugírem	2	0	defugirem	2	2	2
defugís	2	3	defugis	4	0	3
degenerarà	2	8	degenerara	2	0	8
degenerà	2	5	degenera	2	16	21
degenerés	2	6	degeneres	2	11	17
degenerí	2	0	degeneri	2	40	40
degollarà	2	1	degollara	2	0	1
degollà	2	0	degolla	4	6	6
degotegés	2	0	degoteges	2	1	1
degotejà	2	0	degoteja	2	1	1
degotà	2	0	degota	2	10	10
degradarà	2	8	degradara	2	1	9
degradà	2	0	degrada	2	114	114
degradàrem	2	0	degradarem	2	1	1
degradés	2	3	degrades	2	0	3
degradí	2	0	degradi	2	19	19
degués	2	70	degues	2	0	70
deguí	2	5	degui	2	110	115
degà	4	261	dega	2	3	264
deixarà	2	775	deixara	2	11	786
deixuplinà	2	0	deixuplina	4	2	2
deixà	2	457	deixa	4	6013	6470
deixàrem	2	2	deixarem	2	322	324
deixàreu	2	0	deixareu	2	22	22
deixés	2	364	deixes	4	299	663
deixí	2	0	deixi	2	1615	1615
dejunàrem	2	0	dejunarem	2	1	1
dejuní	2	0	dejuni	2	81	81
delatarà	2	4	delatara	2	0	4
delatà	2	0	delata	2	11	11
delatés	2	2	delates	2	0	2
delatí	2	0	delati	2	2	2
delectarà	2	1	delectara	2	0	1
delectà	2	0	delecta	2	11	11
delectí	2	0	delecti	2	2	2
delegarà	2	2	delegara	2	0	2
delegués	2	1	delegues	2	0	1
deleguí	2	0	delegui	2	35	35
delegà	2	10	delega	2	68	78
delegàrem	2	0	delegarem	2	1	1
delerà	2	0	delera	4	1	1
deliberarà	2	17	deliberara	2	0	17
deliberà	2	0	delibera	2	17	17
deliberàrem	2	0	deliberarem	2	11	11
deliberés	2	1	deliberes	2	0	1
deliberí	2	0	deliberi	2	18	18
delimitarà	2	2	delimitara	2	0	2
delimità	2	0	delimita	2	68	68
delimités	2	2	delimites	2	0	2
delimití	2	0	delimiti	2	15	15
delinearà	2	1	delineara	2	0	1
delineà	2	0	delinea	2	1	1
delineés	2	1	delinees	2	0	1
delirés	2	0	delires	2	1	1
delirí	2	0	deliri	2	58	58
delità	2	0	delita	2	1	1
delités	2	0	delites	2	1	1
delmarà	2	2	delmara	2	0	2
delmà	2	2	delma	4	5	7
delmés	2	0	delmes	4	27	27
delmí	2	0	delmi	2	1	1
delí	2	0	deli	4	12	12
demanarà	2	683	demanara	2	4	687
demandarà	2	11	demandara	2	0	11
demandà	2	11	demanda	4	5105	5116
demandàrem	2	0	demandarem	2	1	1
demandés	2	5	demandes	4	2025	2030
demandí	2	0	demandi	2	19	19
demanà	2	313	demana	2	5947	6260
demanàrem	2	0	demanarem	2	197	197
demanàreu	2	0	demanareu	2	4	4
demanés	2	174	demanes	2	73	247
demaní	2	0	demani	2	685	685
demarcà	2	1	demarca	4	6	7
demarqués	2	1	demarques	4	0	1
demarquí	2	0	demarqui	2	1	1
demetí	2	0	demeti	2	1	1
democratitzarà	2	4	democratitzara	2	0	4
democratitzà	2	0	democratitza	2	8	8
democratitzés	2	2	democratitzes	2	0	2
democratitzí	2	0	democratitzi	2	9	9
demonitzà	2	0	demonitza	2	7	7
demonitzí	2	0	demonitzi	2	1	1
demorarà	2	7	demorara	2	0	7
demorà	2	2	demora	4	1152	1154
demorés	2	1	demores	4	204	205
demorí	2	0	demori	2	17	17
demostrarà	2	240	demostrara	2	0	240
demostrà	2	185	demostra	2	5682	5867
demostràrem	2	0	demostrarem	2	61	61
demostrés	2	81	demostres	2	9	90
demostrí	2	0	demostri	2	646	646
demà	4	9093	dema	4	5	9098
demès	2	3	demes	4	8	11
demés	2	69	demes	4	8	77
denegarà	2	14	denegara	2	0	14
denegués	2	15	denegues	2	1	16
deneguí	2	0	denegui	2	29	29
denegà	2	6	denega	2	136	142
denegàrem	2	0	denegarem	2	2	2
denigrà	2	1	denigra	2	4	5
denominarà	2	14	denominara	2	0	14
denominà	2	18	denomina	2	735	753
denominàrem	2	0	denominarem	2	3	3
denominés	2	2	denomines	2	0	2
denominí	2	0	denomini	2	34	34
denotarà	2	1	denotara	2	0	1
denotà	2	1	denota	2	348	349
denotàrem	2	0	denotarem	2	2	2
denotí	2	0	denoti	2	10	10
densificà	2	0	densifica	2	2	2
dentària	0	2	dentaria	2	0	2
dentàries	0	2	dentaries	2	0	2
dentí	2	0	denti	2	1	1
denunciarà	2	7	denunciara	2	1	8
denuncià	2	47	denuncia	2	182	229
denunciàrem	2	0	denunciarem	2	5	5
denunciés	2	15	denuncies	2	10	25
denúncia	4	600	denuncia	2	182	782
denúncies	4	500	denuncies	2	10	510
depararà	2	1	deparara	2	0	1
deparà	2	1	depara	2	3	4
depassarà	2	7	depassara	2	0	7
depassà	2	0	depassa	2	77	77
depassàrem	2	0	depassarem	2	2	2
depassés	2	4	depasses	2	0	4
depassí	2	0	depassi	2	25	25
depauperà	2	0	depaupera	2	1	1
dependré	2	0	dependre	2	738	738
depengués	2	63	depengues	2	0	63
depenguí	2	0	depengui	2	162	162
depenjà	2	0	depenja	2	1	1
depilà	2	0	depila	2	1	1
depilés	2	1	depiles	2	0	1
deplorà	2	1	deplora	2	86	87
deplorés	2	4	deplores	2	0	4
deplorí	2	0	deplori	2	1	1
deportarà	2	4	deportara	2	0	4
deportà	2	2	deporta	2	11	13
deportàrem	2	0	deportarem	2	1	1
deportés	2	1	deportes	2	19	20
deportí	2	0	deporti	2	6	6
deposarà	2	0	deposara	2	1	1
depositarà	2	1	depositara	2	0	1
deposità	2	0	deposita	2	7	7
deposà	2	13	deposa	2	3	16
deposés	2	3	deposes	2	0	3
deposí	2	0	deposi	2	5	5
depreciarà	2	3	depreciara	2	0	3
deprecià	2	1	deprecia	2	12	13
deprecií	2	0	deprecii	2	1	1
depredà	2	1	depreda	2	5	6
deprimirà	2	1	deprimira	2	0	1
depurarà	2	2	depurara	2	0	2
depurà	2	1	depura	2	66	67
depurí	2	0	depuri	2	3	3
depòsit	4	15	deposit	2	8	23
derivarà	2	46	derivara	2	0	46
derivà	2	17	deriva	4	2503	2520
derivàrem	2	0	derivarem	2	1	1
derivés	2	5	derives	4	60	65
deriví	2	0	derivi	2	76	76
derogarà	2	5	derogara	2	1	6
derogués	2	3	derogues	2	0	3
deroguí	2	0	derogui	2	40	40
derogà	2	4	deroga	2	109	113
derramà	2	0	derrama	4	1	1
derramés	2	0	derrames	4	1	1
derrapà	2	0	derrapa	2	1	1
derrapés	2	0	derrapes	2	1	1
derrocarà	2	1	derrocara	2	0	1
derrocà	2	3	derroca	2	10	13
derroqués	2	2	derroques	2	2	4
derroquí	2	0	derroqui	2	5	5
derrotarà	2	14	derrotara	2	0	14
derrotà	2	125	derrota	4	2225	2350
derrotàrem	2	0	derrotarem	2	12	12
derrotés	2	13	derrotes	4	258	271
derrotí	2	0	derroti	2	6	6
desacatà	2	0	desacata	2	5	5
desaccelerarà	2	6	desaccelerara	2	0	6
desaccelerà	2	2	desaccelera	2	9	11
desaccelerés	2	1	desacceleres	2	0	1
desaccelerí	2	0	desacceleri	2	6	6
desacoblà	2	1	desacobla	2	21	22
desacoblàrem	2	0	desacoblarem	2	1	1
desaconsellà	2	5	desaconsella	2	32	37
desaconsellí	2	0	desaconselli	2	5	5
desacreditarà	2	5	desacreditara	2	0	5
desacredità	2	3	desacredita	2	49	52
desacredités	2	1	desacredites	2	0	1
desacredití	2	0	desacrediti	2	5	5
desactivarà	2	81	desactivara	2	0	81
desactivà	2	3	desactiva	2	1009	1012
desactivàrem	2	0	desactivarem	2	2	2
desactivés	2	2	desactives	2	23	25
desactiví	2	0	desactivi	2	28	28
desafectés	2	0	desafectes	4	9	9
desafiarà	2	4	desafiara	2	0	4
desafinà	2	0	desafina	2	2	2
desafià	2	9	desafia	2	111	120
desafiàrem	2	0	desafiarem	2	2	2
desafiés	2	9	desafies	2	3	12
desagradarà	2	1	desagradara	2	0	1
desagradà	2	0	desagrada	2	68	68
desagradí	2	0	desagradi	2	4	4
desagregà	2	0	desagrega	2	2	2
desagruparà	2	1	desagrupara	2	0	1
desagrupà	2	0	desagrupa	2	40	40
desaiguà	2	0	desaigua	2	21	21
desaigüés	2	0	desaigües	2	1	1
desairés	2	0	desaires	2	1	1
desajustarà	2	2	desajustara	2	0	2
desajustí	2	0	desajusti	2	1	1
desallotgés	2	1	desallotges	2	0	1
desallotgí	2	0	desallotgi	2	3	3
desallotjarà	2	1	desallotjara	2	0	1
desallotjà	2	0	desallotja	2	2	2
desamagà	2	0	desamaga	2	1	1
desamà	2	0	desama	2	117	117
desancorà	2	0	desancora	2	4	4
desanimarà	2	6	desanimara	2	0	6
desanimà	2	1	desanima	2	34	35
desanimàrem	2	0	desanimarem	2	1	1
desanimés	2	1	desanimes	2	0	1
desanimí	2	0	desanimi	2	13	13
desanà	2	0	desana	2	1	1
desaparegués	2	65	desaparegues	2	0	65
desapareguí	2	0	desaparegui	2	215	215
desaparellà	2	0	desaparella	2	3	3
desaplicà	2	0	desaplica	2	1	1
desaprendré	2	0	desaprendre	2	1	1
desaprofitarà	2	5	desaprofitara	2	0	5
desaprofità	2	1	desaprofita	2	20	21
desaprofitàrem	2	0	desaprofitarem	2	2	2
desaprofités	2	1	desaprofites	2	0	1
desaprofití	2	0	desaprofiti	2	13	13
desaprovarà	2	3	desaprovara	2	1	4
desaprovà	2	3	desaprova	2	40	43
desaprovàrem	2	0	desaprovarem	2	1	1
desaproví	2	0	desaprovi	2	4	4
desarborà	2	0	desarbora	2	1	1
desarmarà	2	2	desarmara	2	0	2
desarmà	2	0	desarma	2	8	8
desarmàrem	2	0	desarmarem	2	3	3
desarmés	2	10	desarmes	2	0	10
desarmí	2	0	desarmi	2	9	9
desarrelà	2	0	desarrela	2	2	2
desarrelí	2	0	desarreli	2	1	1
desarticulà	2	0	desarticula	2	2	2
desarxivà	2	0	desarxiva	2	5	5
desarà	2	314	desara	2	0	314
desassemblarà	2	1	desassemblara	2	0	1
desassignarà	2	1	desassignara	2	0	1
desassignà	2	0	desassigna	2	15	15
desassocià	2	0	desassocia	2	16	16
desatendré	2	0	desatendre	2	60	60
desatengués	2	1	desatengues	2	0	1
desatenguí	2	0	desatengui	2	1	1
desatesà	2	0	desatesa	2	25	25
desatesés	2	0	desateses	2	55	55
desatrossà	2	0	desatrossa	2	1	1
desautoritzà	2	0	desautoritza	2	6	6
desautoritzí	2	0	desautoritzi	2	2	2
desavén	2	0	desaven	2	11	11
desballestà	2	1	desballesta	2	4	5
desballestí	2	0	desballesti	2	3	3
desbancà	2	3	desbanca	2	1	4
desbanquí	2	0	desbanqui	2	3	3
desbaratarà	2	2	desbaratara	2	0	2
desbaratà	2	1	desbarata	2	12	13
desbaratés	2	1	desbarates	2	0	1
desbaratí	2	0	desbarati	2	5	5
desbarrà	2	0	desbarra	2	1	1
desblocà	2	0	desbloca	2	63	63
desbloquegés	2	2	desbloqueges	2	1	3
desbloquegí	2	0	desbloquegi	2	40	40
desbloquejarà	2	17	desbloquejara	2	0	17
desbloquejà	2	0	desbloqueja	2	150	150
desbloquejàrem	2	0	desbloquejarem	2	2	2
desbloquí	2	0	desbloqui	2	2	2
desbocà	2	0	desboca	2	2	2
desbordarà	2	4	desbordara	2	0	4
desbordà	2	1	desborda	2	54	55
desbordés	2	2	desbordes	2	0	2
desbordí	2	0	desbordi	2	10	10
desbrossà	2	0	desbrossa	2	1	1
desbudellarà	2	1	desbudellara	2	0	1
desburocratitzí	2	0	desburocratitzi	2	1	1
descalcés	2	0	descalces	0	5	5
descalcí	2	0	descalci	2	1	1
descalçà	2	0	descalça	0	24	24
descansarà	2	16	descansara	2	1	17
descansà	2	2	descansa	2	319	321
descansàrem	2	0	descansarem	2	6	6
descansés	2	4	descanses	2	3	7
descansí	2	0	descansi	2	48	48
descapitalitzàrem	2	0	descapitalitzarem	2	1	1
descarboxilà	2	0	descarboxila	2	1	1
descargolarà	2	1	descargolara	2	0	1
descargolà	2	0	descargola	2	1	1
descarregarà	2	24	descarregara	2	0	24
descarregués	2	5	descarregues	2	12	17
descarreguí	2	0	descarregui	2	20	20
descarregà	2	1	descarrega	2	326	327
descarregàrem	2	1	descarregarem	2	1	2
descarregàreu	2	0	descarregareu	2	2	2
descarrilà	2	2	descarrila	2	3	5
descarrilés	2	4	descarriles	2	0	4
descarrilí	2	0	descarrili	2	7	7
descartarà	2	30	descartara	2	0	30
descartà	2	8	descarta	2	332	340
descartàrem	2	0	descartarem	2	3	3
descartés	2	1	descartes	4	122	123
descartí	2	0	descarti	2	77	77
descarí	2	0	descari	2	1	1
descendirà	2	32	descendira	2	0	32
descentralitzarà	2	1	descentralitzara	2	0	1
descentralitzà	2	0	descentralitza	2	4	4
descentralitzàrem	2	0	descentralitzarem	2	1	1
descentralitzés	2	1	descentralitzes	2	0	1
descentralitzí	2	0	descentralitzi	2	9	9
desclassificà	2	1	desclassifica	2	0	1
desclassifiqués	2	1	desclassifiques	2	0	1
desclavà	2	0	desclava	2	1	1
desclouré	2	0	descloure	2	9	9
descobrirà	2	46	descobrira	2	2	48
descobrírem	2	2	descobrirem	2	52	54
descobríreu	2	0	descobrireu	2	4	4
descodificarà	2	2	descodificara	2	0	2
descodificà	2	0	descodifica	2	46	46
descodifiquí	2	0	descodifiqui	2	2	2
descolorí	2	1	descolori	2	0	1
descol·locà	2	1	descol·loca	2	1	2
descompensarà	2	1	descompensara	2	0	1
descompilà	2	0	descompila	2	3	3
descompondré	2	0	descompondre	2	129	129
descomponguí	2	0	descompongui	2	4	4
descomptarà	2	8	descomptara	2	0	8
descomptà	2	1	descompta	2	5	6
descomptàrem	2	0	descomptarem	2	1	1
descomptés	2	0	descomptes	2	157	157
descomptí	2	0	descompti	2	4	4
desconcertarà	2	1	desconcertara	2	0	1
desconcertà	2	3	desconcerta	2	36	39
desconcertí	2	0	desconcerti	2	1	1
desconeguí	2	0	desconegui	2	15	15
desconfigurà	2	0	desconfigura	2	1	1
desconfià	2	0	desconfia	2	30	30
desconfiàrem	2	0	desconfiarem	2	1	1
desconfiés	2	0	desconfies	2	2	2
desconfií	2	1	desconfii	2	0	1
desconfíem	2	0	desconfiem	2	14	14
desconfíeu	2	0	desconfieu	2	4	4
descongelà	2	0	descongela	2	5	5
descongelí	2	0	descongeli	2	2	2
descongestionarà	2	2	descongestionara	2	0	2
descongestionà	2	0	descongestiona	2	1	1
descongestioní	2	0	descongestioni	2	1	1
desconnectarà	2	11	desconnectara	2	0	11
desconnectà	2	0	desconnecta	2	124	124
desconnectàrem	2	0	desconnectarem	2	1	1
desconnectàreu	2	0	desconnectareu	2	1	1
desconnectés	2	5	desconnectes	2	0	5
desconnectí	2	0	desconnecti	2	19	19
descontaminà	2	0	descontamina	2	1	1
descontentà	2	0	descontenta	0	84	84
descontentés	2	0	descontentes	0	17	17
descontrolà	2	1	descontrola	2	2	3
descontrolés	2	2	descontroles	2	0	2
descontrolí	2	0	descontroli	2	5	5
descoratgés	2	1	descoratges	4	0	1
descoratgí	2	0	descoratgi	2	5	5
descoratjarà	2	11	descoratjara	2	0	11
descoratjà	2	0	descoratja	2	26	26
descordà	2	0	descorda	2	3	3
descordàrem	2	0	descordarem	2	1	1
descordés	2	0	descordes	2	1	1
descrigués	2	6	descrigues	2	0	6
descriguí	2	1	descrigui	2	100	101
descriuré	2	31	descriure	2	4069	4100
descuidà	2	1	descuida	2	5	6
descuidés	2	3	descuides	2	3	6
descuidí	2	0	descuidi	2	2	2
descurarà	2	3	descurara	2	0	3
descurà	2	0	descura	2	32	32
descuràrem	2	0	descurarem	2	3	3
descurés	2	1	descures	2	0	1
descurí	2	0	descuri	2	12	12
descàrrega	4	957	descarrega	2	326	1283
descàrregues	4	405	descarregues	2	12	417
desdejunà	2	0	desdejuna	2	3	3
desdejuní	2	0	desdejuni	2	68	68
desdenyà	2	0	desdenya	2	4	4
desdibuixà	2	0	desdibuixa	2	7	7
desdibuixí	2	0	desdibuixi	2	1	1
desdiguí	2	0	desdigui	2	3	3
desdoblegà	2	0	desdoblega	2	5	5
desdoblà	2	0	desdobla	2	2	2
desembarassà	2	0	desembarassa	2	1	1
desembarassés	2	1	desembarasses	2	1	2
desembarcarà	2	3	desembarcara	2	2	5
desembarcà	2	35	desembarca	2	16	51
desembarcàrem	2	0	desembarcarem	2	1	1
desembarcàreu	2	1	desembarcareu	2	0	1
desembarqués	2	6	desembarques	2	2	8
desembarquí	2	0	desembarqui	2	53	53
desembeinà	2	0	desembeina	2	1	1
desembocarà	2	52	desembocara	2	0	52
desembocà	2	12	desemboca	2	289	301
desembolicà	2	0	desembolica	2	12	12
desemboliquí	2	0	desemboliqui	2	1	1
desemboqués	2	9	desemboques	2	0	9
desemboquí	2	0	desemboqui	2	69	69
desemborsarà	2	5	desemborsara	2	0	5
desemborsà	2	0	desemborsa	2	16	16
desemborsí	2	0	desemborsi	2	5	5
desemmascarà	2	0	desemmascara	2	11	11
desemmascarí	2	0	desemmascari	2	3	3
desempalleguí	2	0	desempallegui	2	1	1
desempallegà	2	0	desempallega	2	1	1
desempallegàrem	2	0	desempallegarem	2	1	1
desempaquetarà	2	2	desempaquetara	2	0	2
desempaquetà	2	0	desempaqueta	2	12	12
desempaquetés	2	1	desempaquetes	2	0	1
desempaquetí	2	0	desempaqueti	2	1	1
desempatà	2	0	desempata	2	1	1
desempolsà	2	0	desempolsa	2	1	1
desencadenarà	2	27	desencadenara	2	1	28
desencadenà	2	11	desencadena	2	73	84
desencadenàrem	2	0	desencadenarem	2	2	2
desencadenés	2	8	desencadenes	2	0	8
desencadení	2	0	desencadeni	2	21	21
desencantà	2	1	desencanta	2	0	1
desencantés	2	1	desencantes	2	0	1
desencapsulà	2	0	desencapsula	2	1	1
desencoratjà	2	1	desencoratja	2	3	4
desencreuà	2	0	desencreua	2	1	1
desencriptarà	2	1	desencriptara	2	0	1
desencriptà	2	0	desencripta	2	25	25
desencriptí	2	0	desencripti	2	1	1
desendollà	2	0	desendolla	2	4	4
desenfocà	2	0	desenfoca	2	11	11
desenfoquí	2	0	desenfoqui	2	2	2
desenganxarà	2	2	desenganxara	2	0	2
desenganxà	2	0	desenganxa	2	11	11
desenganxàrem	2	0	desenganxarem	2	1	1
desenganxés	2	1	desenganxes	2	0	1
desenganxí	2	0	desenganxi	2	1	1
desenganyà	2	0	desenganya	2	1	1
desenganyí	2	0	desenganyi	2	1	1
desenllaçà	2	0	desenllaça	2	27	27
desenllustrà	2	0	desenllustra	2	1	1
desenredà	2	0	desenreda	2	1	1
desenroscà	2	0	desenrosca	2	1	1
desenrotllà	2	0	desenrotlla	2	12	12
desenrotllí	2	0	desenrotlli	2	1	1
desentelarà	2	1	desentelara	2	0	1
desentelà	2	0	desentela	2	1	1
desentendré	2	0	desentendre	2	41	41
desentengués	2	3	desentengues	2	0	3
desentenguí	2	0	desentengui	2	9	9
desenterrà	2	2	desenterra	2	5	7
desenterrí	2	0	desenterri	2	1	1
desentonà	2	0	desentona	2	5	5
desentoní	2	0	desentoni	2	1	1
desentranyarà	2	2	desentranyara	2	0	2
desentrellaçà	2	0	desentrellaça	2	14	14
desentumírem	2	0	desentumirem	2	1	1
desenvoluparà	2	257	desenvolupara	2	2	259
desenvolupà	2	286	desenvolupa	2	1337	1623
desenvolupàrem	2	0	desenvoluparem	2	50	50
desenvolupés	2	106	desenvolupes	2	6	112
desenvolupí	2	0	desenvolupi	2	777	777
desequilibrarà	2	2	desequilibrara	2	0	2
desequilibrà	2	0	desequilibra	2	3	3
desequilibrí	2	0	desequilibri	2	707	707
desertitzà	2	0	desertitza	2	2	2
desertà	2	5	deserta	0	88	93
desertés	2	3	desertes	0	14	17
desertí	2	0	deserti	2	4	4
desesperancés	2	0	desesperances	4	1	1
desesperançà	2	0	desesperança	4	99	99
desesperarà	2	1	desesperara	2	0	1
desesperà	2	1	desespera	2	26	27
desesperés	2	0	desesperes	2	1	1
desestabilitzarà	2	17	desestabilitzara	2	0	17
desestabilitzà	2	0	desestabilitza	2	40	40
desestabilitzàrem	2	0	desestabilitzarem	2	1	1
desestabilitzés	2	5	desestabilitzes	2	0	5
desestabilitzí	2	0	desestabilitzi	2	16	16
desestimarà	2	2	desestimara	2	0	2
desestimà	2	2	desestima	2	27	29
desestimés	2	2	desestimes	2	0	2
desestimí	2	0	desestimi	2	8	8
desestructurà	2	0	desestructura	2	1	1
desfasà	2	0	desfasa	2	2	2
desfasí	2	0	desfasi	2	1	1
desfavorirà	2	1	desfavorira	2	0	1
desfavorírem	2	0	desfavorirem	2	1	1
desfermà	2	0	desferma	2	6	6
desfermí	2	0	desfermi	2	4	4
desferrà	2	0	desferra	4	1	1
desferrés	2	0	desferres	4	12	12
desfigurà	2	0	desfigura	2	8	8
desfigurés	2	1	desfigures	2	0	1
desfigurí	2	0	desfiguri	2	1	1
desfilà	2	2	desfila	4	6	8
desfilés	2	1	desfiles	4	0	1
desfilí	2	0	desfili	2	1	1
desfoguí	2	0	desfogui	2	2	2
desfogà	2	0	desfoga	2	3	3
desfoní	2	0	desfoni	2	1	1
desforestà	2	0	desforesta	2	1	1
desfosforilà	2	0	desfosforila	2	2	2
desfragmentà	2	0	desfragmenta	2	2	2
desfressés	2	0	desfresses	4	1	1
desfullà	2	0	desfulla	2	1	1
desféu	2	2	desfeu	2	14	16
desganà	2	0	desgana	4	24	24
desganés	2	0	desganes	4	2	2
desgasificà	2	0	desgasifica	2	2	2
desgastarà	2	1	desgastara	2	0	1
desgastà	2	1	desgasta	2	15	16
desgastí	2	0	desgasti	2	3	3
desgasà	2	0	desgasa	2	1	1
desgelà	2	0	desgela	2	2	2
desglacés	2	1	desglaces	4	0	1
desglaçà	2	0	desglaça	4	2	2
desglossarà	2	2	desglossara	2	0	2
desglossà	2	0	desglossa	2	17	17
desglossí	2	0	desglossi	2	1	1
desgracià	2	0	desgracia	2	10	10
desgranà	2	0	desgrana	2	1	1
desgravà	2	0	desgrava	2	1	1
desgraví	2	0	desgravi	2	2	2
desgràcia	4	4548	desgracia	2	10	4558
desgràcies	4	151	desgracies	2	0	151
desguassà	2	0	desguassa	2	19	19
desguassí	2	0	desguassi	2	1	1
deshabilitarà	2	6	deshabilitara	2	0	6
deshabilità	2	0	deshabilita	2	86	86
deshabilití	2	0	deshabiliti	2	5	5
deshabità	2	0	deshabita	2	1	1
desheretés	2	1	desheretes	2	0	1
deshidratà	2	0	deshidrata	2	5	5
deshidratés	2	0	deshidrates	2	1	1
deshidratí	2	0	deshidrati	2	1	1
deshidrogenarà	2	1	deshidrogenara	2	0	1
deshonestà	2	0	deshonesta	0	30	30
deshonestés	2	0	deshonestes	0	38	38
deshonorà	2	0	deshonora	2	1	1
deshonrà	2	0	deshonra	4	39	39
deshonrés	2	0	deshonres	4	1	1
deshonrí	2	0	deshonri	2	1	1
deshumanitzarà	2	2	deshumanitzara	2	0	2
deshumanitzà	2	0	deshumanitza	2	3	3
designarà	2	29	designara	2	0	29
designà	2	40	designa	2	282	322
designàrem	2	0	designarem	2	1	1
designés	2	29	designes	2	0	29
designí	2	0	designi	2	93	93
desil·lusionà	2	2	desil·lusiona	2	9	11
desil·lusionés	2	1	desil·lusiones	2	0	1
desil·lusioní	2	0	desil·lusioni	2	1	1
desincentivarà	2	2	desincentivara	2	0	2
desincentivà	2	0	desincentiva	2	7	7
desincentivés	2	1	desincentives	2	0	1
desincentiví	2	0	desincentivi	2	2	2
desinclinà	2	0	desinclina	2	2	2
desinflarà	2	1	desinflara	2	0	1
desinflà	2	0	desinfla	2	7	7
desinflés	2	1	desinfles	2	0	1
desinformà	2	0	desinforma	2	3	3
desinformí	2	0	desinformi	2	1	1
desinstal·larà	2	6	desinstal·lara	2	0	6
desinstal·là	2	0	desinstal·la	2	79	79
desinstal·làreu	2	0	desinstal·lareu	2	2	2
desinstal·lí	2	0	desinstal·li	2	1	1
desintegrarà	2	6	desintegrara	2	0	6
desintegrà	2	9	desintegra	2	61	70
desintegrés	2	3	desintegres	2	0	3
desintegrí	2	0	desintegri	2	8	8
desinteressí	2	0	desinteressi	2	2	2
desintoxicà	2	0	desintoxica	2	2	2
desistirà	2	6	desistira	2	0	6
desistírem	2	0	desistirem	2	7	7
desitgés	2	54	desitges	2	61	115
desitgí	2	0	desitgi	2	581	581
desitjarà	2	34	desitjara	2	2	36
desitjà	2	3	desitja	2	4709	4712
desitjàrem	2	0	desitjarem	2	7	7
desitjàreu	2	0	desitjareu	2	15	15
desitjós	0	101	desitjos	4	2204	2305
deslegitimà	2	0	deslegitima	2	3	3
deslegitimí	2	0	deslegitimi	2	1	1
deslletà	2	0	deslleta	2	1	1
deslligarà	2	4	deslligara	2	0	4
deslligués	2	3	deslligues	2	0	3
deslliguí	2	0	deslligui	2	22	22
deslligà	2	0	deslliga	2	31	31
deslliurarà	2	10	deslliurara	2	0	10
deslliurà	2	1	deslliura	2	23	24
deslliuràrem	2	0	deslliurarem	2	12	12
deslliurés	2	2	deslliures	2	0	2
deslliurí	2	0	deslliuri	2	17	17
desllustrà	2	0	desllustra	2	1	1
deslocalitzarà	2	1	deslocalitzara	2	0	1
deslocalitzà	2	0	deslocalitza	2	11	11
deslocalitzí	2	0	deslocalitzi	2	1	1
desmagnetitzarà	2	1	desmagnetitzara	2	0	1
desmaiarà	2	2	desmaiara	2	0	2
desmaià	2	0	desmaia	2	18	18
desmaiés	2	1	desmaies	2	2	3
desmantellarà	2	5	desmantellara	2	0	5
desmantellà	2	4	desmantella	2	18	22
desmantellàrem	2	0	desmantellarem	2	1	1
desmantellés	2	3	desmantelles	2	0	3
desmantellí	2	0	desmantelli	2	28	28
desmarcà	2	0	desmarca	2	87	87
desmarqués	2	1	desmarques	2	1	2
desmarquí	2	0	desmarqui	2	2	2
desmaximitzà	2	0	desmaximitza	2	12	12
desmaí	2	0	desmai	4	17	17
desmembrarà	2	1	desmembrara	2	0	1
desmembrà	2	1	desmembra	2	1	2
desmentirà	2	8	desmentira	2	0	8
desmentí	2	1	desmenti	2	0	1
desmentís	2	5	desmentis	2	0	5
desmesclés	2	0	desmescles	2	1	1
desmilitaritzés	2	1	desmilitaritzes	2	0	1
desmilitaritzí	2	0	desmilitaritzi	2	2	2
desmillorà	2	0	desmillora	2	2	2
desminimitzà	2	0	desminimitza	2	3	3
desminà	2	0	desmina	2	2	2
desmitificarà	2	1	desmitificara	2	0	1
desmitificà	2	0	desmitifica	2	2	2
desmitificàrem	2	0	desmitificarem	2	1	1
desmobilitzarà	2	1	desmobilitzara	2	0	1
desmobilitzà	2	0	desmobilitza	2	1	1
desmobilitzés	2	1	desmobilitzes	2	1	2
desmoralitzà	2	1	desmoralitza	2	2	3
desmoralitzés	2	1	desmoralitzes	2	0	1
desmoralitzí	2	0	desmoralitzi	2	1	1
desmotivà	2	0	desmotiva	2	4	4
desmultiplexà	2	0	desmultiplexa	2	1	1
desmuntarà	2	8	desmuntara	2	0	8
desmuntà	2	2	desmunta	2	66	68
desmuntí	2	0	desmunti	2	11	11
desnaturalitzà	2	0	desnaturalitza	2	7	7
desnaturalitzí	2	0	desnaturalitzi	2	1	1
desnuà	2	0	desnua	2	1	1
desobeírem	2	1	desobeirem	2	0	1
desocupà	2	0	desocupa	2	3	3
desocupés	2	2	desocupes	2	0	2
desordenà	2	0	desordena	2	2	2
desordení	2	0	desordeni	2	1	1
desorganitzà	2	0	desorganitza	2	1	1
desorientà	2	0	desorienta	2	6	6
desorientí	2	0	desorienti	2	1	1
desovà	2	0	desova	2	2	2
desparasità	2	0	desparasita	2	5	5
desparellà	2	0	desparella	2	1	1
despatxarà	2	3	despatxara	2	0	3
despatxà	2	0	despatxa	2	15	15
despatxés	2	3	despatxes	2	0	3
despatxí	2	0	despatxi	2	3	3
despenalitzà	2	2	despenalitza	2	4	6
despenalitzí	2	0	despenalitzi	2	3	3
despendré	2	0	despendre	2	6	6
despengés	2	1	despenges	2	0	1
despengí	2	0	despengi	2	2	2
despenjà	2	0	despenja	2	3	3
despersonalitzà	2	0	despersonalitza	2	2	2
despertarà	2	35	despertara	2	1	36
despertà	2	13	desperta	0	533	546
despertàrem	2	0	despertarem	2	7	7
despertàreu	2	0	despertareu	2	5	5
despertés	2	20	despertes	0	21	41
despertí	2	0	desperti	2	86	86
despistarà	2	1	despistara	2	0	1
despistà	2	0	despista	2	1	1
despistàrem	2	0	despistarem	2	2	2
desplacés	2	25	desplaces	2	14	39
desplací	2	0	desplaci	2	78	78
desplaçarà	2	84	desplaçara	2	2	86
desplaçà	2	46	desplaça	2	679	725
desplaçàrem	2	0	desplaçarem	2	2	2
desplegarà	2	34	desplegara	2	0	34
desplegués	2	16	desplegues	2	0	16
despleguí	2	0	desplegui	2	22	22
desplegà	2	30	desplega	2	152	182
desplegàrem	2	0	desplegarem	2	4	4
desplomarà	2	2	desplomara	2	0	2
desplomà	2	4	desploma	2	21	25
desplomés	2	2	desplomes	2	1	3
desplomí	2	0	desplomi	2	5	5
despoblà	2	1	despobla	2	0	1
despolaritzà	2	0	despolaritza	2	2	2
despolititzà	2	0	despolititza	2	1	1
desposseírem	2	0	desposseirem	2	1	1
despreciarà	2	1	despreciara	2	0	1
desprendré	2	0	desprendre	2	148	148
desprengués	2	9	desprengues	2	0	9
desprenguí	2	0	desprengui	2	13	13
despreocupà	2	0	despreocupa	2	1	1
despressuritzà	2	1	despressuritza	2	0	1
desprestigià	2	0	desprestigia	2	7	7
desproporcionà	2	0	desproporciona	2	1	1
despullarà	2	4	despullara	2	0	4
despullà	2	0	despulla	4	46	46
despullàrem	2	0	despullarem	2	1	1
despullés	2	6	despulles	4	86	92
despullí	2	0	despulli	2	10	10
despuntà	2	0	despunta	2	7	7
desqualificarà	2	3	desqualificara	2	0	3
desqualificà	2	0	desqualifica	2	16	16
desqualifiqués	2	1	desqualifiques	2	0	1
desqualifiquí	2	0	desqualifiqui	2	2	2
desregistrarà	2	1	desregistrara	2	0	1
desregistrà	2	0	desregistra	2	3	3
desregularà	2	2	desregulara	2	0	2
desregulà	2	0	desregula	2	1	1
desregulí	2	0	desreguli	2	2	2
dessagnarà	2	1	dessagnara	2	0	1
dessagnà	2	0	dessagna	2	5	5
dessagnés	2	2	dessagnes	2	1	3
dessagní	2	0	dessagni	2	3	3
dessalà	2	0	dessala	2	1	1
dessaturà	2	0	dessatura	2	17	17
desseleccionarà	2	5	desseleccionara	2	0	5
desseleccionà	2	0	desselecciona	2	98	98
dessequés	2	1	desseques	2	0	1
desserialitzà	2	0	desserialitza	2	3	3
dessincronitzà	2	0	dessincronitza	2	2	2
dessoldà	2	0	dessolda	2	1	1
destacarà	2	30	destacara	2	0	30
destacà	2	123	destaca	2	2238	2361
destacàrem	2	0	destacarem	2	20	20
destapà	2	1	destapa	2	15	16
destapés	2	2	destapes	2	0	2
destapí	2	0	destapi	2	1	1
destaqués	2	17	destaques	2	1	18
destaquí	2	0	destaqui	2	114	114
destensà	2	0	destensa	2	1	1
desterrà	2	1	desterra	2	6	7
destesés	2	0	desteses	2	1	1
destil·là	2	1	destil·la	2	16	17
destil·lí	2	0	destil·li	2	1	1
destinarà	2	149	destinara	2	0	149
destinà	2	13	destina	2	416	429
destinàrem	2	0	destinarem	2	18	18
destinés	2	42	destines	2	0	42
destiní	2	0	destini	2	189	189
destorbarà	2	2	destorbara	2	0	2
destorbà	2	0	destorba	2	4	4
destorbés	2	2	destorbes	2	1	3
destorbí	2	0	destorbi	2	1	1
destrempà	2	0	destrempa	2	1	1
destriarà	2	1	destriara	2	0	1
destrià	2	0	destria	2	2	2
destronà	2	2	destrona	2	0	2
destronés	2	1	destrones	2	0	1
destrossarà	2	5	destrossara	2	0	5
destrossà	2	3	destrossa	4	45	48
destrossàrem	2	0	destrossarem	2	4	4
destrossés	2	6	destrosses	4	61	67
destrossí	2	0	destrossi	2	3	3
destruírem	2	0	destruirem	2	33	33
destruíreu	2	0	destruireu	2	4	4
destrà	2	0	destra	4	22	22
destrés	2	0	destres	4	19	19
destrí	2	0	destri	2	2	2
desvalisà	2	0	desvalisa	2	1	1
desvalorà	2	0	desvalora	2	2	2
desvalorí	2	0	desvalori	2	2	2
desvelarà	2	1	desvelara	2	0	1
desvelà	2	0	desvela	2	3	3
desvelés	2	0	desveles	2	1	1
desvelí	2	0	desveli	2	1	1
desvetllarà	2	1	desvetllara	2	0	1
desvetllà	2	1	desvetlla	2	8	9
desvetllí	2	0	desvetlli	2	1	1
desviarà	2	11	desviara	2	0	11
desvincularà	2	1	desvinculara	2	0	1
desvinculà	2	1	desvincula	2	29	30
desvinculàrem	2	0	desvincularem	2	1	1
desvinculés	2	3	desvincules	2	0	3
desvinculí	2	0	desvinculi	2	11	11
desvirtuarà	2	1	desvirtuara	2	0	1
desvirtuà	2	0	desvirtua	2	27	27
desviuré	2	0	desviure	2	3	3
desvià	2	10	desvia	2	161	171
desviàrem	2	0	desviarem	2	6	6
desviés	2	12	desvies	2	0	12
desvií	2	0	desvii	2	1	1
desvorés	2	0	desvores	2	1	1
desxifrarà	2	1	desxifrara	2	0	1
desxifrà	2	0	desxifra	2	20	20
desxifrés	2	0	desxifres	2	2	2
desxifrí	2	0	desxifri	2	2	2
desà	2	0	desa	2	3154	3154
desànim	4	30	desanim	2	2	32
desàrem	2	0	desarem	2	1	1
desàreu	2	0	desareu	2	7	7
desè	0	578	dese	2	6	584
desé	0	4	dese	2	6	10
desés	2	1	deses	2	13	14
desí	2	0	desi	2	98	98
detallarà	2	13	detallara	2	0	13
detallà	2	1	detalla	2	243	244
detallàrem	2	0	detallarem	2	4	4
detallés	2	7	detalles	2	4	11
detallí	2	0	detalli	2	82	82
detectarà	2	52	detectara	2	0	52
detectà	2	21	detecta	2	535	556
detectàrem	2	0	detectarem	2	2	2
detectàreu	2	0	detectareu	2	1	1
detectés	2	5	detectes	2	3	8
detectí	2	0	detecti	2	84	84
deteriorarà	2	22	deteriorara	2	0	22
deteriorà	2	13	deteriora	2	101	114
deteriorés	2	13	deteriores	2	0	13
deteriorí	2	0	deteriori	2	41	41
determinarà	2	302	determinara	2	0	302
determinà	2	51	determina	2	1658	1709
determinàrem	2	0	determinarem	2	10	10
determinàreu	2	0	determinareu	2	3	3
determinés	2	38	determines	2	3	41
determiní	2	0	determini	2	261	261
detestà	2	0	detesta	2	19	19
detestés	2	1	detestes	2	1	2
detestí	2	0	detesti	2	1	1
detindré	2	109	detindre	2	25	134
detingués	2	43	detingues	2	4	47
detinguí	2	0	detingui	2	190	190
detonarà	2	1	detonara	2	0	1
detonà	2	4	detona	2	17	21
detoní	2	0	detoni	2	1	1
deturà	2	1	detura	2	1	2
deuré	2	3	deure	4	3517	3520
devaluarà	2	2	devaluara	2	0	2
devaluà	2	0	devalua	2	26	26
devaluàrem	2	0	devaluarem	2	1	1
devalués	2	1	devalues	2	0	1
devastarà	2	1	devastara	2	0	1
devastà	2	8	devasta	2	10	18
devorarà	2	4	devorara	2	0	4
devorà	2	0	devora	7	28	28
devorés	2	1	devores	2	0	1
devorí	2	0	devori	2	5	5
dextrinés	2	0	dextrines	4	1	1
deïficà	2	0	deïfica	2	2	2
deïfiqués	2	1	deïfiques	2	0	1
deïfiquí	2	0	deïfiqui	2	1	1
diafragmà	2	0	diafragma	4	101	101
diafragmés	2	0	diafragmes	4	13	13
diagnosticarà	2	6	diagnosticara	2	0	6
diagnosticà	2	4	diagnostica	2	72	76
diagnostiqués	2	1	diagnostiques	2	0	1
diagnostiquí	2	0	diagnostiqui	2	7	7
diagnòstic	0	1465	diagnostic	2	20	1485
diagnòstica	0	36	diagnostica	2	72	108
diagnòstiques	0	22	diagnostiques	2	0	22
diagonalitzà	2	0	diagonalitza	2	1	1
diagramà	2	0	diagrama	4	1741	1741
diagramés	2	0	diagrames	4	800	800
dialogarà	2	5	dialogara	2	0	5
dialogués	2	2	dialogues	2	7	9
dialoguí	2	0	dialogui	2	31	31
dialogà	2	0	dialoga	2	9	9
dialogàrem	2	0	dialogarem	2	7	7
diamantés	2	0	diamantes	2	4	4
diapositivà	2	0	diapositiva	4	624	624
diapositivés	2	0	diapositives	4	759	759
dibuixarà	2	101	dibuixara	2	0	101
dibuixà	2	11	dibuixa	2	796	807
dibuixàrem	2	0	dibuixarem	2	3	3
dibuixàreu	2	0	dibuixareu	2	4	4
dibuixés	2	6	dibuixes	2	6	12
dibuixí	2	0	dibuixi	2	24	24
dictaminarà	2	6	dictaminara	2	0	6
dictaminà	2	2	dictamina	2	22	24
dictaminés	2	2	dictamines	2	0	2
dictaminí	2	0	dictamini	2	17	17
dictarà	2	26	dictara	2	2	28
dictà	2	18	dicta	2	198	216
dictàrem	2	0	dictarem	2	1	1
dictés	2	18	dictes	2	2	20
dictí	2	0	dicti	2	100	100
difamà	2	0	difama	2	5	5
difamí	2	0	difami	2	4	4
diferenciarà	2	12	diferenciara	2	0	12
diferencià	2	2	diferencia	2	365	367
diferenciés	2	3	diferencies	2	20	23
diferirà	2	10	diferira	2	0	10
diferència	4	8993	diferencia	2	365	9358
diferències	4	7554	diferencies	2	20	7574
dificultarà	2	74	dificultara	2	0	74
dificultà	2	3	dificulta	2	465	468
dificultàrem	2	0	dificultarem	2	1	1
dificultàreu	2	0	dificultareu	2	1	1
dificultés	2	5	dificultes	2	1	6
dificultí	2	0	dificulti	2	46	46
difondré	2	1	difondre	2	859	860
difongués	2	8	difongues	2	0	8
difonguí	2	0	difongui	2	45	45
difractà	2	0	difracta	2	2	2
difuminarà	2	5	difuminara	2	0	5
difuminà	2	1	difumina	2	111	112
difuminés	2	2	difumines	2	0	2
difuminí	2	0	difumini	2	3	3
digitalitzarà	2	1	digitalitzara	2	0	1
digitalitzà	2	0	digitalitza	2	5	5
digití	2	0	digiti	2	1	1
dignificarà	2	3	dignificara	2	0	3
dignificà	2	0	dignifica	2	9	9
dignifiquí	2	0	dignifiqui	2	1	1
dignà	2	0	digna	4	868	868
dignés	2	0	dignes	4	727	727
digní	2	0	digni	2	5	5
digués	2	643	digues	2	522	1165
diguí	2	1	digui	2	2553	2554
dilapidà	2	0	dilapida	2	6	6
dilapidí	2	0	dilapidi	2	2	2
dilatarà	2	2	dilatara	2	0	2
dilatà	2	0	dilata	2	14	14
dilatí	2	1	dilati	2	1	2
diligència	4	367	diligencia	2	0	367
diligències	4	91	diligencies	2	0	91
dilucidà	2	3	dilucida	2	8	11
dilucidés	2	1	dilucides	2	0	1
dilucidí	2	0	dilucidi	2	6	6
diluvií	2	0	diluvii	2	1	1
diluvió	4	0	diluvio	2	1	1
diluírem	2	0	diluirem	2	2	2
dimanà	2	0	dimana	2	4	4
dimaní	2	0	dimani	2	1	1
dimensionà	2	0	dimensiona	2	15	15
dimensionés	2	0	dimensiones	2	1	1
dimensioní	2	0	dimensioni	2	1	1
dimeritzà	2	0	dimeritza	2	2	2
dimeritzí	2	0	dimeritzi	2	1	1
dimidià	2	0	dimidia	2	1	1
dimitirà	2	12	dimitira	2	0	12
dinamitzarà	2	3	dinamitzara	2	0	3
dinamitzà	2	0	dinamitza	2	4	4
dinamitzí	2	0	dinamitzi	2	4	4
dinamità	2	0	dinamita	4	60	60
dinamités	2	1	dinamites	4	0	1
dinamití	2	0	dinamiti	2	1	1
dinarà	2	2	dinara	2	4	6
dindí	2	0	dindi	2	48	48
dinyà	2	0	dinya	2	1	1
dinyés	2	0	dinyes	2	1	1
dinà	2	0	dina	4	40	40
dinàrem	2	0	dinarem	2	2	2
dinés	2	0	dines	4	7	7
diní	2	0	dini	2	86	86
diplomà	2	6	diploma	4	229	235
diplomés	2	0	diplomes	4	222	222
dipositarà	2	5	dipositara	2	0	5
diposità	2	7	diposita	2	77	84
dipositàrem	2	0	dipositarem	2	2	2
dipositària	0	15	dipositaria	2	2	17
dipositàries	0	2	dipositaries	2	0	2
diposités	2	5	diposites	2	0	5
diposití	2	0	dipositi	2	13	13
diputà	2	0	diputa	2	1	1
dipòsit	4	1368	diposit	2	3	1371
dirigirà	2	146	dirigira	2	4	150
dirigírem	2	0	dirigirem	2	29	29
dirimirà	2	7	dirimira	2	0	7
disbauxà	2	0	disbauxa	4	12	12
disbauxés	2	0	disbauxes	4	1	1
disciplinarà	2	2	disciplinara	2	0	2
disciplinà	2	1	disciplina	4	1658	1659
disciplinària	0	47	disciplinaria	2	1	48
disciplinàries	0	110	disciplinaries	2	0	110
disciplinés	2	1	disciplines	4	419	420
discipliní	2	0	disciplini	2	1	1
discontinuà	2	2	discontinua	2	11	13
discontinués	2	0	discontinues	2	4	4
discontínua	0	39	discontinua	2	11	50
discontínues	0	24	discontinues	2	4	28
discordés	2	0	discordes	2	1	1
discrepà	2	0	discrepa	2	38	38
discrepàrem	2	0	discreparem	2	4	4
discrepés	2	1	discrepes	2	0	1
discrepí	2	0	discrepi	2	6	6
discretitzà	2	0	discretitza	2	1	1
discriminarà	2	9	discriminara	2	0	9
discriminà	2	0	discrimina	2	133	133
discriminés	2	2	discrimines	2	0	2
discriminí	2	0	discrimini	2	61	61
disculparà	2	9	disculpara	2	0	9
disculpà	2	9	disculpa	4	360	369
disculpàrem	2	0	disculparem	2	2	2
disculpés	2	10	disculpes	4	876	886
disculpí	2	0	disculpi	2	325	325
discutirà	2	121	discutira	2	0	121
discutírem	2	0	discutirem	2	120	120
disfressarà	2	2	disfressara	2	0	2
disfressà	2	0	disfressa	4	179	179
disfressés	2	2	disfresses	4	92	94
disfressí	2	0	disfressi	2	5	5
disfrutà	2	0	disfruta	2	4	4
disgregués	2	1	disgregues	2	0	1
disgreguí	2	0	disgregui	2	2	2
disgregà	2	1	disgrega	2	3	4
disgustarà	2	3	disgustara	2	0	3
disgustà	2	3	disgusta	2	34	37
disgustés	2	2	disgustes	2	0	2
disgustí	2	0	disgusti	2	9	9
dislocà	2	0	disloca	2	1	1
disminuírem	2	0	disminuirem	2	3	3
disminuíreu	2	0	disminuireu	2	1	1
dismutà	2	0	dismuta	2	1	1
dispararà	2	17	disparara	2	0	17
disparà	2	48	dispara	2	319	367
disparàrem	2	0	dispararem	2	4	4
disparàreu	2	0	disparareu	2	1	1
disparés	2	18	dispares	2	17	35
disparí	2	0	dispari	2	42	42
dispensarà	2	4	dispensara	2	0	4
dispensà	2	3	dispensa	4	109	112
dispensés	2	4	dispenses	4	11	15
dispensí	2	0	dispensi	2	37	37
dispersarà	2	2	dispersara	2	1	3
dispersà	2	13	dispersa	0	188	201
dispersàrem	2	0	dispersarem	2	1	1
dispersés	2	7	disperses	0	184	191
dispersí	2	0	dispersi	2	9	9
disposarà	2	210	disposara	2	0	210
disposà	2	20	disposa	2	3856	3876
disposàrem	2	1	disposarem	2	187	188
disposàreu	2	0	disposareu	2	17	17
disposés	2	81	disposes	2	18	99
disposí	2	0	disposi	2	625	625
disputarà	2	7	disputara	2	0	7
disputà	2	183	disputa	4	1455	1638
disputàrem	2	0	disputarem	2	2	2
disputés	2	4	disputes	4	950	954
disputí	2	0	disputi	2	6	6
disseccionà	2	0	dissecciona	2	1	1
disseccionés	2	0	dissecciones	2	1	1
disseminà	2	0	dissemina	2	5	5
disseminí	2	0	dissemini	2	2	2
dissentírem	2	0	dissentirem	2	1	1
dissenyarà	2	11	dissenyara	2	0	11
dissenyà	2	72	dissenya	2	107	179
dissenyàrem	2	0	dissenyarem	2	2	2
dissenyés	2	27	dissenyes	2	1	28
dissenyí	2	0	dissenyi	2	32	32
dissequí	2	0	dissequi	2	1	1
dissertà	2	1	disserta	2	1	2
dissimulà	2	0	dissimula	2	16	16
dissimulàrem	2	0	dissimularem	2	1	1
dissimulí	2	0	dissimuli	2	4	4
dissiparà	2	13	dissipara	2	0	13
dissipà	2	12	dissipa	2	40	52
dissipàrem	2	0	dissiparem	2	1	1
dissipés	2	8	dissipes	2	0	8
dissipí	2	0	dissipi	2	24	24
dissocià	2	0	dissocia	2	27	27
dissoldré	2	0	dissoldre	2	748	748
dissolgués	2	20	dissolgues	2	0	20
dissolguí	2	0	dissolgui	2	25	25
dissuadirà	2	13	dissuadira	2	0	13
dissuadírem	2	0	dissuadirem	2	1	1
distanciarà	2	4	distanciara	2	0	4
distancià	2	6	distancia	2	88	94
distanciàrem	2	0	distanciarem	2	2	2
distanciés	2	4	distancies	2	7	11
distarà	2	3	distara	2	0	3
distendré	2	0	distendre	2	12	12
distingirà	2	7	distingira	2	0	7
distingírem	2	0	distingirem	2	4	4
distorsionarà	2	20	distorsionara	2	0	20
distorsionà	2	0	distorsiona	2	210	210
distorsionàrem	2	0	distorsionarem	2	1	1
distorsionés	2	3	distorsiones	2	2	5
distorsioní	2	0	distorsioni	2	54	54
distragués	2	7	distragues	2	0	7
distrauré	2	5	distraure	2	10	15
distribuírem	2	0	distribuirem	2	9	9
distà	2	0	dista	2	304	304
distància	4	5588	distancia	2	88	5676
distàncies	4	1071	distancies	2	7	1078
distès	2	12	distes	2	0	12
distén	2	0	disten	2	120	120
distés	2	1	distes	2	0	1
distí	2	0	disti	2	3	3
distòpia	4	2	distopia	4	6	8
distòpies	4	2	distopies	4	0	2
dità	4	0	dita	2	746	746
divagà	2	0	divaga	2	5	5
divergirà	2	2	divergira	2	0	2
diversificarà	2	4	diversificara	2	0	4
diversificà	2	1	diversifica	2	8	9
diversifiquí	2	0	diversifiqui	2	6	6
divertirà	2	3	divertira	2	0	3
divertírem	2	0	divertirem	2	3	3
dividirà	2	53	dividira	2	0	53
dividírem	2	0	dividirem	2	9	9
divinitzà	2	0	divinitza	2	1	1
divisà	2	0	divisa	4	489	489
divisés	2	0	divises	4	496	496
divisí	2	0	divisi	2	4	4
divorciarà	2	2	divorciara	2	1	3
divorcià	2	12	divorcia	2	9	21
divorciàreu	2	0	divorciareu	2	1	1
divorciés	2	2	divorcies	2	0	2
divulgarà	2	4	divulgara	2	0	4
divulgués	2	5	divulgues	2	0	5
divulguí	2	0	divulgui	2	17	17
divulgà	2	1	divulga	2	14	15
diègesi	4	0	diegesi	4	1	1
doblarà	2	7	doblara	2	0	7
doblegarà	2	16	doblegara	2	0	16
doblegués	2	3	doblegues	2	2	5
dobleguí	2	0	doblegui	2	28	28
doblegà	2	1	doblega	2	37	38
doblegàrem	2	0	doblegarem	2	3	3
doblà	2	6	dobla	4	29	35
doblàrem	2	0	doblarem	2	1	1
doblàreu	2	0	doblareu	2	1	1
doblària	4	0	doblaria	2	2	2
doblés	2	1	dobles	4	820	821
doblí	2	0	dobli	2	4	4
dobló	4	1	doblo	2	2	3
doctorà	2	47	doctora	4	218	265
doctorés	2	0	doctores	4	13	13
documentarà	2	1	documentara	2	0	1
documentà	2	12	documenta	2	161	173
documentàrem	2	0	documentarem	2	1	1
documentària	0	2	documentaria	2	1	3
documentí	2	0	documenti	2	6	6
dodecàedre	4	34	dodecaedre	4	15	49
dodecàedres	4	1	dodecaedres	4	1	2
doldré	2	0	doldre	2	6	6
dolguí	2	0	dolgui	2	5	5
dolés	2	0	doles	2	2	2
dolí	2	0	doli	2	5	5
domesticà	2	1	domestica	2	11	12
domestiqués	2	0	domestiques	2	3	3
domestiquí	2	0	domestiqui	2	1	1
domiciliària	0	18	domiciliaria	2	0	18
domiciliàries	0	3	domiciliaries	2	0	3
dominarà	2	21	dominara	2	0	21
dominicà	0	57	dominica	4	62	119
dominiquès	0	0	dominiques	0	3	3
dominiqués	0	0	dominiques	0	3	3
dominà	2	29	domina	2	319	348
dominàreu	2	0	dominareu	2	1	1
dominés	2	9	domines	2	3	12
dominí	2	0	domini	2	4899	4899
dominó	4	35	domino	2	46	81
domà	2	0	doma	4	27	27
domèstic	0	601	domestic	2	17	618
domèstica	0	685	domestica	2	11	696
domèstiques	0	315	domestiques	2	3	318
domés	2	0	domes	4	3	3
domí	2	0	domi	2	6	6
domín	2	0	domin	2	2	2
domínica	4	0	dominica	4	62	62
domíniques	4	0	dominiques	0	3	3
donarà	2	2625	donara	2	15	2640
donà	2	696	dona	4	16824	17520
donàrem	2	3	donarem	2	915	918
donàreu	2	0	donareu	2	15	15
donés	2	850	dones	4	32681	33531
doní	2	4	doni	2	3638	3642
dopà	2	0	dopa	4	5	5
dormirà	2	11	dormira	2	1	12
dormità	2	0	dormita	2	1	1
dormités	2	1	dormites	2	0	1
dormí	2	2	dormi	2	25	27
dormírem	2	0	dormirem	2	8	8
dormíreu	2	0	dormireu	2	2	2
dormís	2	7	dormis	2	14	21
dosà	2	0	dosa	2	5	5
dosàrem	2	0	dosarem	2	1	1
dosè	0	1	dose	2	2	3
dosé	0	0	dose	2	2	2
dosés	2	0	doses	2	1	1
dosí	2	0	dosi	2	586	586
dotarà	2	56	dotara	2	1	57
dotzè	0	141	dotze	3	2948	3089
dotzé	0	2	dotze	3	2948	2950
dotà	2	7	dota	2	154	161
dotàrem	2	0	dotarem	2	7	7
dotés	2	18	dotes	2	1	19
dotí	2	0	doti	2	151	151
drageés	2	0	dragees	4	1	1
dragués	2	0	dragues	4	12	12
dragà	2	0	draga	4	6	6
dramatitzà	2	0	dramatitza	2	3	3
dramatitzí	2	0	dramatitzi	2	1	1
drapés	2	0	drapes	2	1	1
drenarà	2	1	drenara	2	0	1
drenà	2	1	drena	2	81	82
drení	2	0	dreni	2	4	4
dretà	0	75	dreta	0	7580	7655
dreçà	2	0	dreça	2	4	4
driblà	2	0	dribla	2	2	2
dringà	2	0	dringa	2	1	1
drogués	2	0	drogues	4	3920	3920
drogà	2	0	droga	4	1285	1285
dropés	2	0	dropes	4	1	1
duanà	2	0	duana	4	484	484
duanés	2	0	duanes	4	759	759
duaní	2	0	duani	2	1	1
dubtarà	2	58	dubtara	2	1	59
dubtà	2	6	dubta	2	122	128
dubtàrem	2	0	dubtarem	2	28	28
dubtés	2	5	dubtes	2	3222	3227
dubtí	2	0	dubti	2	66	66
dugués	2	157	dugues	2	2	159
duguí	2	0	dugui	2	974	974
dugés	2	2	duges	4	0	2
dugí	2	0	dugi	2	2	2
duplicarà	2	65	duplicara	2	0	65
duplicà	2	1	duplica	2	381	382
duplicàrem	2	0	duplicarem	2	3	3
dupliqués	2	7	dupliques	2	0	7
dupliquí	2	0	dupliqui	2	42	42
durarà	2	237	durara	2	2	239
durà	2	613	dura	0	2323	2936
duràrem	2	0	durarem	2	2	2
duré	2	41	dure	2	5	46
durés	2	28	dures	0	1034	1062
durí	2	0	duri	2	132	132
dutxà	2	0	dutxa	4	158	158
dutxés	2	0	dutxes	4	39	39
dutxí	2	0	dutxi	2	1	1
dàrem	2	0	darem	2	3	3
dènou	3	4	denou	3	1	5
dèsset	3	14	desset	3	3	17
déna	4	2	dena	4	15	17
dénes	4	1	denes	4	2	3
déus	4	1501	deus	4	396	1897
díades	4	2	diades	4	2	4
díedre	4	9	diedre	0	5	14
díedres	4	6	diedres	0	11	17
dígit	4	187	digit	2	9	196
dígnat	0	0	dignat	2	15	15
dígraf	4	15	digraf	4	1	16
dígrafs	4	31	digrafs	4	1	32
dòlar	4	924	dolar	2	7	931
dòmino	4	27	domino	2	46	73
dòric	0	42	doric	4	3	45
dóna	2	12542	dona	4	16824	29366
dóner	4	3	doner	0	2	5
dónes	2	126	dones	4	32681	32807
dóngola	4	0	dongola	4	5	5
dúplica	4	1	duplica	2	381	382
eclipsarà	2	3	eclipsara	2	0	3
eclipsà	2	3	eclipsa	2	23	26
eclipsés	2	1	eclipses	2	7	8
eclipsí	2	0	eclipsi	2	269	269
economitzés	2	1	economitzes	2	0	1
economitzí	2	0	economitzi	2	3	3
edificà	2	10	edifica	2	3	13
edificàrem	2	0	edificarem	2	1	1
edifiqués	2	1	edifiques	2	0	1
editarà	2	5	editara	2	0	5
edità	2	66	edita	4	3226	3292
editàreu	2	0	editareu	2	6	6
edités	2	5	edites	4	4	9
edití	2	0	editi	2	29	29
educarà	2	2	educara	2	0	2
educà	2	13	educa	2	43	56
educàrem	2	0	educarem	2	1	1
educàreu	2	0	educareu	2	1	1
edulcorà	2	0	edulcora	2	1	1
edulcorí	2	0	edulcori	2	1	1
eduqués	2	1	eduques	2	0	1
eduquí	2	0	eduqui	2	9	9
efectuarà	2	95	efectuara	2	0	95
efectuà	2	17	efectua	2	211	228
efectuàrem	2	0	efectuarem	2	11	11
efectués	2	31	efectues	2	0	31
efígie	4	36	efigie	2	1	37
efígies	4	15	efigies	2	0	15
eimèria	4	0	eimeria	4	1	1
eixamplarà	2	3	eixamplara	2	0	3
eixamplà	2	2	eixampla	4	42	44
eixamplàrem	2	0	eixamplarem	2	1	1
eixamplí	2	0	eixampli	2	3	3
eixarrancà	2	0	eixarranca	2	1	1
eixirà	2	10	eixira	2	1	11
eixugués	2	1	eixugues	2	1	2
eixuguí	2	0	eixugui	2	2	2
eixugà	2	0	eixuga	2	18	18
eixírem	2	0	eixirem	2	4	4
eixíreu	2	0	eixireu	2	2	2
ejaculà	2	0	ejacula	2	4	4
ejectà	2	0	ejecta	2	8	8
elaborarà	2	221	elaborara	2	0	221
elaborà	2	29	elabora	2	335	364
elaboràrem	2	1	elaborarem	2	59	60
elaborés	2	125	elabores	2	0	125
elaborí	2	0	elabori	2	654	654
electrificarà	2	2	electrificara	2	0	2
electrificà	2	0	electrifica	2	1	1
electritzà	2	0	electritza	2	2	2
electrocutà	2	0	electrocuta	2	1	1
electrolitzà	2	0	electrolitza	2	3	3
elegirà	2	24	elegira	2	0	24
elegírem	2	0	elegirem	2	7	7
elevarà	2	52	elevara	2	1	53
elevà	2	30	eleva	2	474	504
elevàrem	2	0	elevarem	2	4	4
elevés	2	14	eleves	2	1	15
eleví	2	0	elevi	2	67	67
elevó	4	0	elevo	2	5	5
eliminarà	2	513	eliminara	2	1	514
eliminà	2	44	elimina	2	3120	3164
eliminàrem	2	0	eliminarem	2	26	26
eliminàreu	2	0	eliminareu	2	9	9
eliminés	2	67	elimines	2	50	117
eliminí	2	0	elimini	2	311	311
elogiarà	2	3	elogiara	2	0	3
elogià	2	26	elogia	2	100	126
elogiés	2	2	elogies	2	0	2
elucidà	2	1	elucida	2	0	1
elucidí	2	0	elucidi	2	1	1
eludirà	2	6	eludira	2	0	6
eludírem	2	0	eludirem	2	3	3
emanarà	2	2	emanara	2	0	2
emanciparà	2	2	emancipara	2	0	2
emancipà	2	0	emancipa	2	1	1
emancipés	2	1	emancipes	2	0	1
emancipí	2	0	emancipi	2	5	5
emanà	2	2	emana	2	121	123
emanés	2	3	emanes	2	0	3
emaní	2	0	emani	2	15	15
embafà	2	0	embafa	2	1	1
embalatgés	2	0	embalatges	4	34	34
embalsamà	2	2	embalsama	2	1	3
embalsamàrem	2	1	embalsamarem	2	0	1
embalà	2	0	embala	2	4	4
embalés	2	0	embales	2	1	1
embalí	2	0	embali	2	1	1
embarassà	2	0	embarassa	2	1	1
embarassés	2	0	embarasses	2	1	1
embarassí	2	0	embarassi	2	1	1
embarbussés	2	0	embarbusses	2	1	1
embarbussí	2	0	embarbussi	2	1	1
embarcarà	2	7	embarcara	2	0	7
embarcà	2	38	embarca	2	34	72
embarcàrem	2	0	embarcarem	2	6	6
embardissàrem	2	0	embardissarem	2	1	1
embargà	2	1	embarga	2	22	23
embarnillés	2	0	embarnilles	2	1	1
embarqués	2	4	embarques	2	1	5
embarquí	2	0	embarqui	2	160	160
embarrancà	2	2	embarranca	2	2	4
embarranquí	2	0	embarranqui	2	1	1
embassà	2	0	embassa	2	2	2
embastà	2	0	embasta	4	1	1
embeinà	2	0	embeina	2	1	1
embenà	2	0	embena	2	8	8
embenés	2	0	embenes	2	1	1
embení	2	0	embeni	2	159	159
embeuré	2	0	embeure	2	1	1
emblanquinà	2	0	emblanquina	2	1	1
embogirà	2	1	embogira	2	0	1
emboirà	2	0	emboira	2	1	1
emboirí	2	0	emboiri	2	1	1
embolcallarà	2	1	embolcallara	2	0	1
embolcallà	2	0	embolcalla	2	23	23
embolcallés	2	1	embolcalles	2	0	1
embolcà	2	0	embolca	2	1	1
embolicarà	2	1	embolicara	2	0	1
embolicà	2	2	embolica	2	55	57
embolicàrem	2	0	embolicarem	2	1	1
emboliqués	2	1	emboliques	2	1	2
emboliquí	2	0	emboliqui	2	2	2
emborrascà	2	0	emborrasca	2	1	1
emborratxarà	2	1	emborratxara	2	0	1
emborratxà	2	1	emborratxa	2	15	16
emborratxés	2	1	emborratxes	2	0	1
emborratxí	2	0	emborratxi	2	5	5
emboscà	2	2	embosca	4	0	2
embotellà	2	0	embotella	2	4	4
embotonà	2	0	embotona	2	1	1
embotà	2	0	embota	2	1	1
embovà	2	0	embova	2	1	1
emboçà	2	0	emboça	2	1	1
embrancà	2	1	embranca	2	2	3
embriagués	2	0	embriagues	0	1	1
embriagà	2	0	embriaga	0	2	2
embruixà	2	0	embruixa	2	1	1
embrutà	2	0	embruta	2	17	17
embrutés	2	3	embrutes	2	1	4
embrutí	2	0	embruti	2	2	2
embrutís	2	0	embrutis	2	1	1
embullarà	2	3	embullara	2	0	3
embullà	2	0	embulla	2	5	5
embullí	2	0	embulli	2	2	2
embussarà	2	2	embussara	2	0	2
embussà	2	0	embussa	2	6	6
embussí	2	0	embussi	2	2	2
embutxacarà	2	1	embutxacara	2	0	1
embutxacà	2	0	embutxaca	2	7	7
embòlic	0	0	embolic	4	212	212
embòlica	0	1	embolica	2	55	56
embòlics	0	0	embolics	4	50	50
embòliques	0	0	emboliques	2	1	1
emergirà	2	9	emergira	2	0	9
emetré	2	3	emetre	2	3004	3007
emetés	2	94	emetes	2	0	94
emetí	2	3	emeti	2	290	293
emfasitzà	2	4	emfasitza	2	30	34
emfasitzí	2	0	emfasitzi	2	1	1
emfatitzarà	2	2	emfatitzara	2	0	2
emfatitzà	2	7	emfatitza	2	131	138
emfatitzàrem	2	0	emfatitzarem	2	1	1
emfatitzés	2	2	emfatitzes	2	0	2
emfatitzí	2	0	emfatitzi	2	6	6
emigrà	2	56	emigra	2	23	79
emigrés	2	2	emigres	2	1	3
emigrí	2	0	emigri	2	6	6
emmagatzemarà	2	108	emmagatzemara	2	0	108
emmagatzemà	2	2	emmagatzema	2	602	604
emmagatzemàrem	2	0	emmagatzemarem	2	3	3
emmagatzemàreu	2	0	emmagatzemareu	2	1	1
emmagatzemés	2	4	emmagatzemes	2	2	6
emmagatzemí	2	0	emmagatzemi	2	39	39
emmalaltirà	2	2	emmalaltira	2	0	2
emmallà	2	0	emmalla	2	2	2
emmanillà	2	0	emmanilla	2	7	7
emmarcarà	2	1	emmarcara	2	0	1
emmarcà	2	1	emmarca	2	157	158
emmarqués	2	1	emmarques	2	0	1
emmarquí	2	0	emmarqui	2	13	13
emmascarà	2	0	emmascara	4	39	39
emmascarés	2	1	emmascares	4	0	1
emmascarí	2	0	emmascari	2	1	1
emmerdà	2	0	emmerda	2	1	1
emmerdís	2	0	emmerdis	2	1	1
emmetzinà	2	0	emmetzina	2	3	3
emmirallà	2	0	emmiralla	2	46	46
emmordassà	2	0	emmordassa	2	5	5
emmordassés	2	1	emmordasses	2	0	1
emmordassí	2	0	emmordassi	2	1	1
emmotllarà	2	1	emmotllara	2	0	1
emmotllà	2	0	emmotlla	2	2	2
emmotllí	2	0	emmotlli	2	3	3
emmurallà	2	1	emmuralla	2	0	1
emmèn	2	0	emmen	4	15	15
emocionarà	2	2	emocionara	2	0	2
emocionà	2	2	emociona	2	27	29
emocionés	2	0	emociones	2	2	2
emocioní	2	0	emocioni	2	2	2
empacà	2	0	empaca	2	2	2
empaità	2	0	empaita	2	10	10
empaités	2	1	empaites	2	1	2
empalmà	2	0	empalma	2	4	4
empalmés	2	0	empalmes	2	1	1
empalà	2	0	empala	2	2	2
empantanà	2	0	empantana	2	1	1
empantanés	2	1	empantanes	2	0	1
empaquetà	2	1	empaqueta	2	28	29
empaquetés	2	1	empaquetes	2	0	1
empararà	2	1	emparara	2	0	1
emparellà	2	0	emparella	2	14	14
emparentà	2	0	emparenta	2	2	2
emparà	2	5	empara	4	740	745
emparés	2	3	empares	4	0	3
emparí	2	0	empari	2	26	26
empassarà	2	8	empassara	2	0	8
empassà	2	3	empassa	2	24	27
empassàrem	2	0	empassarem	2	3	3
empassés	2	2	empasses	2	3	5
empassí	2	0	empassi	2	6	6
empastifà	2	0	empastifa	2	16	16
empastifàrem	2	0	empastifarem	2	1	1
empatollés	2	0	empatolles	2	10	10
empatxà	2	0	empatxa	2	1	1
empatà	2	357	empata	2	4	361
empatés	2	2	empates	2	0	2
empeguí	2	0	empegui	2	1	1
empeltà	2	0	empelta	2	1	1
empentarà	2	1	empentara	2	0	1
empentà	2	2	empenta	4	265	267
empentés	2	0	empentes	4	27	27
empentí	2	0	empenti	2	1	1
empentís	0	0	empentis	2	1	1
empenyerà	2	11	empenyera	2	0	11
empenyés	2	7	empenyes	4	1	8
empenyí	2	0	empenyi	2	14	14
empenà	2	0	empena	2	1	1
empesquí	2	0	empesqui	2	1	1
empestà	2	0	empesta	2	14	14
empestés	2	0	empestes	2	2	2
empesà	2	0	empesa	4	46	46
empesés	2	0	empeses	4	31	31
empetitirà	2	1	empetitira	2	0	1
empiparà	2	3	empipara	2	0	3
empipà	2	0	empipa	2	7	7
empipí	2	0	empipi	2	3	3
empitjorarà	2	74	empitjorara	2	0	74
empitjorà	2	21	empitjora	2	204	225
empitjoràrem	2	0	empitjorarem	2	3	3
empitjorés	2	8	empitjores	2	1	9
empitjorí	2	0	empitjori	2	99	99
emplacés	2	1	emplaces	2	0	1
emplací	2	0	emplaci	2	3	3
emplastrés	2	0	emplastres	2	2	2
emplaçarà	2	3	emplaçara	2	0	3
emplaçà	2	1	emplaça	2	28	29
emplenarà	2	21	emplenara	2	0	21
emplenà	2	0	emplena	2	133	133
emplenés	2	0	emplenes	2	4	4
emplení	2	0	empleni	2	12	12
empobrirà	2	6	empobrira	2	0	6
empobrírem	2	0	empobrirem	2	2	2
empoderà	2	0	empodera	2	1	1
empolainà	2	0	empolaina	2	1	1
empolvorà	2	0	empolvora	2	3	3
emportarà	2	45	emportara	2	0	45
emportà	2	14	emporta	2	215	229
emportàrem	2	0	emportarem	2	8	8
emportés	2	24	emportes	2	18	42
emportí	2	0	emporti	2	109	109
emportín	2	0	emportin	2	69	69
emprarà	2	251	emprara	2	0	251
empremtà	2	0	empremta	4	525	525
empremtés	2	0	empremtes	4	673	673
emprendré	2	5	emprendre	2	2657	2662
emprengués	2	42	emprengues	2	0	42
emprenguí	2	0	emprengui	2	257	257
emprenyarà	2	6	emprenyara	2	0	6
emprenyà	2	1	emprenya	2	19	20
emprenyés	2	0	emprenyes	2	3	3
emprenyí	2	0	emprenyi	2	2	2
empresonarà	2	1	empresonara	2	0	1
empresonà	2	14	empresona	2	61	75
empresonés	2	3	empresones	2	0	3
empresoní	2	0	empresoni	2	10	10
emprovà	2	0	emprova	4	4	4
emprovés	2	0	emproves	4	1	1
emproví	2	0	emprovi	2	1	1
emprà	2	85	empra	2	1162	1247
empràrem	2	0	emprarem	2	34	34
empràreu	2	0	emprareu	2	6	6
emprèn	2	107	empren	2	704	811
emprès	2	763	empres	2	2	765
emprén	2	0	empren	2	704	704
emprés	2	34	empres	2	2	36
emprí	2	0	empri	2	169	169
empudegà	2	0	empudega	2	1	1
empunyà	2	1	empunya	2	9	10
empunyés	2	1	empunyes	2	0	1
emularà	2	4	emulara	2	0	4
emulà	2	1	emula	2	44	45
emulàreu	2	0	emulareu	2	1	1
emulés	2	1	emules	2	0	1
emulí	2	0	emuli	2	5	5
emès	2	1028	emes	4	19	1047
emés	2	13	emes	4	19	32
enamorarà	2	7	enamorara	2	0	7
enamorà	2	17	enamora	2	127	144
enamorés	2	5	enamores	2	17	22
enamorí	2	0	enamori	2	11	11
enarborà	2	1	enarbora	2	10	11
enarborí	2	0	enarbori	2	8	8
encabotà	2	0	encabota	2	1	1
encabrità	2	0	encabrita	2	1	1
encabírem	2	0	encabirem	2	1	1
encadenà	2	0	encadena	2	19	19
encadenés	2	1	encadenes	2	2	3
encadení	2	0	encadeni	2	1	1
encaixarà	2	18	encaixara	2	1	19
encaixà	2	1	encaixa	2	378	379
encaixàrem	2	0	encaixarem	2	1	1
encaixàreu	2	0	encaixareu	2	1	1
encaixés	2	6	encaixes	2	5	11
encaixí	2	0	encaixi	2	50	50
encalcés	2	0	encalces	2	1	1
encallarà	2	1	encallara	2	0	1
encallà	2	6	encalla	2	11	17
encallàrem	2	0	encallarem	2	1	1
encallés	2	5	encalles	2	1	6
encallí	2	0	encalli	2	3	3
encalçà	2	1	encalça	2	0	1
encaminarà	2	7	encaminara	2	0	7
encaminà	2	2	encamina	2	62	64
encaminàrem	2	0	encaminarem	2	3	3
encaminés	2	1	encamines	2	0	1
encaminí	2	0	encamini	2	15	15
encantarà	2	50	encantara	2	0	50
encantà	2	3	encanta	2	602	605
encantària	4	0	encantaria	2	282	282
encantés	2	1	encantes	2	2	3
encantí	2	0	encanti	2	5	5
encapritxà	2	0	encapritxa	2	3	3
encapritxés	2	0	encapritxes	2	2	2
encapsulà	2	0	encapsula	2	13	13
encapsulí	2	0	encapsuli	2	1	1
encapsà	2	0	encapsa	2	2	2
encapçalarà	2	10	encapçalara	2	0	10
encapçalà	2	68	encapçala	2	105	173
encapçalés	2	6	encapçales	2	2	8
encapçalí	2	0	encapçali	2	22	22
encararà	2	2	encarara	2	0	2
encarirà	2	8	encarira	2	0	8
encarnarà	2	4	encarnara	2	0	4
encarnà	2	1	encarna	4	107	108
encarnés	2	1	encarnes	2	0	1
encarní	2	0	encarni	2	8	8
encarregarà	2	230	encarregara	2	0	230
encarregués	2	56	encarregues	2	11	67
encarreguí	2	0	encarregui	2	275	275
encarregà	2	123	encarrega	2	547	670
encarregàrem	2	0	encarregarem	2	40	40
encarregàreu	2	0	encarregareu	2	2	2
encarrilarà	2	1	encarrilara	2	0	1
encarrilí	2	0	encarrili	2	4	4
encartà	2	0	encarta	2	43	43
encarà	2	8	encara	6	93095	93103
encaràrem	2	0	encararem	2	1	1
encarés	2	2	encares	2	0	2
encarí	2	0	encari	2	4	4
encarírem	2	0	encarirem	2	1	1
encarís	2	1	encaris	2	1	2
encasellí	2	0	encaselli	2	1	1
encastà	2	0	encasta	2	1	1
encaterinà	2	0	encaterina	2	1	1
encausés	2	1	encauses	2	0	1
encausí	2	0	encausi	2	1	1
encavalcà	2	0	encavalca	2	12	12
encavalquí	2	0	encavalqui	2	1	1
encebà	2	0	enceba	2	10	10
encebí	2	0	encebi	2	1	1
enceguí	2	0	encegui	2	5	5
encegà	2	1	encega	2	6	7
encendrà	2	13	encendra	2	0	13
encendré	2	10	encendre	2	342	352
encengués	2	6	encengues	2	0	6
encenguí	2	0	encengui	2	24	24
encensà	2	0	encensa	2	2	2
encerclarà	2	2	encerclara	2	0	2
encerclà	2	2	encercla	2	16	18
encerclàrem	2	0	encerclarem	2	1	1
encertarà	2	3	encertara	2	0	3
encertà	2	2	encerta	2	83	85
encertàrem	2	0	encertarem	2	1	1
encertés	2	1	encertes	2	1	2
encertí	2	0	encerti	2	11	11
encertís	2	0	encertis	2	1	1
encetà	2	7	enceta	2	13	20
encetés	2	1	encetes	2	0	1
encimbellà	2	0	encimbella	2	2	2
encimentà	2	1	encimenta	2	0	1
encimà	2	0	encima	2	1	1
encintà	2	0	encinta	0	4	4
encintés	2	0	encintes	0	1	1
encistellà	2	0	encistella	2	1	1
encistellí	2	0	encistelli	2	2	2
encisà	2	0	encisa	2	7	7
enclavà	2	0	enclava	2	3	3
enclavés	2	0	enclaves	2	1	1
enclaví	2	0	enclavi	2	1	1
encletxés	2	0	encletxes	2	2	2
enclogués	2	1	enclogues	2	0	1
encobertà	2	0	encoberta	2	165	165
encobertés	2	0	encobertes	2	61	61
encolomarà	2	1	encolomara	2	0	1
encolomés	2	0	encolomes	2	2	2
encolomí	2	0	encolomi	2	1	1
encomanarà	2	14	encomanara	2	0	14
encomanà	2	14	encomana	2	70	84
encomanàrem	2	0	encomanarem	2	1	1
encomanés	2	7	encomanes	2	1	8
encomaní	2	0	encomani	2	18	18
encomià	2	0	encomia	2	3	3
encongirà	2	5	encongira	2	0	5
encongírem	2	0	encongirem	2	1	1
encontrarà	2	1	encontrara	2	0	1
encontrà	2	1	encontra	2	0	1
encontrés	2	0	encontres	2	46	46
encoratgés	2	12	encoratges	2	0	12
encoratgí	2	0	encoratgi	2	60	60
encoratjarà	2	53	encoratjara	2	0	53
encoratjà	2	37	encoratja	2	241	278
encoratjàrem	2	0	encoratjarem	2	9	9
encorbà	2	0	encorba	2	1	1
encorbés	2	0	encorbes	2	1	1
encotillà	2	0	encotilla	2	2	2
encotillí	2	0	encotilli	2	1	1
encreuarà	2	1	encreuara	2	0	1
encreuà	2	1	encreua	2	9	10
encreuàrem	2	0	encreuarem	2	1	1
encreuí	2	0	encreui	2	1	1
encriptarà	2	24	encriptara	2	0	24
encriptà	2	0	encripta	2	111	111
encriptàrem	2	0	encriptarem	2	1	1
encriptí	2	0	encripti	2	5	5
encunyà	2	36	encunya	2	15	51
encunyàrem	2	0	encunyarem	2	1	1
encunyés	2	3	encunyes	2	0	3
encunyí	2	0	encunyi	2	7	7
endarrerirà	2	4	endarrerira	2	0	4
endarrerià	2	0	endarreria	2	4	4
endegués	2	1	endegues	2	0	1
endegà	2	11	endega	2	1	12
enderrocarà	2	4	enderrocara	2	0	4
enderrocà	2	3	enderroca	2	14	17
enderrocàrem	2	0	enderrocarem	2	1	1
enderrocàreu	2	0	enderrocareu	2	1	1
enderroqués	2	4	enderroques	2	0	4
enderroquí	2	0	enderroqui	2	3	3
endeutarà	2	1	endeutara	2	0	1
endeutà	2	1	endeuta	2	2	3
endeutí	2	0	endeuti	2	1	1
endevinà	2	1	endevina	2	96	97
endevinés	2	2	endevines	2	6	8
endeviní	2	0	endevini	2	9	9
endimonià	2	0	endimonia	2	1	1
endinsarà	2	1	endinsara	2	0	1
endinsà	2	10	endinsa	2	67	77
endinsàrem	2	0	endinsarem	2	2	2
endinsí	2	0	endinsi	2	12	12
endolcírem	2	0	endolcirem	2	1	1
endollà	2	0	endolla	2	17	17
endollés	2	0	endolles	2	1	1
endollí	2	0	endolli	2	6	6
endolà	2	0	endola	2	1	1
endossà	2	0	endossa	2	4	4
endossí	2	0	endossi	2	3	3
endrapà	2	0	endrapa	2	1	1
endreçà	2	0	endreça	4	11	11
endugués	2	8	endugues	2	0	8
enduguí	2	0	endugui	2	14	14
endurirà	2	4	endurira	2	0	4
endurà	2	11	endura	2	0	11
enduré	2	17	endure	2	0	17
endurí	2	5	enduri	2	0	5
endurís	2	2	enduris	2	0	2
enemistà	2	1	enemista	2	0	1
enemistí	2	0	enemisti	2	1	1
enervà	2	0	enerva	2	1	1
enfadarà	2	9	enfadara	2	0	9
enfadà	2	6	enfada	2	52	58
enfadés	2	3	enfades	2	3	6
enfadí	2	0	enfadi	2	10	10
enfangà	2	0	enfanga	2	2	2
enfilarà	2	1	enfilara	2	0	1
enfilà	2	2	enfila	4	44	46
enfilés	2	1	enfiles	4	0	1
enfilí	2	0	enfili	2	1	1
enfità	2	0	enfita	2	1	1
enfocarà	2	13	enfocara	2	0	13
enfocà	2	5	enfoca	2	134	139
enfocàrem	2	0	enfocarem	2	5	5
enfonsarà	2	44	enfonsara	2	1	45
enfonsà	2	57	enfonsa	2	190	247
enfonsàrem	2	0	enfonsarem	2	4	4
enfonsés	2	24	enfonses	2	2	26
enfonsí	2	0	enfonsi	2	65	65
enfoqués	2	6	enfoques	2	1	7
enfoquí	2	0	enfoqui	2	36	36
enformà	2	0	enforma	2	3	3
enfornà	2	0	enforna	2	2	2
enforquillà	2	1	enforquilla	2	0	1
enfortirà	2	139	enfortira	2	0	139
enfortírem	2	0	enfortirem	2	14	14
enfosquirà	2	8	enfosquira	2	0	8
enfosquí	2	1	enfosqui	2	0	1
enfosquís	2	2	enfosquis	2	0	2
enfredà	2	1	enfreda	2	0	1
enfrontarà	2	137	enfrontara	2	0	137
enfrontà	2	69	enfronta	2	2240	2309
enfrontàrem	2	0	enfrontarem	2	140	140
enfrontàreu	2	0	enfrontareu	2	1	1
enfrontés	2	21	enfrontes	2	12	33
enfrontí	2	0	enfronti	2	130	130
enfurirà	2	2	enfurira	2	0	2
enfurismà	2	14	enfurisma	2	9	23
enfurismés	2	1	enfurismes	2	0	1
enfurià	2	0	enfuria	2	5	5
enfurírem	2	0	enfurirem	2	1	1
engabià	2	0	engabia	2	2	2
engalanà	2	0	engalana	2	2	2
engalbà	2	0	engalba	4	5	5
engalipà	2	0	engalipa	2	4	4
engalipí	2	0	engalipi	2	4	4
enganxarà	2	16	enganxara	2	0	16
enganxà	2	2	enganxa	2	611	613
enganxàrem	2	0	enganxarem	2	1	1
enganxés	2	1	enganxes	2	7	8
enganxí	2	0	enganxi	2	15	15
enganxó	4	0	enganxo	2	3	3
enganyarà	2	5	enganyara	2	0	5
enganyà	2	2	enganya	2	116	118
enganyàrem	2	0	enganyarem	2	6	6
enganyés	2	4	enganyes	2	12	16
enganyí	2	0	enganyi	2	34	34
engarjolí	2	0	engarjoli	2	1	1
engarlandà	2	1	engarlanda	2	0	1
engarrotà	2	0	engarrota	2	1	1
engegarà	2	17	engegara	2	0	17
engegués	2	2	engegues	2	2	4
engeguí	2	0	engegui	2	17	17
engegà	2	11	engega	2	152	163
engegàrem	2	0	engegarem	2	2	2
engendrarà	2	9	engendrara	2	0	9
engendrà	2	23	engendra	2	70	93
engendrés	2	2	engendres	2	0	2
engendrí	2	0	engendri	2	3	3
enginyà	2	0	enginya	4	2	2
enginyàrem	2	0	enginyarem	2	1	1
enginyés	2	1	enginyes	4	0	1
enginyí	2	0	enginyi	2	1	1
englobarà	2	15	englobara	2	0	15
englobà	2	2	engloba	2	253	255
englobés	2	9	englobes	2	0	9
englobí	2	0	englobi	2	73	73
engolirà	2	3	engolira	2	0	3
engolà	2	0	engola	2	1	1
engrandirà	2	11	engrandira	2	0	11
engranà	2	0	engrana	2	1	1
engreixarà	2	0	engreixara	2	1	1
engreixà	2	0	engreixa	2	8	8
engreixés	2	0	engreixes	2	2	2
engreixí	2	0	engreixi	2	1	1
engreixín	2	0	engreixin	2	1	1
engrescà	2	1	engresca	2	2	3
engroguirà	2	1	engroguira	2	0	1
engrunà	2	0	engruna	4	9	9
engrunés	2	0	engrunes	4	85	85
engruní	2	0	engruni	2	1	1
enjardinà	2	0	enjardina	2	1	1
enjogassà	2	1	enjogassa	2	0	1
enjudiciarà	2	7	enjudiciara	2	0	7
enjudicià	2	0	enjudicia	2	16	16
enjudiciàrem	2	0	enjudiciarem	2	2	2
enlairarà	2	4	enlairara	2	0	4
enlairà	2	18	enlaira	2	23	41
enlairàrem	2	0	enlairarem	2	2	2
enlairés	2	6	enlaires	2	0	6
enlairí	2	0	enlairi	2	11	11
enllacarà	2	1	enllacara	2	0	1
enllacés	2	2	enllaces	2	1	3
enllací	2	0	enllaci	2	8	8
enllaunà	2	0	enllauna	2	2	2
enllaçarà	2	19	enllaçara	2	0	19
enllaçà	2	5	enllaça	2	481	486
enllaçàrem	2	0	enllaçarem	2	1	1
enllaçàreu	2	0	enllaçareu	2	1	1
enllestírem	2	0	enllestirem	2	1	1
enllistà	2	1	enllista	2	1	2
enlluernà	2	0	enlluerna	2	5	5
enlluernés	2	1	enlluernes	2	0	1
enlluerní	2	0	enlluerni	2	2	2
enllumenà	2	0	enllumena	2	1	1
enllustrà	2	0	enllustra	2	1	1
ennuegarà	2	1	ennuegara	2	0	1
ennueguí	2	0	ennuegui	2	1	1
ennuegàrem	2	0	ennuegarem	2	1	1
ennuvolà	2	0	ennuvola	2	5	5
ennuvolí	2	0	ennuvoli	2	3	3
enquadrarà	2	3	enquadrara	2	0	3
enquadrà	2	0	enquadra	2	79	79
enquadrí	2	0	enquadri	2	8	8
enquestà	2	1	enquesta	4	1725	1726
enquestés	2	1	enquestes	4	695	696
enrabià	2	1	enrabia	2	4	5
enrabiés	2	1	enrabies	2	0	1
enrabií	2	0	enrabii	2	1	1
enragés	2	6	enrages	2	0	6
enrajolarà	2	1	enrajolara	2	0	1
enrajolà	2	0	enrajola	2	11	11
enraonà	2	1	enraona	2	5	6
enraonàrem	2	0	enraonarem	2	1	1
enraonés	2	0	enraones	2	2	2
enrecordarà	2	1	enrecordara	2	0	1
enrecordés	2	0	enrecordes	2	3	3
enredarà	2	1	enredara	2	0	1
enrederà	2	0	enredera	2	5	5
enrederí	2	1	enrederi	2	0	1
enredà	2	2	enreda	2	8	10
enredés	2	1	enredes	2	3	4
enregistrarà	2	20	enregistrara	2	0	20
enregistrà	2	44	enregistra	2	280	324
enregistràrem	2	0	enregistrarem	2	1	1
enregistrés	2	6	enregistres	2	2	8
enregistrí	2	0	enregistri	2	7	7
enretirà	2	2	enretira	2	2	4
enretirí	2	0	enretiri	2	1	1
enriquirà	2	28	enriquira	2	0	28
enriquírem	2	0	enriquirem	2	2	2
enrobustírem	2	0	enrobustirem	2	1	1
enrocà	2	0	enroca	2	1	1
enrojolà	2	0	enrojola	2	2	2
enrolà	2	7	enrola	2	1	8
enrolí	2	0	enroli	2	1	1
enroscà	2	0	enrosca	2	1	1
enrotllarà	2	4	enrotllara	2	0	4
enrotllà	2	1	enrotlla	2	31	32
enrònies	4	1	enronies	2	0	1
ensabonés	2	0	ensabones	2	1	1
ensagnà	2	0	ensagna	2	2	2
ensangonà	2	1	ensangona	2	0	1
ensellà	2	0	ensella	2	5	5
ensenyarà	2	35	ensenyara	2	2	37
ensenyà	2	106	ensenya	4	721	827
ensenyàrem	2	0	ensenyarem	2	11	11
ensenyàreu	2	0	ensenyareu	2	1	1
ensenyés	2	33	ensenyes	4	37	70
ensenyí	2	0	ensenyi	2	91	91
ensinistrà	2	1	ensinistra	2	3	4
ensinistràreu	2	0	ensinistrareu	2	1	1
ensopegarà	2	7	ensopegara	2	0	7
ensopegués	2	0	ensopegues	2	3	3
ensopeguí	2	0	ensopegui	2	6	6
ensopegà	2	0	ensopega	2	74	74
ensopegàrem	2	0	ensopegarem	2	10	10
ensorrarà	2	21	ensorrara	2	0	21
ensorrà	2	5	ensorra	2	20	25
ensorràrem	2	0	ensorrarem	2	1	1
ensorrés	2	8	ensorres	2	0	8
ensorrí	2	0	ensorri	2	18	18
ensucrà	2	0	ensucra	2	1	1
ensulsià	2	1	ensulsia	2	0	1
ensumarà	2	3	ensumara	2	0	3
ensumà	2	0	ensuma	2	8	8
ensumés	2	0	ensumes	2	2	2
ensumí	2	0	ensumi	2	2	2
entabanà	2	0	entabana	2	3	3
entabaní	2	0	entabani	2	1	1
entaforarà	2	1	entaforara	2	0	1
entaforà	2	0	entafora	2	3	3
entaforés	2	0	entafores	2	1	1
entallà	2	0	entalla	4	1	1
entallí	2	0	entalli	2	1	1
entaularà	2	18	entaulara	2	0	18
entaulà	2	17	entaula	2	22	39
entaulàrem	2	0	entaularem	2	13	13
entaulés	2	20	entaules	2	2	22
entaulí	2	0	entauli	2	83	83
entelarà	2	4	entelara	2	0	4
entelà	2	0	entela	2	25	25
entelàrem	2	0	entelarem	2	2	2
entelí	2	0	enteli	2	4	4
entendré	2	10	entendre	4	14528	14538
entengués	2	35	entengues	2	4	39
entenguí	2	0	entengui	2	397	397
enterbolirà	2	2	enterbolira	2	0	2
enterrarà	2	9	enterrara	2	0	9
enterrà	2	4	enterra	2	44	48
enterràrem	2	0	enterrarem	2	8	8
enterràreu	2	0	enterrareu	2	3	3
enterrés	2	8	enterres	2	1	9
enterrí	2	0	enterri	2	15	15
entestà	2	0	entesta	2	4	4
entestés	2	0	entestes	2	1	1
entintà	2	0	entinta	2	5	5
entomarà	2	1	entomara	2	0	1
entomà	2	0	entoma	2	1	1
entomés	2	0	entomes	2	1	1
entonarà	2	1	entonara	2	0	1
entonà	2	0	entona	2	12	12
entonés	2	1	entones	2	0	1
entoní	2	0	entoni	2	3	3
entornà	2	1	entorna	2	1	2
entorpirà	2	5	entorpira	2	0	5
entortolligà	2	0	entortolliga	2	2	2
entortà	2	0	entorta	2	1	1
entossudírem	2	0	entossudirem	2	1	1
entrapà	2	1	entrapa	2	0	1
entrarà	2	595	entrara	2	7	602
entravès	2	0	entraves	2	5	5
entrebancà	2	1	entrebanca	2	3	4
entrebanqués	2	0	entrebanques	2	1	1
entrebanquí	2	0	entrebanqui	2	1	1
entrebatré	2	0	entrebatre	2	1	1
entrecreuà	2	0	entrecreua	2	3	3
entrecreuí	2	0	entrecreui	2	1	1
entrecuixà	2	0	entrecuixa	2	1	1
entregarà	2	11	entregara	2	0	11
entregués	2	11	entregues	4	85	96
entreguí	2	0	entregui	2	19	19
entregà	2	14	entrega	4	503	517
entregàrem	2	0	entregarem	2	5	5
entregàreu	2	0	entregareu	2	3	3
entrellací	2	0	entrellaci	2	3	3
entrellaçarà	2	1	entrellaçara	2	0	1
entrellaçà	2	1	entrellaça	2	13	14
entrellucà	2	0	entrelluca	2	6	6
entrelluquí	2	0	entrelluqui	2	1	1
entremesclà	2	0	entremescla	2	1	1
entremetré	2	0	entremetre	2	62	62
entremetés	2	1	entremetes	2	0	1
entremetí	2	0	entremeti	2	10	10
entrenarà	2	2	entrenara	2	1	3
entrenà	2	27	entrena	2	122	149
entrenàrem	2	0	entrenarem	2	4	4
entrenés	2	6	entrenes	2	3	9
entrení	2	0	entreni	2	3	3
entreobrí	2	1	entreobri	2	0	1
entreplantà	2	0	entreplanta	4	2	2
entresòl	4	25	entresol	4	4	29
entresòls	4	1	entresols	4	1	2
entretelà	2	0	entretela	4	1	1
entretenguí	2	0	entretengui	2	1	1
entretindré	2	10	entretindre	2	2	12
entretinguí	2	0	entretingui	2	7	7
entreveuré	2	0	entreveure	2	111	111
entrevistarà	2	4	entrevistara	2	0	4
entrevistà	2	16	entrevista	2	1540	1556
entrevistés	2	5	entrevistes	2	575	580
entrevistí	2	1	entrevisti	2	5	6
entrevèiem	2	0	entreveiem	2	1	1
entrevéiem	2	0	entreveiem	2	1	1
entrevéu	2	0	entreveu	2	7	7
entristirà	2	2	entristira	2	0	2
entroncà	2	0	entronca	2	12	12
entronitzà	2	2	entronitza	2	2	4
entropessà	2	0	entropessa	2	2	2
entrà	2	353	entra	2	2419	2772
entràrem	2	1	entrarem	2	87	88
entràreu	2	1	entrareu	2	11	12
entrén	2	0	entren	2	1300	1300
entrés	2	295	entres	2	59	354
entrí	2	0	entri	2	1170	1170
entrò	7	0	entro	2	69	69
entubà	2	0	entuba	2	1	1
entusiasmarà	2	3	entusiasmara	2	0	3
entusiasmà	2	2	entusiasma	2	49	51
entusiasmàrem	2	0	entusiasmarem	2	1	1
entusiasmés	2	0	entusiasmes	2	9	9
entusiasmí	2	0	entusiasmi	2	6	6
enumerarà	2	4	enumerara	2	0	4
enumerà	2	3	enumera	2	304	307
enumeràrem	2	0	enumerarem	2	4	4
enumerés	2	3	enumeres	2	0	3
enumerí	2	0	enumeri	2	17	17
enunciarà	2	1	enunciara	2	0	1
enuncià	2	2	enuncia	2	60	62
enunciés	2	2	enuncies	2	0	2
enutgés	2	0	enutges	2	1	1
enutgí	2	0	enutgi	2	1	1
enutjà	2	1	enutja	2	6	7
enutjós	0	68	enutjos	4	1	69
envasà	2	0	envasa	2	4	4
envasí	2	0	envasi	2	2	2
envaírem	2	0	envairem	2	2	2
envegès	0	0	enveges	4	6	6
envegés	0	0	enveges	4	6	6
envegí	2	0	envegi	2	4	4
envejarà	2	1	envejara	2	0	1
envejà	2	0	enveja	4	154	154
envejàrem	2	0	envejarem	2	1	1
envellirà	2	3	envellira	2	0	3
envellírem	2	0	envellirem	2	1	1
enverinarà	2	7	enverinara	2	0	7
enverinà	2	2	enverina	2	27	29
enverinés	2	6	enverines	2	0	6
enveriní	2	0	enverini	2	4	4
envermellirà	2	1	envermellira	2	0	1
envernissà	2	1	envernissa	2	0	1
enviarà	2	534	enviara	2	5	539
envidà	2	0	envida	2	2	2
envinà	2	0	envina	2	1	1
enviudà	2	1	enviuda	2	0	1
enviudés	2	0	enviudes	2	1	1
envià	2	443	envia	2	2775	3218
enviàrem	2	0	enviarem	2	145	145
enviàreu	2	0	enviareu	2	8	8
enviés	2	183	envies	2	29	212
envií	2	5	envii	2	8	13
envoltarà	2	9	envoltara	2	0	9
envoltà	2	7	envolta	0	936	943
envoltàrem	2	0	envoltarem	2	2	2
envoltés	2	3	envoltes	0	0	3
envoltí	2	0	envolti	2	6	6
envolà	2	2	envola	2	1	3
enxamparà	2	3	enxampara	2	1	4
enxampà	2	1	enxampa	2	15	16
enxampàrem	2	0	enxamparem	2	10	10
enxampés	2	1	enxampes	2	0	1
enxampí	2	0	enxampi	2	11	11
enyorarà	2	1	enyorara	2	0	1
enyorà	2	1	enyora	2	14	15
enyoràrem	2	0	enyorarem	2	2	2
enyorés	2	1	enyores	2	7	8
enyorí	2	0	enyori	2	1	1
enèmic	0	0	enemic	0	1996	1996
enèmics	0	0	enemics	0	1866	1866
equalitzà	2	0	equalitza	2	13	13
equilibrarà	2	4	equilibrara	2	0	4
equilibrà	2	0	equilibra	2	54	54
equilibrés	2	3	equilibres	2	1	4
equilibrí	2	0	equilibri	2	8041	8041
equipararà	2	2	equiparara	2	0	2
equiparà	2	0	equipara	2	23	23
equiparés	2	2	equipares	2	0	2
equiparí	2	0	equipari	2	21	21
equipà	2	2	equipa	2	18	20
equipàrem	2	0	equiparem	2	4	4
equipés	2	53	equipes	2	0	53
equipí	2	0	equipi	2	8	8
equivalgués	2	1	equivalgues	2	0	1
equivalguí	2	0	equivalgui	2	20	20
equivocarà	2	3	equivocara	2	0	3
equivocà	2	2	equivoca	2	241	243
equivocàrem	2	1	equivocarem	2	3	4
equivoqués	2	8	equivoques	2	52	60
equivoquí	2	0	equivoqui	2	49	49
equívoc	0	69	equivoc	4	1	70
equívoca	0	27	equivoca	2	241	268
equívocs	0	66	equivocs	4	0	66
equívoques	0	18	equivoques	2	52	70
erigirà	2	2	erigira	2	0	2
erigírem	2	0	erigirem	2	2	2
ermà	2	0	erma	0	17	17
ermés	2	0	ermes	0	22	22
erolés	2	0	eroles	4	5	5
erosionarà	2	4	erosionara	2	0	4
erosionà	2	6	erosiona	2	41	47
erosionàrem	2	0	erosionarem	2	1	1
erosioní	2	0	erosioni	2	9	9
erradicarà	2	7	erradicara	2	0	7
erradicà	2	1	erradica	2	5	6
erradicàrem	2	0	erradicarem	2	4	4
erradiqués	2	2	erradiques	2	0	2
erradiquí	2	0	erradiqui	2	15	15
errà	2	1	erra	4	30	31
erràrem	2	0	errarem	2	1	1
erràreu	2	0	errareu	2	1	1
errés	2	4	erres	4	7	11
errí	2	0	erri	2	1	1
eructà	2	0	eructa	2	1	1
eructés	2	0	eructes	2	1	1
erupcionà	2	1	erupciona	2	2	3
erupcionés	2	1	erupciones	2	0	1
esbarjós	0	0	esbarjos	4	2	2
esbatussó	4	1	esbatusso	2	0	1
esberlà	2	0	esberla	4	3	3
esberlés	2	0	esberles	4	1	1
esbiaixà	2	0	esbiaixa	2	12	12
esbiaixí	2	0	esbiaixi	2	1	1
esbocinà	2	0	esbocina	2	2	2
esborrarà	2	118	esborrara	2	0	118
esborronà	2	0	esborrona	2	4	4
esborrà	2	2	esborra	2	762	764
esborràrem	2	0	esborrarem	2	1	1
esborràreu	2	0	esborrareu	2	7	7
esborrés	2	11	esborres	2	5	16
esborrí	2	0	esborri	2	34	34
esbossarà	2	2	esbossara	2	0	2
esbossà	2	10	esbossa	2	75	85
esbossàrem	2	0	esbossarem	2	2	2
esbossés	2	3	esbosses	2	0	3
esbossí	2	0	esbossi	2	25	25
esbotzà	2	0	esbotza	2	2	2
esbotzí	2	0	esbotzi	2	1	1
esbrinarà	2	3	esbrinara	2	0	3
esbrinà	2	1	esbrina	2	37	38
esbrinàrem	2	0	esbrinarem	2	30	30
esbrinàreu	2	0	esbrinareu	2	1	1
esbrinés	2	5	esbrines	2	2	7
esbriní	2	0	esbrini	2	33	33
esbroncà	2	0	esbronca	2	2	2
esbronquí	2	0	esbronqui	2	1	1
esbrossà	2	0	esbrossa	2	1	1
esbucà	2	0	esbuca	2	1	1
esbudellàrem	2	0	esbudellarem	2	1	1
esbufegà	2	0	esbufega	2	4	4
escaigués	2	1	escaigues	2	0	1
escaiguí	2	0	escaigui	2	62	62
escairà	2	0	escaira	2	9	9
escairés	2	0	escaires	2	8	8
escalabrà	2	0	escalabra	2	2	2
escalarà	2	34	escalara	2	0	34
escaldà	2	0	escalda	4	44	44
escaldés	2	0	escaldes	4	4	4
escalfarà	2	2	escalfara	2	0	2
escalfà	2	2	escalfa	2	150	152
escalfàrem	2	0	escalfarem	2	2	2
escalfés	2	4	escalfes	2	6	10
escalfí	2	0	escalfi	2	23	23
escalonarà	2	1	escalonara	2	0	1
escalonà	2	0	escalona	4	9	9
escaloní	2	0	escaloni	2	2	2
escalopà	2	0	escalopa	4	3	3
escalà	2	6	escala	4	15928	15934
escalè	0	8	escale	2	3	11
escalé	0	0	escale	2	3	3
escalés	2	1	escales	4	1011	1012
escalí	2	0	escali	2	12	12
escaló	4	12	escalo	2	1	13
escamarlà	2	22	escamarla	2	0	22
escamotejà	2	0	escamoteja	2	7	7
escamparà	2	4	escampara	2	1	5
escampà	2	11	escampa	2	52	63
escampàrem	2	0	escamparem	2	4	4
escampés	2	6	escampes	2	1	7
escampí	2	0	escampi	2	13	13
escamà	2	0	escama	4	5	5
escamés	2	0	escames	4	28	28
escandalitzà	2	1	escandalitza	2	31	32
escandalitzés	2	1	escandalitzes	2	0	1
escandalitzí	2	0	escandalitzi	2	1	1
escandí	2	0	escandi	4	15	15
escanegí	2	0	escanegi	2	8	8
escanejarà	2	9	escanejara	2	0	9
escanejà	2	1	escaneja	2	125	126
escantellà	2	0	escantella	2	1	1
escanyarà	2	3	escanyara	2	0	3
escanyà	2	0	escanya	2	20	20
escanyés	2	2	escanyes	2	0	2
escanyí	2	0	escanyi	2	3	3
escaparà	2	25	escapara	2	4	29
escapcí	2	0	escapci	2	1	1
escapolí	2	2	escapoli	2	2	4
escapolírem	2	0	escapolirem	2	1	1
escapà	2	49	escapa	2	418	467
escapàrem	2	0	escaparem	2	10	10
escapàreu	2	0	escapareu	2	4	4
escapçarà	2	6	escapçara	2	0	6
escapçà	2	0	escapça	4	182	182
escapés	2	31	escapes	2	5	36
escapí	2	0	escapi	2	65	65
escaramussà	2	0	escaramussa	4	73	73
escaramussés	2	0	escaramusses	4	108	108
escarbà	2	0	escarba	2	2	2
escarbés	2	0	escarbes	2	1	1
escarní	2	0	escarni	4	4	4
escarnís	2	0	escarnis	4	1	1
escarotà	2	0	escarota	2	1	1
escarrassà	2	1	escarrassa	2	0	1
escarrassó	4	0	escarrasso	2	2	2
escarràssem	2	0	escarrassem	2	1	1
escarà	2	0	escara	2	4	4
escarés	2	0	escares	2	1	1
escassegí	2	0	escassegi	2	3	3
escassejarà	2	2	escassejara	2	0	2
escassejà	2	0	escasseja	2	45	45
escatainí	2	0	escataini	2	1	1
escatimarà	2	45	escatimara	2	0	45
escatimà	2	0	escatima	2	20	20
escatimàrem	2	0	escatimarem	2	26	26
escatimés	2	1	escatimes	2	0	1
escatimí	2	0	escatimi	2	14	14
escatà	2	0	escata	4	13	13
escatés	2	0	escates	4	204	204
escauré	2	0	escaure	2	11	11
escenificà	2	1	escenifica	2	4	5
escindirà	2	1	escindira	2	0	1
esclafarà	2	1	esclafara	2	0	1
esclafà	2	2	esclafa	2	14	16
esclafàrem	2	0	esclafarem	2	2	2
esclafés	2	4	esclafes	2	0	4
esclafí	2	1	esclafi	2	2	3
esclarirà	2	3	esclarira	2	0	3
esclatarà	2	25	esclatara	2	1	26
esclatà	2	87	esclata	2	99	186
esclatés	2	51	esclates	2	0	51
esclatí	2	0	esclati	2	47	47
esclavitzarà	2	1	esclavitzara	2	0	1
esclavitzà	2	1	esclavitza	2	5	6
esclavitzàrem	2	0	esclavitzarem	2	1	1
esclavitzí	2	0	esclavitzi	2	1	1
esclerosí	2	0	esclerosi	2	232	232
escodrinyà	2	0	escodrinya	2	3	3
escodrinyí	2	0	escodrinyi	2	1	1
escodà	2	0	escoda	4	2	2
escolaritzà	2	0	escolaritza	2	1	1
escolarà	2	1	escolara	2	0	1
escollirà	2	19	escollira	2	0	19
escollà	2	0	escolla	2	1	1
escollí	2	75	escolli	2	4	79
escollírem	2	0	escollirem	2	5	5
escollíreu	2	0	escollireu	2	4	4
escollís	2	20	escollis	2	1	21
escoltarà	2	105	escoltara	2	0	105
escoltà	2	16	escolta	0	2022	2038
escoltàrem	2	0	escoltarem	2	80	80
escoltàreu	2	0	escoltareu	2	12	12
escoltés	2	57	escoltes	0	318	375
escoltí	2	0	escolti	2	531	531
escolés	2	0	escoles	4	4794	4794
escolí	2	0	escoli	2	11	11
escombrarà	2	1	escombrara	2	0	1
escombrà	2	3	escombra	4	79	82
escombrés	2	4	escombres	4	20	24
escombrí	2	0	escombri	2	5	5
escometré	2	1	escometre	2	336	337
escometés	2	5	escometes	2	0	5
escometí	2	0	escometi	2	14	14
escopinyà	2	0	escopinya	4	3	3
escopinyés	2	0	escopinyes	4	9	9
escopinà	2	0	escopina	4	1	1
escopirà	2	1	escopira	2	0	1
escorcollà	2	1	escorcolla	2	3	4
escorcollés	2	3	escorcolles	2	0	3
escorcollí	2	0	escorcolli	2	1	1
escorcés	2	0	escorces	4	25	25
escortarà	2	2	escortara	2	0	2
escortà	2	6	escorta	4	258	264
escortàrem	2	0	escortarem	2	2	2
escortés	2	0	escortes	4	65	65
escorxarà	2	1	escorxara	2	0	1
escorxà	2	0	escorxa	4	3	3
escorà	2	2	escora	4	5	7
escorçà	2	0	escorça	4	576	576
escorí	2	0	escori	2	4	4
escotà	2	0	escota	4	3	3
escotés	2	0	escotes	4	1	1
escridassà	2	0	escridassa	2	5	5
escridàssem	2	0	escridassem	2	1	1
escrigués	2	40	escrigues	4	1	41
escriguí	2	1	escrigui	2	178	179
escripturà	2	0	escriptura	4	2958	2958
escripturés	2	0	escriptures	4	381	381
escriuré	2	48	escriure	2	12581	12629
escrutarà	2	1	escrutara	2	0	1
escrutàrem	2	0	escrutarem	2	1	1
escudellà	2	0	escudella	4	14	14
escudellés	2	0	escudelles	4	4	4
escudà	2	0	escuda	2	19	19
escudés	2	1	escudes	2	0	1
escudí	2	0	escudi	2	7	7
escullés	2	1	esculles	2	0	1
escullí	2	0	esculli	2	37	37
esculturà	2	0	escultura	4	902	902
esculturés	2	0	escultures	4	659	659
escumà	2	0	escuma	4	165	165
escumés	2	0	escumes	4	36	36
escurcés	2	2	escurces	2	1	3
escurcí	2	0	escurci	2	4	4
escurà	2	0	escura	2	3	3
escurçarà	2	9	escurçara	2	0	9
escurçà	2	4	escurça	2	67	71
escurçàrem	2	0	escurçarem	2	2	2
escurçó	4	67	escurço	2	1	68
escà	2	0	esca	4	19	19
escàlem	4	0	escalem	2	2	2
escàpol	0	3	escapol	2	0	3
escàrpia	4	1	escarpia	2	0	1
escó	4	728	esco	2	3	731
escórpora	4	11	escorpora	2	0	11
esdevenguí	2	2	esdevengui	2	0	2
esdevindré	2	1	esdevindre	2	42	43
esdevingués	2	91	esdevingues	2	2	93
esdevinguí	2	1	esdevingui	2	111	112
esfondrarà	2	16	esfondrara	2	0	16
esfondrà	2	6	esfondra	2	34	40
esfondràrem	2	0	esfondrarem	2	2	2
esfondrés	2	6	esfondres	2	0	6
esfondrí	2	0	esfondri	2	14	14
esforcés	2	16	esforces	2	5	21
esforcí	2	2	esforci	2	129	131
esforçarà	2	117	esforçara	2	0	117
esforçà	2	10	esforça	2	266	276
esforçàrem	2	0	esforçarem	2	87	87
esfumarà	2	6	esfumara	2	0	6
esfumà	2	3	esfuma	2	9	12
esfumés	2	1	esfumes	2	0	1
esfumí	2	0	esfumi	2	2	2
esgarrapà	2	0	esgarrapa	2	10	10
esgarrapés	2	0	esgarrapes	2	1	1
esgarrarà	2	1	esgarrara	2	0	1
esgarrifà	2	0	esgarrifa	2	2	2
esgarrià	2	0	esgarria	2	1	1
esgarriés	2	1	esgarries	2	0	1
esgarrà	2	0	esgarra	2	1	1
esgavellà	2	0	esgavella	2	2	2
esglaià	2	0	esglaia	2	2	2
esglaonà	2	0	esglaona	2	2	2
esglaí	2	0	esglai	4	22	22
esgotarà	2	14	esgotara	2	0	14
esgotà	2	8	esgota	2	112	120
esgotàrem	2	0	esgotarem	2	6	6
esgotés	2	7	esgotes	2	0	7
esgotí	2	0	esgoti	2	41	41
esgrimirà	2	1	esgrimira	2	0	1
esgrunà	2	0	esgruna	2	1	1
esguardà	2	0	esguarda	2	1	1
esguerrarà	2	2	esguerrara	2	0	2
esguerrà	2	1	esguerra	2	0	1
esguerrés	2	1	esguerres	2	1	2
esguerrí	2	0	esguerri	2	1	1
esmaixà	2	1	esmaixa	2	0	1
esmarà	2	0	esmara	2	1	1
esmenarà	2	12	esmenara	2	0	12
esmentarà	2	25	esmentara	2	1	26
esmentà	2	17	esmenta	2	2784	2801
esmentàrem	2	0	esmentarem	2	11	11
esmentàreu	2	0	esmentareu	2	1	1
esmentés	2	56	esmentes	2	1	57
esmentí	2	0	esmenti	2	318	318
esmenà	2	7	esmena	4	21465	21472
esmenàrem	2	0	esmenarem	2	3	3
esmenés	2	9	esmenes	4	26520	26529
esmení	2	0	esmeni	2	63	63
esmercés	2	0	esmerces	2	2	2
esmerçà	2	1	esmerça	2	0	1
esmicolà	2	1	esmicola	2	6	7
esmicolí	2	0	esmicoli	2	2	2
esmolà	2	0	esmola	2	2	2
esmolés	2	0	esmoles	2	1	1
esmorzarà	2	1	esmorzara	2	0	1
esmorzà	2	2	esmorza	2	5	7
esmorzàrem	2	0	esmorzarem	2	3	3
esmorzés	2	0	esmorzes	2	1	1
esmunyirà	2	1	esmunyira	2	0	1
esmunyí	2	2	esmunyi	2	1	3
esmunyís	2	1	esmunyis	2	0	1
esmussà	2	0	esmussa	2	1	1
esmussés	2	1	esmusses	2	0	1
esmà	2	0	esma	4	11	11
esnifà	2	0	esnifa	2	2	2
espadellà	2	0	espadella	4	5	5
espaiarà	2	2	espaiara	2	0	2
espaià	2	0	espaia	2	5	5
espantarà	2	9	espantara	2	0	9
espantà	2	2	espanta	2	158	160
espantàrem	2	0	espantarem	2	1	1
espantàreu	2	0	espantareu	2	3	3
espantés	2	4	espantes	2	17	21
espantí	2	0	espanti	2	23	23
espanyà	2	0	espanya	4	8717	8717
espanyés	2	0	espanyes	4	12	12
espartà	2	67	esparta	4	230	297
espasmés	2	0	espasmes	2	29	29
espassà	2	0	espassa	2	4	4
espassés	2	0	espasses	2	2	2
espasà	2	0	espasa	4	1203	1203
espasés	2	0	espases	4	438	438
espasí	2	18	espasi	2	0	18
espatllarà	2	1	espatllara	2	0	1
espatllà	2	0	espatlla	4	477	477
espatllàrem	2	0	espatllarem	2	1	1
espatllés	2	3	espatlles	4	371	374
espatllí	2	0	espatlli	2	9	9
espatlló	4	0	espatllo	2	1	1
espatlà	2	0	espatla	4	2	2
espatlés	2	0	espatles	4	1	1
espavilarà	2	5	espavilara	2	0	5
espavilà	2	0	espavila	2	14	14
espavilàrem	2	0	espavilarem	2	3	3
espavilés	2	0	espaviles	2	2	2
espaí	2	0	espai	4	19094	19094
espaís	2	0	espais	4	3852	3852
especialitzarà	2	1	especialitzara	2	1	2
especialitzà	2	40	especialitza	2	100	140
especialitzés	2	1	especialitzes	2	1	2
especialitzí	2	0	especialitzi	2	2	2
especificarà	2	35	especificara	2	2	37
especificà	2	3	especifica	2	2042	2045
especificàrem	2	0	especificarem	2	4	4
especificàreu	2	0	especificareu	2	4	4
especifiqués	2	17	especifiques	2	8	25
especifiquí	2	0	especifiqui	2	164	164
especià	2	0	especia	2	4	4
especiés	2	0	especies	2	10	10
especulà	2	15	especula	2	146	161
especulàrem	2	0	especularem	2	3	3
especulés	2	1	especules	2	0	1
especulí	2	0	especuli	2	5	5
específic	0	4001	especific	2	7	4008
específica	0	3955	especifica	2	2042	5997
específiques	0	4953	especifiques	2	8	4961
espellofí	2	0	espellofi	2	1	1
espellucà	2	0	espelluca	2	1	1
espellà	2	0	espella	2	1	1
espellí	2	0	espelli	2	1	1
espellís	2	0	espellis	2	1	1
espentà	2	0	espenta	4	9	9
espentés	2	0	espentes	4	1	1
esperancés	2	0	esperances	4	2002	2002
esperançà	2	0	esperança	4	5607	5607
esperarà	2	127	esperara	2	2	129
esperità	2	0	esperita	2	1	1
esperonà	2	0	esperona	2	5	5
esperonés	2	1	esperones	2	0	1
esperoní	2	0	esperoni	2	1	1
esperà	2	13	espera	4	7936	7949
esperàrem	2	1	esperarem	2	146	147
esperàreu	2	0	esperareu	2	3	3
esperès	2	0	esperes	4	137	137
esperés	2	49	esperes	4	137	186
esperí	2	0	esperi	2	312	312
esperó	4	139	espero	2	22242	22381
espetegà	2	0	espetega	2	1	1
espeternegà	2	0	espeternega	2	2	2
espiarà	2	1	espiara	2	0	1
espifiés	2	0	espifies	2	1	1
espigolà	2	0	espigola	2	5	5
espigués	2	0	espigues	4	29	29
espigà	2	0	espiga	4	55	55
espinà	2	0	espina	4	197	197
espinés	2	0	espines	4	238	238
espirés	2	0	espires	4	8	8
espitllerà	2	0	espitllera	4	10	10
espitllerés	2	0	espitlleres	4	37	37
espià	2	0	espia	4	268	268
espiés	2	2	espies	4	224	226
espió	4	0	espio	2	1	1
esplaiarà	2	1	esplaiara	2	0	1
esplaià	2	0	esplaia	2	5	5
esplaiés	2	1	esplaies	2	0	1
esplaí	2	0	esplai	4	44	44
esplugués	2	0	esplugues	4	22	22
espluguí	2	1	esplugui	2	0	1
esplugà	2	0	espluga	4	8	8
espollà	2	0	espolla	4	2	2
espolsà	2	0	espolsa	2	9	9
espolí	4	0	espoli	4	36	36
espongés	2	0	esponges	4	66	66
esponjà	2	0	esponja	4	58	58
esponsoritzà	2	0	esponsoritza	2	2	2
esporgà	2	0	esporga	4	1	1
esporulà	2	0	esporula	2	1	1
esposà	2	2	esposa	2	2609	2611
esposés	2	0	esposes	2	319	319
espremerà	2	1	espremera	2	0	1
espremérem	2	0	espremerem	2	1	1
espremí	2	0	espremi	2	3	3
espumejà	2	0	espumeja	2	1	1
espumà	2	0	espuma	4	4	4
espumés	2	0	espumes	4	1	1
espunyà	2	0	espunya	4	1	1
espurnejà	2	0	espurneja	2	1	1
espurnà	2	0	espurna	4	127	127
espurnés	2	0	espurnes	4	77	77
espècia	4	56	especia	2	4	60
espècie	4	6952	especie	2	11	6963
espècies	4	9076	especies	2	10	9086
espècul	4	5	especul	2	0	5
espòrula	4	0	esporula	2	1	1
esquarterà	2	0	esquartera	2	2	2
esquarteràrem	2	0	esquarterarem	2	2	2
esqueixà	2	0	esqueixa	2	1	1
esquellà	2	0	esquella	4	10	10
esquellés	2	0	esquelles	4	2	2
esquematitzà	2	0	esquematitza	2	2	2
esquenà	2	0	esquena	4	1414	1414
esquenés	2	0	esquenes	4	34	34
esquerdarà	2	2	esquerdara	2	0	2
esquerdà	2	2	esquerda	4	151	153
esquerdés	2	0	esquerdes	4	173	173
esquerdí	2	0	esquerdi	2	3	3
esquerrés	2	0	esquerres	0	583	583
esquerà	2	0	esquera	2	3	3
esquilà	2	0	esquila	4	8	8
esquilés	2	2	esquiles	2	0	2
esquilí	2	9	esquili	2	0	9
esquincí	2	0	esquinci	2	3	3
esquinçarà	2	3	esquinçara	2	0	3
esquinçà	2	1	esquinça	2	6	7
esquistós	0	2	esquistos	4	34	36
esquitxà	2	1	esquitxa	2	19	20
esquitxés	2	1	esquitxes	2	0	1
esquitxí	2	0	esquitxi	2	1	1
esquità	2	0	esquita	2	1	1
esquivarà	2	2	esquivara	2	0	2
esquivà	2	1	esquiva	4	25	26
esquivés	2	2	esquives	0	2	4
esquiví	2	0	esquivi	2	2	2
esquià	2	0	esquia	2	12	12
esquí	2	527	esqui	2	3	530
estabilitzarà	2	14	estabilitzara	2	0	14
estabilitzà	2	5	estabilitza	2	62	67
estabilitzés	2	5	estabilitzes	2	0	5
estabilitzí	2	0	estabilitzi	2	37	37
establirà	2	605	establira	2	1	606
establés	2	0	estables	4	1112	1112
establí	2	476	establi	2	2	478
establírem	2	0	establirem	2	79	79
establíreu	2	0	establireu	2	8	8
establís	2	253	establis	2	2	255
estabulà	2	0	estabula	2	1	1
estacionarà	2	1	estacionara	2	0	1
estacionà	2	4	estaciona	2	5	9
estacionària	0	63	estacionaria	2	1	64
estacionàries	0	33	estacionaries	2	0	33
estacionés	2	0	estaciones	2	1	1
estacà	2	0	estaca	4	57	57
estafarà	2	2	estafara	2	0	2
estafà	2	0	estafa	4	139	139
estafàrem	2	0	estafarem	2	1	1
estafés	2	1	estafes	4	82	83
estafí	2	0	estafi	2	21	21
estalviarà	2	77	estalviara	2	0	77
estalvià	2	1	estalvia	2	181	182
estalviàrem	2	0	estalviarem	2	32	32
estalviàreu	2	0	estalviareu	2	9	9
estalviés	2	5	estalvies	2	7	12
estampillà	2	0	estampilla	4	2	2
estampà	2	1	estampa	4	28	29
estampés	2	1	estampes	4	30	31
estampí	2	0	estampi	2	1	1
estancarà	2	3	estancara	2	0	3
estancà	2	4	estanca	0	25	29
estancàrem	2	0	estancarem	2	2	2
estandarditzà	2	1	estandarditza	2	8	9
estanqués	2	1	estanques	0	12	13
estanyadà	2	0	estanyada	4	1	1
estanyà	2	0	estanya	4	2	2
estaqués	2	0	estaques	4	43	43
estarrufà	2	0	estarrufa	2	1	1
estarrufí	2	0	estarrufi	2	1	1
estatgés	2	0	estatges	4	18	18
estatjà	2	0	estatja	4	1	1
estavellarà	2	2	estavellara	2	0	2
estavellà	2	31	estavella	2	33	64
estavellàrem	2	0	estavellarem	2	2	2
estavellés	2	11	estavelles	2	5	16
estavellí	2	0	estavelli	2	10	10
estaí	2	0	estai	4	8	8
estefanià	0	1	estefania	4	32	33
estellà	2	1	estella	4	44	45
estenallés	2	0	estenalles	2	3	3
estendré	2	70	estendre	2	2954	3024
estengués	2	82	estengues	2	0	82
estenguí	2	0	estengui	2	336	336
estenografià	2	0	estenografia	4	4	4
estereotipà	2	0	estereotipa	2	1	1
esterilitzà	2	1	esterilitza	2	3	4
esternudà	2	0	esternuda	2	10	10
estesà	2	0	estesa	2	680	680
estesés	2	0	esteses	2	206	206
estevà	2	0	esteva	4	5	5
estevés	2	0	esteves	4	23	23
estibà	2	0	estiba	4	12	12
estigmatitzarà	2	3	estigmatitzara	2	0	3
estigmatitzà	2	0	estigmatitza	2	12	12
estigmatitzí	2	0	estigmatitzi	2	4	4
estigués	2	1409	estigues	2	132	1541
estiguí	2	0	estigui	2	9299	9299
estilitzà	2	0	estilitza	2	6	6
estilà	2	0	estila	2	1	1
estilés	2	0	estiles	2	1	1
estimarà	2	19	estimara	2	2	21
estimbà	2	0	estimba	2	1	1
estimbàrem	2	0	estimbarem	2	1	1
estimbés	2	1	estimbes	2	0	1
estimbí	2	0	estimbi	2	1	1
estimularà	2	129	estimulara	2	0	129
estimulà	2	6	estimula	2	269	275
estimulàrem	2	0	estimularem	2	10	10
estimulés	2	16	estimules	2	0	16
estimulí	2	0	estimuli	2	114	114
estimà	2	72	estima	4	2925	2997
estimàrem	2	0	estimarem	2	4	4
estimàreu	2	0	estimareu	2	2	2
estimés	2	22	estimes	4	172	194
estimí	2	0	estimi	2	123	123
estintolà	2	0	estintola	2	1	1
estipendiària	4	1	estipendiaria	2	0	1
estipularà	2	2	estipulara	2	0	2
estipulà	2	5	estipula	2	666	671
estipulés	2	9	estipules	2	0	9
estipulí	2	0	estipuli	2	34	34
estirarà	2	7	estirara	2	1	8
estirà	2	1	estira	4	176	177
estiràrem	2	0	estirarem	2	1	1
estirè	4	8	estire	2	0	8
estirés	2	2	estires	4	8	10
estirí	2	0	estiri	2	8	8
estiró	4	0	estiro	2	5	5
estisorés	2	0	estisores	2	10	10
estivà	2	0	estiva	2	2	2
estiví	2	0	estivi	2	1	1
estofà	2	0	estofa	4	4	4
estomacà	2	0	estomaca	2	4	4
estomaqués	2	1	estomaques	2	0	1
estomaquí	2	0	estomaqui	2	5	5
estorà	2	0	estora	4	56	56
estorés	2	0	estores	4	53	53
estossegués	2	0	estossegues	2	1	1
estosseguí	2	0	estossegui	2	1	1
estovà	2	0	estova	2	4	4
estovés	2	2	estoves	2	0	2
estoví	2	0	estovi	2	2	2
estrangulà	2	1	estrangula	2	3	4
estrangulés	2	1	estrangules	2	0	1
estranyarà	2	14	estranyara	2	0	14
estranyà	2	0	estranya	0	998	998
estranyés	2	0	estranyes	0	328	328
estranyí	2	0	estranyi	2	11	11
estratificà	2	0	estratifica	2	1	1
estrebà	2	0	estreba	2	3	3
estrelà	2	0	estrela	4	149	149
estrelés	2	0	estreles	4	7	7
estrenarà	2	11	estrenara	2	1	12
estrenyerà	2	10	estrenyera	2	1	11
estrenyérem	2	0	estrenyerem	2	2	2
estrenyés	2	1	estrenyes	2	1	2
estrenyí	2	0	estrenyi	2	21	21
estrenà	2	203	estrena	4	1093	1296
estrenés	2	13	estrenes	4	105	118
estrení	2	0	estreni	2	1	1
estressà	2	0	estressa	2	1	1
estretirà	2	2	estretira	2	0	2
estricà	2	0	estrica	2	2	2
estripà	2	3	estripa	2	14	17
estripés	2	1	estripes	2	0	1
estripí	2	0	estripi	2	1	1
estrià	2	0	estria	4	8	8
estriés	2	0	estries	4	27	27
estroncà	2	1	estronca	2	0	1
estructurarà	2	8	estructurara	2	0	8
estructurà	2	1	estructura	4	9956	9957
estructuràrem	2	0	estructurarem	2	2	2
estructurés	2	1	estructures	4	5860	5861
estructurí	2	0	estructuri	2	12	12
estrès	2	728	estres	4	12	740
estrés	4	20	estres	4	12	32
estudiarà	2	261	estudiara	2	2	263
estudià	2	773	estudia	2	516	1289
estudiàrem	2	1	estudiarem	2	198	199
estudiés	2	115	estudies	2	16	131
estufà	2	0	estufa	4	27	27
estufés	2	0	estufes	4	24	24
està	2	134747	esta	3	541	135288
estàlvia	0	18	estalvia	2	181	199
estàlvies	0	9	estalvies	2	7	16
estènia	4	0	estenia	2	343	343
estès	2	973	estes	3	113	1086
estés	2	28	estes	3	113	141
estímul	4	1108	estimul	2	0	1108
estípula	4	0	estipula	2	666	666
estípules	4	12	estipules	2	0	12
estòs	2	0	estos	3	45	45
estómac	4	317	estomac	4	19	336
estómacs	4	21	estomacs	4	0	21
esvalotàrem	2	0	esvalotarem	2	1	1
esvarà	2	0	esvara	2	1	1
esverà	2	0	esvera	2	1	1
esverí	2	0	esveri	2	3	3
eternitzarà	2	2	eternitzara	2	0	2
eternitzà	2	0	eternitza	2	5	5
eternitzí	2	0	eternitzi	2	3	3
etilè	4	45	etile	2	0	45
etiquetarà	2	8	etiquetara	2	0	8
etiquetà	2	5	etiqueta	4	5382	5387
etiquetés	2	1	etiquetes	4	4171	4172
etiquetí	2	0	etiqueti	2	12	12
etzibà	2	1	etziba	2	1	2
età	4	34	eta	4	427	461
evacuà	2	8	evacua	2	7	15
evacués	2	6	evacues	2	0	6
evangelitzà	2	2	evangelitza	2	0	2
evaporarà	2	3	evaporara	2	0	3
evaporà	2	0	evapora	2	43	43
evaporés	2	2	evapores	2	0	2
evaporí	2	0	evapori	2	15	15
evidenciarà	2	3	evidenciara	2	0	3
evidencià	2	2	evidencia	2	200	202
evidenciés	2	2	evidencies	2	14	16
evidència	4	2186	evidencia	2	200	2386
evidències	4	593	evidencies	2	14	607
evitarà	2	249	evitara	2	2	251
evità	2	27	evita	2	971	998
evitàrem	2	0	evitarem	2	72	72
evitàreu	2	0	evitareu	2	9	9
evités	2	51	evites	2	3	54
evití	2	0	eviti	2	355	355
evocà	2	3	evoca	2	136	139
evolucionarà	2	45	evolucionara	2	0	45
evolucionà	2	65	evoluciona	2	209	274
evolucionàrem	2	0	evolucionarem	2	3	3
evolucionés	2	14	evoluciones	2	0	14
evolucioní	2	0	evolucioni	2	85	85
evoqués	2	2	evoques	2	0	2
evoquí	2	0	evoqui	2	3	3
exacerbarà	2	9	exacerbara	2	0	9
exacerbà	2	3	exacerba	2	32	35
exacerbàrem	2	0	exacerbarem	2	2	2
exacerbí	2	0	exacerbi	2	3	3
exagerarà	2	1	exagerara	2	0	1
exagerà	2	1	exagera	2	44	45
exageràrem	2	0	exagerarem	2	1	1
exagerés	2	2	exageres	2	0	2
exagerí	2	0	exageri	2	6	6
exaltarà	2	1	exaltara	2	0	1
exaltà	2	2	exalta	2	15	17
exaltí	2	0	exalti	2	1	1
exalçà	2	0	exalça	2	4	4
examinarà	2	465	examinara	2	1	466
examinà	2	27	examina	2	507	534
examinàrem	2	0	examinarem	2	374	374
examinés	2	118	examines	2	2	120
examiní	2	0	examini	2	609	609
exasperà	2	1	exaspera	2	5	6
excavà	2	7	excava	2	19	26
excavés	2	2	excaves	2	0	2
excaví	2	0	excavi	2	2	2
excedirà	2	17	excedira	2	0	17
excedírem	2	0	excedirem	2	3	3
exceptuà	2	0	exceptua	2	15	15
excitarà	2	1	excitara	2	0	1
excità	2	0	excita	2	24	24
excitàrem	2	0	excitarem	2	1	1
excités	2	0	excites	2	2	2
excití	2	0	exciti	2	3	3
excitó	4	5	excito	2	2	7
exclamà	2	13	exclama	2	18	31
exclamés	2	4	exclames	2	0	4
exclogués	2	28	exclogues	2	0	28
excloguí	2	0	exclogui	2	175	175
exclouré	2	1	excloure	2	1432	1433
excomunicà	2	9	excomunica	2	4	13
excomuniqués	2	1	excomuniques	2	0	1
excomuniquí	2	0	excomuniqui	2	1	1
excretà	2	0	excreta	4	17	17
excretés	2	0	excretes	4	3	3
exculpà	2	0	exculpa	2	3	3
excusarà	2	1	excusara	2	0	1
excusà	2	2	excusa	4	1100	1102
excusés	2	1	excuses	4	312	313
excusí	2	0	excusi	2	17	17
executarà	2	354	executara	2	0	354
executà	2	26	executa	2	1879	1905
executàrem	2	0	executarem	2	6	6
executés	2	31	executes	2	2	33
executí	2	0	executi	2	281	281
exemplificarà	2	1	exemplificara	2	0	1
exemplificà	2	0	exemplifica	2	72	72
exemptà	2	0	exempta	0	161	161
exemptés	2	0	exemptes	0	166	166
exercirà	2	550	exercira	2	1	551
exercitarà	2	1	exercitara	2	0	1
exercità	2	1	exercita	2	11	12
exercití	2	0	exerciti	2	5	5
exercírem	2	0	exercirem	2	41	41
exfolià	2	0	exfolia	2	3	3
exhalarà	2	1	exhalara	2	0	1
exhalà	2	0	exhala	2	6	6
exhalés	2	0	exhales	2	1	1
exhalí	2	0	exhali	2	2	2
exhaurirà	2	1	exhaurira	2	0	1
exhibirà	2	10	exhibira	2	0	10
exhibírem	2	0	exhibirem	2	1	1
exhortarà	2	4	exhortara	2	0	4
exhortà	2	2	exhorta	2	103	105
exhortàrem	2	0	exhortarem	2	1	1
exhortés	2	2	exhortes	2	0	2
exhortí	2	0	exhorti	2	5	5
exhumà	2	0	exhuma	2	1	1
exigirà	2	437	exigira	2	0	437
exigírem	2	0	exigirem	2	51	51
exigíreu	2	0	exigireu	2	1	1
exilià	2	29	exilia	2	7	36
exiliàrem	2	0	exiliarem	2	1	1
exiliàreu	2	0	exiliareu	2	1	1
exiliés	2	4	exilies	2	0	4
eximirà	2	8	eximira	2	0	8
eximí	2	2	eximi	0	1	3
eximírem	2	0	eximirem	2	2	2
eximís	2	5	eximis	0	1	6
existirà	2	298	existira	2	4	302
exonerarà	2	1	exonerara	2	0	1
exonerà	2	6	exonera	2	17	23
exonerés	2	1	exoneres	2	0	1
exonerí	2	0	exoneri	2	6	6
expandirà	2	36	expandira	2	0	36
expandírem	2	0	expandirem	2	1	1
expedientí	2	0	expedienti	2	1	1
expedirà	2	9	expedira	2	0	9
expendré	2	0	expendre	2	3	3
experimentarà	2	71	experimentara	2	1	72
experimentà	2	56	experimenta	2	395	451
experimentàrem	2	0	experimentarem	2	23	23
experimentàreu	2	0	experimentareu	2	4	4
experimentés	2	10	experimentes	2	3	13
experimentí	2	0	experimenti	2	51	51
expirarà	2	56	expirara	2	1	57
expirà	2	6	expira	2	181	187
expirés	2	27	expires	2	0	27
expirí	2	0	expiri	2	98	98
expià	2	0	expia	2	1	1
explicarà	2	135	explicara	2	3	138
explicitarà	2	2	explicitara	2	0	2
explicità	2	0	explicita	2	39	39
explicití	2	0	expliciti	2	7	7
explicà	2	91	explica	2	2839	2930
explicàrem	2	1	explicarem	2	53	54
explicàreu	2	0	explicareu	2	2	2
expliqués	2	215	expliques	2	58	273
expliquí	2	0	expliqui	2	493	493
explorarà	2	20	explorara	2	0	20
explorà	2	35	explora	2	423	458
exploràrem	2	0	explorarem	2	9	9
explorés	2	10	explores	2	1	11
explorí	2	0	explori	2	36	36
explosionà	2	0	explosiona	2	2	2
explotarà	2	37	explotara	2	1	38
explotà	2	21	explota	2	197	218
explotàrem	2	0	explotarem	2	6	6
explotés	2	15	explotes	2	0	15
explotí	2	0	exploti	2	56	56
explícit	0	431	explicit	2	8	439
explícita	0	881	explicita	2	39	920
explícites	0	158	explicites	2	0	158
exportarà	2	50	exportara	2	0	50
exportà	2	6	exporta	2	1672	1678
exportàrem	2	0	exportarem	2	5	5
exportàveu	2	0	exportaveu	4	1	1
exportés	2	3	exportes	2	1	4
exportí	2	0	exporti	2	42	42
exposarà	2	84	exposara	2	0	84
exposà	2	38	exposa	2	876	914
exposàrem	2	0	exposarem	2	19	19
exposés	2	36	exposes	2	4	40
exposí	2	0	exposi	2	204	204
expressarà	2	62	expressara	2	1	63
expressà	2	84	expressa	4	2110	2194
expressàrem	2	0	expressarem	2	22	22
expressés	2	90	expresses	4	29	119
expressí	2	0	expressi	2	445	445
expropià	2	2	expropia	2	5	7
expulsarà	2	13	expulsara	2	1	14
expulsà	2	34	expulsa	2	170	204
expulsàrem	2	0	expulsarem	2	1	1
expulsés	2	25	expulses	2	0	25
expulsí	2	0	expulsi	2	25	25
exsudarà	2	1	exsudara	2	0	1
exsudà	2	0	exsuda	2	1	1
extasià	2	0	extasia	2	1	1
exterioritzà	2	0	exterioritza	2	1	1
exterioritzés	2	1	exterioritzes	2	0	1
exterioritzí	2	0	exterioritzi	2	1	1
exterminà	2	3	extermina	2	7	10
exterminàrem	2	0	exterminarem	2	1	1
exterminés	2	3	extermines	2	0	3
exterminí	2	0	extermini	2	235	235
externalitzà	2	0	externalitza	2	4	4
extingirà	2	8	extingira	2	0	8
extirparà	2	1	extirpara	2	0	1
extirpà	2	0	extirpa	2	7	7
extirpí	2	0	extirpi	2	4	4
extorsionà	2	0	extorsiona	2	2	2
extractés	2	0	extractes	2	242	242
extradirà	2	2	extradira	2	0	2
extradírem	2	0	extradirem	2	1	1
extragués	2	7	extragues	2	0	7
extralimitarà	2	1	extralimitara	2	0	1
extralimità	2	0	extralimita	2	3	3
extralimités	2	1	extralimites	2	0	1
extralimití	2	0	extralimiti	2	2	2
extrapolà	2	1	extrapola	2	16	17
extrapolàrem	2	0	extrapolarem	2	1	1
extrapolés	2	1	extrapoles	2	0	1
extrapolí	2	0	extrapoli	2	1	1
extrauré	2	4	extraure	2	97	101
extraviarà	2	1	extraviara	2	0	1
extravià	2	0	extravia	2	2	2
extraviés	2	1	extravies	2	0	1
extremunció	4	11	extremuncio	2	0	11
extremà	2	0	extrema	0	1999	1999
extremés	2	0	extremes	0	480	480
extremí	2	0	extremi	2	4	4
exèrcit	4	14895	exercit	2	1955	16850
exèrcits	4	1601	exercits	2	48	1649
exímia	0	0	eximia	2	13	13
eó	4	11	eo	4	37	48
fabricarà	2	10	fabricara	2	0	10
fabricà	2	11	fabrica	2	292	303
fabricàrem	2	1	fabricarem	2	2	3
fabriqués	2	4	fabriques	2	9	13
fabriquí	2	0	fabriqui	2	26	26
fabulés	2	0	fabules	2	1	1
facetà	2	0	faceta	4	212	212
facetés	2	0	facetes	4	239	239
facilitarà	2	680	facilitara	2	0	680
facilità	2	22	facilita	2	936	958
facilitàrem	2	0	facilitarem	2	32	32
facilitàreu	2	0	facilitareu	2	1	1
facilitària	0	0	facilitaria	2	261	261
facilités	2	74	facilites	2	1	75
facilití	2	0	faciliti	2	571	571
factoritzarà	2	1	factoritzara	2	0	1
factoritzà	2	0	factoritza	2	5	5
facturarà	2	3	facturara	2	0	3
facturà	2	0	factura	4	1029	1029
facturàrem	2	0	facturarem	2	2	2
facturés	2	1	factures	4	687	688
facturí	2	0	facturi	2	4	4
facultarà	2	1	facultara	2	0	1
facultà	2	0	faculta	2	32	32
facultés	2	2	facultes	2	0	2
facultí	2	0	faculti	2	9	9
fadigà	2	0	fadiga	4	2	2
fadà	2	0	fada	4	107	107
fadés	2	0	fades	4	282	282
fadí	2	0	fadi	2	2	2
fagocità	2	1	fagocita	2	1	2
fagocitària	0	1	fagocitaria	2	0	1
fagocitàries	0	1	fagocitaries	2	0	1
fagòcit	4	19	fagocit	2	0	19
faixà	2	0	faixa	4	48	48
faixés	2	0	faixes	4	12	12
faixí	2	5	faixi	2	0	5
faixó	4	1	faixo	2	0	1
falcà	2	0	falca	4	55	55
fallarà	2	43	fallara	2	0	43
fallà	2	20	falla	4	710	730
fallàrem	2	0	fallarem	2	4	4
fallàreu	2	0	fallareu	2	1	1
fallés	2	33	falles	4	186	219
fallí	2	0	falli	2	76	76
fallís	2	0	fallis	2	5	5
falqués	2	4	falques	4	19	23
falsegí	2	0	falsegi	2	4	4
falsejarà	2	1	falsejara	2	0	1
falsejà	2	0	falseja	2	25	25
falsificà	2	2	falsifica	2	8	10
falsifiquí	2	0	falsifiqui	2	1	1
falsà	2	0	falsa	0	965	965
falsària	0	1	falsaria	2	0	1
falsàries	0	1	falsaries	2	0	1
falsés	2	0	falses	0	796	796
falsí	2	0	falsi	2	1	1
faltarà	2	58	faltara	2	2	60
faltà	2	2	falta	4	16630	16632
faltàrem	2	0	faltarem	2	4	4
faltés	2	17	faltes	4	219	236
faltí	2	0	falti	2	77	77
familiaritzarà	2	1	familiaritzara	2	0	1
familiaritzà	2	6	familiaritza	2	3	9
familiaritzàrem	2	0	familiaritzarem	2	1	1
familiaritzés	2	1	familiaritzes	2	0	1
familiaritzí	2	0	familiaritzi	2	13	13
fanatitzà	2	0	fanatitza	2	1	1
fanfarronegés	2	0	fanfarroneges	2	1	1
fanfarronejà	2	0	fanfarroneja	2	3	3
fangués	2	0	fangues	4	1	1
fangà	2	0	fanga	4	8	8
fantasiegí	2	0	fantasiegi	2	1	1
fantasiejà	2	1	fantasieja	2	3	4
fantasià	2	0	fantasia	4	637	637
fantasiàrem	2	0	fantasiarem	2	2	2
fantasiés	2	1	fantasies	4	133	134
farcirà	2	1	farcira	2	0	1
fargués	2	0	fargues	4	5	5
fargà	2	0	farga	4	20	20
farratgés	2	0	farratges	4	84	84
fartà	2	0	farta	0	67	67
fartàrem	2	0	fartarem	2	1	1
fartés	2	0	fartes	0	8	8
faró	4	2	faro	4	28	30
fascinarà	2	1	fascinara	2	0	1
fascinà	2	1	fascina	2	35	36
fascinés	2	0	fascines	2	1	1
fastiguejà	2	1	fastigueja	2	1	2
fatigués	2	0	fatigues	4	6	6
fatiguí	2	0	fatigui	2	1	1
fatigà	2	0	fatiga	4	235	235
fatxendà	2	0	fatxenda	4	2	2
fatxendés	2	0	fatxendes	4	1	1
febrejà	2	0	febreja	2	3	3
fecundà	2	0	fecunda	0	26	26
fecundés	2	0	fecundes	0	10	10
federà	2	1	federa	2	0	1
federí	2	0	federi	2	1	1
feixà	2	0	feixa	4	1	1
feixés	2	0	feixes	4	14	14
felicitarà	2	5	felicitara	2	0	5
felicità	2	9	felicita	2	265	274
felicitàrem	2	0	felicitarem	2	3	3
felicités	2	9	felicites	2	3	12
felicití	2	0	feliciti	2	114	114
feminitzà	2	0	feminitza	2	3	3
femtà	2	0	femta	4	58	58
femtés	2	0	femtes	4	12	12
femà	2	0	fema	2	13	13
femí	2	0	femi	2	11	11
fendí	2	0	fendi	4	2	2
fenià	4	25	fenia	2	2	27
ferirà	2	2	ferira	2	0	2
fermentà	2	0	fermenta	2	11	11
fermentí	2	0	fermenti	2	3	3
fermà	2	2	ferma	0	2818	2820
fermés	2	1	fermes	0	555	556
ferrarà	2	0	ferrara	4	170	170
ferratgés	2	0	ferratges	4	2	2
ferrés	2	1	ferres	4	1	2
ferrí	2	0	ferri	4	276	276
ferrós	0	22	ferros	4	22	44
fertilitzarà	2	1	fertilitzara	2	0	1
fertilitzà	2	0	fertilitza	2	8	8
ferí	2	10	feri	2	0	10
ferírem	2	0	ferirem	2	1	1
ferís	2	5	feris	2	0	5
festegés	2	0	festeges	2	1	1
festegí	2	0	festegi	2	1	1
festejarà	2	2	festejara	2	0	2
festejà	2	0	festeja	2	8	8
festivà	2	0	festiva	0	35	35
festivés	2	0	festives	0	34	34
feudalitzà	2	1	feudalitza	2	0	1
fiancés	2	0	fiances	4	25	25
fiançà	2	0	fiança	4	176	176
fiarà	2	2	fiara	2	0	2
fibló	4	29	fiblo	2	0	29
fibrosà	2	0	fibrosa	2	21	21
fibrosés	2	0	fibroses	2	21	21
fibrosí	2	0	fibrosi	2	65	65
ficarà	2	25	ficara	2	0	25
ficcionés	2	0	ficciones	2	2	2
ficà	2	4	fica	2	154	158
ficàrem	2	0	ficarem	2	11	11
figuerolà	0	0	figuerola	4	8	8
figurarà	2	84	figurara	2	0	84
figurà	2	4	figura	4	4501	4505
figurés	2	42	figures	4	2008	2050
figurí	2	0	figuri	2	228	228
filigranà	2	0	filigrana	4	20	20
filigranés	2	0	filigranes	4	8	8
filià	2	0	filia	2	2	2
filiés	2	0	filies	2	2	2
filií	2	0	filii	2	1	1
fillolà	2	0	fillola	4	5	5
fillolés	2	0	filloles	4	1	1
filmà	2	8	filma	2	17	25
filmàrem	2	0	filmarem	2	1	1
filmés	2	2	filmes	2	1	3
filmí	2	0	filmi	2	3	3
filosofà	2	0	filosofa	2	2	2
filtrarà	2	11	filtrara	2	0	11
filtrà	2	6	filtra	2	440	446
filtrés	2	9	filtres	2	1803	1812
filtrí	2	0	filtri	2	17	17
filà	2	0	fila	4	2239	2239
filàries	4	4	filaries	2	0	4
filés	2	0	files	4	1980	1980
filí	2	2	fili	2	3	5
filòsof	4	792	filosof	2	2	794
filòsofa	4	44	filosofa	2	2	46
filòsofes	4	1	filosofes	2	0	1
finalitzarà	2	132	finalitzara	2	0	132
finalitzà	2	137	finalitza	2	571	708
finalitzàrem	2	0	finalitzarem	2	10	10
finalitzàreu	2	0	finalitzareu	2	3	3
finalitzés	2	86	finalitzes	2	4	90
finalitzí	2	0	finalitzi	2	548	548
financés	2	24	finances	4	2860	2884
financí	2	0	financi	2	161	161
finançarà	2	141	finançara	2	0	141
finançà	2	19	finança	4	465	484
finançàrem	2	0	finançarem	2	31	31
fingirà	2	1	fingira	2	0	1
fingírem	2	0	fingirem	2	1	1
fintés	2	0	fintes	4	2	2
finà	2	0	fina	4	525	525
finès	0	307	fines	4	254	561
finés	2	3	fines	4	254	257
finí	2	3	fini	2	47	50
finís	2	0	finis	2	9	9
fiqués	2	13	fiques	2	34	47
fiquí	2	0	fiqui	2	42	42
firmarà	2	3	firmara	2	0	3
firmà	2	19	firma	4	319	338
firmés	2	1	firmes	4	67	68
firmí	2	1	firmi	2	6	7
firà	2	0	fira	4	466	466
firés	2	0	fires	4	140	140
fiscalitzarà	2	1	fiscalitzara	2	0	1
fiscalitzà	2	0	fiscalitza	2	4	4
fiscalitzés	2	1	fiscalitzes	2	0	1
fiscalitzí	2	0	fiscalitzi	2	2	2
fissionà	2	0	fissiona	2	1	1
fitarà	2	1	fitara	2	0	1
fitxarà	2	26	fitxara	2	0	26
fitxà	2	48	fitxa	4	418	466
fitxàrem	2	0	fitxarem	2	1	1
fitxés	2	3	fitxes	4	399	402
fitxí	2	0	fitxi	2	12	12
fità	2	0	fita	4	930	930
fités	2	0	fites	0	308	308
fití	2	0	fiti	2	1	1
fixarà	2	85	fixara	2	1	86
fixà	2	25	fixa	0	1527	1552
fixàrem	2	1	fixarem	2	23	24
fixés	2	72	fixes	0	376	448
fixí	2	0	fixi	2	285	285
fià	2	0	fia	2	60	60
fiàrem	2	0	fiarem	2	1	1
fiés	2	1	fies	2	16	17
fií	2	0	fii	2	10	10
flagel·là	2	0	flagel·la	2	1	1
flairés	2	0	flaires	2	2	2
flamà	2	0	flama	4	363	363
flamés	2	0	flames	4	470	470
flamí	2	1	flami	2	0	1
flanquegí	2	0	flanquegi	2	1	1
flanquejà	2	1	flanqueja	2	6	7
flaquegí	2	0	flaquegi	2	4	4
flaquejarà	2	2	flaquejara	2	0	2
flaquejà	2	0	flaqueja	2	11	11
flaquejàrem	2	0	flaquejarem	2	2	2
flexibilitzarà	2	3	flexibilitzara	2	0	3
flexibilitzà	2	0	flexibilitza	2	11	11
flexibilitzí	2	0	flexibilitzi	2	9	9
flexionarà	2	1	flexionara	2	0	1
flexionà	2	0	flexiona	2	10	10
flexioní	2	0	flexioni	2	2	2
fliparà	2	1	flipara	2	0	1
flirtegés	2	0	flirteges	2	1	1
flirtejà	2	0	flirteja	2	11	11
flocà	2	0	floca	4	3	3
florirà	2	8	florira	2	0	8
florís	2	3	floris	4	19	22
flotarà	2	3	flotara	2	0	3
flotà	2	0	flota	4	3938	3938
flotés	2	2	flotes	4	1007	1009
flotí	2	0	floti	2	1	1
flotó	4	0	floto	2	1	1
fluctuarà	2	7	fluctuara	2	0	7
fluctuà	2	2	fluctua	2	39	41
fluixejà	2	0	fluixeja	2	1	1
flòrida	0	1	florida	4	1910	1911
flòrides	0	0	florides	4	8	8
focalitzà	2	1	focalitza	2	24	25
focalitzés	2	1	focalitzes	2	0	1
focalitzí	2	0	focalitzi	2	4	4
fogà	2	0	foga	2	2	2
fogó	4	19	fogo	2	28	47
folià	2	0	folia	4	4	4
foliés	2	0	folies	4	10	10
follarà	2	0	follara	2	1	1
follà	2	0	folla	0	20	20
follàrem	2	0	follarem	2	3	3
follés	2	1	folles	0	26	27
follí	2	0	folli	2	3	3
folrà	2	0	folra	2	1	1
folrés	2	0	folres	2	11	11
fomentarà	2	248	fomentara	2	0	248
fomentà	2	8	fomenta	2	762	770
fomentàrem	2	0	fomentarem	2	28	28
fomentés	2	27	fomentes	2	0	27
fomentí	2	0	fomenti	2	407	407
fonamentarà	2	5	fonamentara	2	0	5
fonamentà	2	1	fonamenta	2	361	362
fonamentés	2	6	fonamentes	2	0	6
fonamentí	2	0	fonamenti	2	56	56
fondegés	2	1	fondeges	2	0	1
fondré	2	5	fondre	2	178	183
fongués	2	5	fongues	2	0	5
fonguí	2	0	fongui	2	32	32
fonà	2	0	fona	4	10	10
fonés	2	0	fones	4	9	9
foní	2	0	foni	2	5	5
fonó	4	6	fono	2	4	10
foradà	2	0	forada	4	9	9
foragità	2	2	foragita	2	2	4
foragités	2	1	foragites	2	0	1
forcejà	2	0	forceja	2	1	1
forcà	2	0	forca	4	146	146
forcés	2	9	forces	4	15294	15303
forcí	2	0	forci	2	37	37
forgés	2	1	forges	4	31	32
forgí	2	0	forgi	2	9	9
forjarà	2	6	forjara	2	0	6
forjà	2	9	forja	4	129	138
forjàrem	2	0	forjarem	2	2	2
formalitzarà	2	6	formalitzara	2	0	6
formalitzà	2	8	formalitza	2	18	26
formalitzàrem	2	0	formalitzarem	2	3	3
formalitzés	2	5	formalitzes	2	0	5
formalitzí	2	0	formalitzi	2	24	24
formarà	2	233	formara	2	0	233
formatarà	2	11	formatara	2	0	11
formatgés	2	0	formatges	4	93	93
formatà	2	0	formata	2	242	242
formatí	2	0	formati	2	2	2
formigoní	2	0	formigoni	2	1	1
formigués	2	0	formigues	4	389	389
formigà	2	0	formiga	4	103	103
formigó	4	418	formigo	2	0	418
formularà	2	60	formulara	2	0	60
formulà	2	25	formula	2	508	533
formulàrem	2	0	formularem	2	39	39
formulària	0	1	formularia	2	12	13
formulàries	0	1	formularies	2	0	1
formulés	2	68	formules	2	9	77
formulí	2	0	formuli	2	245	245
formà	2	463	forma	4	47268	47731
formàrem	2	0	formarem	2	16	16
formàreu	2	0	formareu	2	2	2
formés	2	110	formes	4	9182	9292
formí	2	1	formi	2	358	359
formó	4	0	formo	2	109	109
fornejà	2	0	forneja	2	8	8
fornicà	2	0	fornica	2	3	3
forqués	2	0	forques	4	24	24
forrà	2	0	forra	4	2	2
forrés	2	0	forres	4	4	4
fortificà	2	7	fortifica	2	1	8
fortifiqués	2	3	fortifiques	2	0	3
forà	0	12	fora	6	16728	16740
forçarà	2	48	forçara	2	0	48
forçà	2	71	força	3	16820	16891
forçàrem	2	0	forçarem	2	3	3
fosforilà	2	0	fosforila	2	7	7
fosquegí	2	0	fosquegi	2	1	1
fosquejà	2	0	fosqueja	2	1	1
fossà	2	0	fossa	4	305	305
fossés	2	0	fosses	4	223	223
fossí	2	0	fossi	2	8	8
fotgés	2	0	fotges	4	5	5
fotjà	2	0	fotja	4	2	2
fotocopià	2	0	fotocopia	2	1	1
fotocòpia	4	35	fotocopia	2	1	36
fotocòpies	4	25	fotocopies	2	0	25
fotografiarà	2	1	fotografiara	2	0	1
fotografià	2	5	fotografia	4	2400	2405
fotografiés	2	2	fotografies	4	2246	2248
fotolitografià	2	0	fotolitografia	4	14	14
fotré	2	29	fotre	7	157	186
fotés	2	3	fotes	2	0	3
fotó	4	129	foto	4	1948	2077
fracassarà	2	64	fracassara	2	0	64
fracassà	2	103	fracassa	2	159	262
fracassàrem	2	0	fracassarem	2	29	29
fracassàreu	2	0	fracassareu	2	7	7
fracassés	2	52	fracasses	2	1	53
fracassí	2	0	fracassi	2	85	85
fraccionarà	2	1	fraccionara	2	0	1
fraccionà	2	0	fracciona	2	3	3
fraccionària	0	22	fraccionaria	2	1	23
fraccionàries	0	9	fraccionaries	2	0	9
fracturarà	2	1	fracturara	2	0	1
fracturà	2	2	fractura	4	270	272
fracturés	2	1	fractures	4	128	129
fragmentarà	2	2	fragmentara	2	0	2
fragmentà	2	5	fragmenta	2	25	30
fragmentària	0	70	fragmentaria	2	4	74
fragmentàries	0	59	fragmentaries	2	0	59
fragmentés	2	1	fragmentes	2	0	1
fragmentí	2	0	fragmenti	2	13	13
franciscà	0	137	francisca	4	36	173
frangés	2	0	franges	4	394	394
franjà	2	0	franja	4	1057	1057
franquegés	2	2	franqueges	2	0	2
franquegí	2	0	franquegi	2	1	1
franquejarà	2	2	franquejara	2	0	2
franquejà	2	0	franqueja	2	2	2
franquejàrem	2	0	franquejarem	2	2	2
fraternitzà	2	0	fraternitza	2	1	1
fregarà	2	5	fregara	2	0	5
fregués	2	0	fregues	4	12	12
fregà	2	0	frega	4	65	65
fregírem	2	0	fregirem	2	1	1
fregó	4	0	frego	2	2	2
frenarà	2	29	frenara	2	0	29
frenà	2	3	frena	2	112	115
frenàrem	2	0	frenarem	2	2	2
frenés	2	7	frenes	2	2	9
frení	2	0	freni	2	56	56
freqüentà	2	6	freqüenta	2	15	21
frescós	0	0	frescos	0	441	441
fresquejà	2	0	fresqueja	2	2	2
fressà	2	0	fressa	4	10	10
fresà	2	0	fresa	4	49	49
fresés	2	0	freses	4	9	9
fresí	2	0	fresi	2	40	40
frisà	2	0	frisa	2	2	2
frisí	2	0	frisi	2	7	7
frisó	0	101	friso	2	5	106
frisós	0	9	frisos	4	27	36
fronterejà	2	0	frontereja	2	1	1
fructificà	2	1	fructifica	2	3	4
fructifiqués	2	1	fructifiques	2	0	1
fructifiquí	2	0	fructifiqui	2	5	5
fruità	2	0	fruita	4	1072	1072
fruités	2	0	fruites	4	971	971
frustrarà	2	8	frustrara	2	0	8
frustrà	2	5	frustra	2	34	39
frustrés	2	1	frustres	2	0	1
frustrí	2	0	frustri	2	10	10
frànkfurt	4	0	frankfurt	4	566	566
fuetegí	2	0	fuetegi	2	1	1
fuetejà	2	0	fueteja	2	4	4
fugirà	2	7	fugira	2	0	7
fugués	2	0	fugues	4	54	54
fugà	2	2	fuga	4	257	259
fugàrem	2	0	fugarem	2	1	1
fugí	2	65	fugi	2	29	94
fugírem	2	0	fugirem	2	1	1
fugíreu	2	0	fugireu	2	1	1
fugís	2	22	fugis	2	4	26
fulgurà	2	0	fulgura	2	7	7
fullegí	2	0	fullegi	2	1	1
fullejà	2	0	fulleja	2	9	9
fullés	2	0	fulles	4	1651	1651
fulminà	2	0	fulmina	2	1	1
fulminés	2	2	fulmines	2	0	2
fulés	0	0	fules	0	1	1
fumarà	2	3	fumara	2	0	3
fumejà	2	0	fumeja	2	1	1
fumerà	2	0	fumera	0	4	4
fumigà	2	0	fumiga	2	1	1
fumà	2	0	fuma	2	90	90
fumàrem	2	0	fumarem	2	1	1
fumària	4	0	fumaria	2	3	3
fumàries	4	0	fumaries	2	2	2
fumé	2	0	fume	2	4	4
fumés	2	2	fumes	2	14	16
fumí	2	0	fumi	2	26	26
funcionarà	2	788	funcionara	2	4	792
funcionà	2	26	funciona	2	4812	4838
funcionàrem	2	0	funcionarem	2	2	2
funcionària	4	45	funcionaria	2	149	194
funcionàries	4	24	funcionaries	2	0	24
funcionés	2	133	funciones	2	8	141
funcioní	2	0	funcioni	2	1925	1925
fundarà	2	4	fundara	2	1	5
fundà	2	361	funda	4	197	558
fundàrem	2	0	fundarem	2	1	1
fundés	2	11	fundes	4	23	34
fundí	2	0	fundi	2	8	8
funestà	2	0	funesta	0	35	35
funestés	2	0	funestes	0	35	35
furgués	2	0	furgues	4	2	2
furgà	2	0	furga	4	5	5
furgó	4	18	furgo	2	5	23
furtà	2	3	furta	2	9	12
furtàrem	2	0	furtarem	2	2	2
furtí	2	0	furti	2	1	1
furà	2	4	fura	4	33	37
furés	2	0	fures	4	48	48
furí	2	0	furi	2	7	7
fusionarà	2	28	fusionara	2	0	28
fusionà	2	59	fusiona	2	393	452
fusionàrem	2	0	fusionarem	2	1	1
fusionés	2	12	fusiones	2	2	14
fusioní	2	0	fusioni	2	8	8
fusterià	0	1	fusteria	4	69	70
fustigà	2	1	fustiga	2	2	3
fàbrica	4	1995	fabrica	2	292	2287
fàbriques	4	1100	fabriques	2	9	1109
fària	4	0	faria	2	2293	2293
fàries	4	1	faries	2	152	153
fàtic	0	1	fatic	4	0	1
fàtics	0	0	fatics	4	1	1
fèria	4	1	feria	2	16	17
fèries	4	1	feries	2	1	2
fé	2	12	fe	4	3072	3084
féu	2	649	feu	2	10529	11178
fíala	4	0	fiala	4	4	4
fíat	4	0	fiat	4	93	93
fíats	4	0	fiats	2	1	1
fília	4	0	filia	2	2	2
fílies	4	0	filies	2	2	2
fòrbies	4	3	forbies	2	0	3
fòrmic	0	16	formic	2	0	16
fòrnix	4	1	fornix	2	1	2
fòsfor	4	224	fosfor	2	0	224
fóra	2	213	fora	6	16728	16941
fórmula	4	3189	formula	2	508	3697
fórmules	4	1065	formules	2	9	1074
fóssem	2	2	fossem	2	1	3
fúmer	2	1	fumer	0	0	1
gabà	2	0	gaba	2	18	18
gabés	2	1	gabes	2	1	2
gaianès	0	0	gaianes	4	2	2
gaianés	0	0	gaianes	4	2	2
galerí	4	0	galeri	4	69	69
galgués	2	0	galgues	4	3	3
galgà	2	0	galga	4	2	2
galibí	2	0	galibi	2	4	4
galileà	0	4	galilea	4	143	147
galindó	4	1	galindo	4	13	14
gallardó	4	0	gallardo	4	4	4
gallegí	2	0	gallegi	2	1	1
gallejà	2	0	galleja	2	1	1
gallifà	0	0	gallifa	4	8	8
gallàrdia	4	0	gallardia	4	8	8
galopà	2	0	galopa	4	3	3
galopés	2	0	galopes	2	1	1
galvanitzà	2	2	galvanitza	2	0	2
gal·lés	0	2	gal·les	4	1721	1723
galà	0	0	gala	4	536	536
gambarà	2	0	gambara	2	2	2
gambà	2	0	gamba	4	64	64
gambés	2	1	gambes	4	97	98
gambúsia	4	3	gambusia	4	2	5
gambúsies	4	1	gambusies	4	0	1
gamà	2	0	gama	2	129	129
gamés	2	0	games	2	337	337
gamó	4	0	gamo	2	7	7
gandesà	0	0	gandesa	4	9	9
gandià	0	0	gandia	4	53	53
gangrenarà	2	3	gangrenara	2	0	3
gangrenà	2	0	gangrena	4	39	39
gangrenés	2	0	gangrenes	4	1	1
ganivetejà	2	1	ganiveteja	2	0	1
ganxó	4	0	ganxo	4	133	133
ganxós	4	0	ganxos	4	53	53
ganyà	2	0	ganya	4	1	1
ganyés	2	0	ganyes	4	2	2
ganyí	2	0	ganyi	2	1	1
garantirà	2	879	garantira	2	0	879
garantírem	2	0	garantirem	2	104	104
garbó	4	1	garbo	4	26	27
garcià	0	0	garcia	4	305	305
gardenyés	2	0	gardenyes	4	1	1
garfí	2	0	garfi	4	17	17
garfís	2	0	garfis	4	5	5
gargotegí	2	0	gargotegi	2	1	1
gargotejà	2	1	gargoteja	2	0	1
garibaldí	0	0	garibaldi	4	61	61
garlí	2	0	garli	2	2	2
garrigà	0	0	garriga	4	212	212
garrés	4	1	garres	4	5	6
garsà	2	0	garsa	4	44	44
garsés	2	0	garses	4	32	32
gastarà	2	54	gastara	2	0	54
gastà	2	2	gasta	2	453	455
gastàrem	2	0	gastarem	2	34	34
gastàreu	2	0	gastareu	2	1	1
gastés	2	17	gastes	2	11	28
gasés	2	0	gases	4	5	5
gasós	0	114	gasos	4	2896	3010
gatejà	2	0	gateja	2	3	3
gaudirà	2	90	gaudira	2	2	92
gaudírem	2	0	gaudirem	2	25	25
gaudíreu	2	0	gaudireu	2	5	5
gaudís	2	26	gaudis	4	3	29
gaó	4	20	gao	4	98	118
gaús	4	0	gaus	4	1	1
gebrí	2	0	gebri	2	1	1
gelarà	2	3	gelara	2	0	3
gelatinitzà	2	0	gelatinitza	2	1	1
gelà	2	0	gela	4	31	31
gelàrem	2	0	gelarem	2	1	1
gelés	2	1	geles	2	1	2
gelí	2	0	geli	4	16	16
gemeguí	2	0	gemegui	2	1	1
gemegà	2	1	gemega	2	5	6
geminà	2	0	gemina	2	9	9
geminí	2	0	gemini	2	164	164
generalitzarà	2	4	generalitzara	2	0	4
generalitzà	2	5	generalitza	2	85	90
generalitzés	2	4	generalitzes	2	0	4
generalitzí	2	0	generalitzi	2	13	13
generarà	2	456	generara	2	0	456
generà	2	39	genera	2	2451	2490
generàrem	2	0	generarem	2	9	9
generàreu	2	0	generareu	2	4	4
generí	2	0	generi	2	291	291
georeferencià	2	0	georeferencia	2	1	1
germinarà	2	1	germinara	2	0	1
germinà	2	0	germina	2	8	8
germiní	2	0	germini	2	3	3
gerró	4	0	gerro	4	92	92
gesticulà	2	0	gesticula	2	2	2
gestionarà	2	67	gestionara	2	0	67
gestionà	2	5	gestiona	2	1448	1453
gestionàrem	2	0	gestionarem	2	9	9
gestionàreu	2	0	gestionareu	2	1	1
gestionés	2	18	gestiones	2	2	20
gestioní	2	0	gestioni	2	128	128
gestà	2	0	gesta	4	186	186
gestés	2	0	gestes	4	106	106
giragonsés	2	0	giragonses	4	9	9
girarà	2	66	girara	2	0	66
giravoltà	2	1	giravolta	4	2	3
giravoltés	2	0	giravoltes	4	2	2
girà	2	37	gira	4	3354	3391
giràrem	2	0	girarem	2	2	2
girí	2	0	giri	2	101	101
gità	2	1	gita	4	38	39
glacé	4	3	glace	2	2	5
glacés	4	1	glaces	4	1	2
glací	2	0	glaci	2	1	1
glaçà	2	0	glaça	4	13	13
glaçó	4	4	glaço	2	0	4
globalitzarà	2	2	globalitzara	2	0	2
globalitzà	2	0	globalitza	2	12	12
globalitzàrem	2	0	globalitzarem	2	1	1
glorificarà	2	1	glorificara	2	0	1
glorificà	2	2	glorifica	2	24	26
glorià	2	0	gloria	2	173	173
glossà	2	0	glossa	4	19	19
glossés	2	0	glosses	4	30	30
glossí	2	0	glossi	2	1	1
glosà	2	0	glosa	4	7	7
glosés	2	0	gloses	4	4	4
godelletà	0	0	godelleta	4	2	2
godellà	0	0	godella	4	4	4
gofrà	2	0	gofra	2	3	3
gofrés	2	0	gofres	2	11	11
gogí	2	0	gogi	2	3	3
gojós	0	4	gojos	4	1	5
gonà	4	0	gona	4	1	1
googlegés	2	1	googleges	2	0	1
gosarà	2	3	gosara	2	0	3
gosà	2	1	gosa	2	23	24
gosàreu	2	0	gosareu	2	1	1
gosés	2	2	goses	2	21	23
gosí	2	0	gosi	2	7	7
gotejà	2	0	goteja	2	6	6
governarà	2	22	governara	2	0	22
governà	2	100	governa	2	262	362
governàrem	2	0	governarem	2	4	4
governés	2	26	governes	2	5	31
governí	2	0	governi	2	40	40
goès	0	0	goes	4	230	230
goés	0	0	goes	4	230	230
graciés	2	3	gracies	2	101	104
graduarà	2	2	graduara	2	0	2
graduà	2	173	gradua	2	12	185
gradués	2	7	gradues	2	0	7
grafià	2	0	grafia	4	57	57
grafiés	2	0	grafies	4	28	28
grallà	2	0	gralla	4	12	12
grallés	2	0	gralles	4	4	4
granallà	2	0	granalla	4	1	1
granissarà	2	1	granissara	2	0	1
granulà	2	0	granula	2	1	1
granulés	2	0	granules	2	1	1
granà	2	1	grana	0	18	19
granés	2	1	granes	4	4	5
graní	2	0	grani	2	2	2
granís	2	2	granis	2	2	4
grapejà	2	0	grapeja	2	2	2
grapà	2	0	grapa	4	45	45
grapés	2	0	grapes	4	44	44
gratificà	2	0	gratifica	2	1	1
gratifiqués	2	0	gratifiques	2	1	1
gratifiquí	2	0	gratifiqui	2	1	1
gratà	2	0	grata	4	114	114
gratés	2	1	grates	4	25	26
gratí	2	0	grati	2	1	1
gratín	2	0	gratin	2	1	1
gravarà	2	39	gravara	2	1	40
gravitarà	2	1	gravitara	2	1	2
gravità	2	1	gravita	2	10	11
gravités	2	1	gravites	2	2	3
gravití	2	19	graviti	2	1	20
gravitó	4	7	gravito	2	0	7
gravà	2	25	grava	4	398	423
gravàrem	2	0	gravarem	2	3	3
gravés	2	9	graves	4	106	115
graví	2	0	gravi	2	28	28
gredós	0	0	gredos	4	5	5
greixà	2	0	greixa	2	1	1
greixós	0	16	greixos	4	324	340
gresós	0	0	gresos	4	18	18
greugés	2	0	greuges	4	70	70
grifà	2	0	grifa	4	1	1
grifó	4	14	grifo	2	2	16
grillà	2	0	grilla	2	1	1
grilló	4	1	grillo	2	8	9
grinyolà	2	0	grinyola	2	6	6
grisejà	2	0	griseja	2	1	1
grisós	0	19	grisos	0	599	618
gronxà	2	0	gronxa	2	22	22
grumejà	2	0	grumeja	2	1	1
gruà	2	0	grua	4	118	118
grués	2	0	grues	4	75	75
grànul	4	10	granul	2	0	10
guaità	2	0	guaita	4	112	112
guaités	2	0	guaites	4	10	10
gualterí	0	0	gualteri	4	3	3
guanyarà	2	172	guanyara	2	5	177
guanyà	2	1112	guanya	2	803	1915
guanyàrem	2	0	guanyarem	2	126	126
guanyàreu	2	1	guanyareu	2	13	14
guanyés	2	136	guanyes	2	51	187
guanyí	2	0	guanyi	2	160	160
guardarà	2	27	guardara	2	2	29
guardonà	2	6	guardona	2	4	10
guardà	2	5	guarda	4	1084	1089
guardàrem	2	0	guardarem	2	18	18
guardàreu	2	0	guardareu	2	1	1
guardés	2	16	guardes	4	149	165
guardó	4	197	guardo	2	47	244
guarirà	2	1	guarira	2	0	1
guarírem	2	0	guarirem	2	1	1
guerxà	2	0	guerxa	0	15	15
guerxós	0	0	guerxos	0	5	5
guiarà	2	110	guiara	2	0	110
guilloixés	2	0	guilloixes	2	1	1
guillotinà	2	0	guillotina	4	51	51
guillotinés	2	0	guillotines	4	3	3
guillà	2	0	guilla	4	2	2
guillés	2	0	guilles	4	3	3
guindà	2	0	guinda	4	38	38
guindés	2	0	guindes	4	6	6
guineà	0	51	guinea	4	2641	2692
guinguetès	0	0	guinguetes	4	2	2
guinguetés	0	0	guinguetes	4	2	2
guisà	2	0	guisa	4	35	35
guisí	2	0	guisi	2	1	1
guitarà	2	0	guitara	2	2	2
guità	2	0	guita	0	1	1
guixés	2	1	guixes	4	0	1
guià	2	2	guia	4	2076	2078
guiàrem	2	0	guiarem	2	9	9
guiàreu	2	0	guiareu	2	1	1
guiés	2	17	guies	4	760	777
guió	4	1324	guio	2	10	1334
gurú	4	35	guru	4	130	165
gurús	4	7	gurus	4	26	33
gustí	2	0	gusti	2	3	3
gustós	0	69	gustos	4	214	283
guíndola	4	0	guindola	4	1	1
guíndoles	4	0	guindoles	4	1	1
gàlib	4	3	galib	2	0	3
gèlida	0	5	gelida	4	6	11
gèmina	0	4	gemina	2	9	13
gèmini	4	2	gemini	2	164	166
gèminis	4	5	geminis	2	1	6
gènera	4	1	genera	2	2451	2452
gènere	4	8525	genere	2	8	8533
gèneres	4	1645	generes	2	8	1653
gíric	0	0	giric	4	1	1
habilitarà	2	62	habilitara	2	0	62
habilità	2	4	habilita	2	2077	2081
habilitàrem	2	0	habilitarem	2	2	2
habilitàreu	2	0	habilitareu	2	4	4
habilités	2	1	habilites	2	3	4
habilití	2	0	habiliti	2	23	23
habitarà	2	0	habitara	2	1	1
habituà	2	0	habitua	2	1	1
habitués	2	1	habitues	2	0	1
habità	2	4	habita	2	223	227
habités	2	1	habites	2	1	2
habití	2	0	habiti	2	16	16
hackejà	2	0	hackeja	2	1	1
hagués	2	8282	hagues	2	10	8292
haguí	2	1	hagui	2	5	6
hagés	2	6	hages	2	23	29
hagí	2	0	hagi	2	29525	29525
hajà	2	0	haja	2	124	124
halà	2	0	hala	7	15	15
halés	2	0	hales	4	16	16
halí	2	0	hali	2	15	15
haló	4	9	halo	2	220	229
handicapés	2	1	handicapes	2	0	1
harmalà	4	0	harmala	4	4	4
harmonitzarà	2	28	harmonitzara	2	0	28
harmonitzà	2	1	harmonitza	2	79	80
harmonitzàrem	2	0	harmonitzarem	2	10	10
harmonitzés	2	9	harmonitzes	2	0	9
harmonitzí	2	0	harmonitzi	2	69	69
hauré	2	519	haure	2	2	521
heptàedres	4	1	heptaedres	4	0	1
herboritzà	2	1	herboritza	2	0	1
heretarà	2	9	heretara	2	0	9
heretà	2	32	hereta	2	117	149
heretés	2	3	heretes	2	1	4
heretí	2	0	hereti	2	7	7
hernià	2	0	hernia	2	3	3
heterodinà	2	0	heterodina	2	1	1
hexàedre	4	4	hexaedre	4	1	5
hibernarà	2	1	hibernara	2	0	1
hibernà	2	1	hiberna	2	39	40
hiberní	2	0	hiberni	2	3	3
hibridarà	2	1	hibridara	2	0	1
hibridà	2	0	hibrida	2	15	15
hibridés	2	0	hibrides	2	1	1
hidratà	2	0	hidrata	2	1	1
hidrogenarà	2	1	hidrogenara	2	0	1
hidrogenà	2	0	hidrogena	2	2	2
hidrogèn	2	0	hidrogen	4	1855	1855
hidrolitzarà	2	1	hidrolitzara	2	0	1
hidrolitzà	2	0	hidrolitza	2	26	26
higienitzí	2	0	higienitzi	2	1	1
hipertrofià	2	0	hipertrofia	2	1	1
hipertròfia	4	23	hipertrofia	2	1	24
hipnotitzarà	2	1	hipnotitzara	2	0	1
hipnotitzà	2	1	hipnotitza	2	5	6
hipotecarà	2	1	hipotecara	2	0	1
hipotecà	2	0	hipoteca	4	148	148
hipotecària	0	32	hipotecaria	2	8	40
hipotecàries	0	16	hipotecaries	2	0	16
hipotequés	2	0	hipoteques	4	175	175
hipotequí	2	0	hipotequi	2	7	7
hipotetitzà	2	1	hipotetitza	2	1	2
hissà	2	6	hissa	2	10	16
hissés	2	1	hisses	2	0	1
hissí	2	0	hissi	2	9	9
historià	2	0	historia	2	345	345
historiés	2	0	histories	2	27	27
historií	2	0	historii	2	1	1
història	4	20756	historia	2	345	21101
històries	4	2646	histories	2	27	2673
hivernà	2	1	hiverna	2	20	21
holandès	0	730	holandes	4	4	734
holandés	0	9	holandes	4	4	13
holografià	2	0	holografia	4	5	5
homenatgés	2	1	homenatges	4	43	44
homenatjà	2	1	homenatja	2	7	8
homogeneïtzà	2	0	homogeneïtza	2	3	3
homogeneïtzí	2	0	homogeneïtzi	2	2	2
homologarà	2	1	homologara	2	0	1
homologués	2	0	homologues	2	1	1
homologuí	2	0	homologui	2	5	5
homologà	2	0	homologa	2	1	1
homòloga	0	47	homologa	2	1	48
homòlogues	0	66	homologues	2	1	67
honorà	2	8	honora	2	39	47
honoràrem	2	0	honorarem	2	1	1
honorària	0	42	honoraria	2	17	59
honoràries	0	3	honoraries	2	0	3
honorés	2	2	honores	2	2	4
honorí	2	0	honori	4	75	75
honorífic	0	202	honorific	2	3	205
honorífica	0	51	honorifica	2	0	51
honorífiques	0	10	honorifiques	2	0	10
honrarà	2	18	honrara	2	0	18
honrà	2	4	honra	4	244	248
honràrem	2	0	honrarem	2	8	8
honràreu	2	0	honrareu	2	1	1
honrés	2	1	honres	4	6	7
honrí	2	0	honri	2	11	11
hormonà	2	0	hormona	4	188	188
hormonés	2	0	hormones	4	619	619
horroritzà	2	2	horroritza	2	37	39
hospitalitzà	2	0	hospitalitza	2	2	2
hospitalitzés	2	1	hospitalitzes	2	0	1
hostatgés	2	0	hostatges	4	57	57
hostatjarà	2	1	hostatjara	2	0	1
hostatjà	2	7	hostatja	2	28	35
hostejà	2	0	hosteja	2	1	1
huitanta-quatrè	0	0	huitanta-quatre	3	1	1
huitanta-quatré	0	0	huitanta-quatre	3	1	1
humanitzarà	2	2	humanitzara	2	0	2
humanitzà	2	0	humanitza	2	3	3
humanitzés	2	0	humanitzes	2	1	1
humanitzí	2	0	humanitzi	2	1	1
humiliàrem	2	0	humiliarem	2	1	1
humiliés	2	1	humilies	2	0	1
humilií	2	1	humilii	2	0	1
humitegés	2	1	humiteges	2	0	1
humitegí	2	0	humitegi	2	1	1
humitejà	2	0	humiteja	2	4	4
hàbit	4	335	habit	2	8	343
hàbitat	4	946	habitat	2	255	1201
hàbitats	4	763	habitats	2	86	849
hàgem	2	2	hagem	2	6	8
hàgeu	2	17	hageu	2	24	41
hàndicap	4	24	handicap	2	25	49
hèrnia	4	36	hernia	2	3	39
hèrnies	4	12	hernies	2	0	12
híbrid	0	294	hibrid	2	2	296
híbrida	0	103	hibrida	2	15	118
híbrides	0	47	hibrides	2	1	48
iconificà	2	0	iconifica	2	7	7
icositetràedre	4	1	icositetraedre	4	0	1
icosàedre	4	27	icosaedre	4	22	49
icosàedres	4	1	icosaedres	4	1	2
idealitzà	2	0	idealitza	2	3	3
idearà	2	1	ideara	2	0	1
identificarà	2	36	identificara	2	2	38
identificà	2	65	identifica	2	910	975
identificàrem	2	0	identificarem	2	9	9
identifiqués	2	24	identifiques	2	3	27
identifiquí	2	0	identifiqui	2	128	128
ideologitzà	2	0	ideologitza	2	1	1
ideà	2	8	idea	4	16481	16489
ideàrem	2	0	idearem	2	2	2
ideés	2	2	idees	4	7311	7313
ideí	2	0	idei	2	3	3
idolatrarà	2	0	idolatrara	2	1	1
idolatrà	2	0	idolatra	2	5	5
idolatrés	2	0	idolatres	2	1	1
idòlatra	0	6	idolatra	2	5	11
idòlatres	0	7	idolatres	2	1	8
iessà	0	0	iessa	4	2	2
ignorarà	2	155	ignorara	2	0	155
ignorà	2	20	ignora	2	1263	1283
ignoràrem	2	0	ignorarem	2	2	2
ignorés	2	27	ignores	2	3	30
ignorí	2	0	ignori	2	135	135
ignífug	0	13	ignifug	2	0	13
ignífugues	0	15	ignifugues	2	0	15
igualarà	2	4	igualara	2	0	4
igualà	2	18	iguala	4	57	75
igualàrem	2	0	igualarem	2	1	1
igualés	2	1	iguales	4	3	4
igualí	2	0	iguali	2	8	8
il·legalitzarà	2	1	il·legalitzara	2	0	1
il·legalitzà	2	1	il·legalitza	2	6	7
il·legalitzés	2	1	il·legalitzes	2	0	1
il·legalitzí	2	0	il·legalitzi	2	2	2
il·luminarà	2	14	il·luminara	2	0	14
il·luminà	2	4	il·lumina	2	115	119
il·luminàreu	2	0	il·luminareu	2	1	1
il·luminés	2	4	il·lumines	2	2	6
il·luminí	2	0	il·lumini	2	17	17
il·lusionà	2	0	il·lusiona	2	5	5
il·lusionés	2	0	il·lusiones	2	1	1
il·lusioní	2	0	il·lusioni	2	1	1
il·lustrarà	2	13	il·lustrara	2	0	13
il·lustrà	2	17	il·lustra	2	671	688
il·lustrés	2	7	il·lustres	2	105	112
il·lustrí	2	0	il·lustri	2	7	7
imaginarà	2	1	imaginara	2	1	2
imaginà	2	4	imagina	2	212	216
imaginàreu	2	0	imaginareu	2	1	1
imaginària	0	144	imaginaria	2	9	153
imaginàries	0	48	imaginaries	2	5	53
imaginés	2	6	imagines	2	31	37
imaginí	2	0	imagini	2	71	71
imbricà	2	0	imbrica	2	2	2
imbècil	0	220	imbecil	0	0	220
imbècilment	6	1	imbecilment	6	0	1
imbècils	0	60	imbecils	0	0	60
imitarà	2	4	imitara	2	0	4
imità	2	2	imita	2	93	95
imitàrem	2	0	imitarem	2	1	1
imités	2	6	imites	2	0	6
imití	2	0	imiti	2	7	7
immigrà	2	1	immigra	2	0	1
immiscirà	2	3	immiscira	2	0	3
immiscírem	2	0	immiscirem	2	2	2
immobilitzarà	2	1	immobilitzara	2	0	1
immobilitzà	2	1	immobilitza	2	6	7
immobilitzàrem	2	0	immobilitzarem	2	1	1
immobilitzés	2	1	immobilitzes	2	1	2
immolarà	2	0	immolara	2	2	2
immolà	2	2	immola	2	0	2
immortalitzà	2	0	immortalitza	2	2	2
immortalitzí	2	0	immortalitzi	2	1	1
immunitzà	2	0	immunitza	2	1	1
immutà	2	0	immuta	2	3	3
immutés	2	0	immutes	2	2	2
impacientà	2	0	impacienta	2	3	3
impacientés	2	1	impacientes	2	0	1
impacientí	2	0	impacienti	2	2	2
impactarà	2	12	impactara	2	0	12
impactà	2	23	impacta	2	29	52
impactàrem	2	0	impactarem	2	1	1
impactés	2	6	impactes	2	717	723
impactí	2	0	impacti	2	6	6
impartirà	2	13	impartira	2	0	13
impartírem	2	0	impartirem	2	2	2
impedirà	2	268	impedira	2	1	269
impedírem	2	0	impedirem	2	23	23
impedíreu	2	0	impedireu	2	4	4
imperarà	2	4	imperara	2	0	4
impermeabilitzí	2	0	impermeabilitzi	2	2	2
imperà	2	0	impera	2	126	126
imperés	2	3	imperes	2	0	3
imperí	2	0	imperi	2	7452	7452
implantarà	2	22	implantara	2	0	22
implantà	2	2	implanta	2	34	36
implantàrem	2	0	implantarem	2	4	4
implantés	2	11	implantes	2	0	11
implantí	2	0	implanti	2	63	63
implementarà	2	22	implementara	2	0	22
implementà	2	19	implementa	2	399	418
implementàrem	2	0	implementarem	2	3	3
implementés	2	29	implementes	2	0	29
implementí	2	0	implementi	2	46	46
implicarà	2	389	implicara	2	0	389
implicà	2	25	implica	2	5773	5798
implicàrem	2	0	implicarem	2	8	8
impliqués	2	57	impliques	2	2	59
impliquí	2	0	impliqui	2	504	504
implorà	2	3	implora	2	22	25
implorí	2	0	implori	2	1	1
importarà	2	127	importara	2	0	127
importunà	2	0	importuna	2	6	6
importuní	2	0	importuni	2	2	2
importà	2	4	importa	2	4010	4014
importàrem	2	0	importarem	2	10	10
importàreu	2	0	importareu	2	2	2
importés	2	41	importes	2	16	57
importí	2	0	importi	2	134	134
imposarà	2	164	imposara	2	0	164
impossibilitarà	2	6	impossibilitara	2	0	6
impossibilità	2	1	impossibilita	2	49	50
impossibilités	2	2	impossibilites	2	0	2
impossibilití	2	0	impossibiliti	2	8	8
impostà	2	0	imposta	4	11	11
impostés	2	0	impostes	4	12	12
imposà	2	54	imposa	2	1579	1633
imposàrem	2	0	imposarem	2	17	17
imposés	2	60	imposes	2	1	61
imposí	2	0	imposi	2	400	400
impregnarà	2	3	impregnara	2	0	3
impregnà	2	3	impregna	2	61	64
impregnés	2	2	impregnes	2	0	2
impregní	2	0	impregni	2	10	10
impremtà	2	0	impremta	4	281	281
impremtés	2	0	impremtes	4	52	52
impressionarà	2	11	impressionara	2	1	12
impressionà	2	13	impressiona	2	73	86
impressionés	2	1	impressiones	2	1	2
impressioní	2	0	impressioni	2	3	3
imprimirà	2	103	imprimira	2	1	104
imprimíreu	2	0	imprimireu	2	1	1
improvisà	2	4	improvisa	2	19	23
improvisàrem	2	0	improvisarem	2	1	1
improvisés	2	2	improvises	2	1	3
improvés	2	0	improves	2	1	1
improvís	2	33	improvis	2	0	33
impugnarà	2	2	impugnara	2	0	2
impugnà	2	2	impugna	2	15	17
impugnés	2	3	impugnes	2	0	3
impugní	2	0	impugni	2	5	5
impulsarà	2	143	impulsara	2	0	143
impulsà	2	29	impulsa	2	283	312
impulsàrem	2	0	impulsarem	2	21	21
impulsés	2	18	impulses	2	0	18
impulsí	2	0	impulsi	2	187	187
imputarà	2	2	imputara	2	0	2
imputà	2	0	imputa	2	14	14
imputàrem	2	0	imputarem	2	1	1
imputés	2	1	imputes	2	0	1
imputí	2	0	imputi	2	7	7
inactivarà	2	1	inactivara	2	0	1
inactivà	2	0	inactiva	0	241	241
inactivàreu	2	0	inactivareu	2	1	1
inactivés	2	0	inactives	0	137	137
inactiví	2	0	inactivi	2	1	1
inaugurarà	2	30	inaugurara	2	0	30
inaugurà	2	63	inaugura	2	55	118
inauguràrem	2	0	inaugurarem	2	6	6
inaugurés	2	4	inaugures	2	0	4
inaugurí	2	0	inauguri	2	20	20
incapacitarà	2	1	incapacitara	2	0	1
incapacità	2	1	incapacita	2	4	5
incapacití	2	0	incapaciti	2	1	1
incardinà	2	0	incardina	2	5	5
incautà	2	0	incauta	0	2	2
incautés	2	0	incautes	0	1	1
incendiarà	2	1	incendiara	2	0	1
incendià	2	6	incendia	2	22	28
incendiària	0	23	incendiaria	2	1	24
incendiàries	0	44	incendiaries	2	0	44
incendiés	2	3	incendies	2	1	4
incentivarà	2	12	incentivara	2	0	12
incentivà	2	2	incentiva	2	37	39
incentivàrem	2	0	incentivarem	2	3	3
incentivés	2	1	incentives	2	3	4
incentiví	2	0	incentivi	2	24	24
incidirà	2	16	incidira	2	0	16
incinerà	2	0	incinera	2	7	7
incinerés	2	1	incineres	2	0	1
incinerí	2	0	incineri	2	2	2
incitarà	2	13	incitara	2	0	13
incità	2	10	incita	2	124	134
incitàrem	2	0	incitarem	2	2	2
incités	2	7	incites	2	0	7
incití	2	0	inciti	2	34	34
inclinarà	2	14	inclinara	2	0	14
inclinà	2	15	inclina	2	235	250
inclinàrem	2	0	inclinarem	2	1	1
inclinés	2	12	inclines	2	0	12
incliní	2	0	inclini	2	34	34
inclogués	2	374	inclogues	2	0	374
incloguí	2	1	inclogui	2	2081	2082
inclouré	2	11	incloure	2	10868	10879
incoarà	2	3	incoara	2	0	3
incomodarà	2	1	incomodara	2	0	1
incomodà	2	0	incomoda	2	30	30
incomodés	2	1	incomodes	2	1	2
incomodí	2	0	incomodi	2	5	5
incomplirà	2	6	incomplira	2	1	7
incomplírem	2	0	incomplirem	2	3	3
incomuniqués	2	1	incomuniques	2	0	1
incomuniquí	2	0	incomuniqui	2	1	1
incorporarà	2	103	incorporara	2	1	104
incorporà	2	91	incorpora	2	824	915
incorporàrem	2	0	incorporarem	2	19	19
incorporés	2	49	incorpores	2	0	49
incorporí	2	0	incorpori	2	304	304
incoà	2	1	incoa	2	5	6
incoàrem	2	0	incoarem	2	1	1
incoés	2	8	incoes	2	0	8
incrementarà	2	291	incrementara	2	1	292
incrementà	2	72	incrementa	2	752	824
incrementàrem	2	0	incrementarem	2	13	13
incrementàreu	2	0	incrementareu	2	1	1
incrementés	2	34	incrementes	2	1	35
incrementí	2	0	incrementi	2	229	229
increpà	2	0	increpa	2	3	3
incriminà	2	0	incrimina	2	6	6
incriminés	2	1	incrimines	2	0	1
incriminí	2	0	incrimini	2	4	4
incrustarà	2	10	incrustara	2	0	10
incrustà	2	0	incrusta	2	136	136
incrustàrem	2	0	incrustarem	2	1	1
incrustí	2	0	incrusti	2	1	1
incubarà	2	1	incubara	2	0	1
incubà	2	0	incuba	2	11	11
incubí	2	0	incubi	2	2	2
inculcarà	2	0	inculcara	2	1	1
inculcà	2	1	inculca	2	14	15
inculpà	2	1	inculpa	2	4	5
incumbirà	2	11	incumbira	2	0	11
incòmoda	0	200	incomoda	2	30	230
incòmode	0	268	incomode	2	0	268
incòmodes	0	174	incomodes	2	1	175
indagarà	2	3	indagara	2	0	3
indagués	2	2	indagues	2	0	2
indaguí	2	0	indagui	2	5	5
indagà	2	0	indaga	2	12	12
indagàrem	2	0	indagarem	2	1	1
indemnitzarà	2	9	indemnitzara	2	0	9
indemnitzà	2	0	indemnitza	2	6	6
indemnitzés	2	2	indemnitzes	2	0	2
indemnitzí	2	0	indemnitzi	2	14	14
independitzà	2	11	independitza	2	14	25
independitzàrem	2	0	independitzarem	2	1	1
independitzés	2	11	independitzes	2	0	11
independitzí	2	0	independitzi	2	3	3
indexarà	2	3	indexara	2	0	3
indexà	2	0	indexa	2	51	51
indexés	2	0	indexes	2	5	5
indexí	2	0	indexi	2	5	5
indicarà	2	166	indicara	2	0	166
indiciàries	0	1	indiciaries	2	0	1
indiciés	2	0	indicies	2	1	1
indicà	2	44	indica	2	5636	5680
indicàrem	2	0	indicarem	2	9	9
indicàreu	2	0	indicareu	2	4	4
indigestà	2	0	indigesta	0	6	6
indigestés	2	0	indigestes	0	1	1
indignà	2	1	indigna	2	97	98
indignés	2	0	indignes	2	74	74
indigní	2	0	indigni	2	1	1
indiqués	2	81	indiques	2	1	82
indiquí	2	0	indiqui	2	631	631
indisciplinà	2	0	indisciplina	4	14	14
individualitzà	2	0	individualitza	2	1	1
individualitzí	2	0	individualitzi	2	1	1
individuà	2	0	individua	2	1	1
indivídua	0	0	individua	2	1	1
indulgencià	2	0	indulgencia	2	1	1
indulgència	4	165	indulgencia	2	1	166
indulgències	4	28	indulgencies	2	0	28
indultà	2	1	indulta	2	3	4
indultés	2	3	indultes	2	0	3
indultí	2	0	indulti	2	1	1
industrialitzí	2	0	industrialitzi	2	1	1
industrià	2	0	industria	2	42	42
industriés	2	0	industries	2	107	107
induírem	2	0	induirem	2	1	1
indústria	4	17716	industria	2	42	17758
indústries	4	2874	industries	2	107	2981
infamés	2	0	infames	2	55	55
infantilitzà	2	0	infantilitza	2	4	4
infantà	2	3	infanta	4	35	38
infantés	2	0	infantes	4	4	4
infeccionés	2	0	infecciones	2	5	5
infectarà	2	1	infectara	2	0	1
infectà	2	0	infecta	2	50	50
infectés	2	4	infectes	2	4	8
infectí	2	0	infecti	2	11	11
infestà	2	0	infesta	0	10	10
infeudà	2	2	infeuda	2	0	2
infiltrarà	2	1	infiltrara	2	1	2
infiltrà	2	3	infiltra	2	15	18
infiltràrem	2	0	infiltrarem	2	2	2
infiltrí	2	0	infiltri	2	7	7
infirmí	2	0	infirmi	2	1	1
inflamarà	2	3	inflamara	2	0	3
inflamà	2	2	inflama	2	9	11
inflamí	2	0	inflami	2	3	3
inflarà	2	4	inflara	2	0	4
infligirà	2	0	infligira	2	1	1
influenciarà	2	2	influenciara	2	0	2
influencià	2	21	influencia	2	52	73
influenciés	2	3	influencies	2	1	4
influencií	2	0	influencii	2	1	1
influència	4	7578	influencia	2	52	7630
influències	4	930	influencies	2	1	931
influírem	2	0	influirem	2	2	2
inflà	2	0	infla	2	28	28
inflés	2	1	infles	2	0	1
inflí	2	0	infli	2	6	6
infondré	2	0	infondre	2	194	194
infonguí	2	0	infongui	2	19	19
informarà	2	355	informara	2	1	356
informà	2	228	informa	2	1070	1298
informàrem	2	0	informarem	2	72	72
informàreu	2	0	informareu	2	1	1
informés	2	465	informes	2	12239	12704
informí	2	0	informi	2	441	441
infradiagnòstic	4	1	infradiagnostic	2	0	1
inframón	4	77	inframon	4	8	85
infrautilitzà	2	0	infrautilitza	2	3	3
infravalorarà	2	1	infravalorara	2	0	1
infravalorà	2	1	infravalora	2	26	27
infravalorés	2	0	infravalores	2	1	1
infravalorí	2	0	infravalori	2	2	2
infringirà	2	9	infringira	2	0	9
ingerirà	2	1	ingerira	2	0	1
ingerírem	2	0	ingerirem	2	2	2
ingressarà	2	12	ingressara	2	1	13
ingressà	2	179	ingressa	2	55	234
ingressés	2	27	ingresses	2	0	27
ingressí	2	0	ingressi	2	48	48
inhabilitarà	2	47	inhabilitara	2	0	47
inhabilità	2	0	inhabilita	2	646	646
inhabilití	2	0	inhabiliti	2	7	7
inhalà	2	0	inhala	2	16	16
inhalí	2	0	inhali	2	3	3
inhibirà	2	4	inhibira	2	0	4
inhumà	2	271	inhuma	2	1	272
inicialitzarà	2	11	inicialitzara	2	0	11
inicialitzà	2	0	inicialitza	2	89	89
inicialitzí	2	0	inicialitzi	2	4	4
iniciarà	2	444	iniciara	2	1	445
inicià	2	450	inicia	2	2172	2622
iniciàrem	2	0	iniciarem	2	87	87
iniciàreu	2	0	iniciareu	2	4	4
iniciés	2	132	inicies	2	15	147
inicií	2	1	inicii	2	5	6
injectarà	2	7	injectara	2	0	7
injectà	2	0	injecta	2	46	46
injectàrem	2	0	injectarem	2	1	1
injectés	2	0	injectes	2	1	1
injectí	2	0	injecti	2	8	8
injurià	2	0	injuria	2	2	2
injúria	4	20	injuria	2	2	22
injúries	4	23	injuries	2	0	23
innervà	2	0	innerva	2	8	8
innovarà	2	2	innovara	2	0	2
innovà	2	0	innova	2	8	8
innovàrem	2	0	innovarem	2	1	1
innoví	2	0	innovi	2	5	5
inoculà	2	1	inocula	2	1	2
inoculí	2	0	inoculi	2	2	2
inquietarà	2	1	inquietara	2	0	1
inquietà	2	1	inquieta	0	204	205
inquietés	2	1	inquietes	0	17	18
inquietí	2	0	inquieti	2	3	3
inscrigués	2	1	inscrigues	2	0	1
inscriguí	2	0	inscrigui	2	47	47
inscriuré	2	0	inscriure	2	592	592
inseminarà	2	1	inseminara	2	0	1
inseminà	2	0	insemina	2	2	2
inserirà	2	139	inserira	2	2	141
inserírem	2	0	inserirem	2	2	2
inseríreu	2	0	inserireu	2	5	5
insinuà	2	2	insinua	2	51	53
insinués	2	0	insinues	2	2	2
insistirà	2	67	insistira	2	0	67
insistírem	2	0	insistirem	2	88	88
inspeccionarà	2	4	inspeccionara	2	0	4
inspeccionà	2	2	inspecciona	2	51	53
inspeccionàrem	2	0	inspeccionarem	2	1	1
inspeccionés	2	4	inspecciones	2	0	4
inspeccioní	2	0	inspeccioni	2	14	14
inspirarà	2	23	inspirara	2	0	23
inspirà	2	63	inspira	2	403	466
inspiràrem	2	0	inspirarem	2	4	4
inspirés	2	7	inspires	2	2	9
inspirí	2	0	inspiri	2	106	106
instal·larà	2	119	instal·lara	2	1	120
instal·là	2	88	instal·la	2	869	957
instal·làrem	2	0	instal·larem	2	6	6
instal·làreu	2	0	instal·lareu	2	1	1
instal·lés	2	23	instal·les	2	26	49
instal·lí	2	0	instal·li	2	75	75
instancià	2	0	instancia	2	16	16
instanciés	2	0	instancies	2	5	5
instarà	2	40	instara	2	1	41
instaurarà	2	17	instaurara	2	0	17
instaurà	2	7	instaura	2	44	51
instauràrem	2	0	instaurarem	2	2	2
instaurés	2	11	instaures	2	0	11
instaurí	2	0	instauri	2	68	68
instigarà	2	1	instigara	2	0	1
instigués	2	1	instigues	2	0	1
instiguí	2	0	instigui	2	3	3
instigà	2	8	instiga	2	9	17
instil·lí	2	0	instil·li	2	1	1
institucionalitzarà	2	5	institucionalitzara	2	0	5
institucionalitzà	2	1	institucionalitza	2	13	14
institucionalitzés	2	3	institucionalitzes	2	0	3
institucionalitzí	2	0	institucionalitzi	2	9	9
instituírem	2	0	instituirem	2	2	2
instrumentalitzà	2	0	instrumentalitza	2	2	2
instrumentalitzí	2	0	instrumentalitzi	2	3	3
instrumentà	2	0	instrumenta	2	1	1
instrumentés	2	0	instrumentes	2	1	1
instrumentí	2	0	instrumenti	2	1	1
instruírem	2	0	instruirem	2	1	1
instà	2	16	insta	2	1029	1045
instància	4	3423	instancia	2	16	3439
instàncies	4	1175	instancies	2	5	1180
instàrem	2	0	instarem	2	14	14
instés	2	18	instes	2	0	18
instí	2	0	insti	2	126	126
insuflarà	2	1	insuflara	2	0	1
insuflà	2	0	insufla	2	4	4
insuflí	2	0	insufli	2	4	4
insultà	2	0	insulta	2	47	47
insultés	2	1	insultes	2	3	4
insultí	2	0	insulti	2	10	10
insídia	4	2	insidia	2	0	2
insídies	4	2	insidies	2	0	2
integrarà	2	57	integrara	2	0	57
integrà	2	30	integra	2	385	415
integràrem	2	0	integrarem	2	11	11
integrés	2	30	integres	2	0	30
integrí	2	0	integri	2	234	234
intensificarà	2	93	intensificara	2	0	93
intensificà	2	21	intensifica	2	96	117
intensificàrem	2	0	intensificarem	2	15	15
intensifiqués	2	18	intensifiques	2	0	18
intensifiquí	2	0	intensifiqui	2	139	139
intentarà	2	495	intentara	2	4	499
intentà	2	335	intenta	2	3237	3572
intentàrem	2	3	intentarem	2	395	398
intentàreu	2	0	intentareu	2	3	3
intentés	2	151	intentes	2	116	267
intentí	2	0	intenti	2	577	577
interaccionarà	2	1	interaccionara	2	0	1
interaccionà	2	1	interacciona	2	100	101
interaccionés	2	0	interacciones	2	1	1
interaccioní	2	0	interaccioni	2	6	6
interactuarà	2	6	interactuara	2	1	7
interactuà	2	0	interactua	2	76	76
interactuàrem	2	0	interactuarem	2	2	2
interactuàreu	2	0	interactuareu	2	1	1
interactués	2	1	interactues	2	2	3
intercalarà	2	1	intercalara	2	0	1
intercalà	2	0	intercala	2	14	14
intercanviarà	2	8	intercanviara	2	0	8
intercanvià	2	6	intercanvia	2	195	201
intercanviàrem	2	0	intercanviarem	2	5	5
intercanviés	2	2	intercanvies	2	0	2
intercedirà	2	0	intercedira	2	1	1
interceptà	2	8	intercepta	2	20	28
interceptés	2	3	interceptes	2	0	3
interceptí	2	0	intercepti	2	1	1
interconnectarà	2	2	interconnectara	2	0	2
interconnectà	2	0	interconnecta	2	3	3
interconnectí	2	0	interconnecti	2	2	2
interessarà	2	54	interessara	2	0	54
interessà	2	42	interessa	2	1885	1927
interessàrem	2	0	interessarem	2	2	2
interessés	2	30	interesses	2	8	38
interessí	2	0	interessi	2	117	117
interferirà	2	20	interferira	2	0	20
interferírem	2	0	interferirem	2	3	3
interioritzà	2	0	interioritza	2	2	2
interioritzí	2	0	interioritzi	2	2	2
intermedià	2	0	intermedia	2	22	22
intermediària	0	33	intermediaria	2	0	33
intermediàries	0	34	intermediaries	2	1	35
intermediés	2	0	intermedies	2	1	1
intermèdia	0	1548	intermedia	2	22	1570
intermèdies	0	273	intermedies	2	1	274
internacionalitzarà	2	1	internacionalitzara	2	0	1
internacionalitzà	2	0	internacionalitza	2	4	4
internacionalitzí	2	0	internacionalitzi	2	1	1
internalitzà	2	0	internalitza	2	5	5
internalitzí	2	0	internalitzi	2	1	1
internarà	2	2	internara	2	0	2
internà	2	2	interna	0	3492	3494
internés	2	0	internes	0	1950	1950
interní	2	0	interni	2	6	6
interpel·là	2	0	interpel·la	2	17	17
interpel·lí	2	0	interpel·li	2	3	3
interpolarà	2	2	interpolara	2	0	2
interpolà	2	0	interpola	2	33	33
interposarà	2	7	interposara	2	0	7
interposà	2	3	interposa	2	33	36
interposés	2	10	interposes	2	1	11
interposí	2	0	interposi	2	30	30
interpretarà	2	55	interpretara	2	2	57
interpretà	2	101	interpreta	2	677	778
interpretàrem	2	0	interpretarem	2	8	8
interpretés	2	31	interpretes	2	3	34
interpretí	2	0	interpreti	2	92	92
interrelacionà	2	0	interrelaciona	2	5	5
interrogarà	2	4	interrogara	2	0	4
interrogués	2	0	interrogues	2	1	1
interroguí	2	0	interrogui	2	4	4
interrogà	2	4	interroga	2	25	29
interrogàrem	2	0	interrogarem	2	3	3
interrompré	2	10	interrompre	2	854	864
interrompés	2	20	interrompes	2	1	21
interrompí	2	0	interrompi	2	103	103
intersecarà	2	1	intersecara	2	0	1
intersecà	2	0	interseca	2	82	82
intersequí	2	0	intersequi	2	3	3
intervindré	2	75	intervindre	2	3	78
intervingués	2	90	intervingues	2	0	90
intervinguí	2	0	intervingui	2	446	446
intimidà	2	1	intimida	2	19	20
intimidés	2	2	intimides	2	0	2
intimidí	2	0	intimidi	2	7	7
intimà	2	1	intima	4	2	3
intimés	2	1	intimes	4	5	6
intitulà	2	3	intitula	2	0	3
intoxicà	2	0	intoxica	2	4	4
intranquil·litzà	2	0	intranquil·litza	2	6	6
intrigarà	2	1	intrigara	2	0	1
intrigués	2	0	intrigues	4	103	103
intrigà	2	0	intriga	4	102	102
introduírem	2	1	introduirem	2	63	64
introduíreu	2	0	introduireu	2	12	12
intèrpret	4	923	interpret	2	9	932
inundarà	2	13	inundara	2	0	13
inundà	2	7	inunda	2	30	37
inundés	2	5	inundes	2	0	5
inundí	2	0	inundi	2	7	7
inutilitzarà	2	2	inutilitzara	2	0	2
inutilitzà	2	1	inutilitza	2	5	6
invaginà	2	0	invagina	2	2	2
invaginí	2	0	invagini	2	1	1
invalidarà	2	7	invalidara	2	0	7
invalidà	2	2	invalida	2	75	77
invalidàreu	2	0	invalidareu	2	1	1
invalidés	2	3	invalides	2	4	7
invalidí	2	0	invalidi	2	7	7
invectivà	2	0	invectiva	4	5	5
invectivés	2	0	invectives	4	12	12
inventarià	2	0	inventaria	2	4	4
inventarà	2	6	inventara	2	0	6
inventà	2	56	inventa	2	55	111
inventàrem	2	0	inventarem	2	3	3
inventés	2	11	inventes	2	3	14
inventí	2	0	inventi	2	13	13
invertirà	2	61	invertira	2	0	61
invertírem	2	0	invertirem	2	19	19
invertíreu	2	0	invertireu	2	1	1
investigarà	2	49	investigara	2	2	51
investigués	2	72	investigues	2	2	74
investiguí	2	0	investigui	2	290	290
investigà	2	45	investiga	2	191	236
investigàrem	2	0	investigarem	2	37	37
investirà	2	1	investira	2	0	1
investírem	2	0	investirem	2	1	1
invitarà	2	1	invitara	2	0	1
invità	2	8	invita	2	22	30
invités	2	2	invites	2	3	5
invití	2	0	inviti	2	1	1
invocarà	2	18	invocara	2	0	18
invocà	2	3	invoca	2	205	208
invocàrem	2	0	invocarem	2	2	2
involucionà	2	0	involuciona	2	1	1
involucrarà	2	23	involucrara	2	0	23
involucrà	2	30	involucra	2	168	198
involucràrem	2	0	involucrarem	2	4	4
involucrés	2	16	involucres	2	2	18
involucrí	2	0	involucri	2	91	91
invoqués	2	6	invoques	2	1	7
invoquí	2	0	invoqui	2	136	136
invàlid	0	383	invalid	2	7	390
invàlida	0	204	invalida	2	75	279
invàlides	0	67	invalides	2	4	71
inòcul	4	7	inocul	2	0	7
iodà	2	0	ioda	2	1	1
iodí	2	0	iodi	2	1	1
ionitzà	2	0	ionitza	2	13	13
ionitzí	2	0	ionitzi	2	2	2
irisí	2	0	irisi	2	1	1
ironitzà	2	1	ironitza	2	3	4
irradiarà	2	2	irradiara	2	0	2
irradià	2	0	irradia	2	50	50
irrigà	2	0	irriga	2	3	3
irrità	2	4	irrita	2	52	56
irritàrem	2	0	irritarem	2	1	1
irrití	2	0	irriti	2	5	5
irrompré	2	0	irrompre	2	114	114
irrompés	2	3	irrompes	2	0	3
irrompí	2	0	irrompi	2	2	2
irà	2	1	ira	4	849	850
iré	2	0	ire	2	12	12
irés	2	0	ires	4	15	15
irí	2	0	iri	2	17	17
irís	2	0	iris	2	232	232
islamitzés	2	1	islamitzes	2	0	1
isolà	2	0	isola	2	16	16
isolés	2	7	isoles	2	0	7
isomeritzà	2	0	isomeritza	2	2	2
isqués	2	0	isques	2	1	1
isquí	2	0	isqui	4	5	5
italianitzés	2	1	italianitzes	2	0	1
iterà	2	0	itera	2	10	10
iterí	2	0	iteri	2	1	1
jacobí	0	18	jacobi	4	76	94
jactà	2	0	jacta	2	3	3
jamaicà	0	66	jamaica	4	423	489
jaquès	0	0	jaques	4	12	12
jaqués	0	0	jaques	4	12	12
jaumetà	2	0	jaumeta	2	1	1
jauré	2	1	jaure	2	2	3
jerarquitzà	2	0	jerarquitza	2	1	1
jerarquitzí	2	0	jerarquitzi	2	2	2
joguinegí	2	0	joguinegi	2	1	1
jovençà	0	1	jovença	4	0	1
jubilarà	2	6	jubilara	2	0	6
jubilà	2	5	jubila	2	10	15
jubilés	2	3	jubiles	2	1	4
jubilí	2	0	jubili	2	7	7
jugarà	2	84	jugara	2	0	84
jugués	2	45	jugues	2	55	100
juguí	2	0	jugui	2	88	88
jugà	2	321	juga	2	1619	1940
jugàrem	2	0	jugarem	2	18	18
jugàreu	2	0	jugareu	2	1	1
juncosà	0	0	juncosa	4	4	4
junyí	2	0	junyi	2	1	1
jurà	2	13	jura	4	98	111
juràreu	2	1	jurareu	2	2	3
jurés	2	4	jures	4	17	21
jurí	2	0	juri	2	26	26
justificarà	2	20	justificara	2	0	20
justificà	2	9	justifica	2	995	1004
justificàrem	2	0	justificarem	2	1	1
justifiqués	2	20	justifiques	2	1	21
justifiquí	2	0	justifiqui	2	225	225
justà	2	0	justa	4	2596	2596
justés	2	0	justes	4	987	987
jutgés	2	14	jutges	4	1305	1319
jutgí	2	0	jutgi	2	86	86
jutjarà	2	117	jutjara	2	0	117
jutjà	2	7	jutja	2	138	145
jutjàrem	2	0	jutjarem	2	53	53
juxtaposà	2	0	juxtaposa	2	10	10
jòquer	4	58	joquer	4	2	60
jócs	4	1	jocs	4	6577	6578
júnior	0	260	junior	0	381	641
júniors	0	7	juniors	0	59	66
júnyer	2	0	junyer	4	3	3
kenyà	0	19	kenya	4	960	979
laborà	2	0	labora	2	6	6
laboràrem	2	0	laborarem	2	1	1
laborés	2	0	labores	2	1	1
laborí	2	0	labori	2	3	3
lacrà	2	0	lacra	2	1	1
lacrés	2	0	lacres	2	1	1
lactà	2	0	lacta	2	1	1
lactí	2	0	lacti	2	342	342
lacà	2	0	laca	4	57	57
lamentarà	2	19	lamentara	2	0	19
lamentà	2	15	lamenta	2	569	584
lamentàrem	2	0	lamentarem	2	20	20
lamentés	2	8	lamentes	2	2	10
lamentí	2	0	lamenti	2	33	33
laminà	2	0	lamina	2	13	13
laminària	4	0	laminaria	2	14	14
laminàries	4	1	laminaries	2	0	1
laminés	2	0	lamines	2	9	9
lamés	4	0	lames	4	27	27
lapidà	2	0	lapida	2	2	2
lapidària	0	2	lapidaria	2	1	3
lapidàries	0	3	lapidaries	2	0	3
lapidí	2	0	lapidi	2	1	1
laqués	2	0	laques	4	12	12
lasarà	2	0	lasara	2	1	1
lasqués	2	0	lasques	2	1	1
lassà	2	0	lassa	0	11	11
lassí	2	0	lassi	2	2	2
lasà	2	0	lasa	2	19	19
lasí	2	0	lasi	2	1	1
laudà	2	0	lauda	4	20	20
laudés	2	0	laudes	4	8	8
laxà	2	0	laxa	0	76	76
laxés	2	0	laxes	0	35	35
legalitzarà	2	3	legalitzara	2	0	3
legalitzà	2	6	legalitza	2	38	44
legalitzés	2	3	legalitzes	2	0	3
legalitzí	2	0	legalitzi	2	13	13
legislarà	2	9	legislara	2	0	9
legislà	2	5	legisla	2	45	50
legislàrem	2	0	legislarem	2	3	3
legislés	2	11	legisles	2	0	11
legislí	2	0	legisli	2	55	55
legitimarà	2	11	legitimara	2	0	11
legitimà	2	4	legitima	2	79	83
legitimàrem	2	0	legitimarem	2	2	2
legitimària	4	0	legitimaria	2	9	9
legitimés	2	2	legitimes	2	2	4
legitimí	2	0	legitimi	2	16	16
legítim	0	1203	legitim	2	3	1206
legítima	0	883	legitima	2	79	962
legítimes	0	728	legitimes	2	2	730
lesionarà	2	3	lesionara	2	0	3
lesionà	2	8	lesiona	2	29	37
lesionés	2	1	lesiones	2	4	5
lesioní	2	0	lesioni	2	3	3
levità	2	0	levita	0	7	7
levités	2	0	levites	0	6	6
liberalitzarà	2	17	liberalitzara	2	0	17
liberalitzà	2	1	liberalitza	2	27	28
liberalitzàrem	2	0	liberalitzarem	2	5	5
liberalitzés	2	4	liberalitzes	2	0	4
liberalitzí	2	0	liberalitzi	2	19	19
libà	2	0	liba	2	1	1
libí	2	0	libi	2	162	162
licità	2	1	licita	2	0	1
liderarà	2	17	liderara	2	2	19
liderà	2	48	lidera	2	104	152
lideràrem	2	0	liderarem	2	4	4
liderés	2	10	lideres	2	3	13
liderí	2	0	lideri	2	50	50
lidià	2	0	lidia	2	19	19
lilà	4	5	lila	4	135	140
limitarà	2	192	limitara	2	0	192
limità	2	16	limita	2	2566	2582
limitàrem	2	0	limitarem	2	43	43
limitàreu	2	0	limitareu	2	1	1
limités	2	64	limites	2	6	70
limití	2	0	limiti	2	491	491
linealitzà	2	0	linealitza	2	3	3
linxà	2	0	linxa	2	1	1
linxés	2	1	linxes	2	0	1
linxí	2	0	linxi	2	1	1
liquidarà	2	5	liquidara	2	0	5
liquidà	2	1	liquida	2	12	13
liquidàrem	2	0	liquidarem	2	1	1
liquidés	2	3	liquides	2	0	3
liquidí	2	0	liquidi	2	5	5
liquà	2	1	liqua	2	7	8
lisà	2	0	lisa	2	319	319
lisí	2	0	lisi	2	116	116
litigà	2	0	litiga	2	1	1
litografià	2	0	litografia	4	65	65
litografiés	2	0	litografies	4	50	50
lixivià	2	0	lixivia	2	1	1
llacés	2	0	llaces	2	1	1
lladrà	2	0	lladra	2	11	11
lladrés	2	0	lladres	2	312	312
llagués	2	0	llagues	4	2	2
llagà	2	0	llaga	4	2	2
llambregà	2	0	llambrega	4	1	1
llambrejà	2	0	llambreja	2	1	1
llamparà	2	0	llampara	2	2	2
llampegà	2	0	llampega	2	2	2
llampugués	2	0	llampugues	4	1	1
llampugà	2	0	llampuga	4	4	4
llampà	2	0	llampa	2	1	1
llampí	2	1	llampi	2	0	1
llampó	4	0	llampo	2	1	1
llancés	2	65	llances	4	168	233
llancí	2	0	llanci	2	142	142
llandà	2	0	llanda	4	17	17
llandés	2	0	llandes	4	14	14
llanguirà	2	1	llanguira	2	1	2
llançarà	2	126	llançara	2	1	127
llançàrem	2	0	llançarem	2	44	44
llançàreu	2	0	llançareu	2	2	2
llastimà	2	0	llastima	2	2	2
llastimés	2	0	llastimes	2	2	2
llastrà	2	0	llastra	2	15	15
llastrés	2	0	llastres	2	1	1
llastà	2	0	llasta	2	1	1
llatinitzà	2	1	llatinitza	2	0	1
llatà	2	0	llata	4	6	6
llatés	2	0	llates	4	1	1
llatí	2	2542	llati	2	4	2546
llaunà	2	0	llauna	4	151	151
llaunés	2	0	llaunes	4	144	144
llaurarà	2	2	llaurara	2	0	2
llaurà	2	3	llaura	4	24	27
llaurés	2	0	llaures	4	66	66
llavorà	2	0	llavora	4	2	2
llavorés	2	0	llavores	4	5	5
llavà	2	0	llava	2	2	2
llavés	2	0	llaves	2	2	2
llaví	2	1	llavi	2	86	87
llaçà	2	0	llaça	2	4	4
llegarà	2	1	llegara	2	0	1
llegirà	2	65	llegira	2	1	66
llegué	2	0	llegue	2	1	1
llegués	2	0	llegues	0	3	3
llegà	2	5	llega	0	39	44
llegàrem	2	0	llegarem	2	6	6
llegírem	2	1	llegirem	2	14	15
llegíreu	2	0	llegireu	2	5	5
lleixés	2	0	lleixes	4	10	10
llencés	2	6	llences	4	10	16
llencí	2	0	llenci	2	12	12
llenegà	2	0	llenega	4	3	3
llengotejà	2	0	llengoteja	2	1	1
llenyà	2	0	llenya	4	236	236
llenyés	2	0	llenyes	4	2	2
llençarà	2	5	llençara	2	0	5
llençà	2	22	llença	4	124	146
llençàrem	2	0	llençarem	2	2	2
llençàreu	2	0	llençareu	2	1	1
lleonès	0	5	lleones	4	19	24
lleonés	0	0	lleones	4	19	19
llepà	2	0	llepa	4	25	25
llepés	2	2	llepes	4	3	5
llepí	2	0	llepi	2	1	1
llepó	0	0	llepo	2	3	3
llescà	2	0	llesca	4	32	32
llesqués	2	0	llesques	4	38	38
lletregí	2	0	lletregi	2	1	1
lletrejà	2	0	lletreja	2	12	12
lleudà	2	0	lleuda	4	1	1
llevarà	2	15	llevara	2	3	18
llevà	2	5	lleva	4	214	219
llevàrem	2	0	llevarem	2	6	6
llevàreu	2	0	llevareu	2	1	1
llevés	2	10	lleves	4	53	63
lleví	2	0	llevi	2	62	62
llibertà	2	0	lliberta	4	13	13
llibertària	0	28	llibertaria	2	1	29
llibertàries	0	13	llibertaries	2	0	13
llibertés	2	0	llibertes	4	6	6
llibertí	2	15	lliberti	2	1	16
llicenciarà	2	2	llicenciara	2	0	2
llicencià	2	56	llicencia	2	25	81
llicenciés	2	0	llicencies	2	14	14
llicència	4	2734	llicencia	2	25	2759
llicències	4	1376	llicencies	2	14	1390
lligarà	2	3	lligara	2	1	4
lligués	2	4	lligues	4	273	277
lliguí	2	0	lligui	2	20	20
lligà	2	3	lliga	4	3649	3652
lligàrem	2	0	lligarem	2	2	2
lligó	4	0	lligo	2	4	4
llimà	2	0	llima	4	59	59
llimàrem	2	0	llimarem	2	1	1
llimés	2	0	llimes	4	7	7
llimí	2	0	llimi	2	1	1
llimó	4	4	llimo	2	0	4
lliscarà	2	1	lliscara	2	0	1
lliscà	2	1	llisca	2	109	110
llisqués	2	5	llisques	2	2	7
llisquí	2	0	llisqui	2	18	18
llistarà	2	30	llistara	2	0	30
llistà	2	4	llista	4	27256	27260
llistàrem	2	0	llistarem	2	1	1
llistés	2	0	llistes	4	3171	3171
llistí	2	0	llisti	2	5	5
llistó	4	159	llisto	2	4	163
llità	2	0	llita	2	2	2
lliurarà	2	87	lliurara	2	0	87
lliurà	2	54	lliura	4	560	614
lliuràrem	2	0	lliurarem	2	27	27
lliuràreu	2	0	lliurareu	2	1	1
lliurés	2	49	lliures	4	5398	5447
lliurí	2	0	lliuri	2	122	122
lloarà	2	1	lloara	2	0	1
llogarà	2	3	llogara	2	0	3
llogués	2	4	llogues	4	1	5
lloguí	2	0	llogui	2	3	3
llogà	2	10	lloga	4	50	60
llogàrem	2	0	llogarem	2	1	1
llombaí	0	0	llombai	4	3	3
llorigó	4	1	llorigo	2	0	1
llossés	2	0	llosses	4	3	3
lloà	2	20	lloa	4	85	105
lloés	2	2	lloes	4	8	10
lluentà	2	0	lluenta	2	4	4
lluentés	2	0	lluentes	2	2	2
llufà	2	0	llufa	4	5	5
lluitarà	2	50	lluitara	2	1	51
lluità	2	107	lluita	4	20673	20780
lluitàrem	2	1	lluitarem	2	116	117
lluitàreu	2	0	lluitareu	2	6	6
lluités	2	22	lluites	4	723	745
lluití	2	0	lluiti	2	136	136
llunyà	0	712	llunya	0	2	714
llàstima	4	770	llastima	2	2	772
llàstimes	4	1	llastimes	2	2	3
localitzarà	2	4	localitzara	2	0	4
localitzà	2	10	localitza	2	274	284
localitzàrem	2	0	localitzarem	2	1	1
localitzés	2	3	localitzes	2	0	3
localitzí	2	0	localitzi	2	7	7
locutà	2	0	locuta	2	1	1
loriguillà	0	0	loriguilla	4	2	2
lubricà	2	0	lubrica	2	3	3
lubrificà	2	0	lubrifica	2	1	1
lucrà	2	0	lucra	2	1	1
lucrés	2	0	lucres	2	7	7
lucrí	2	1	lucri	2	1	2
luxés	2	0	luxes	2	31	31
luxó	4	1	luxo	2	2	3
làban	4	0	laban	4	18	18
làmina	4	159	lamina	2	13	172
làmines	4	233	lamines	2	9	242
làpida	4	98	lapida	2	2	100
làpides	4	69	lapides	2	0	69
làser	0	512	laser	2	52	564
lícit	0	82	licit	2	0	82
lícita	0	40	licita	2	0	40
lícites	0	15	licites	2	0	15
líder	0	4981	lider	2	15	4996
límit	0	7668	limit	2	44	7712
líquid	0	1083	liquid	2	21	1104
líquida	0	251	liquida	2	12	263
líquides	0	40	liquides	2	0	40
lític	0	11	litic	2	0	11
lúbrica	0	0	lubrica	2	3	3
macerí	2	0	maceri	2	1	1
maculà	2	0	macula	2	2	2
maculí	2	1	maculi	2	0	1
macà	2	0	maca	2	268	268
maduixà	2	0	maduixa	4	46	46
maduixés	2	0	maduixes	4	118	118
madurarà	2	6	madurara	2	0	6
madurà	2	2	madura	4	312	314
madurès	0	1	madures	0	128	129
madurés	2	3	madures	0	128	131
madurí	2	0	maduri	2	14	14
maellà	0	0	maella	4	3	3
magnetitzà	2	0	magnetitza	2	3	3
magnetó	4	14	magneto	4	24	38
magnificà	2	4	magnifica	2	17	21
magnifiqués	2	1	magnifiques	2	2	3
magnífic	0	1027	magnific	2	2	1029
magnífica	0	494	magnifica	2	17	511
magníficat	4	2	magnificat	2	19	21
magníficats	4	2	magnificats	2	4	6
magnífiques	0	117	magnifiques	2	2	119
majorà	2	0	majora	4	21	21
majorés	2	0	majores	4	1	1
majorí	2	0	majori	2	2	2
malaxà	2	0	malaxa	2	2	2
malbaratà	2	0	malbarata	2	25	25
malbaratàrem	2	0	malbaratarem	2	3	3
malbaratí	2	0	malbarati	2	8	8
malcasà	2	0	malcasa	2	1	1
malcrià	2	0	malcria	2	2	2
maldí	2	0	maldi	2	3	3
malentendré	2	0	malentendre	2	2	2
malfià	2	0	malfia	2	3	3
malgastarà	2	13	malgastara	2	0	13
malgastà	2	0	malgasta	2	61	61
malgastàrem	2	0	malgastarem	2	8	8
malgastàreu	2	0	malgastareu	2	1	1
malgastés	2	2	malgastes	2	2	4
malgastí	2	0	malgasti	2	31	31
malicià	2	0	malicia	2	1	1
malignà	2	0	maligna	2	38	38
malignés	2	0	malignes	2	82	82
malinterpretà	2	1	malinterpreta	2	22	23
malinterpretés	2	1	malinterpretes	2	0	1
malinterpretí	2	0	malinterpreti	2	22	22
mallà	2	0	malla	4	482	482
mallés	2	0	malles	4	137	137
mallí	2	0	malli	2	1	1
malló	4	0	mallo	2	5	5
malmetré	2	0	malmetre	2	98	98
malmetés	2	3	malmetes	2	0	3
malmetí	2	0	malmeti	2	7	7
malparlà	2	0	malparla	2	1	1
malpensà	2	0	malpensa	2	17	17
maltractà	2	1	maltracta	2	23	24
maltractés	2	0	maltractes	2	5	5
maltractí	2	0	maltracti	2	4	4
maltès	0	166	maltes	4	1	167
malvendré	2	0	malvendre	2	9	9
malversà	2	0	malversa	2	1	1
malversí	2	0	malversi	2	1	1
malviuré	2	0	malviure	4	1	1
malvés	2	0	malves	4	6	6
malícia	4	42	malicia	2	1	43
mamprendré	2	0	mamprendre	2	3	3
mamà	2	122	mama	4	1078	1200
mamària	0	20	mamaria	2	0	20
mamàries	0	20	mamaries	2	0	20
mamí	2	0	mami	2	28	28
mamó	4	3	mamo	2	7	10
manarà	2	10	manara	2	3	13
mancarà	2	55	mancara	2	0	55
mancà	2	0	manca	0	4323	4323
mancàrem	2	0	mancarem	2	9	9
manducà	2	0	manduca	4	1	1
manegués	2	0	manegues	2	1	1
maneguí	2	0	manegui	2	2	2
manegà	2	3	manega	2	9	12
manegés	2	3	maneges	2	2	5
manegí	2	0	manegi	2	20	20
manejarà	2	14	manejara	2	0	14
manejà	2	0	maneja	2	139	139
manejàrem	2	0	manejarem	2	9	9
mangostà	4	2	mangosta	4	70	72
mangués	2	0	mangues	4	27	27
mangà	2	1	manga	4	459	460
manifassejà	2	0	manifasseja	2	1	1
manifestarà	2	41	manifestara	2	0	41
manifestà	2	39	manifesta	0	1223	1262
manifestàrem	2	0	manifestarem	2	12	12
manifestés	2	55	manifestes	0	53	108
manifestí	2	0	manifesti	2	235	235
maniobrà	2	6	maniobra	4	1004	1010
maniobrés	2	2	maniobres	4	487	489
manipulà	2	1	manipula	2	92	93
manipulés	2	2	manipules	2	3	5
manipulí	2	0	manipuli	2	18	18
manllevarà	2	2	manllevara	2	0	2
manllevà	2	0	manlleva	2	28	28
manllevés	2	1	manlleves	2	0	1
manlleví	2	0	manllevi	2	1	1
manqués	2	15	manques	0	609	624
manquí	2	0	manqui	2	90	90
manresà	0	2	manresa	4	61	63
mantindré	2	109	mantindre	2	91	200
mantingués	2	298	mantingues	2	87	385
mantinguí	2	0	mantingui	2	1727	1727
mantó	4	3	manto	4	3	6
manufacturà	2	0	manufactura	4	144	144
manufacturés	2	0	manufactures	4	66	66
manxà	2	0	manxa	4	226	226
manxés	2	0	manxes	4	19	19
manxó	4	0	manxo	2	1	1
manà	2	18	mana	4	216	234
manàrem	2	0	manarem	2	5	5
manàreu	2	0	manareu	2	1	1
manés	2	9	manes	4	20	29
maní	2	3	mani	4	115	118
manípul	4	3	manipul	2	0	3
maparà	2	1	mapara	2	0	1
mapà	2	0	mapa	4	4191	4191
mapés	2	0	mapes	4	1559	1559
mapí	2	0	mapi	2	39	39
maquetà	2	0	maqueta	4	90	90
maquetés	2	0	maquetes	4	71	71
maquillà	2	0	maquilla	2	6	6
maquillí	2	0	maquilli	2	1	1
maquinà	2	0	maquina	2	14	14
maquinària	4	805	maquinaria	2	18	823
maquinàries	4	16	maquinaries	2	0	16
maquinés	2	0	maquines	2	14	14
maquiní	2	0	maquini	2	2	2
maqués	2	0	maques	2	64	64
maquí	2	0	maqui	2	4	4
maquís	4	0	maquis	2	10	10
marbrés	2	0	marbres	2	39	39
marcarà	2	214	marcara	2	1	215
marcegí	2	0	marcegi	2	1	1
marcejà	2	0	marceja	2	16	16
marcirà	2	1	marcira	2	0	1
marcà	2	185	marca	4	5789	5974
marcàrem	2	0	marcarem	2	6	6
marcàreu	2	0	marcareu	2	2	2
marcí	2	0	marci	4	25	25
marededéu	4	5	marededeu	4	3	8
marededéus	4	1	marededeus	4	0	1
maregés	2	0	mareges	2	2	2
maregí	2	0	maregi	2	1	1
marejà	2	0	mareja	2	3	3
margalidà	0	0	margalida	4	10	10
marginalitzà	2	1	marginalitza	2	1	2
marginarà	2	6	marginara	2	0	6
marginà	2	0	margina	2	30	30
marginés	2	2	margines	2	0	2
marginí	2	0	margini	2	11	11
margués	2	0	margues	4	9	9
margà	2	0	marga	4	24	24
marinarà	2	0	marinara	2	1	1
marinà	2	0	marina	4	2609	2609
marinés	2	0	marines	4	1223	1223
mariní	2	1	marini	2	10	11
marinís	0	0	marinis	2	9	9
marquí	2	0	marqui	2	154	154
marrarà	2	0	marrara	2	1	1
marroquinà	2	0	marroquina	4	176	176
marroquinés	2	0	marroquines	4	187	187
marruquí	2	1	marruqui	2	0	1
marrà	2	19	marra	4	5	24
marrés	2	0	marres	2	1	1
marrí	2	0	marri	2	3	3
martiritzà	2	1	martiritza	2	0	1
martiritzàrem	2	0	martiritzarem	2	1	1
martiritzí	2	0	martiritzi	2	1	1
marxarà	2	39	marxara	2	1	40
marxà	2	233	marxa	4	9486	9719
marxàrem	2	1	marxarem	2	28	29
marxàreu	2	0	marxareu	2	2	2
marxés	2	94	marxes	4	197	291
marxí	2	0	marxi	2	117	117
marés	4	4	mares	4	1063	1067
mascarà	2	0	mascara	4	20	20
mascarés	2	0	mascares	4	4	4
masculinitzà	2	0	masculinitza	2	1	1
massacrà	2	2	massacra	2	12	14
massacrés	2	1	massacres	2	372	373
massacrí	2	0	massacri	2	1	1
massificà	2	0	massifica	2	1	1
massillà	2	0	massilla	4	5	5
massissà	2	0	massissa	2	21	21
massissés	2	0	massisses	2	10	10
mastegarà	2	1	mastegara	2	0	1
mastegués	2	1	mastegues	2	4	5
masteguí	2	0	mastegui	2	1	1
mastegà	2	2	mastega	2	10	12
masturbà	2	0	masturba	2	3	3
matarà	2	150	matara	4	27	177
materialitzarà	2	21	materialitzara	2	0	21
materialitzà	2	2	materialitza	2	49	51
materialitzàrem	2	0	materialitzarem	2	3	3
materialitzés	2	18	materialitzes	2	0	18
materialitzí	2	0	materialitzi	2	57	57
matinejà	2	0	matineja	2	2	2
matinà	2	0	matina	2	6	6
matiné	4	1	matine	2	3	4
matinés	2	2	matines	2	27	29
matisà	2	1	matisa	2	19	20
matisàrem	2	0	matisarem	2	1	1
matisés	2	2	matises	2	0	2
matisí	2	0	matisi	2	3	3
matriculà	2	14	matricula	2	20	34
matriculés	2	1	matricules	2	1	2
matrícula	4	301	matricula	2	20	321
matrícules	4	64	matricules	2	1	65
matxó	4	0	matxo	4	4	4
matà	2	64	mata	4	833	897
matàrem	2	0	matarem	2	44	44
matàreu	2	0	matareu	2	15	15
matés	2	59	mates	4	121	180
matí	2	6343	mati	2	116	6459
matín	2	1	matin	2	115	116
matís	2	141	matis	2	42	183
maulà	2	0	maula	4	3	3
maulés	2	0	maules	4	2	2
maurà	2	0	maura	4	22	22
maurés	2	0	maures	4	25	25
maximitzarà	2	1	maximitzara	2	0	1
maximitzà	2	1	maximitza	2	114	115
maximitzàrem	2	0	maximitzarem	2	2	2
maximitzés	2	2	maximitzes	2	0	2
maximitzí	2	0	maximitzi	2	15	15
maçonà	2	0	maçona	2	1	1
maçonés	2	0	maçones	2	2	2
mecanitzà	2	0	mecanitza	2	2	2
mecanografià	2	0	mecanografia	4	42	42
mediarà	2	3	mediara	2	0	3
medicà	2	0	medica	2	37	37
mediqués	2	0	mediques	2	2	2
medità	2	2	medita	2	11	13
medités	2	1	medites	2	2	3
medití	2	0	mediti	2	6	6
medià	2	7	media	2	698	705
mediàrem	2	0	mediarem	2	1	1
mediàs	2	0	medias	4	2	2
mediés	2	10	medies	2	0	10
medií	2	0	medii	2	9	9
medrí	2	0	medri	2	1	1
medís	4	0	medis	4	271	271
melarà	2	0	melara	2	1	1
melindrós	0	2	melindros	4	1	3
melà	2	0	mela	2	14	14
melé	4	20	mele	2	2	22
melés	2	1	meles	2	41	42
melí	2	0	meli	2	5	5
meló	4	64	melo	2	58	122
membrà	2	0	membra	2	1	1
membrés	2	0	membres	2	112575	112575
memoritzarà	2	2	memoritzara	2	0	2
memoritzà	2	0	memoritza	2	3	3
memoritzàreu	2	0	memoritzareu	2	1	1
memoritzés	2	0	memoritzes	2	1	1
memoritzí	2	0	memoritzi	2	1	1
menarà	2	0	menara	2	2	2
mencionà	2	28	menciona	2	329	357
mencionàrem	2	1	mencionarem	2	1	2
mencionés	2	6	menciones	2	1	7
mencioní	2	0	mencioni	2	6	6
mengés	2	19	menges	4	79	98
mengí	2	1	mengi	2	45	46
menjarà	2	37	menjara	2	0	37
menjà	2	7	menja	4	694	701
menjàrem	2	1	menjarem	2	27	28
menjàreu	2	0	menjareu	2	2	2
mentirà	2	3	mentira	2	1	4
mentorà	2	0	mentora	4	22	22
mentorés	2	0	mentores	4	5	5
mentà	4	0	menta	4	68	68
mentí	2	2	menti	2	2	4
mentírem	2	0	mentirem	2	1	1
mentíreu	2	0	mentireu	2	1	1
mentís	2	7	mentis	2	3	10
mentó	4	16	mento	2	2	18
menyscabarà	2	12	menyscabara	2	0	12
menyscabà	2	0	menyscaba	2	75	75
menyscabàrem	2	0	menyscabarem	2	1	1
menyscabés	2	4	menyscabes	2	0	4
menyscabí	2	0	menyscabi	2	26	26
menysprearà	2	3	menyspreara	2	0	3
menyspreà	2	3	menysprea	2	132	135
menyspreés	2	4	menysprees	2	3	7
menyspreí	2	0	menysprei	2	1	1
menystinguí	2	0	menystingui	2	2	2
menysvalorà	2	0	menysvalora	2	1	1
menà	2	4	mena	4	8891	8895
menés	2	0	menes	4	82	82
mení	2	0	meni	2	4	4
mequinensà	0	0	mequinensa	4	26	26
meravellarà	2	1	meravellara	2	0	1
meravellà	2	0	meravella	4	142	142
meravellés	2	0	meravelles	4	214	214
meravellí	2	0	meravelli	2	1	1
mercadejà	2	0	mercadeja	2	1	1
mereixérem	2	0	mereixerem	2	1	1
mereixés	2	9	mereixes	2	78	87
mereixí	2	0	mereixi	2	117	117
meresqués	2	1	meresques	2	0	1
meritarà	2	3	meritara	2	0	3
merità	2	0	merita	4	7	7
mesarà	2	0	mesara	2	1	1
mesclarà	2	11	mesclara	2	0	11
mesclà	2	2	mescla	4	1199	1201
mesclés	2	0	mescles	4	291	291
mesclí	2	0	mescli	2	2	2
mestallà	2	0	mestalla	4	10	10
mestissà	2	0	mestissa	4	36	36
mestissés	2	0	mestisses	4	7	7
mesurarà	2	44	mesurara	2	0	44
mesurà	2	14	mesura	4	17914	17928
mesuràrem	2	2	mesurarem	2	12	14
mesurés	2	7	mesures	4	48550	48557
mesurí	2	0	mesuri	2	25	25
mesuró	4	0	mesuro	2	12	12
mesà	2	0	mesa	4	1690	1690
mesè	0	0	mese	2	4	4
mesé	0	0	mese	2	4	4
mesés	2	1	meses	4	18	19
mesí	2	0	mesi	2	14	14
mesó	4	26	meso	2	10	36
metabolitzarà	2	1	metabolitzara	2	0	1
metabolitzà	2	0	metabolitza	2	20	20
metabolitzés	2	1	metabolitzes	2	0	1
metamorfitzà	2	0	metamorfitza	2	1	1
metamorfosí	2	0	metamorfosi	2	77	77
metgés	2	0	metges	4	1800	1800
metilà	2	0	metila	2	1	1
metilè	4	25	metile	2	0	25
metilé	4	1	metile	2	0	1
metrallà	2	0	metralla	4	43	43
metropolità	0	336	metropolita	4	2	338
metré	2	0	metre	4	532	532
metà	4	379	meta	4	1134	1513
metés	2	0	metes	4	822	822
metí	2	0	meti	2	4	4
mexicà	0	489	mexica	0	3	492
micorrizà	2	0	micorriza	4	2	2
micorrizés	2	0	micorrizes	4	2	2
microcirurgià	4	0	microcirurgia	4	2	2
micró	4	2	micro	4	172	174
micètoma	4	0	micetoma	4	1	1
midà	2	0	mida	4	10224	10224
midés	2	0	mides	4	773	773
midí	2	0	midi	4	456	456
midó	4	145	mido	2	4	149
migrarà	2	3	migrara	2	0	3
migrà	2	6	migra	2	62	68
migrí	2	0	migri	2	4	4
milanès	0	18	milanes	4	1	19
milanés	0	5	milanes	4	1	6
militaritzarà	2	4	militaritzara	2	0	4
militaritzà	2	0	militaritza	2	3	3
militaritzés	2	1	militaritzes	2	0	1
militaritzí	2	0	militaritzi	2	2	2
milità	2	13	milita	2	27	40
milités	2	2	milites	2	2	4
millarès	4	0	millares	4	1	1
millarés	4	0	millares	4	1	1
millorarà	2	728	millorara	2	1	729
millorà	2	66	millora	4	9709	9775
milloràrem	2	0	millorarem	2	76	76
milloràreu	2	0	millorareu	2	1	1
millorés	2	56	millores	4	4179	4235
millorí	2	0	millori	2	679	679
mimetitzà	2	0	mimetitza	2	2	2
mimetitzí	2	0	mimetitzi	2	1	1
mimà	2	0	mima	2	5	5
mimés	2	0	mimes	2	2	2
mimí	2	3	mimi	2	70	73
minarà	2	24	minara	2	0	24
miniarà	2	0	miniara	2	1	1
miniaturitzarà	2	2	miniaturitzara	2	0	2
miniaturà	2	0	miniatura	4	775	775
miniaturés	2	0	miniatures	4	809	809
minimitzarà	2	14	minimitzara	2	0	14
minimitzà	2	0	minimitza	2	191	191
minimitzàrem	2	0	minimitzarem	2	1	1
minimitzés	2	4	minimitzes	2	0	4
minimitzí	2	0	minimitzi	2	33	33
ministrà	2	0	ministra	2	1368	1368
ministrés	2	0	ministres	2	8296	8296
ministrí	2	0	ministri	2	1	1
minià	2	0	minia	2	1	1
minorarà	2	1	minorara	2	0	1
minoritzés	2	1	minoritzes	2	0	1
minorà	2	0	minora	2	5	5
minorés	2	1	minores	2	4	5
minorí	2	0	minori	2	12	12
minutà	2	0	minuta	4	7	7
minutés	2	0	minutes	4	63	63
minutí	2	0	minuti	2	1	1
minvarà	2	18	minvara	2	0	18
minvà	2	6	minva	4	74	80
minvàrem	2	0	minvarem	2	1	1
minvés	2	5	minves	4	2	7
minví	2	0	minvi	2	16	16
minà	2	6	mina	4	1066	1072
minés	2	5	mines	4	2586	2591
miní	2	0	mini	2	256	256
miolà	2	0	miola	2	2	2
mirarà	2	43	mirara	2	2	45
mirmídons	0	2	mirmidons	4	2	4
mirrà	2	0	mirra	4	25	25
mirrí	2	0	mirri	2	2	2
mirà	2	15	mira	4	3765	3780
miràrem	2	1	mirarem	2	37	38
miràreu	2	0	mirareu	2	5	5
mirés	2	37	mires	4	626	663
mirí	2	0	miri	2	540	540
missionà	2	0	missiona	2	1	1
missionés	2	0	missiones	2	1	1
missà	2	0	missa	4	689	689
missés	2	0	misses	4	138	138
missí	2	0	missi	2	3	3
mistificà	2	0	mistifica	2	2	2
misàntrop	0	1	misantrop	0	7	8
mitigarà	2	10	mitigara	2	0	10
mitiguí	2	0	mitigui	2	8	8
mitigà	2	1	mitiga	2	15	16
mitjanà	2	0	mitjana	4	8422	8422
mitjançà	2	1	mitjança	2	2	3
mitjanés	2	0	mitjanes	4	5028	5028
mitrà	2	0	mitra	4	39	39
mitrés	2	0	mitres	4	3	3
mixturà	2	0	mixtura	4	5	5
mixturés	2	0	mixtures	4	2	2
mobilitzarà	2	22	mobilitzara	2	0	22
mobilitzà	2	11	mobilitza	2	60	71
mobilitzàrem	2	0	mobilitzarem	2	6	6
mobilitzés	2	10	mobilitzes	2	0	10
mobilitzí	2	0	mobilitzi	2	58	58
moblés	2	0	mobles	2	420	420
mocà	2	0	moca	4	23	23
modelarà	2	3	modelara	2	0	3
modelitzà	2	0	modelitza	2	4	4
modelà	2	2	modela	2	41	43
modelés	2	1	modeles	2	0	1
modelí	2	0	modeli	2	3	3
moderarà	2	3	moderara	2	0	3
modernitzarà	2	7	modernitzara	2	0	7
modernitzà	2	4	modernitza	2	23	27
modernitzàrem	2	0	modernitzarem	2	1	1
modernitzés	2	2	modernitzes	2	0	2
modernitzí	2	0	modernitzi	2	9	9
moderà	2	0	modera	2	27	27
moderés	2	4	moderes	2	0	4
moderí	2	0	moderi	2	15	15
modificarà	2	190	modificara	2	0	190
modificà	2	33	modifica	2	2177	2210
modificàrem	2	0	modificarem	2	28	28
modificàreu	2	0	modificareu	2	1	1
modifiqués	2	70	modifiques	2	2	72
modifiquí	2	0	modifiqui	2	431	431
modularà	2	1	modulara	2	0	1
modulà	2	0	modula	2	28	28
modulés	2	0	modules	2	14	14
modulí	2	0	moduli	2	1	1
mofà	2	0	mofa	4	36	36
mofés	2	0	mofes	4	5	5
mofí	2	0	mofi	2	3	3
mogués	2	40	mogues	4	3	43
moguí	2	0	mogui	2	208	208
molarà	2	1	molara	2	0	1
moldré	2	0	moldre	2	74	74
molestarà	2	22	molestara	2	0	22
molestà	2	3	molesta	0	396	399
molestàrem	2	0	molestarem	2	4	4
molestés	2	11	molestes	0	54	65
molestí	2	0	molesti	2	51	51
molestós	0	0	molestos	0	118	118
molinà	2	0	molina	4	101	101
molinés	2	0	molines	4	4	4
molà	2	0	mola	4	72	72
molés	2	0	moles	4	25	25
molín	2	0	molin	2	4	4
moló	4	1	molo	2	5	6
momificà	2	0	momifica	2	1	1
monedà	2	0	moneda	4	5985	5985
monedés	2	0	monedes	4	2499	2499
monitorarà	2	3	monitorara	2	0	3
monitorà	2	0	monitora	4	40	40
monitorés	2	0	monitores	4	2	2
monitorí	2	0	monitori	2	25	25
monologués	2	0	monologues	2	3	3
monopolitzà	2	1	monopolitza	2	6	7
monopolitzés	2	2	monopolitzes	2	0	2
monopolitzí	2	0	monopolitzi	2	6	6
montgaí	0	0	montgai	4	3	3
monyó	4	10	monyo	4	8	18
moqués	2	0	moques	4	2	2
moquí	2	0	moqui	2	1	1
moragués	2	0	moragues	4	3	3
moragà	2	0	moraga	4	17	17
moralitzà	2	0	moralitza	2	1	1
moralitzí	2	0	moralitzi	2	1	1
morbós	0	5	morbos	4	0	5
morfinà	2	0	morfina	4	92	92
morfinés	2	0	morfines	4	1	1
morirà	2	204	morira	2	7	211
mormó	0	68	mormo	2	0	68
morrejà	2	0	morreja	2	1	1
morró	4	0	morro	4	94	94
mortificarà	2	1	mortificara	2	0	1
mortificà	2	0	mortifica	2	3	3
morí	2	743	mori	4	277	1020
morírem	2	0	morirem	2	82	82
moríreu	2	0	morireu	2	18	18
morís	2	180	moris	2	56	236
morós	0	5	moros	0	80	85
moscà	2	0	mosca	4	185	185
mosqués	2	0	mosques	4	160	160
mossegarà	2	5	mossegara	2	0	5
mossegués	2	1	mossegues	4	0	1
mosseguí	2	0	mossegui	2	2	2
mossegà	2	1	mossega	4	75	76
mossegàrem	2	0	mossegarem	2	1	1
mossó	0	0	mosso	4	38	38
mostassà	4	0	mostassa	4	110	110
mostrarà	2	2261	mostrara	2	4	2265
mostrejarà	2	3	mostrejara	2	0	3
mostrejà	2	0	mostreja	2	9	9
mostrà	2	215	mostra	4	24822	25037
mostràrem	2	0	mostrarem	2	53	53
mostràreu	2	0	mostrareu	2	1	1
mostrés	2	119	mostres	4	2036	2155
mostrí	2	0	mostri	2	979	979
mostós	0	0	mostos	4	55	55
motegí	2	0	motegi	2	4	4
motivarà	2	13	motivara	2	0	13
motivà	2	9	motiva	0	92	101
motivàrem	2	0	motivarem	2	2	2
motivés	2	5	motives	0	3	8
motiví	2	0	motivi	2	26	26
motllurà	2	0	motllura	4	24	24
motllurés	2	0	motllures	4	42	42
motlurés	2	0	motlures	4	1	1
mouré	2	12	moure	2	4167	4179
mudà	2	25	muda	2	205	230
mudàrem	2	2	mudarem	2	1	3
mudés	2	9	mudes	2	70	79
mudí	2	0	mudi	2	8	8
mullerés	2	0	mulleres	2	2	2
mullà	2	2	mulla	4	28	30
mullés	2	1	mulles	4	0	1
mullí	2	0	mulli	2	5	5
multicòpia	4	1	multicopia	2	0	1
multiplexà	2	0	multiplexa	2	3	3
multiplicarà	2	24	multiplicara	2	0	24
multiplicà	2	3	multiplica	2	228	231
multiplicàrem	2	0	multiplicarem	2	2	2
multipliqués	2	4	multipliques	2	1	5
multipliquí	2	0	multipliqui	2	13	13
multà	2	2	multa	4	386	388
multés	2	0	multes	4	591	591
multí	2	0	multi	2	99	99
mundà	2	28	munda	2	26	54
mundés	2	0	mundes	2	2	2
mundí	2	0	mundi	2	56	56
munirà	2	0	munira	2	1	1
muntanyès	0	2	muntanyes	4	3494	3496
muntanyés	0	0	muntanyes	4	3494	3494
muntarà	2	27	muntara	2	0	27
muntà	2	21	munta	4	258	279
muntàrem	2	0	muntarem	2	1	1
muntàreu	2	0	muntareu	2	1	1
muntès	0	0	muntes	4	5	5
muntés	2	4	muntes	4	5	9
muntí	2	0	munti	2	13	13
muní	2	0	muni	4	35	35
murallà	2	0	muralla	4	495	495
murallés	2	0	muralles	4	500	500
murmurarà	2	2	murmurara	2	0	2
murmurà	2	1	murmura	2	15	16
murmurés	2	1	murmures	2	2	3
murmurí	2	0	murmuri	2	34	34
murrí	0	0	murri	0	10	10
murà	2	0	mura	4	32	32
murés	2	0	mures	4	2	2
murí	2	2	muri	2	7	9
muró	4	0	muro	4	218	218
musicà	2	1	musica	2	59	60
musiqués	2	0	musiques	2	1	1
musiquí	2	0	musiqui	2	1	1
musà	2	2	musa	4	162	164
musés	2	0	muses	4	56	56
musí	2	1	musi	2	4	5
mutarà	2	0	mutara	2	19	19
mutilà	2	3	mutila	2	4	7
mutilàreu	2	0	mutilareu	2	1	1
mutilés	2	0	mutiles	2	1	1
mutà	2	0	muta	2	15	15
mutí	2	0	muti	2	16	16
mutó	4	0	muto	2	11	11
mà	4	8861	ma	3	831	9692
màcula	4	11	macula	2	2	13
màcules	4	5	macules	2	0	5
mànegues	4	47	manegues	2	1	48
màquina	4	3182	maquina	2	14	3196
màquines	4	1864	maquines	2	14	1878
màscara	4	1651	mascara	4	20	1671
màscares	4	471	mascares	4	4	475
màser	4	11	maser	4	2	13
màsers	4	9	masers	4	0	9
màssic	0	18	massic	4	0	18
màstec	4	1	mastec	4	0	1
màstic	4	7	mastic	2	0	7
màx	7	110	max	4	1002	1112
mèdic	0	1355	medic	2	3	1358
mèdica	0	2266	medica	2	37	2303
mèdicament	6	29	medicament	4	473	502
mèdiques	0	698	mediques	2	2	700
mèlic	0	0	melic	4	65	65
mèlics	0	0	melics	4	3	3
mènada	4	0	menada	2	2	2
mènades	4	10	menades	2	1	11
mèrit	4	1237	merit	2	21	1258
mèu	4	3	meu	4	59489	59492
mèus	4	0	meus	4	11612	11612
més	4	423587	mes	1	10911	434498
mín	7	62	min	2	246	308
míster	4	8	mister	4	52	60
mític	0	121	mitic	2	0	121
mòdica	0	3	modica	4	4	7
mòdul	4	2913	modul	2	14	2927
mòllera	4	0	mollera	4	2	2
mòlleres	4	0	molleres	4	1	1
mòlt	2	33	molt	2	154977	155010
mòlta	2	42	molta	2	8119	8161
mòltes	2	2	moltes	2	31482	31484
mòlts	2	4	molts	2	47153	47157
mònada	4	19	monada	4	8	27
mònades	4	8	monades	4	3	11
mòria	4	7	moria	2	194	201
mòries	4	0	mories	2	4	4
món	4	43247	mon	3	438	43685
móres	4	13	mores	4	33	46
múltiplex	0	8	multiplex	2	7	15
músic	0	794	music	2	1151	1945
música	0	11372	musica	2	59	11431
músiques	0	70	musiques	2	1	71
mústic	0	2	mustic	2	0	2
músties	0	1	musties	2	0	1
nacionalitzà	2	8	nacionalitza	2	3	11
nacionalitzés	2	1	nacionalitzes	2	0	1
nacionalitzí	2	0	nacionalitzi	2	3	3
nadà	2	0	nada	2	33	33
nadés	2	1	nades	2	2	3
nadí	2	0	nadi	2	9	9
nadó	4	551	nado	2	1	552
nafrà	2	0	nafra	4	83	83
nafrés	2	0	nafres	4	24	24
nafrí	2	0	nafri	2	1	1
naixérem	2	0	naixerem	2	1	1
naixés	2	25	naixes	2	0	25
naixí	2	0	naixi	2	2	2
nannà	2	0	nanna	2	20	20
nanní	2	0	nanni	2	4	4
napà	2	0	napa	4	24	24
napí	2	0	napi	2	2	2
napís	4	0	napis	2	3	3
narrà	2	9	narra	2	315	324
narrés	2	1	narres	2	0	1
narrí	2	0	narri	2	1	1
nasalitzà	2	0	nasalitza	2	1	1
nasqués	2	19	nasques	2	0	19
natgés	2	0	natges	4	30	30
naturalitzà	2	1	naturalitza	2	5	6
naufragarà	2	3	naufragara	2	0	3
naufragués	2	5	naufragues	2	0	5
naufraguí	2	0	naufragui	2	6	6
naufragà	2	2	naufraga	2	8	10
navegarà	2	9	navegara	2	0	9
navegués	2	9	navegues	2	8	17
naveguí	2	0	navegui	2	13	13
navegà	2	43	navega	2	443	486
navegàrem	2	0	navegarem	2	3	3
navegàreu	2	0	navegareu	2	4	4
necessitarà	2	556	necessitara	2	0	556
necessità	2	15	necessita	2	10288	10303
necessitàrem	2	1	necessitarem	2	589	590
necessitàreu	2	0	necessitareu	2	262	262
necessités	2	50	necessites	2	587	637
necessití	2	0	necessiti	2	379	379
necrosí	2	0	necrosi	2	56	56
nedà	2	5	neda	2	105	110
nedés	2	2	nedes	2	1	3
negarà	2	51	negara	2	8	59
negativà	2	0	negativa	0	2846	2846
negativés	2	0	negatives	0	1733	1733
negociarà	2	42	negociara	2	0	42
negocià	2	32	negocia	2	174	206
negociàrem	2	0	negociarem	2	42	42
negociàreu	2	0	negociareu	2	2	2
negociés	2	29	negocies	2	8	37
negocií	2	0	negocii	2	1	1
neguitejà	2	0	neguiteja	2	2	2
negués	2	69	negues	2	14	83
neguí	2	0	negui	2	176	176
negà	2	111	nega	2	1275	1386
negàrem	2	0	negarem	2	10	10
negàreu	2	0	negareu	2	1	1
nerví	0	0	nervi	4	229	229
netegés	2	6	neteges	4	56	62
netegí	2	0	netegi	2	26	26
netejarà	2	42	netejara	2	0	42
netejà	2	9	neteja	4	2246	2255
netejàrem	2	0	netejarem	2	3	3
netejàreu	2	0	netejareu	2	1	1
neulà	2	0	neula	0	4	4
neulés	2	0	neules	0	11	11
neurocirurgià	4	10	neurocirurgia	4	9	19
neutralitzarà	2	5	neutralitzara	2	0	5
neutralitzà	2	1	neutralitza	2	31	32
neutralitzàrem	2	0	neutralitzarem	2	1	1
neutralitzés	2	1	neutralitzes	2	2	3
neutralitzí	2	0	neutralitzi	2	8	8
nevarà	2	2	nevara	2	0	2
nevés	2	2	neves	4	209	211
neví	2	0	nevi	2	9	9
niarà	2	0	niara	2	2	2
niellà	2	0	niella	4	1	1
nimbà	2	0	nimba	4	6	6
nimbés	2	0	nimbes	2	2	2
ninó	4	0	nino	4	36	36
nitrogèn	2	0	nitrogen	4	796	796
nitrà	2	0	nitra	4	22	22
nitrós	0	34	nitros	4	3	37
nià	2	0	nia	2	44	44
niàs	2	0	nias	4	5	5
niés	2	0	nies	2	1	1
nií	2	0	nii	2	13	13
nocà	2	0	noca	2	3	3
nodrirà	2	5	nodrira	2	0	5
noedès	0	0	noedes	4	2	2
noedés	0	0	noedes	4	2	2
noliejà	2	1	nolieja	2	1	2
nombrà	2	0	nombra	4	5	5
nombrés	2	0	nombres	4	3467	3467
nomenarà	2	28	nomenara	2	1	29
nomenà	2	266	nomena	2	195	461
nomenàrem	2	0	nomenarem	2	7	7
nomenés	2	48	nomenes	2	1	49
nomení	2	0	nomeni	2	89	89
nominà	2	3	nomina	2	24	27
nominés	2	2	nomines	2	0	2
nominí	2	0	nomini	2	3	3
nomèn	2	0	nomen	2	38	38
només	6	82510	nomes	4	276	82786
nomí	2	0	nomi	2	8	8
nonà	4	1	nona	4	18	19
noquejà	2	0	noqueja	2	3	3
noranta-quatrè	0	0	noranta-quatre	3	8	8
noranta-quatré	0	0	noranta-quatre	3	8	8
normalitzarà	2	4	normalitzara	2	0	4
normalitzà	2	0	normalitza	2	52	52
normalitzés	2	2	normalitzes	2	0	2
normalitzí	2	0	normalitzi	2	15	15
normà	2	0	norma	4	3688	3688
normés	2	0	normes	4	27460	27460
notarà	2	26	notara	2	1	27
noticià	2	0	noticia	2	38	38
noticiés	2	0	noticies	2	97	97
notificarà	2	65	notificara	2	0	65
notificà	2	7	notifica	2	173	180
notificàrem	2	0	notificarem	2	23	23
notificàreu	2	0	notificareu	2	2	2
notifiqués	2	6	notifiques	2	0	6
notifiquí	2	0	notifiqui	2	40	40
notà	2	17	nota	4	7813	7830
notàrem	2	0	notarem	2	8	8
notàreu	2	0	notareu	2	32	32
notària	4	1	notaria	2	11	12
notàries	4	0	notaries	2	2	2
notés	2	11	notes	4	3624	3635
notí	2	0	noti	2	66	66
notícia	4	2094	noticia	2	38	2132
notícies	4	3704	noticies	2	97	3801
nouré	2	0	noure	2	2	2
novel·là	2	1	novel·la	4	3150	3151
novel·lés	2	0	novel·les	4	1060	1060
nugà	2	0	nuga	2	2	2
numerà	2	2	numera	2	20	22
numerària	0	2	numeraria	2	0	2
numerí	2	0	numeri	2	5	5
nuà	2	0	nua	0	164	164
nués	2	0	nues	0	86	86
nàufrag	0	15	naufrag	2	0	15
nàufraga	0	0	naufraga	2	8	8
néta	4	178	neta	0	1058	1236
nétes	4	19	netes	0	628	647
néts	4	331	nets	0	878	1209
níquel	4	326	niquel	2	2	328
nòmina	4	70	nomina	2	24	94
nòmines	4	30	nomines	2	0	30
nòvia	4	49	novia	4	37	86
nòvies	4	1	novies	4	0	1
nós	5	13	nos	4	95	108
nóvia	4	4	novia	4	37	41
número	4	9359	numero	2	74	9433
obcecà	2	0	obceca	2	1	1
objectarà	2	5	objectara	2	0	5
objectivà	2	0	objectiva	0	916	916
objectivés	2	0	objectives	0	321	321
objectà	2	5	objecta	2	14	19
objectés	2	0	objectes	2	7014	7014
objectí	2	0	objecti	2	1	1
oblidarà	2	50	oblidara	2	1	51
oblidà	2	11	oblida	2	506	517
oblidàrem	2	0	oblidarem	2	72	72
oblidàreu	2	0	oblidareu	2	3	3
oblidés	2	28	oblides	2	50	78
oblidí	2	0	oblidi	2	223	223
obligarà	2	234	obligara	2	1	235
obligués	2	54	obligues	2	5	59
obliguí	2	0	obligui	2	253	253
obligà	2	86	obliga	2	1550	1636
obligàrem	2	0	obligarem	2	18	18
obligàreu	2	0	obligareu	2	2	2
obliquà	2	0	obliqua	0	64	64
obliqüés	2	0	obliqües	0	12	12
obnubilà	2	0	obnubila	2	1	1
obrarà	2	3	obrara	2	0	3
obrirà	2	928	obrira	2	4	932
obrà	2	0	obra	4	12663	12663
obràrem	2	0	obrarem	2	4	4
obrés	2	4	obres	4	9487	9491
obrí	2	140	obri	2	625	765
obrírem	2	0	obrirem	2	55	55
obríreu	2	0	obrireu	2	15	15
obrís	2	81	obris	2	48	129
obsequià	2	1	obsequia	2	6	7
observarà	2	50	observara	2	0	50
observà	2	109	observa	2	1209	1318
observàrem	2	2	observarem	2	53	55
observàreu	2	0	observareu	2	10	10
observés	2	27	observes	2	3	30
observí	2	0	observi	2	95	95
obsessionarà	2	3	obsessionara	2	0	3
obsessionà	2	1	obsessiona	2	13	14
obsessionés	2	0	obsessiones	2	1	1
obsessioní	2	0	obsessioni	2	6	6
obstaculitzarà	2	25	obstaculitzara	2	0	25
obstaculitzà	2	5	obstaculitza	2	136	141
obstaculitzàrem	2	0	obstaculitzarem	2	1	1
obstaculitzés	2	9	obstaculitzes	2	0	9
obstaculitzí	2	0	obstaculitzi	2	67	67
obstinarà	2	4	obstinara	2	0	4
obstinà	2	0	obstina	2	58	58
obstinàrem	2	0	obstinarem	2	1	1
obstinés	2	3	obstines	2	1	4
obstiní	2	0	obstini	2	14	14
obstà	2	0	obsta	2	26	26
obtindré	2	12	obtindre	2	116	128
obtingués	2	119	obtingues	2	12	131
obtinguí	2	0	obtingui	2	404	404
obviarà	2	1	obviara	2	0	1
obvià	2	0	obvia	2	17	17
obviàreu	2	0	obviareu	2	1	1
obviés	2	1	obvies	2	4	5
ocasionarà	2	85	ocasionara	2	1	86
ocasionà	2	28	ocasiona	2	254	282
ocasionàrem	2	0	ocasionarem	2	2	2
ocasionés	2	4	ocasiones	2	3	7
ocasioní	2	0	ocasioni	2	52	52
occidentalitzà	2	1	occidentalitza	2	0	1
occidentalitzí	2	0	occidentalitzi	2	1	1
octaví	4	1	octavi	4	46	47
octubrés	2	0	octubres	2	1	1
octà	4	6	octa	4	21	27
octàedre	4	22	octaedre	4	16	38
octàedres	4	8	octaedres	4	5	13
ocultarà	2	62	ocultara	2	0	62
ocultà	2	3	oculta	0	1622	1625
ocultàrem	2	0	ocultarem	2	2	2
ocultés	2	6	ocultes	0	368	374
ocultí	2	0	oculti	2	50	50
ocuparà	2	366	ocupara	2	1	367
ocupà	2	252	ocupa	2	4057	4309
ocupàrem	2	1	ocuparem	2	146	147
ocupés	2	145	ocupes	2	15	160
ocupí	2	0	ocupi	2	800	800
odiarà	2	5	odiara	2	0	5
odià	2	0	odia	2	161	161
odiàrem	2	0	odiarem	2	2	2
odiés	2	2	odies	2	57	59
odorí	2	0	odori	2	1	1
ofegarà	2	13	ofegara	2	0	13
ofegués	2	5	ofegues	2	5	10
ofeguí	2	0	ofegui	2	15	15
ofegà	2	6	ofega	2	61	67
ofegàrem	2	0	ofegarem	2	4	4
ofendré	2	3	ofendre	2	206	209
ofengués	2	1	ofengues	2	0	1
ofenguí	2	0	ofengui	2	15	15
oferirà	2	658	oferira	2	2	660
oferírem	2	0	oferirem	2	67	67
oferíreu	2	0	oferireu	2	1	1
oficialitzarà	2	1	oficialitzara	2	0	1
oficialitzà	2	5	oficialitza	2	2	7
oficialitzí	2	0	oficialitzi	2	1	1
oficiarà	2	1	oficiara	2	0	1
oficià	2	4	oficia	2	6	10
oficií	2	1	oficii	2	1	2
ofrenà	2	0	ofrena	4	88	88
ofrenés	2	0	ofrenes	4	159	159
ofrení	2	0	ofreni	2	1	1
ofuscà	2	0	ofusca	2	3	3
oià	2	0	oia	2	1	1
oiés	2	0	oies	2	1	1
olesà	0	0	olesa	4	11	11
olivetà	0	1	oliveta	4	0	1
olivà	2	0	oliva	4	683	683
olivés	2	1	olives	4	177	178
oliví	2	2	olivi	2	1	3
ollerià	0	0	olleria	4	3	3
olorà	2	0	olora	2	24	24
olorés	2	0	olores	2	10	10
olorí	2	0	olori	2	1	1
ombrejarà	2	3	ombrejara	2	0	3
ombrejà	2	0	ombreja	2	8	8
ombrà	2	0	ombra	4	1602	1602
ombrés	2	0	ombres	4	692	692
ometré	2	7	ometre	2	397	404
ometés	2	6	ometes	2	0	6
ometí	2	0	ometi	2	24	24
omplirà	2	92	omplira	2	1	93
omplí	2	10	ompli	2	94	104
omplírem	2	0	omplirem	2	7	7
omplíreu	2	0	omplireu	2	2	2
omplís	2	9	omplis	2	6	15
omès	2	189	omes	4	4	193
omés	2	2	omes	4	4	6
oncogèn	4	2	oncogen	0	3	5
oncogén	4	0	oncogen	0	3	3
oncògens	0	3	oncogens	4	5	8
ondarà	2	0	ondara	4	7	7
ondejarà	2	1	ondejara	2	0	1
ondulà	2	0	ondula	2	5	5
ondà	2	0	onda	4	38	38
ondés	2	0	ondes	4	7	7
onegés	2	3	oneges	2	0	3
onegí	2	0	onegi	2	5	5
onejarà	2	3	onejara	2	0	3
onejà	2	1	oneja	2	18	19
onzè	0	137	onze	3	1795	1932
onzé	0	2	onze	3	1795	1797
operarà	2	27	operara	2	0	27
operà	2	24	opera	2	1618	1642
operàrem	2	0	operarem	2	4	4
operària	4	5	operaria	2	10	15
operés	2	19	operes	2	3	22
operí	2	0	operi	2	91	91
operó	4	52	opero	2	3	55
opilí	2	0	opili	2	1	1
opinarà	2	4	opinara	2	0	4
opinà	2	13	opina	2	1039	1052
opinés	2	4	opines	2	22	26
opiní	2	0	opini	2	46	46
oposarà	2	63	oposara	2	1	64
oposà	2	77	oposa	2	1151	1228
oposàrem	2	0	oposarem	2	76	76
oposés	2	38	oposes	2	3	41
oposí	2	0	oposi	2	188	188
optarà	2	25	optara	2	0	25
optimitzarà	2	6	optimitzara	2	0	6
optimitzà	2	0	optimitza	2	78	78
optimitzàrem	2	0	optimitzarem	2	1	1
optimitzí	2	0	optimitzi	2	11	11
optimà	2	0	optima	2	4	4
optimés	2	0	optimes	2	2	2
optà	2	22	opta	2	175	197
optàrem	2	1	optarem	2	11	12
optàreu	2	0	optareu	2	1	1
optés	2	27	optes	2	0	27
optí	2	0	opti	2	79	79
orbitarà	2	4	orbitara	2	0	4
orbità	2	2	orbita	2	161	163
orbitària	0	3	orbitaria	2	2	5
orbités	2	1	orbites	2	1	2
orbití	2	0	orbiti	2	6	6
orbà	2	0	orba	4	4	4
orbés	2	0	orbes	0	7	7
ordenarà	2	38	ordenara	2	1	39
ordenà	2	436	ordena	2	1221	1657
ordenàrem	2	0	ordenarem	2	5	5
ordenàreu	2	0	ordenareu	2	1	1
ordenés	2	30	ordenes	2	7	37
ordení	2	0	ordeni	2	40	40
ordinès	0	0	ordines	4	4	4
ordinés	0	0	ordines	4	4	4
ordí	2	1	ordi	4	155	156
ordís	2	1	ordis	4	5	6
orejà	2	0	oreja	2	25	25
orellés	2	0	orelles	4	505	505
orellí	2	0	orelli	2	1	1
organitzarà	2	143	organitzara	2	1	144
organitzà	2	176	organitza	2	767	943
organitzàrem	2	0	organitzarem	2	66	66
organitzàreu	2	0	organitzareu	2	1	1
organitzés	2	60	organitzes	2	4	64
organitzí	2	0	organitzi	2	186	186
orientarà	2	45	orientara	2	0	45
orientà	2	4	orienta	2	198	202
orientàrem	2	0	orientarem	2	4	4
orientés	2	14	orientes	2	2	16
orientí	2	0	orienti	2	71	71
originarà	2	35	originara	2	0	35
originà	2	69	origina	2	358	427
originàrem	2	0	originarem	2	2	2
originària	0	393	originaria	2	23	416
originàries	0	142	originaries	2	0	142
originés	2	8	origines	2	7	15
originí	2	0	origini	2	29	29
orinà	2	1	orina	4	245	246
orinés	2	0	orines	4	3	3
oriolà	0	1	oriola	4	16	17
orlà	2	2	orla	4	20	22
orlés	2	0	orles	4	9	9
orlí	2	0	orli	2	1	1
ornamentà	2	0	ornamenta	2	1	1
ornà	2	0	orna	2	3	3
ornés	2	0	ornes	2	2	2
orní	2	0	orni	2	3	3
orquestrà	2	6	orquestra	4	2149	2155
orquestrés	2	1	orquestres	4	179	180
orsà	2	0	orsa	4	10	10
orsí	2	0	orsi	2	3	3
ortigués	2	0	ortigues	4	6	6
ortigà	2	0	ortiga	4	5	5
ortografià	2	0	ortografia	4	740	740
ortografiés	2	0	ortografies	4	37	37
ortòedre	4	2	ortoedre	4	4	6
orxetà	0	0	orxeta	4	3	3
orxà	0	0	orxa	4	5	5
orés	2	0	ores	4	1	1
orí	2	0	ori	2	30	30
orín	2	0	orin	2	13	13
oscil·larà	2	8	oscil·lara	2	0	8
oscil·là	2	2	oscil·la	2	184	186
oscil·lés	2	2	oscil·les	2	0	2
oscil·lí	2	0	oscil·li	2	5	5
oscà	2	3	osca	4	69	72
osqués	2	0	osques	0	26	26
ossós	0	0	ossos	4	1075	1075
ostentarà	2	12	ostentara	2	0	12
ostentà	2	23	ostenta	2	253	276
ostentés	2	2	ostentes	2	0	2
ostentí	2	0	ostenti	2	28	28
ovacionà	2	0	ovaciona	2	2	2
ovalà	2	0	ovala	2	1	1
ovulà	2	0	ovula	2	2	2
oxidarà	2	2	oxidara	2	0	2
oxidà	2	0	oxida	2	54	54
oxidí	2	0	oxidi	2	2	2
oxigenà	2	0	oxigena	2	2	2
oxigèn	2	0	oxigen	4	1584	1584
oí	2	0	oi	7	2413	2413
oís	2	0	ois	4	4	4
pacificarà	2	1	pacificara	2	0	1
pacificà	2	2	pacifica	2	20	22
pacifiqués	2	1	pacifiques	2	0	1
pacifiquí	2	0	pacifiqui	2	2	2
pactarà	2	1	pactara	2	0	1
pactà	2	5	pacta	2	39	44
pactàrem	2	0	pactarem	2	3	3
pactés	2	1	pactes	2	277	278
pactí	2	0	pacti	2	12	12
pacífica	0	2071	pacifica	2	20	2091
pacífiques	0	412	pacifiques	2	0	412
pagarà	2	268	pagara	2	0	268
pagarés	4	10	pagares	2	0	10
paginà	2	0	pagina	2	18	18
paginés	2	0	pagines	2	3	3
pagués	2	74	pagues	4	54	128
paguí	2	0	pagui	2	253	253
pagàrem	2	0	pagarem	2	85	85
pagàreu	2	0	pagareu	2	10	10
paixés	2	0	paixes	2	1	1
palanquejarà	2	1	palanquejara	2	0	1
palanquí	0	2	palanqui	4	0	2
palatalitzà	2	0	palatalitza	2	1	1
palejà	2	0	paleja	2	1	1
palesà	2	0	palesa	2	267	267
palesés	2	0	paleses	2	25	25
pallarés	0	1	pallares	2	0	1
pallà	2	0	palla	4	289	289
pallés	2	0	palles	4	10	10
palpità	2	0	palpita	2	1	1
palpà	2	1	palpa	2	9	10
pal·lià	2	0	pal·lia	2	3	3
pal·liàrem	2	0	pal·liarem	2	1	1
pal·lií	2	0	pal·lii	2	2	2
palès	2	277	pales	4	77	354
palés	0	3	pales	4	77	80
paló	4	0	palo	4	64	64
pampalluguejà	2	0	pampallugueja	2	2	2
pampallugués	2	0	pampallugues	2	14	14
panteixà	2	0	panteixa	2	1	1
panyà	2	0	panya	2	2	2
panyí	2	0	panyi	2	1	1
papà	2	117	papa	4	4703	4820
papés	2	0	papes	4	285	285
papí	2	0	papi	2	28	28
papú	0	6	papu	4	3	9
papús	0	9	papus	4	8	17
parafinà	2	0	parafina	4	37	37
parafinés	2	0	parafines	4	6	6
parafrasegí	2	0	parafrasegi	2	1	1
parafrasejà	2	0	parafraseja	2	9	9
paralitzarà	2	14	paralitzara	2	0	14
paralitzà	2	2	paralitza	2	48	50
paralitzàrem	2	0	paralitzarem	2	1	1
paralitzés	2	8	paralitzes	2	0	8
paralitzí	2	0	paralitzi	2	28	28
parametritzà	2	0	parametritza	2	9	9
parapetà	2	0	parapeta	2	3	3
pararà	2	185	parara	2	2	187
parasità	2	0	parasita	2	8	8
parasitària	0	22	parasitaria	2	2	24
parasitàries	0	29	parasitaries	2	0	29
parcel·là	2	0	parcel·la	4	164	164
parcel·lària	0	3	parcel·laria	2	0	3
parcel·làries	0	2	parcel·laries	2	0	2
parcel·lés	2	0	parcel·les	4	234	234
pardinès	0	0	pardines	4	2	2
pardinés	0	0	pardines	4	2	2
paredés	2	0	paredes	2	29	29
pareguí	2	0	paregui	2	1	1
paretó	4	1	pareto	4	43	44
parionà	2	0	pariona	2	1	1
parlamentària	0	4535	parlamentaria	2	2	4537
parlamentàries	0	1667	parlamentaries	2	1	1668
parlamentí	2	0	parlamenti	2	1	1
parlarà	2	286	parlara	2	8	294
parlotejà	2	0	parloteja	2	2	2
parlà	2	69	parla	4	6522	6591
parlàrem	2	2	parlarem	2	381	383
parlàreu	2	0	parlareu	2	5	5
parlés	2	210	parles	4	379	589
parlí	2	1	parli	2	884	885
parodià	2	0	parodia	2	19	19
parodiés	2	0	parodies	2	5	5
parpellegés	2	0	parpelleges	2	1	1
parpellegí	2	0	parpellegi	2	14	14
parpellejarà	2	12	parpellejara	2	0	12
parpellejà	2	0	parpelleja	2	29	29
participarà	2	297	participara	2	1	298
participà	2	624	participa	2	1142	1766
participàrem	2	0	participarem	2	66	66
participés	2	126	participes	2	4	130
participí	2	0	participi	2	686	686
particularitzà	2	0	particularitza	2	1	1
partirà	2	29	partira	2	0	29
partícip	0	81	particip	2	0	81
partírem	2	0	partirem	2	8	8
partíreu	2	0	partireu	2	1	1
parà	2	6	para	4	823	829
paràrem	2	0	pararem	2	40	40
paràsit	0	213	parasit	2	0	213
paràsita	0	26	parasita	2	8	34
paràsites	0	21	parasites	2	0	21
parí	2	2	pari	2	353	355
paròdia	4	213	parodia	2	19	232
paròdies	4	59	parodies	2	5	64
passarà	2	1211	passara	2	11	1222
passegés	2	1	passeges	2	4	5
passegí	2	0	passegi	2	2	2
passejà	2	0	passeja	2	78	78
passejàrem	2	0	passejarem	2	1	1
passivà	2	0	passiva	0	403	403
passivés	2	0	passives	0	80	80
passà	2	902	passa	4	7923	8825
passàrem	2	1	passarem	2	172	173
passàreu	2	0	passareu	2	13	13
passés	2	319	passes	4	273	592
passí	2	1	passi	2	1603	1604
passó	4	0	passo	2	563	563
pasteuritzà	2	0	pasteuritza	2	1	1
pasturà	2	0	pastura	4	179	179
pasturés	2	0	pastures	4	263	263
pasturí	2	0	pasturi	2	3	3
pastà	2	0	pasta	4	330	330
pastés	2	1	pastes	4	32	33
pastís	4	534	pastis	2	1	535
pastós	0	5	pastos	4	1	6
patentà	2	7	patenta	4	9	16
patentés	2	5	patentes	4	2	7
patentí	2	0	patenti	2	18	18
patinarà	2	1	patinara	2	0	1
patinà	2	0	patina	2	16	16
patinés	2	0	patines	2	1	1
patirà	2	28	patira	2	3	31
patrocinarà	2	1	patrocinara	2	0	1
patrocinà	2	20	patrocina	2	68	88
patrocinàrem	2	0	patrocinarem	2	1	1
patrocinés	2	2	patrocines	2	0	2
patrociní	2	0	patrocini	4	381	381
patrullà	2	5	patrulla	4	364	369
patrullés	2	1	patrulles	4	316	317
patrullí	2	0	patrulli	2	2	2
patí	2	184	pati	4	749	933
patírem	2	0	patirem	2	5	5
patíreu	2	0	patireu	2	3	3
patís	2	22	patis	4	107	129
pautà	2	0	pauta	4	177	177
pautés	2	0	pautes	4	446	446
pavoní	2	0	pavoni	2	1	1
pecarà	2	3	pecara	2	0	3
pecà	2	0	peca	2	22	22
pecàrem	2	0	pecarem	2	1	1
pedalejà	2	0	pedaleja	2	4	4
pedalà	2	0	pedala	2	2	2
pedregà	2	0	pedrega	4	3	3
pedània	0	0	pedania	4	11	11
pedànies	0	0	pedanies	4	1	1
pegarà	2	4	pegara	2	0	4
pegués	2	3	pegues	0	25	28
peguí	2	0	pegui	2	8	8
pegà	2	0	pega	0	103	103
pegàrem	2	0	pegarem	2	1	1
peixés	2	0	peixes	2	1	1
pelaí	4	0	pelai	4	18	18
pelegrinà	2	1	pelegrina	4	17	18
pelegrinés	2	0	pelegrines	4	7	7
pelfà	2	0	pelfa	4	4	4
pellà	2	0	pella	4	11	11
pellí	2	0	pelli	2	3	3
pelà	2	0	pela	4	105	105
pelés	2	0	peles	4	15	15
pelí	2	0	peli	2	9	9
penalitzarà	2	41	penalitzara	2	0	41
penalitzà	2	0	penalitza	2	117	117
penalitzàrem	2	0	penalitzarem	2	2	2
penalitzés	2	2	penalitzes	2	0	2
penalitzí	2	0	penalitzi	2	51	51
pencà	2	0	penca	4	1	1
pendulà	2	0	pendula	2	2	2
penedirà	2	6	penedira	2	0	6
penedí	2	3	penedi	2	0	3
penedírem	2	0	penedirem	2	3	3
penedíreu	2	0	penedireu	2	4	4
penedís	2	4	penedis	2	0	4
penetrarà	2	7	penetrara	2	0	7
penetrà	2	17	penetra	2	93	110
penetrés	2	8	penetres	2	0	8
penetrí	2	0	penetri	2	21	21
pengés	2	3	penges	2	3	6
pengí	2	0	pengi	2	34	34
penitenciària	0	35	penitenciaria	2	19	54
penitenciàries	0	32	penitenciaries	2	0	32
penitència	4	87	penitencia	2	0	87
penitències	4	3	penitencies	2	0	3
penjarà	2	7	penjara	2	0	7
penjà	2	5	penja	2	292	297
penjàrem	2	0	penjarem	2	5	5
penjàreu	2	0	penjareu	2	1	1
penqués	2	0	penques	4	3	3
pensarà	2	79	pensara	2	2	81
pensà	2	56	pensa	4	3966	4022
pensàrem	2	3	pensarem	2	26	29
pensàreu	2	0	pensareu	2	13	13
pensés	2	87	penses	4	928	1015
pensí	2	1	pensi	2	486	487
pentinà	2	0	pentina	2	13	13
pentosà	4	0	pentosa	4	12	12
pentà	4	5	penta	4	17	22
penyorà	2	0	penyora	4	21	21
penyorés	2	0	penyores	4	2	2
penà	2	0	pena	4	6506	6506
penés	2	0	penes	4	3140	3140
penó	4	6	peno	2	1	7
peoní	2	0	peoni	2	2	2
pequés	2	0	peques	2	1	1
pequí	2	0	pequi	2	4	4
peraltà	2	0	peralta	4	27	27
percebré	2	0	percebre	2	653	653
percebé	2	3	percebe	4	4	7
percebés	2	9	percebes	4	9	18
percebí	2	0	percebi	2	70	70
percolà	2	0	percola	2	1	1
perdonarà	2	45	perdonara	2	1	46
perdonà	2	6	perdona	2	470	476
perdonàreu	2	0	perdonareu	2	3	3
perdonés	2	9	perdones	2	22	31
perdoní	2	0	perdoni	2	340	340
perdré	2	51	perdre	2	7485	7536
perdurarà	2	19	perdurara	2	0	19
perdurà	2	9	perdura	2	72	81
perdurés	2	3	perdures	2	0	3
perdurí	2	0	perduri	2	33	33
perdés	2	166	perdes	2	4	170
perdí	2	0	perdi	2	383	383
perdó	4	633	perdo	2	74	707
peregrinà	2	0	peregrina	2	7	7
peregrinés	2	0	peregrines	2	1	1
peregriní	2	0	peregrini	2	16	16
perfeccionarà	2	1	perfeccionara	2	0	1
perfeccionà	2	8	perfecciona	2	14	22
perfeccionàrem	2	0	perfeccionarem	2	3	3
perfeccioní	2	0	perfeccioni	2	12	12
perfilarà	2	6	perfilara	2	0	6
perfilà	2	0	perfila	2	114	114
perfilés	2	2	perfiles	2	0	2
perfilí	2	0	perfili	2	13	13
perfondré	2	0	perfondre	2	1	1
perforà	2	2	perfora	2	18	20
perforí	2	0	perfori	2	1	1
perfumés	2	0	perfumes	2	1	1
pergelisòl	4	2	pergelisol	4	1	3
perillarà	2	2	perillara	2	0	2
perillà	2	0	perilla	2	40	40
perillés	2	3	perilles	2	0	3
perillí	2	0	perilli	2	15	15
perirà	2	2	perira	2	0	2
perités	2	0	perites	0	1	1
perjudicarà	2	123	perjudicara	2	1	124
perjudicà	2	3	perjudica	2	528	531
perjudicàrem	2	0	perjudicarem	2	12	12
perjudiqués	2	13	perjudiques	2	0	13
perjudiquí	2	0	perjudiqui	2	137	137
perjurí	2	0	perjuri	2	22	22
perllongarà	2	2	perllongara	2	0	2
perllongà	2	13	perllonga	4	17	30
perlés	0	0	perles	4	180	180
permeabilitzà	2	0	permeabilitza	2	1	1
permetré	2	177	permetre	2	15504	15681
permetés	2	544	permetes	2	2	546
permetí	2	0	permeti	2	7525	7525
permutà	2	0	permuta	4	39	39
permutés	2	0	permutes	4	38	38
permutí	2	0	permuti	2	1	1
pernoctà	2	1	pernocta	2	2	3
pernoctí	2	0	pernocti	2	1	1
perpetrà	2	1	perpetra	2	13	14
perpetrés	2	1	perpetres	2	0	1
perpetrí	2	0	perpetri	2	8	8
perpetuarà	2	9	perpetuara	2	0	9
perpetuà	2	1	perpetua	2	61	62
perpetuàrem	2	0	perpetuarem	2	1	1
perpetués	2	1	perpetues	2	1	2
perquès	4	18	perques	4	7	25
perseguirà	2	34	perseguira	2	0	34
perseguírem	2	0	perseguirem	2	18	18
perseverarà	2	3	perseverara	2	1	4
perseverà	2	0	persevera	2	7	7
perseveràrem	2	0	perseverarem	2	6	6
perseverés	2	3	perseveres	2	0	3
perseverí	2	0	perseveri	2	20	20
persistirà	2	23	persistira	2	1	24
persistírem	2	0	persistirem	2	5	5
personalitzà	2	0	personalitza	2	207	207
personalitzàrem	2	0	personalitzarem	2	1	1
personalitzés	2	0	personalitzes	2	1	1
personalitzí	2	0	personalitzi	2	5	5
personarà	2	1	personara	2	0	1
personificarà	2	1	personificara	2	0	1
personificà	2	0	personifica	2	39	39
personà	2	0	persona	4	12291	12291
personàrem	2	0	personarem	2	1	1
personés	2	2	persones	4	54565	54567
personí	2	0	personi	2	2	2
persuadirà	2	1	persuadira	2	0	1
persuadírem	2	0	persuadirem	2	1	1
persà	0	0	persa	0	922	922
pertanyerà	2	18	pertanyera	2	1	19
pertanyés	2	23	pertanyes	2	0	23
pertanyí	2	0	pertanyi	2	101	101
pertocarà	2	4	pertocara	2	0	4
pertocà	2	0	pertoca	2	39	39
pertoqués	2	2	pertoques	2	0	2
pertoquí	2	0	pertoqui	2	18	18
pertorbarà	2	3	pertorbara	2	0	3
pertorbà	2	4	pertorba	2	45	49
pertorbés	2	3	pertorbes	2	0	3
pertorbí	2	0	pertorbi	2	12	12
pervisquí	2	0	pervisqui	2	2	2
perviuré	2	0	perviure	2	5	5
perxà	2	0	perxa	4	47	47
perxés	2	1	perxes	4	4	5
perífrasi	4	3	perifrasi	2	0	3
perífrasis	4	2	perifrasis	2	0	2
perís	2	0	peris	4	16	16
peròxid	4	89	peroxid	2	0	89
pesarà	2	18	pesara	2	1	19
pescarà	2	4	pescara	4	47	51
pescà	2	0	pesca	4	12649	12649
pescàrem	2	0	pescarem	2	4	4
pesqués	2	5	pesques	4	27	32
pesquí	2	0	pesqui	2	18	18
pessigués	2	1	pessigues	2	0	1
pessigà	2	0	pessiga	2	9	9
pestanyegés	2	1	pestanyeges	2	0	1
pestanyejà	2	0	pestanyeja	2	1	1
pesà	2	2	pesa	2	288	290
pesés	2	3	peses	2	60	63
pesí	2	0	pesi	2	177	177
petardejà	2	0	petardeja	2	1	1
petarà	2	2	petara	2	0	2
petaré	2	0	petare	4	1	1
petgés	2	0	petges	4	8	8
peticionà	2	1	peticiona	2	0	1
peticionària	0	3	peticionaria	2	0	3
peticionàries	0	4	peticionaries	2	0	4
peticionés	2	0	peticiones	2	1	1
petjà	2	0	petja	4	5	5
petrifiquí	2	0	petrifiqui	2	2	2
petà	2	0	peta	2	36	36
petí	2	0	peti	2	9	9
petó	4	371	peto	2	24	395
peüllà	2	0	peülla	4	15	15
peüllés	2	0	peülles	4	33	33
picarà	2	6	picara	2	0	6
picotejà	2	0	picoteja	2	2	2
picà	2	1	pica	4	201	202
picàrem	2	0	picarem	2	1	1
pigmentària	0	3	pigmentaria	2	0	3
pigmentàries	0	2	pigmentaries	2	0	2
pignorà	2	0	pignora	2	1	1
pillarà	2	2	pillara	2	0	2
pillà	2	0	pilla	4	2	2
pillàreu	2	0	pillareu	2	1	1
pillés	2	0	pilles	4	2	2
pillí	2	0	pilli	2	2	2
pilonà	2	0	pilona	4	3	3
pilonés	2	0	pilones	4	4	4
pilotà	2	9	pilota	4	1229	1238
pilotés	2	0	pilotes	4	220	220
pilotí	2	0	piloti	2	4	4
pincés	2	0	pinces	4	86	86
pincí	2	0	pinci	2	1	1
pintarà	2	14	pintara	2	2	16
pintà	2	47	pinta	4	514	561
pintàrem	2	0	pintarem	2	2	2
pintàreu	2	0	pintareu	2	9	9
pintés	2	16	pintes	4	35	51
pintí	2	0	pinti	2	9	9
pinzellà	2	0	pinzella	2	1	1
pinà	4	0	pina	4	17	17
pinçà	2	1	pinça	4	69	70
pipà	2	0	pipa	4	79	79
pipés	2	0	pipes	4	42	42
pipí	2	118	pipi	2	3	121
pipó	4	1	pipo	2	1	2
piqué	4	39	pique	2	4	43
piqués	2	2	piques	4	147	149
piquí	2	0	piqui	2	2	2
pirategés	2	0	pirateges	2	1	1
piratejà	2	0	pirateja	2	1	1
piratejàrem	2	0	piratejarem	2	1	1
pirà	2	1	pira	4	38	39
pirè	4	1	pire	2	3	4
piré	4	0	pire	2	3	3
pirés	2	0	pires	4	86	86
pirí	2	0	piri	2	37	37
piscà	2	0	pisca	2	4	4
pispà	2	0	pispa	2	5	5
pispés	2	0	pispes	2	5	5
pisés	2	0	pises	4	1	1
pisí	2	0	pisi	2	1	1
pitgés	2	1	pitges	4	0	1
pitgí	2	0	pitgi	2	3	3
pitjà	2	0	pitja	4	8	8
piulà	2	1	piula	4	20	21
piulés	2	1	piules	4	2	3
piuló	4	0	piulo	2	1	1
pivotà	2	0	pivota	2	8	8
pivotí	2	0	pivoti	2	5	5
pixelà	2	0	pixela	2	10	10
pixà	2	1	pixa	4	11	12
pixés	2	0	pixes	4	10	10
pixí	2	0	pixi	2	18	18
placà	2	0	placa	4	1202	1202
placés	2	0	places	4	606	606
plagià	2	1	plagia	2	0	1
plagué	2	1	plague	2	5	6
plagués	2	1	plagues	4	292	293
plaguí	2	0	plagui	2	54	54
plagà	2	0	plaga	4	468	468
planegés	2	4	planeges	2	10	14
planegí	2	0	planegi	2	7	7
planejarà	2	1	planejara	2	0	1
planejà	2	54	planeja	2	277	331
planejàrem	2	0	planejarem	2	1	1
planificarà	2	6	planificara	2	0	6
planificà	2	7	planifica	2	71	78
planificàrem	2	0	planificarem	2	1	1
planificàreu	2	0	planificareu	2	1	1
planifiqués	2	1	planifiques	2	3	4
planifiquí	2	0	planifiqui	2	15	15
plantarà	2	3	plantara	2	0	3
plantegés	2	94	planteges	2	2	96
plantegí	2	0	plantegi	2	449	449
plantejarà	2	280	plantejara	2	0	280
plantejà	2	22	planteja	2	4878	4900
plantejàrem	2	0	plantejarem	2	76	76
plantà	2	9	planta	4	3957	3966
plantés	2	5	plantes	4	5265	5270
plantí	2	0	planti	2	8	8
plantó	4	1	planto	2	6	7
planxà	2	0	planxa	4	87	87
planxés	2	1	planxes	4	86	87
planxí	2	0	planxi	2	1	1
planyés	2	0	planyes	2	1	1
planà	2	0	plana	4	1552	1552
planària	0	4	planaria	2	2	6
planàries	0	13	planaries	2	0	13
planés	2	0	planes	4	861	861
planí	2	0	plani	2	3	3
planó	4	0	plano	2	26	26
plaqué	4	0	plaque	2	4	4
plaqués	2	0	plaques	4	798	798
plasmarà	2	10	plasmara	2	0	10
plasmà	2	2	plasma	4	1857	1859
plasmés	2	1	plasmes	4	44	45
plasmí	2	0	plasmi	2	34	34
plasmó	4	1	plasmo	2	1	2
plastificà	2	0	plastifica	2	2	2
plategés	2	0	plateges	2	1	1
platejarà	2	2	platejara	2	0	2
platinà	2	0	platina	4	12	12
platinés	2	0	platines	4	7	7
platiní	2	0	platini	2	14	14
plauré	2	0	plaure	2	20	20
plaçà	2	0	plaça	4	2078	2078
plebiscitària	0	4	plebiscitaria	2	0	4
plebiscitàries	0	1	plebiscitaries	2	0	1
pledejà	2	0	pledeja	2	1	1
plegarà	2	12	plegara	2	0	12
plegués	2	7	plegues	4	6	13
pleguí	2	0	plegui	2	10	10
plegà	2	0	plega	4	64	64
plegó	4	0	plego	2	15	15
plisí	2	0	plisi	2	1	1
plomà	2	0	ploma	4	317	317
plomés	2	0	plomes	4	319	319
plomí	2	15	plomi	2	1	16
plomís	0	1	plomis	2	0	1
plorarà	2	9	plorara	2	0	9
ploricà	2	0	plorica	2	1	1
ploricó	0	4	plorico	2	0	4
ploriquejarà	2	1	ploriquejara	2	0	1
ploriquejà	2	0	ploriqueja	2	2	2
plorà	2	3	plora	2	121	124
ploràrem	2	0	plorarem	2	4	4
plorés	2	0	plores	2	20	20
plorí	2	0	plori	2	6	6
ploró	0	0	ploro	2	31	31
plotejà	2	0	ploteja	2	8	8
plujà	0	0	pluja	4	1557	1557
plujós	0	71	plujos	0	1	72
plàtera	4	3	platera	4	0	3
plàteres	4	3	plateres	4	0	3
plèroma	4	0	pleroma	4	4	4
poblarà	2	1	poblara	2	0	1
poblà	2	0	pobla	4	62	62
poblés	2	0	pobles	4	9012	9012
poblí	2	0	pobli	2	4	4
poboledà	0	0	poboleda	4	2	2
podrirà	2	1	podrira	2	0	1
podrírem	2	0	podrirem	2	1	1
podà	2	0	poda	4	53	53
podària	4	1	podaria	2	3	4
podés	2	4	podes	4	4	8
podí	2	0	podi	2	126	126
poetà	2	0	poeta	4	1867	1867
poetés	2	0	poetes	4	699	699
poetí	2	0	poeti	2	5	5
polaritzarà	2	1	polaritzara	2	0	1
polaritzà	2	0	polaritza	2	8	8
polaritzí	2	0	polaritzi	2	2	2
polemitzà	2	1	polemitza	2	2	3
polemitzí	2	0	polemitzi	2	1	1
policromà	2	0	policroma	0	5	5
policromés	2	0	policromes	0	5	5
polimeritzà	2	1	polimeritza	2	3	4
polititzà	2	0	polititza	2	4	4
polititzí	2	0	polititzi	2	4	4
polliní	2	0	pollini	2	11	11
pollà	2	0	polla	4	62	62
pollés	2	0	polles	4	17	17
pollí	2	6	polli	2	0	6
pollín	2	0	pollin	2	2	2
polpà	2	0	polpa	4	79	79
polpés	2	0	polpes	4	3	3
polsà	2	0	polsa	2	3	3
polsí	2	0	polsi	2	1	1
polsós	0	8	polsos	4	86	94
polvoritzà	2	0	polvoritza	2	7	7
pol·linitzarà	2	1	pol·linitzara	2	0	1
pol·linitzà	2	0	pol·linitza	2	4	4
políedre	4	79	poliedre	4	14	93
políedres	4	58	poliedres	4	11	69
polígens	4	0	poligens	4	1	1
polís	2	2	polis	4	113	115
pompeià	0	9	pompeia	4	92	101
pompejà	2	0	pompeja	2	1	1
poncellà	2	0	poncella	0	2	2
poncellés	2	0	poncelles	0	6	6
ponderarà	2	2	ponderara	2	0	2
ponderà	2	1	pondera	2	19	20
ponderàrem	2	0	ponderarem	2	1	1
ponderí	2	0	ponderi	2	3	3
pondré	2	1	pondre	2	44	45
ponguí	2	0	pongui	2	14	14
pontificà	2	1	pontifica	2	2	3
pontà	2	0	ponta	2	29	29
pontés	2	0	pontes	2	9	9
pontó	4	8	ponto	2	19	27
popularitzà	2	19	popularitza	2	8	27
popularitzés	2	1	popularitzes	2	0	1
popularitzí	2	0	popularitzi	2	1	1
popà	2	0	popa	4	156	156
popés	2	0	popes	4	4	4
porcà	2	0	porca	0	13	13
porcí	0	234	porci	4	6	240
porcó	0	0	porco	2	27	27
porqués	2	0	porques	0	2	2
porquí	2	5	porqui	2	1	6
porrerà	0	0	porrera	4	2	2
porró	4	7	porro	4	23	30
portarà	2	1197	portara	2	4	1201
portellà	0	0	portella	4	13	13
portà	2	334	porta	4	12478	12812
portàrem	2	0	portarem	2	129	129
portàreu	2	1	portareu	2	12	13
portàveu	2	2	portaveu	4	1093	1095
portés	2	185	portes	4	2979	3164
portí	2	0	porti	2	833	833
portó	4	4	porto	2	1136	1140
posarà	2	996	posara	2	14	1010
posicionarà	2	9	posicionara	2	0	9
posicionà	2	11	posiciona	2	80	91
posicionàrem	2	0	posicionarem	2	1	1
posicionés	2	6	posiciones	2	1	7
posicioní	2	0	posicioni	2	12	12
positivà	2	0	positiva	0	6631	6631
positivés	2	0	positives	0	2312	2312
posposarà	2	12	posposara	2	0	12
posposà	2	5	posposa	2	63	68
posposàrem	2	0	posposarem	2	5	5
posposés	2	20	posposes	2	0	20
posposí	2	0	posposi	2	85	85
possessionà	2	1	possessiona	2	0	1
possibilitarà	2	76	possibilitara	2	0	76
possibilità	2	4	possibilita	2	182	186
possibilitàrem	2	0	possibilitarem	2	1	1
possibilités	2	2	possibilites	2	0	2
possibilití	2	0	possibiliti	2	82	82
postdatà	2	0	postdata	4	7	7
postergarà	2	2	postergara	2	0	2
postergués	2	1	postergues	2	0	1
posterguí	2	0	postergui	2	7	7
postergà	2	1	posterga	2	7	8
postergàrem	2	0	postergarem	2	1	1
posteritzà	2	0	posteritza	2	5	5
postil·là	2	0	postil·la	4	5	5
postprocessà	2	0	postprocessa	2	3	3
postrés	2	0	postres	2	132	132
postularà	2	1	postulara	2	0	1
postulà	2	17	postula	2	133	150
postulés	2	6	postules	2	0	6
postulí	2	0	postuli	2	2	2
posà	2	247	posa	4	7023	7270
posàrem	2	3	posarem	2	346	349
posàreu	2	0	posareu	2	12	12
posés	2	402	poses	4	187	589
posí	2	0	posi	2	2525	2525
potenciarà	2	35	potenciara	2	0	35
potencià	2	1	potencia	2	93	94
potenciàrem	2	0	potenciarem	2	4	4
potenciés	2	3	potencies	2	11	14
potència	4	2697	potencia	2	93	2790
potències	4	1726	potencies	2	11	1737
pouà	2	0	poua	4	1	1
poà	2	0	poa	4	8	8
poés	2	0	poes	4	2	2
practicarà	2	7	practicara	2	0	7
practicà	2	28	practica	2	505	533
practicàrem	2	0	practicarem	2	4	4
practicàreu	2	0	practicareu	2	1	1
practiqués	2	11	practiques	2	5	16
practiquí	2	0	practiqui	2	71	71
pradellà	0	0	pradella	4	1	1
preassignà	2	0	preassigna	2	2	2
precalculà	2	0	precalcula	2	1	1
precarregarà	2	1	precarregara	2	0	1
precarregués	2	0	precarregues	2	1	1
precarregà	2	0	precarrega	2	16	16
precedirà	2	9	precedira	2	0	9
preceptuà	2	0	preceptua	2	1	1
precintés	2	0	precintes	2	5	5
precipitarà	2	8	precipitara	2	0	8
precipità	2	8	precipita	2	37	45
precipités	2	4	precipites	2	1	5
precipití	2	0	precipiti	2	14	14
precisarà	2	52	precisara	2	0	52
precisà	2	1	precisa	2	2436	2437
precisàrem	2	0	precisarem	2	4	4
precisés	2	15	precises	2	802	817
precisí	2	0	precisi	2	49	49
preclassificà	2	1	preclassifica	2	0	1
preconfigurà	2	0	preconfigura	2	1	1
preconitzà	2	0	preconitza	2	183	183
preconitzés	2	1	preconitzes	2	0	1
preconitzí	2	0	preconitzi	2	5	5
precàrrega	4	19	precarrega	2	16	35
precàrregues	4	0	precarregues	2	1	1
predestinà	2	0	predestina	2	1	1
predeterminarà	2	1	predeterminara	2	0	1
predeterminà	2	0	predetermina	2	9	9
predeterminés	2	1	predetermines	2	0	1
predeterminí	2	0	predetermini	2	1	1
predicà	2	17	predica	2	60	77
predicàrem	2	0	predicarem	2	2	2
predigués	2	1	predigues	2	0	1
prediguí	2	0	predigui	2	4	4
prediqués	2	5	prediques	2	2	7
prediquí	2	0	prediqui	2	13	13
predisposarà	2	1	predisposara	2	0	1
predisposà	2	0	predisposa	2	7	7
predisposí	2	0	predisposi	2	1	1
predominarà	2	4	predominara	2	0	4
predominà	2	2	predomina	2	165	167
predominí	2	0	predomini	2	236	236
predís	2	0	predis	4	2	2
preescalfà	2	0	preescalfa	2	1	1
preestablirà	2	4	preestablira	2	0	4
preestrenà	2	0	preestrena	4	22	22
preestrenés	2	0	preestrenes	4	5	5
preferirà	2	21	preferira	2	0	21
preferírem	2	0	preferirem	2	5	5
preferíreu	2	0	preferireu	2	9	9
prefigurà	2	0	prefigura	2	19	19
prefigurí	2	0	prefiguri	2	3	3
prefixà	2	0	prefixa	2	8	8
prefixés	2	0	prefixes	2	13	13
pregadéu	4	3	pregadeu	4	0	3
pregadéus	4	3	pregadeus	4	0	3
pregonarà	2	1	pregonara	2	0	1
pregonà	2	1	pregona	4	20	21
pregonés	2	0	pregones	4	3	3
pregoní	2	0	pregoni	2	1	1
preguntarà	2	131	preguntara	2	3	134
preguntà	2	56	pregunta	4	21306	21362
preguntàrem	2	3	preguntarem	2	36	39
preguntàreu	2	0	preguntareu	2	9	9
preguntés	2	57	preguntes	4	11399	11456
preguntí	2	0	pregunti	2	169	169
pregués	2	4	pregues	2	2	6
preguí	2	0	pregui	2	14	14
pregà	2	3	prega	2	79	82
pregàrem	2	0	pregarem	2	3	3
pregària	4	243	pregaria	2	192	435
pregàries	4	144	pregaries	2	4	148
pregó	4	12	prego	2	2447	2459
preinscriuré	2	0	preinscriure	2	1	1
prejubilà	2	0	prejubila	2	1	1
prejutgés	2	5	prejutges	2	0	5
prejutgí	2	0	prejutgi	2	2	2
prejutjarà	2	3	prejutjara	2	0	3
prejutjà	2	0	prejutja	2	36	36
prejutjàrem	2	0	prejutjarem	2	1	1
preludià	2	0	preludia	2	3	3
premiarà	2	5	premiara	2	0	5
premiàrem	2	0	premiarem	2	1	1
premorí	2	0	premori	2	1	1
premsà	2	0	premsa	4	5901	5901
premsés	2	0	premses	4	42	42
premérem	2	0	premerem	2	4	4
preméreu	2	0	premereu	2	1	1
premés	2	3	premes	2	0	3
premí	2	0	premi	4	8153	8153
premíem	2	0	premiem	2	7	7
prendré	2	206	prendre	2	18913	19119
prengués	2	427	prengues	2	1	428
prenguí	2	0	prengui	2	2054	2054
prenyà	2	0	prenya	2	1	1
preocuparà	2	14	preocupara	2	0	14
preocupà	2	10	preocupa	2	4204	4214
preocupàrem	2	0	preocuparem	2	13	13
preocupés	2	34	preocupes	2	51	85
preocupí	2	0	preocupi	2	236	236
prepararà	2	107	preparara	2	0	107
preparà	2	85	prepara	2	843	928
preparàrem	2	0	prepararem	2	44	44
preparàreu	2	0	preparareu	2	2	2
preparés	2	80	prepares	2	9	89
preparí	2	0	prepari	2	277	277
preponderà	2	0	prepondera	2	1	1
preposà	2	0	preposa	2	5	5
preprocessà	2	0	preprocessa	2	1	1
preregistrés	2	0	preregistres	2	10	10
presagiarà	2	1	presagiara	2	0	1
presagià	2	2	presagia	2	39	41
presagií	2	0	presagii	2	3	3
prescindirà	2	4	prescindira	2	0	4
prescindírem	2	0	prescindirem	2	3	3
prescriguí	2	0	prescrigui	2	18	18
prescriuré	2	0	prescriure	2	126	126
presenciarà	2	3	presenciara	2	0	3
presencià	2	5	presencia	2	46	51
presenciàrem	2	0	presenciarem	2	10	10
presentarà	2	1948	presentara	2	4	1952
presentà	2	293	presenta	2	6400	6693
presentàrem	2	2	presentarem	2	529	531
presentàreu	2	1	presentareu	2	3	4
presentés	2	559	presentes	2	17	576
presentí	2	0	presenti	2	1668	1668
preservarà	2	31	preservara	2	0	31
preservà	2	6	preserva	2	278	284
preservàrem	2	0	preservarem	2	8	8
preservés	2	11	preserves	2	1	12
preserví	2	0	preservi	2	73	73
presidirà	2	41	presidira	2	0	41
presidí	2	56	presidi	4	18	74
presidís	2	8	presidis	4	10	18
pressionarà	2	37	pressionara	2	0	37
pressionà	2	23	pressiona	2	176	199
pressionàrem	2	0	pressionarem	2	21	21
pressionés	2	13	pressiones	2	6	19
pressioní	2	0	pressioni	2	118	118
pressupostarà	2	2	pressupostara	2	0	2
pressupostà	2	0	pressuposta	2	5	5
pressupostàrem	2	0	pressupostarem	2	1	1
pressupostària	0	4999	pressupostaria	2	11	5010
pressupostàries	0	2841	pressupostaries	2	1	2842
pressupostés	2	1	pressupostes	2	0	1
pressupostí	2	0	pressuposti	2	5	5
pressuposà	2	0	pressuposa	2	327	327
pressuposí	2	0	pressuposi	2	3	3
pressuritzà	2	0	pressuritza	2	4	4
prestarà	2	273	prestara	2	2	275
prestigià	2	0	prestigia	2	4	4
prestà	2	7	presta	4	1048	1055
prestàrem	2	0	prestarem	2	89	89
prestés	2	113	prestes	0	8	121
prestí	2	0	presti	2	672	672
presumirà	2	2	presumira	2	0	2
presumí	2	2	presumi	2	0	2
presumís	2	1	presumis	2	1	2
presència	4	8195	presencia	2	46	8241
presències	4	37	presencies	2	0	37
pretendré	2	5	pretendre	2	671	676
pretengués	2	24	pretengues	2	0	24
pretenguí	2	0	pretengui	2	257	257
pretesà	2	0	pretesa	2	79	79
pretesés	2	0	preteses	2	17	17
pretextà	2	0	pretexta	4	1	1
pretèrit	0	30	preterit	2	6	36
pretèrits	0	9	preterits	2	3	12
preuí	2	1	preui	2	0	1
prevaldré	2	0	prevaldre	2	34	34
prevalgués	2	26	prevalgues	2	0	26
prevalguí	2	0	prevalgui	2	210	210
prevariquí	2	0	prevariqui	2	1	1
preveiés	2	16	preveies	2	0	16
preveuré	2	0	preveure	2	1563	1563
previndré	2	0	previndre	2	9	9
previngués	2	3	previngues	2	0	3
previnguí	2	0	previngui	2	26	26
previsualitzarà	2	1	previsualitzara	2	0	1
previsualitzà	2	0	previsualitza	2	143	143
prevèiem	2	13	preveiem	2	111	124
prevèieu	2	0	preveieu	2	2	2
prevéiem	2	0	preveiem	2	111	111
prevéieu	2	0	preveieu	2	2	2
prevéu	2	1	preveu	2	4061	4062
preà	2	0	prea	4	8	8
preés	2	1	prees	4	1	2
preí	2	0	prei	2	1	1
preó	4	1	preo	2	1	2
primarà	2	3	primara	2	0	3
primà	2	0	prima	4	816	816
primària	0	1967	primaria	2	13	1980
primàries	0	552	primaries	2	3	555
primés	2	0	primes	0	797	797
primí	2	0	primi	2	3	3
principià	2	0	principia	2	42	42
principiés	2	0	principies	2	1	1
prioritzarà	2	2	prioritzara	2	0	2
prioritzà	2	1	prioritza	2	33	34
prioritzàrem	2	0	prioritzarem	2	1	1
prioritzés	2	5	prioritzes	2	0	5
prioritzí	2	0	prioritzi	2	10	10
pristí	0	7	pristi	0	3	10
prisà	2	0	prisa	2	9	9
privarà	2	33	privara	2	0	33
privatitzarà	2	2	privatitzara	2	0	2
privatitzà	2	1	privatitza	2	16	17
privatitzí	2	0	privatitzi	2	4	4
privilegiarà	2	2	privilegiara	2	0	2
privilegià	2	0	privilegia	2	32	32
privà	2	3	priva	2	193	196
privàrem	2	0	privarem	2	6	6
privàreu	2	0	privareu	2	1	1
privés	2	11	prives	2	1	12
priví	2	0	privi	2	35	35
procedirà	2	270	procedira	2	0	270
procedírem	2	0	procedirem	2	190	190
procedíreu	2	0	procedireu	2	1	1
processarà	2	36	processara	2	0	36
processà	2	0	processa	2	241	241
processàreu	2	0	processareu	2	1	1
processés	2	1	processes	2	4	5
processí	2	0	processi	2	39	39
processó	4	260	processo	2	16	276
proclamarà	2	5	proclamara	2	1	6
proclamà	2	114	proclama	4	281	395
proclamàrem	2	0	proclamarem	2	6	6
proclamés	2	15	proclames	4	59	74
proclamí	2	0	proclami	2	40	40
procreà	2	0	procrea	2	1	1
procurarà	2	86	procurara	2	0	86
procurà	2	8	procura	4	252	260
procuràrem	2	0	procurarem	2	103	103
procurés	2	13	procures	4	0	13
procurí	2	0	procuri	2	143	143
prodigà	2	1	prodiga	2	5	6
produírem	2	0	produirem	2	9	9
profanà	2	0	profana	2	29	29
profanés	2	0	profanes	2	6	6
professionalitzà	2	3	professionalitza	2	1	4
professà	2	8	professa	4	37	45
professés	2	0	professes	4	2	2
professí	2	0	professi	2	7	7
professó	4	0	professo	2	17	17
profetitzà	2	1	profetitza	2	7	8
profetitzí	2	0	profetitzi	2	2	2
profetà	2	0	profeta	4	323	323
profetés	2	0	profetes	4	156	156
profunditzà	2	0	profunditza	2	1	1
profunditzés	2	1	profunditzes	2	0	1
programarà	2	4	programara	2	0	4
programà	2	7	programa	4	38481	38488
programàrem	2	0	programarem	2	2	2
programés	2	2	programes	4	18161	18163
programí	2	0	programi	2	12	12
progressarà	2	26	progressara	2	0	26
progressà	2	13	progressa	2	161	174
progressàrem	2	0	progressarem	2	24	24
progressés	2	7	progresses	2	3	10
progressí	2	0	progressi	2	131	131
progrès	2	28	progres	0	7	35
prohibirà	2	77	prohibira	2	2	79
prohibírem	2	0	prohibirem	2	17	17
projectarà	2	7	projectara	2	0	7
projectà	2	10	projecta	2	270	280
projectàrem	2	0	projectarem	2	4	4
projectés	2	6	projectes	2	14467	14473
projectí	2	0	projecti	2	17	17
proliferarà	2	1	proliferara	2	0	1
proliferà	2	1	prolifera	2	22	23
proliferí	2	0	proliferi	2	4	4
prologuí	2	0	prologui	2	1	1
prologà	2	1	prologa	2	0	1
prolongarà	2	52	prolongara	2	0	52
prolongués	2	14	prolongues	2	0	14
prolonguí	2	0	prolongui	2	96	96
prolongà	2	3	prolonga	2	96	99
prolongàrem	2	0	prolongarem	2	6	6
prolífera	0	1	prolifera	2	22	23
prometré	2	3	prometre	2	1693	1696
prometés	2	27	prometes	2	1	28
prometí	2	1	prometi	4	56	57
promiscuà	2	0	promiscua	2	3	3
promocionarà	2	9	promocionara	2	0	9
promocionà	2	1	promociona	2	59	60
promocionàrem	2	0	promocionarem	2	2	2
promocionés	2	7	promociones	2	1	8
promocioní	2	0	promocioni	2	21	21
promogués	2	36	promogues	2	0	36
promoguí	2	0	promogui	2	493	493
promouré	2	4	promoure	2	9360	9364
promulgarà	2	8	promulgara	2	0	8
promulgués	2	13	promulgues	2	1	14
promulguí	2	0	promulgui	2	28	28
promulgà	2	34	promulga	2	24	58
promulgàrem	2	0	promulgarem	2	1	1
promíscua	0	7	promiscua	2	3	10
promíscues	0	3	promiscues	2	0	3
pronosticà	2	6	pronostica	2	28	34
pronosticàrem	2	0	pronosticarem	2	1	1
pronunciarà	2	113	pronunciara	2	0	113
pronuncià	2	29	pronuncia	2	423	452
pronunciàrem	2	0	pronunciarem	2	33	33
pronunciés	2	86	pronuncies	2	3	89
pronòstic	0	182	pronostic	2	3	185
pronòstica	0	0	pronostica	2	28	28
pronúncia	4	37	pronuncia	2	423	460
pronúncies	4	4	pronuncies	2	3	7
propagarà	2	13	propagara	2	0	13
propagués	2	12	propagues	2	0	12
propaguí	2	0	propagui	2	34	34
propagà	2	8	propaga	2	129	137
propalà	2	0	propala	2	1	1
propiciarà	2	85	propiciara	2	0	85
propicià	2	10	propicia	2	31	41
propiciàrem	2	0	propiciarem	2	3	3
propiciés	2	8	propicies	2	1	9
propinarà	2	1	propinara	2	0	1
propinà	2	0	propina	4	38	38
propinés	2	0	propines	4	17	17
propiní	2	0	propini	2	2	2
proporcionarà	2	732	proporcionara	2	1	733
proporcionà	2	69	proporciona	2	5234	5303
proporcionàrem	2	1	proporcionarem	2	42	43
proporcionàreu	2	0	proporcionareu	2	5	5
proporcionés	2	121	proporciones	2	7	128
proporcioní	2	0	proporcioni	2	690	690
proposarà	2	354	proposara	2	1	355
proposà	2	202	proposa	2	8514	8716
proposàrem	2	0	proposarem	2	146	146
proposàreu	2	0	proposareu	2	1	1
proposés	2	102	proposes	2	22	124
proposí	2	0	proposi	2	613	613
propugnarà	2	3	propugnara	2	0	3
propugnà	2	2	propugna	2	232	234
propugní	2	0	propugni	2	20	20
propulsarà	2	1	propulsara	2	0	1
propulsà	2	1	propulsa	2	6	7
propí	4	1	propi	0	14104	14105
propícia	0	116	propicia	2	31	147
propícies	0	83	propicies	2	1	84
prorratejà	2	0	prorrateja	2	1	1
prorrogarà	2	12	prorrogara	2	0	12
prorrogués	2	17	prorrogues	2	0	17
prorroguí	2	0	prorrogui	2	36	36
prorrogà	2	1	prorroga	2	34	35
prorrogàrem	2	0	prorrogarem	2	2	2
prorrompré	2	0	prorrompre	2	3	3
prorrompí	2	0	prorrompi	2	1	1
proscriguí	2	0	proscrigui	2	5	5
proscriuré	2	0	proscriure	2	32	32
prospectés	2	0	prospectes	2	57	57
prosperarà	2	21	prosperara	2	0	21
prosperà	2	21	prospera	2	82	103
prosperés	2	23	prosperes	2	0	23
prosperí	2	0	prosperi	2	91	91
prosseguirà	2	143	prosseguira	2	0	143
prosseguírem	2	0	prosseguirem	2	62	62
prosternà	2	1	prosterna	2	0	1
prostrarà	2	1	prostrara	2	0	1
prostrà	2	0	prostra	2	2	2
prostrés	2	1	prostres	2	0	1
protagonitzarà	2	5	protagonitzara	2	0	5
protagonitzà	2	33	protagonitza	2	47	80
protagonitzés	2	2	protagonitzes	2	0	2
protagonitzí	2	0	protagonitzi	2	5	5
protegirà	2	208	protegira	2	0	208
protegírem	2	0	protegirem	2	49	49
protegíreu	2	0	protegireu	2	3	3
protestarà	2	4	protestara	2	0	4
protestà	2	23	protesta	4	1604	1627
protestàrem	2	0	protestarem	2	3	3
protestés	2	9	protestes	4	1706	1715
protestí	2	0	protesti	2	28	28
provarà	2	57	provara	2	0	57
provindré	2	0	provindre	2	1	1
provingués	2	9	provingues	2	0	9
provinguí	2	0	provingui	2	90	90
provisòria	0	2	provisoria	4	1	3
provisòries	0	4	provisories	4	0	4
provocarà	2	382	provocara	2	1	383
provocà	2	205	provoca	2	1588	1793
provocàrem	2	0	provocarem	2	12	12
provocàreu	2	0	provocareu	2	3	3
provoqués	2	46	provoques	2	2	48
provoquí	2	0	provoqui	2	143	143
provà	2	66	prova	4	9391	9457
provàrem	2	0	provarem	2	21	21
provàreu	2	0	provareu	2	1	1
prové	2	1980	prove	2	11	1991
provén	2	0	proven	2	146	146
provés	2	27	proves	4	8465	8492
proví	2	0	provi	2	80	80
pràctic	0	1525	practic	2	2	1527
pràctica	0	16391	practica	2	505	16896
pràctiques	0	8443	practiques	2	5	8448
prèdica	4	10	predica	2	60	70
prèdiques	4	5	prediques	2	2	7
prístina	0	5	pristina	0	191	196
prístines	0	2	pristines	0	2	4
pròdiga	0	9	prodiga	2	5	14
pròdigues	0	2	prodigues	2	0	2
pròrroga	4	754	prorroga	2	34	788
pròrrogues	4	69	prorrogues	2	0	69
pròsperes	0	154	prosperes	2	0	154
pròtasi	4	1	protasi	4	2	3
pròteus	4	2	proteus	4	24	26
psicoanalitzà	2	1	psicoanalitza	2	0	1
psicoanalitzés	2	0	psicoanalitzes	2	1	1
publicarà	2	329	publicara	2	4	333
publicità	2	0	publicita	2	5	5
publicitària	0	199	publicitaria	2	2	201
publicitàries	0	160	publicitaries	2	2	162
publicití	2	0	publiciti	2	2	2
publicà	2	814	publica	2	1154	1968
publicàrem	2	0	publicarem	2	52	52
publicàreu	2	0	publicareu	2	1	1
publiqués	2	138	publiques	2	14	152
publiquí	2	0	publiqui	2	225	225
pugnà	2	0	pugna	4	76	76
pugnés	2	1	pugnes	4	10	11
pugní	2	0	pugni	2	5	5
pugés	2	32	puges	4	11	43
pugí	2	0	pugi	2	127	127
pujarà	2	46	pujara	2	0	46
pujà	2	23	puja	4	702	725
pujàrem	2	1	pujarem	2	11	12
pujàreu	2	0	pujareu	2	4	4
pullés	0	1	pulles	4	3	4
pul·lulà	2	0	pul·lula	2	1	1
puntejà	2	0	punteja	2	4	4
puntualitzà	2	0	puntualitza	2	12	12
puntualitzés	2	1	puntualitzes	2	0	1
puntualitzí	2	0	puntualitzi	2	2	2
puntuarà	2	13	puntuara	2	0	13
puntuà	2	44	puntua	2	74	118
puntuàreu	2	0	puntuareu	2	1	1
puntués	2	1	puntues	2	0	1
puntà	2	0	punta	4	1499	1499
puntés	2	0	puntes	4	443	443
punxarà	2	1	punxara	2	1	2
punxà	2	2	punxa	4	39	41
punxàrem	2	0	punxarem	2	1	1
punxés	2	0	punxes	4	67	67
punxó	4	15	punxo	2	2	17
purgarà	2	4	purgara	2	0	4
purgués	2	1	purgues	4	100	101
purgà	2	2	purga	4	236	238
purificarà	2	1	purificara	2	0	1
purificà	2	2	purifica	2	12	14
purifiqués	2	1	purifiques	2	0	1
purifiquí	2	0	purifiqui	2	1	1
purpurí	0	0	purpuri	0	4	4
purés	4	2	pures	0	118	120
purí	4	2	puri	4	16	18
pàg	7	282	pag	2	10	292
pàgina	4	13733	pagina	2	18	13751
pàgines	4	4755	pagines	2	3	4758
pàlmer	4	0	palmer	4	301	301
pàlmers	4	0	palmers	4	4	4
pàl·lia	4	1	pal·lia	2	3	4
pària	4	40	paria	4	12	52
pàries	4	16	paries	4	1	17
pàssera	4	0	passera	4	7	7
pàsseres	4	0	passeres	4	3	3
pàtina	4	12	patina	2	16	28
pàtines	4	2	patines	2	1	3
pèl	4	632	pel	2	121555	122187
pèls	4	308	pels	7	44005	44313
pèndol	4	159	pendol	2	0	159
pèndola	4	3	pendola	2	0	3
pèndul	0	4	pendul	2	0	4
pèndula	0	0	pendula	2	2	2
pèndules	0	7	pendules	2	0	7
pènol	4	2	penol	4	0	2
pèons	4	0	peons	4	476	476
pèrit	0	7	perit	2	39	46
pèrites	0	0	perites	0	1	1
pèrits	0	2	perits	2	30	32
pètita	4	0	petita	0	9426	9426
pètites	4	0	petites	0	12153	12153
pífia	4	5	pifia	2	0	5
pífies	4	1	pifies	2	0	1
píxel	4	811	pixel	2	42	853
pòlies	4	0	polies	2	1	1
pòlisses	4	75	polisses	2	0	75
pòntic	0	9	pontic	4	3	12
pòrtland	4	9	portland	4	329	338
pórca	4	0	porca	0	13	13
pórques	4	0	porques	0	2	2
públic	0	17303	public	2	335	17638
pública	0	18137	publica	2	1154	19291
públiques	0	7045	publiques	2	14	7059
quadriculà	2	0	quadricula	2	4	4
quadruplicarà	2	2	quadruplicara	2	0	2
quadruplicà	2	0	quadruplica	2	4	4
quadrupliqués	2	1	quadrupliques	2	0	1
quadrupliquí	2	0	quadrupliqui	2	2	2
quadrà	2	1	quadra	4	113	114
quadrés	2	0	quadres	4	1052	1052
quadrí	2	0	quadri	2	8	8
quadrícula	4	595	quadricula	2	4	599
quadrícules	4	50	quadricules	2	0	50
quadró	4	0	quadro	4	5	5
qualificarà	2	12	qualificara	2	0	12
qualificà	2	36	qualifica	2	275	311
qualificàrem	2	0	qualificarem	2	1	1
qualifiqués	2	7	qualifiques	2	0	7
qualifiquí	2	0	qualifiqui	2	42	42
quallarà	2	4	quallara	2	0	4
quallà	2	0	qualla	2	6	6
quallés	2	1	qualles	2	1	2
quantificà	2	1	quantifica	2	29	30
quantificàrem	2	0	quantificarem	2	2	2
quantifiqués	2	1	quantifiques	2	1	2
quantifiquí	2	0	quantifiqui	2	5	5
quantitzà	2	0	quantitza	2	2	2
quaranta-quatrè	0	1	quaranta-quatre	3	29	30
quaranta-quatré	0	0	quaranta-quatre	3	29	29
quartarà	2	0	quartara	2	1	1
quarterà	2	0	quartera	0	1	1
quarterés	2	0	quarteres	0	1	1
quarteró	0	1	quartero	2	0	1
quartà	2	0	quarta	0	2485	2485
quartés	2	0	quartes	0	286	286
quartó	4	0	quarto	2	11	11
quatretondà	0	0	quatretonda	4	4	4
quatrè	0	0	quatre	3	22228	22228
quatré	0	0	quatre	3	22228	22228
quedarà	2	972	quedara	2	5	977
quedà	2	401	queda	4	9537	9938
quedàrem	2	1	quedarem	2	149	150
quedàreu	2	0	quedareu	2	13	13
quedés	2	422	quedes	4	117	539
quedí	2	0	quedi	2	1983	1983
queixarà	2	7	queixara	2	0	7
queixà	2	17	queixa	4	777	794
queixàrem	2	0	queixarem	2	1	1
queixés	2	4	queixes	4	1225	1229
queixí	2	0	queixi	2	12	12
queixós	0	5	queixos	4	1	6
quequejà	2	0	quequeja	2	3	3
querellà	2	1	querella	4	47	48
querellés	2	0	querelles	4	39	39
querà	2	0	quera	4	2	2
quillà	2	0	quilla	4	69	69
quillés	2	0	quilles	4	4	4
quilometrés	2	0	quilometres	2	39	39
quilòmetre	4	320	quilometre	2	2	322
quilòmetres	4	3050	quilometres	2	39	3089
quilós	0	0	quilos	4	220	220
quintaessencià	2	0	quintaessencia	2	1	1
quintuplicarà	2	1	quintuplicara	2	0	1
quintuplicà	2	0	quintuplica	2	2	2
quintupliquí	2	0	quintupliqui	2	1	1
quintés	2	0	quintes	0	24	24
quinzè	0	62	quinze	3	3300	3362
quinzé	0	3	quinze	3	3300	3303
quissó	4	0	quisso	4	5	5
quitó	4	1	quito	4	76	77
què	5	86338	que	1	2317413	2403751
qüestionarà	2	14	qüestionara	2	0	14
qüestionà	2	14	qüestiona	2	404	418
qüestionàrem	2	0	qüestionarem	2	6	6
qüestionés	2	11	qüestiones	2	4	15
qüestioní	2	0	qüestioni	2	89	89
rabià	2	0	rabia	2	10	10
rabiés	2	0	rabies	2	1	1
raciociní	2	0	raciocini	2	8	8
racionalitzarà	2	5	racionalitzara	2	0	5
racionalitzà	2	1	racionalitza	2	21	22
racionalitzí	2	0	racionalitzi	2	19	19
racionarà	2	1	racionara	2	0	1
racionàrem	2	0	racionarem	2	1	1
racioní	2	0	racioni	2	2	2
radicalitzarà	2	1	radicalitzara	2	0	1
radicalitzà	2	4	radicalitza	2	6	10
radicalitzí	2	0	radicalitzi	2	4	4
radicarà	2	19	radicara	2	0	19
radicà	2	0	radica	2	880	880
radiografià	2	0	radiografia	4	54	54
radiografiés	2	0	radiografies	4	30	30
radiotelegrafià	2	0	radiotelegrafia	4	29	29
radiqués	2	1	radiques	2	0	1
radiquí	2	0	radiqui	2	13	13
radià	2	0	radia	2	9	9
radií	2	0	radii	2	1	1
radó	4	64	rado	4	2	66
ragusà	4	1	ragusa	4	34	35
ragués	2	0	ragues	2	1	1
ragés	2	0	rages	2	7	7
ragí	2	0	ragi	2	3	3
rajà	2	22	raja	2	153	175
ralentitzés	2	0	ralentitzes	2	1	1
rallà	2	0	ralla	2	1	1
rallí	2	0	ralli	2	3	3
ramadà	4	64	ramada	4	5	69
ramalés	2	0	ramales	2	1	1
ramificà	2	0	ramifica	2	14	14
ramifiqués	2	1	ramifiques	2	0	1
rampinyà	2	0	rampinya	2	13	13
ramà	2	0	rama	4	140	140
ramària	4	0	ramaria	2	1	1
ramés	2	0	rames	4	10	10
ramí	2	0	rami	2	19	19
ramós	0	0	ramos	4	273	273
rancià	2	0	rancia	2	3	3
randà	2	0	randa	4	59	59
randí	2	0	randi	2	18	18
ranejà	2	0	raneja	2	22	22
ranquejà	2	0	ranqueja	2	2	2
ranurà	2	0	ranura	4	209	209
ranurés	2	0	ranures	4	126	126
raonà	2	3	raona	2	20	23
raonés	2	0	raones	2	3	3
raoní	2	0	raoni	2	6	6
rapegí	2	0	rapegi	2	1	1
rapejà	2	0	rapeja	2	3	3
rapinyà	2	0	rapinya	4	5	5
raptarà	2	1	raptara	2	0	1
raptà	2	0	rapta	2	4	4
raptés	2	1	raptes	2	18	19
raptí	2	0	rapti	2	13	13
rapà	2	0	rapa	4	15	15
rapè	4	22	rape	2	15	37
rapès	4	0	rapes	4	2	2
rapé	4	0	rape	2	15	15
rapés	2	1	rapes	4	2	3
rarificà	2	0	rarifica	2	2	2
rasclà	2	0	rascla	4	1	1
rascló	4	7	rasclo	2	0	7
rascà	2	0	rasca	4	9	9
raspallà	2	0	raspalla	2	7	7
raspallí	2	0	raspalli	2	1	1
raspà	2	0	raspa	4	4	4
rasquerà	0	0	rasquera	4	2	2
rasqués	2	0	rasques	4	6	6
rastellà	2	0	rastella	2	1	1
rasteritzà	2	0	rasteritza	2	7	7
rastregés	2	1	rastreges	2	1	2
rastregí	2	0	rastregi	2	4	4
rastrejà	2	0	rastreja	2	48	48
rastrejàrem	2	0	rastrejarem	2	2	2
rasà	2	0	rasa	0	150	150
rasés	2	1	rases	0	52	53
rasí	2	0	rasi	2	1	1
ratificarà	2	65	ratificara	2	0	65
ratificà	2	21	ratifica	2	148	169
ratificàrem	2	0	ratificarem	2	9	9
ratifiqués	2	55	ratifiques	2	0	55
ratifiquí	2	0	ratifiqui	2	318	318
ratllà	2	0	ratlla	4	333	333
ratllés	2	1	ratlles	4	340	341
ratllí	2	0	ratlli	2	4	4
ratxà	2	0	ratxa	4	111	111
ratxés	2	0	ratxes	4	65	65
ratà	2	0	rata	4	237	237
ratés	2	0	rates	0	348	348
ratí	2	0	rati	2	66	66
rauquí	2	0	rauqui	2	2	2
rauré	2	0	raure	2	4	4
reaccionarà	2	57	reaccionara	2	0	57
reaccionà	2	12	reacciona	2	263	275
reaccionàrem	2	0	reaccionarem	2	11	11
reaccionària	0	112	reaccionaria	2	28	140
reaccionàries	0	71	reaccionaries	2	0	71
reaccionés	2	19	reacciones	2	6	25
reaccioní	2	0	reaccioni	2	90	90
reactivarà	2	6	reactivara	2	0	6
reactivà	2	3	reactiva	0	115	118
reactivàrem	2	0	reactivarem	2	1	1
reactivés	2	2	reactives	0	82	84
reactiví	2	0	reactivi	2	10	10
readaptarà	2	1	readaptara	2	0	1
readaptà	2	0	readapta	2	1	1
readmetré	2	0	readmetre	2	26	26
readmetés	2	1	readmetes	2	0	1
reafirmarà	2	16	reafirmara	2	0	16
reafirmà	2	14	reafirma	2	281	295
reafirmàrem	2	0	reafirmarem	2	6	6
reafirmés	2	10	reafirmes	2	0	10
reafirmí	2	0	reafirmi	2	71	71
reagruparà	2	3	reagrupara	2	0	3
reagrupà	2	4	reagrupa	2	10	14
reagrupàrem	2	0	reagruparem	2	1	1
reagrupés	2	3	reagrupes	2	0	3
reagrupí	2	0	reagrupi	2	5	5
reajustà	2	0	reajusta	2	5	5
reajustí	2	0	reajusti	2	2	2
realcí	2	0	realci	2	9	9
realimentà	2	0	realimenta	2	2	2
realineà	2	1	realinea	2	3	4
realitzarà	2	580	realitzara	2	3	583
realitzà	2	337	realitza	2	2436	2773
realitzàrem	2	1	realitzarem	2	106	107
realitzàreu	2	0	realitzareu	2	4	4
realitzés	2	246	realitzes	2	7	253
realitzí	2	0	realitzi	2	1118	1118
realçarà	2	8	realçara	2	0	8
realçà	2	0	realça	2	90	90
reanimà	2	0	reanima	2	5	5
reanomenarà	2	3	reanomenara	2	0	3
reanomenà	2	18	reanomena	2	281	299
reanomenés	2	2	reanomenes	2	0	2
reanomení	2	0	reanomeni	2	2	2
reapareguí	2	0	reaparegui	2	6	6
reaprendré	2	0	reaprendre	2	1	1
rearmà	2	0	rearma	2	4	4
rearmés	2	2	rearmes	2	0	2
rearmí	2	0	rearmi	2	1	1
reassegurés	2	1	reassegures	2	0	1
reassentà	2	1	reassenta	2	0	1
reassignarà	2	2	reassignara	2	0	2
reassignà	2	0	reassigna	2	24	24
reassignàrem	2	0	reassignarem	2	1	1
reassignés	2	1	reassignes	2	0	1
reassigní	2	0	reassigni	2	5	5
reavaluarà	2	1	reavaluara	2	0	1
reavaluà	2	1	reavalua	2	6	7
rebaixarà	2	12	rebaixara	2	0	12
rebaixà	2	2	rebaixa	4	181	183
rebaixàrem	2	0	rebaixarem	2	3	3
rebaixés	2	6	rebaixes	4	100	106
rebaixí	2	0	rebaixi	2	27	27
reballà	2	0	reballa	2	1	1
rebatejà	2	7	rebateja	2	1	8
rebatré	2	1	rebatre	2	99	100
rebatés	2	1	rebates	2	0	1
rebatí	2	0	rebati	2	3	3
rebecà	2	0	rebeca	4	20	20
rebel·larà	2	1	rebel·lara	2	0	1
rebel·là	2	6	rebel·la	2	20	26
rebel·lés	2	1	rebel·les	2	0	1
rebel·lí	2	0	rebel·li	2	2	2
rebentarà	2	3	rebentara	2	0	3
rebentà	2	1	rebenta	2	15	16
rebentés	2	1	rebentes	2	0	1
rebentí	2	0	rebenti	2	1	1
rebequés	2	0	rebeques	4	1	1
rebesnét	4	10	rebesnet	4	4	14
rebesnéta	4	5	rebesneta	4	0	5
rebesnéts	4	2	rebesnets	4	0	2
reblà	2	1	rebla	2	0	1
reblés	2	0	rebles	2	3	3
rebló	4	5	reblo	2	0	5
rebobinà	2	0	rebobina	2	27	27
rebolcà	2	0	rebolca	2	1	1
rebolicà	2	0	rebolica	4	1	1
rebolqués	2	0	rebolques	2	1	1
rebotarà	2	3	rebotara	2	0	3
rebotà	2	0	rebota	2	36	36
rebotí	2	0	reboti	2	6	6
rebregarà	2	1	rebregara	2	0	1
rebregués	2	0	rebregues	2	1	1
rebrotà	2	1	rebrota	2	3	4
rebré	2	37	rebre	2	16177	16214
rebuscà	2	0	rebusca	2	1	1
rebusqués	2	1	rebusques	2	0	1
rebutgés	2	148	rebutges	2	6	154
rebutgí	2	0	rebutgi	2	409	409
rebutjarà	2	81	rebutjara	2	1	82
rebutjà	2	137	rebutja	2	1426	1563
rebutjàrem	2	0	rebutjarem	2	52	52
rebés	2	184	rebes	2	3	187
rebí	2	0	rebi	2	793	793
rebò	0	0	rebo	2	149	149
recaigués	2	7	recaigues	2	0	7
recaiguí	2	0	recaigui	2	80	80
recalarà	2	0	recalara	2	1	1
recalcarà	2	6	recalcara	2	0	6
recalcularà	2	2	recalculara	2	0	2
recalculà	2	0	recalcula	2	46	46
recalculí	2	0	recalculi	2	3	3
recalcà	2	3	recalca	2	196	199
recalcàrem	2	0	recalcarem	2	1	1
recalqués	2	3	recalques	2	0	3
recalquí	2	0	recalqui	2	21	21
recalà	2	10	recala	2	5	15
recalés	2	1	recales	2	0	1
recamí	2	0	recami	2	1	1
recapacitarà	2	2	recapacitara	2	0	2
recapacità	2	0	recapacita	2	4	4
recapacitàrem	2	0	recapacitarem	2	4	4
recapacités	2	5	recapacites	2	0	5
recapacití	2	0	recapaciti	2	39	39
recapitalitzí	2	0	recapitalitzi	2	1	1
recapitulà	2	1	recapitula	2	5	6
recapitulí	2	0	recapituli	2	6	6
recaptarà	2	8	recaptara	2	0	8
recapturà	2	1	recaptura	2	12	13
recaptà	2	8	recapta	2	46	54
recaptàrem	2	0	recaptarem	2	6	6
recaptés	2	4	recaptes	2	0	4
recaptí	2	0	recapti	2	24	24
recargolà	2	0	recargola	2	1	1
recarregarà	2	9	recarregara	2	0	9
recarregués	2	1	recarregues	2	2	3
recarreguí	2	0	recarregui	2	10	10
recarregà	2	0	recarrega	2	138	138
recauré	2	0	recaure	2	287	287
recavà	2	0	recava	2	2	2
recelà	2	0	recela	2	6	6
recepcionà	2	0	recepciona	2	1	1
receptà	2	0	recepta	4	593	593
receptés	2	1	receptes	4	400	401
recercà	2	0	recerca	4	26373	26373
recerqués	2	0	recerques	4	2691	2691
reciclarà	2	4	reciclara	2	0	4
reciclà	2	1	recicla	2	31	32
reciclàrem	2	0	reciclarem	2	1	1
reciclés	2	1	recicles	2	0	1
reciclí	2	0	recicli	2	5	5
recidivà	2	0	recidiva	4	2	2
reciprocà	2	0	reciproca	2	2	2
reciproqués	2	0	reciproques	2	1	1
recità	2	3	recita	2	35	38
recités	2	2	recites	2	1	3
recití	2	0	reciti	2	1	1
reclamarà	2	22	reclamara	2	0	22
reclamà	2	82	reclama	2	615	697
reclamàrem	2	0	reclamarem	2	8	8
reclamàreu	2	0	reclamareu	2	1	1
reclamés	2	21	reclames	2	2	23
reclamí	2	0	reclami	2	51	51
reclassificarà	2	1	reclassificara	2	0	1
reclassificà	2	9	reclassifica	2	8	17
reclassifiquí	2	0	reclassifiqui	2	3	3
reclinà	2	1	reclina	2	2	3
recliní	2	0	reclini	2	1	1
reclouré	2	0	recloure	2	14	14
reclutarà	2	1	reclutara	2	0	1
reclutà	2	16	recluta	4	73	89
reclutàrem	2	0	reclutarem	2	1	1
reclutés	2	4	reclutes	4	187	191
reclutí	2	0	recluti	2	2	2
recobrarà	2	4	recobrara	2	1	5
recobrirà	2	1	recobrira	2	0	1
recobrà	2	10	recobra	2	6	16
recobràrem	2	0	recobrarem	2	3	3
recobrés	2	5	recobres	2	0	5
recobrí	2	0	recobri	2	12	12
recodificà	2	0	recodifica	2	13	13
recollirà	2	88	recollira	2	0	88
recollírem	2	0	recollirem	2	17	17
recolonitzà	2	1	recolonitza	2	0	1
recolzarà	2	152	recolzara	2	0	152
recolzà	2	33	recolza	2	1143	1176
recolzàrem	2	0	recolzarem	2	88	88
recolzés	2	33	recolzes	2	5	38
recolzí	2	0	recolzi	2	347	347
recol·lectà	2	0	recol·lecta	2	30	30
recol·lectàreu	2	0	recol·lectareu	2	1	1
recol·lectés	2	0	recol·lectes	2	5	5
recol·lectí	2	0	recol·lecti	2	1	1
recol·locà	2	2	recol·loca	2	3	5
recol·locàrem	2	0	recol·locarem	2	1	1
recomanarà	2	38	recomanara	2	1	39
recomanà	2	52	recomana	2	1584	1636
recomanàrem	2	0	recomanarem	2	12	12
recomanés	2	25	recomanes	2	5	30
recomaní	2	0	recomani	2	81	81
recombinà	2	0	recombina	2	6	6
recomençà	2	1	recomença	2	2	3
recomençàrem	2	0	recomençarem	2	1	1
recompensarà	2	14	recompensara	2	0	14
recompensà	2	2	recompensa	4	591	593
recompensàrem	2	0	recompensarem	2	4	4
recompensés	2	2	recompenses	4	212	214
recompensí	2	0	recompensi	2	35	35
recompilà	2	0	recompila	2	3	3
recompilí	2	0	recompili	2	1	1
recompondré	2	1	recompondre	2	34	35
recomponguí	2	0	recompongui	2	1	1
recomprà	2	0	recompra	4	41	41
recomprés	2	0	recompres	4	1	1
recomptarà	2	2	recomptara	2	0	2
recomptà	2	0	recompta	2	1	1
recomptés	2	0	recomptes	2	76	76
reconciliarà	2	2	reconciliara	2	0	2
reconcilià	2	6	reconcilia	2	40	46
reconciliàrem	2	0	reconciliarem	2	2	2
reconciliés	2	5	reconcilies	2	0	5
reconegués	2	143	reconegues	2	0	143
reconeguí	2	0	reconegui	2	999	999
reconfigurà	2	0	reconfigura	2	9	9
reconfirmà	2	0	reconfirma	2	2	2
reconfirmés	2	1	reconfirmes	2	0	1
reconfirmí	2	0	reconfirmi	2	1	1
reconfortarà	2	1	reconfortara	2	0	1
reconfortà	2	0	reconforta	2	37	37
reconfortés	2	0	reconfortes	2	1	1
reconfortí	2	0	reconforti	2	1	1
reconnectà	2	0	reconnecta	2	17	17
reconnectí	2	0	reconnecti	2	1	1
reconquerirà	2	1	reconquerira	2	0	1
reconquerírem	2	0	reconquerirem	2	2	2
reconquistà	2	2	reconquista	4	4	6
reconsiderarà	2	14	reconsiderara	2	0	14
reconsiderà	2	1	reconsidera	2	7	8
reconsideràrem	2	0	reconsiderarem	2	1	1
reconsiderés	2	42	reconsideres	2	1	43
reconsiderí	2	0	reconsideri	2	198	198
reconstruírem	2	0	reconstruirem	2	2	2
recontà	2	0	reconta	2	1	1
recontés	2	0	recontes	2	1	1
reconvertirà	2	2	reconvertira	2	0	2
recopilarà	2	21	recopilara	2	0	21
recopilà	2	4	recopila	2	72	76
recopilàrem	2	0	recopilarem	2	2	2
recopilés	2	8	recopiles	2	1	9
recopilí	2	0	recopili	2	14	14
recordarà	2	321	recordara	2	1	322
recordà	2	29	recorda	2	2634	2663
recordàrem	2	0	recordarem	2	94	94
recordàreu	2	0	recordareu	2	15	15
recordés	2	55	recordes	2	519	574
recordí	2	0	recordi	2	551	551
recouré	2	0	recoure	2	1	1
recrearà	2	3	recreara	2	0	3
recremà	2	0	recrema	2	1	1
recreà	2	4	recrea	2	38	42
recreàrem	2	0	recrearem	2	2	2
recriminà	2	1	recrimina	2	9	10
recriminàrem	2	0	recriminarem	2	1	1
recriminí	2	0	recrimini	2	2	2
recristal·litzà	2	0	recristal·litza	2	1	1
rectificarà	2	10	rectificara	2	0	10
rectificà	2	2	rectifica	2	39	41
rectificàrem	2	0	rectificarem	2	21	21
rectifiqués	2	10	rectifiques	2	1	11
rectifiquí	2	0	rectifiqui	2	61	61
reculà	2	2	recula	2	17	19
reculàrem	2	0	recularem	2	5	5
reculí	2	0	reculi	2	2	2
recuperarà	2	105	recuperara	2	3	108
recuperà	2	80	recupera	2	497	577
recuperàrem	2	0	recuperarem	2	40	40
recuperàreu	2	0	recuperareu	2	2	2
recuperés	2	55	recuperes	2	6	61
recuperí	2	0	recuperi	2	258	258
recusà	2	0	recusa	2	2	2
recà	2	0	reca	2	12	12
recàlcul	4	16	recalcul	2	0	16
recàrrega	4	103	recarrega	2	138	241
recàrregues	4	6	recarregues	2	2	8
recàveu	2	0	recaveu	2	1	1
recíproc	0	349	reciproc	2	1	350
recíproca	0	398	reciproca	2	2	400
recíproques	0	121	reciproques	2	1	122
recòndit	0	5	recondit	2	0	5
recòndits	0	5	recondits	2	0	5
redactarà	2	49	redactara	2	0	49
redactà	2	26	redacta	2	84	110
redactàrem	2	0	redactarem	2	9	9
redactés	2	33	redactes	2	0	33
redactí	2	0	redacti	2	100	100
redecorí	2	0	redecori	2	1	1
redefinirà	2	4	redefinira	2	0	4
redefinírem	2	0	redefinirem	2	2	2
redenominà	2	1	redenomina	2	0	1
redibuixarà	2	5	redibuixara	2	0	5
redibuixà	2	1	redibuixa	2	15	16
redimensionarà	2	27	redimensionara	2	3	30
redimensionà	2	0	redimensiona	2	192	192
redimensioní	2	0	redimensioni	2	5	5
redimirà	2	2	redimira	2	0	2
redirigirà	2	12	redirigira	2	0	12
redirigírem	2	0	redirigirem	2	1	1
redissenyà	2	4	redissenya	2	3	7
redissenyés	2	1	redissenyes	2	1	2
redoblarà	2	12	redoblara	2	0	12
redoblà	2	0	redobla	2	5	5
redoblàrem	2	0	redoblarem	2	7	7
redoblés	2	2	redobles	2	0	2
redoblí	2	0	redobli	2	20	20
redolà	2	0	redola	2	1	1
redolí	2	4	redoli	2	0	4
redrecí	2	0	redreci	2	3	3
redreçà	2	1	redreça	2	18	19
redundarà	2	199	redundara	2	0	199
redundà	2	0	redunda	2	426	426
redundés	2	2	redundes	2	0	2
redundí	2	0	redundi	2	68	68
reduírem	2	0	reduirem	2	63	63
reduíreu	2	0	reduireu	2	2	2
redéu	7	18	redeu	7	1	19
reedificà	2	2	reedifica	2	0	2
reedità	2	4	reedita	2	1	5
reeduquí	2	0	reeduqui	2	1	1
reeixirà	2	1	reeixira	2	0	1
reelaborà	2	2	reelabora	2	4	6
reelaborí	2	0	reelabori	2	1	1
reemborsarà	2	12	reemborsara	2	0	12
reemborsà	2	1	reemborsa	2	11	12
reemborsàrem	2	0	reemborsarem	2	1	1
reemborsàreu	2	0	reemborsareu	2	1	1
reemborsés	2	2	reemborses	2	0	2
reemborsí	2	0	reemborsi	2	14	14
reemetré	2	0	reemetre	2	5	5
reempaquetà	2	0	reempaqueta	2	2	2
reemplacés	2	17	reemplaces	2	2	19
reemplací	2	0	reemplaci	2	48	48
reemplaçarà	2	89	reemplaçara	2	2	91
reemplaçà	2	41	reemplaça	2	576	617
reemplaçàrem	2	0	reemplaçarem	2	6	6
reencaminarà	2	1	reencaminara	2	0	1
reencarnà	2	0	reencarna	2	2	2
reenfocà	2	0	reenfoca	2	1	1
reentrí	2	0	reentri	2	1	1
reenviarà	2	10	reenviara	2	0	10
reenvià	2	0	reenvia	2	94	94
reenviàrem	2	0	reenviarem	2	1	1
reenviés	2	0	reenvies	2	1	1
reequilibrarà	2	1	reequilibrara	2	0	1
reequilibrà	2	0	reequilibra	2	1	1
reequilibrés	2	2	reequilibres	2	0	2
reequilibrí	2	0	reequilibri	2	95	95
reescalfà	2	1	reescalfa	2	2	3
reescrigués	2	2	reescrigues	2	0	2
reescriguí	2	0	reescrigui	2	5	5
reescriuré	2	0	reescriure	2	214	214
reestimà	2	0	reestima	2	1	1
reestrenà	2	1	reestrena	4	23	24
reestrenés	2	0	reestrenes	4	4	4
reestructurarà	2	3	reestructurara	2	0	3
reestructurà	2	7	reestructura	2	25	32
reestructuràrem	2	0	reestructurarem	2	2	2
reestructurés	2	1	reestructures	2	0	1
reestructurí	2	0	reestructuri	2	10	10
reexaminarà	2	8	reexaminara	2	0	8
reexaminà	2	3	reexamina	2	3	6
reexaminàrem	2	0	reexaminarem	2	2	2
reexaminés	2	1	reexamines	2	0	1
reexaminí	2	0	reexamini	2	8	8
reexplicà	2	0	reexplica	2	1	1
reexposà	2	0	reexposa	2	1	1
referenciarà	2	1	referenciara	2	0	1
referencià	2	0	referencia	2	110	110
referenciés	2	0	referencies	2	9	9
referendarà	2	1	referendara	2	0	1
referendària	0	3	referendaria	2	2	5
referirà	2	73	referira	2	0	73
refermarà	2	1	refermara	2	0	1
refermà	2	1	referma	2	7	8
refermí	2	0	refermi	2	1	1
referència	4	14598	referencia	2	110	14708
referències	4	2632	referencies	2	9	2641
referírem	2	0	referirem	2	23	23
refilà	2	0	refila	2	1	1
refinancés	2	1	refinances	2	0	1
refinancí	2	0	refinanci	2	1	1
refinançarà	2	1	refinançara	2	0	1
refinançà	2	0	refinança	2	1	1
refinarà	2	1	refinara	2	0	1
refinà	2	1	refina	2	17	18
refiní	2	0	refini	2	1	1
refià	2	1	refia	2	4	5
refiés	2	2	refies	2	3	5
refií	2	0	refii	2	2	2
reflectirà	2	139	reflectira	2	0	139
reflectírem	2	0	reflectirem	2	3	3
reflectíreu	2	0	reflectireu	2	1	1
reflexionarà	2	29	reflexionara	2	0	29
reflexionà	2	1	reflexiona	2	87	88
reflexionàrem	2	0	reflexionarem	2	20	20
reflexionés	2	29	reflexiones	2	2	31
reflexioní	2	0	reflexioni	2	163	163
refondré	2	0	refondre	2	50	50
refonguí	2	0	refongui	2	2	2
reforcés	2	47	reforces	2	1	48
reforcí	2	0	reforci	2	446	446
reforjà	2	0	reforja	2	1	1
reformarà	2	18	reformara	2	0	18
reformatarà	2	7	reformatara	2	0	7
reformatà	2	0	reformata	2	14	14
reformulà	2	0	reformula	2	8	8
reformulés	2	2	reformules	2	0	2
reformulí	2	0	reformuli	2	4	4
reformà	2	17	reforma	4	14154	14171
reformàrem	2	1	reformarem	2	9	10
reformés	2	13	reformes	4	8562	8575
reformí	2	0	reformi	2	67	67
reforçarà	2	376	reforçara	2	1	377
reforçà	2	19	reforça	2	1003	1022
reforçàrem	2	0	reforçarem	2	42	42
refractà	2	0	refracta	2	6	6
refractària	0	5	refractaria	2	1	6
refractàries	0	8	refractaries	2	0	8
refractí	2	0	refracti	2	1	1
refredarà	2	10	refredara	2	0	10
refredà	2	4	refreda	2	98	102
refredés	2	8	refredes	2	0	8
refredí	2	0	refredi	2	22	22
refregués	2	0	refregues	2	1	1
refregà	2	0	refrega	2	13	13
refrenarà	2	1	refrenara	2	0	1
refrenà	2	2	refrena	2	3	5
refrenés	2	2	refrenes	2	0	2
refrení	2	0	refreni	2	1	1
refrescarà	2	6	refrescara	2	0	6
refrescà	2	0	refresca	2	199	199
refresqués	2	1	refresques	2	0	1
refresquí	2	0	refresqui	2	5	5
refrigerarà	2	1	refrigerara	2	0	1
refrigerà	2	0	refrigera	2	5	5
refrigerés	2	0	refrigeres	2	1	1
refrigerí	2	0	refrigeri	2	10	10
refugiarà	2	1	refugiara	2	0	1
refugià	2	11	refugia	2	34	45
refugiàrem	2	0	refugiarem	2	1	1
refugiés	2	3	refugies	2	0	3
refundà	2	6	refunda	2	1	7
refundí	2	0	refundi	2	10	10
refusarà	2	11	refusara	2	0	11
refusà	2	54	refusa	2	74	128
refusés	2	17	refuses	2	6	23
refusí	2	0	refusi	2	9	9
refutà	2	4	refuta	2	23	27
refutí	2	0	refuti	2	11	11
reféu	2	1	refeu	2	3	4
regalarà	2	5	regalara	2	0	5
regalimà	2	0	regalima	2	3	3
regallà	2	0	regalla	2	1	1
regalà	2	7	regala	4	20	27
regalàrem	2	0	regalarem	2	2	2
regalés	2	2	regales	4	3	5
regalí	2	0	regali	2	5	5
reganyà	2	0	reganya	2	2	2
reganí	2	0	regani	2	22	22
regategés	2	0	regateges	2	1	1
regategí	2	0	regategi	2	1	1
regatejarà	2	2	regatejara	2	0	2
regatejà	2	0	regateja	2	7	7
regatà	2	0	regata	4	51	51
regatés	2	0	regates	4	22	22
regató	4	0	regato	2	1	1
regenerarà	2	7	regenerara	2	0	7
regenerà	2	0	regenera	2	51	51
regenerés	2	1	regeneres	2	0	1
regentarà	2	1	regentara	2	0	1
regentà	2	1	regenta	2	19	20
regentés	2	0	regentes	2	1	1
regentí	2	1	regenti	2	1	2
regionalitzà	2	0	regionalitza	2	2	2
regirarà	2	1	regirara	2	0	1
regirà	2	52	regira	2	8	60
regirés	2	1	regires	2	0	1
regirí	2	0	regiri	2	1	1
registrarà	2	53	registrara	2	1	54
registrà	2	44	registra	2	789	833
registràrem	2	0	registrarem	2	4	4
registrés	2	20	registres	2	3566	3586
registrí	2	0	registri	2	85	85
reglamentarà	2	3	reglamentara	2	0	3
reglamentà	2	1	reglamenta	2	26	27
reglamentàrem	2	0	reglamentarem	2	2	2
reglamentària	0	261	reglamentaria	2	1	262
reglamentàries	0	304	reglamentaries	2	0	304
reglamentés	2	5	reglamentes	2	0	5
reglamentí	2	0	reglamenti	2	18	18
reglà	2	0	regla	4	2839	2839
reglés	2	0	regles	4	6363	6363
regnarà	2	20	regnara	2	0	20
regnà	2	35	regna	4	272	307
regnàrem	2	0	regnarem	2	2	2
regnés	2	9	regnes	4	1290	1299
regní	2	0	regni	2	68	68
regosòl	4	0	regosol	4	1	1
regressà	2	1	regressa	2	5	6
regressés	2	1	regresses	2	0	1
reguardà	2	0	reguarda	4	6	6
regularitzarà	2	3	regularitzara	2	0	3
regularitzà	2	0	regularitza	2	8	8
regularitzés	2	1	regularitzes	2	0	1
regularitzí	2	0	regularitzi	2	8	8
regularà	2	61	regulara	2	0	61
regulà	2	3	regula	2	710	713
regulàrem	2	0	regularem	2	3	3
regulés	2	41	regules	2	2	43
regulí	2	0	reguli	2	282	282
reguló	4	0	regulo	2	1	1
regurgitarà	2	1	regurgitara	2	0	1
regurgità	2	0	regurgita	2	3	3
regurgití	2	0	regurgiti	2	1	1
regués	2	0	regues	4	2	2
reguí	2	0	regui	2	2	2
regà	2	0	rega	4	33	33
regàlia	4	1	regalia	4	22	23
regàlies	4	0	regalies	4	38	38
regàrem	2	0	regarem	2	3	3
regís	2	7	regis	0	83	90
regó	4	0	rego	2	4	4
rehabilità	2	3	rehabilita	2	5	8
rehabilití	2	0	rehabiliti	2	2	2
reimaginés	2	0	reimagines	2	2	2
reimplantà	2	0	reimplanta	2	1	1
reimposarà	2	1	reimposara	2	0	1
reimposà	2	1	reimposa	2	0	1
reimprimirà	2	1	reimprimira	2	0	1
reincorporà	2	8	reincorpora	2	11	19
reincorporàrem	2	0	reincorporarem	2	1	1
reincorporés	2	3	reincorpores	2	1	4
reincorporí	2	0	reincorpori	2	6	6
reindexà	2	0	reindexa	2	4	4
reindexí	2	0	reindexi	2	1	1
reingressà	2	1	reingressa	2	2	3
reinicialitzarà	2	2	reinicialitzara	2	0	2
reinicialitzà	2	0	reinicialitza	2	114	114
reinicialitzí	2	0	reinicialitzi	2	1	1
reiniciarà	2	71	reiniciara	2	0	71
reinicià	2	3	reinicia	2	639	642
reiniciàrem	2	0	reiniciarem	2	1	1
reiniciàreu	2	0	reiniciareu	2	1	1
reiniciés	2	5	reinicies	2	8	13
reinicií	2	0	reinicii	2	5	5
reinscriuré	2	0	reinscriure	2	1	1
reinstal·larà	2	1	reinstal·lara	2	0	1
reinstal·là	2	1	reinstal·la	2	25	26
reinstal·lí	2	0	reinstal·li	2	2	2
reinstaurarà	2	1	reinstaurara	2	0	1
reinstaurà	2	4	reinstaura	2	3	7
reinstaurés	2	3	reinstaures	2	0	3
reinstaurí	2	0	reinstauri	2	11	11
reintegrarà	2	2	reintegrara	2	0	2
reintegrà	2	0	reintegra	2	8	8
reintegrí	2	0	reintegri	2	3	3
reintentarà	2	2	reintentara	2	0	2
reintentà	2	0	reintenta	2	28	28
reinterpretà	2	0	reinterpreta	2	6	6
reinterpretí	2	0	reinterpreti	2	2	2
reintroduírem	2	0	reintroduirem	2	1	1
reinventà	2	1	reinventa	2	20	21
reinvertirà	2	4	reinvertira	2	0	4
reiterarà	2	5	reiterara	2	0	5
reiterà	2	11	reitera	2	274	285
reiteràrem	2	0	reiterarem	2	14	14
reiterés	2	4	reiteres	2	0	4
reiterí	2	0	reiteri	2	56	56
reivindicarà	2	1	reivindicara	2	0	1
reivindicà	2	7	reivindica	2	105	112
reivindicàrem	2	0	reivindicarem	2	1	1
reivindiqués	2	2	reivindiques	2	0	2
reivindiquí	2	0	reivindiqui	2	20	20
rejovenirà	2	1	rejovenira	2	0	1
rejuntà	2	1	rejunta	2	0	1
relacionarà	2	11	relacionara	2	1	12
relacionà	2	12	relaciona	2	487	499
relacionàrem	2	0	relacionarem	2	1	1
relacionés	2	4	relaciones	2	12	16
relacioní	2	0	relacioni	2	36	36
relativitzà	2	0	relativitza	2	11	11
relativitzí	2	0	relativitzi	2	3	3
relatà	2	7	relata	2	226	233
relatí	2	0	relati	2	1	1
relaxarà	2	5	relaxara	2	0	5
relaxà	2	0	relaxa	2	106	106
relaxàrem	2	0	relaxarem	2	2	2
relaxés	2	4	relaxes	2	3	7
relaxí	2	0	relaxi	2	22	22
relegarà	2	2	relegara	2	0	2
relegués	2	2	relegues	2	0	2
releguí	2	0	relegui	2	9	9
relegà	2	1	relega	2	23	24
rellampegà	2	0	rellampega	2	1	1
rellancés	2	1	rellances	2	0	1
rellancí	2	0	rellanci	2	22	22
rellançarà	2	3	rellançara	2	0	3
rellançà	2	2	rellança	2	11	13
rellançàrem	2	0	rellançarem	2	2	2
rellevarà	2	3	rellevara	2	0	3
rellevà	2	17	relleva	2	2	19
rellevàrem	2	0	rellevarem	2	1	1
rellevés	2	1	relleves	2	0	1
relleví	2	0	rellevi	2	1	1
relligà	2	0	relliga	2	2	2
relliscà	2	0	rellisca	2	13	13
rellisqués	2	1	rellisques	2	0	1
rellisquí	2	0	rellisqui	2	2	2
remarcà	2	34	remarca	4	83	117
remarqués	2	0	remarques	4	3	3
remarquí	2	0	remarqui	2	1	1
remasteritzà	2	0	remasteritza	2	1	1
rematarà	2	1	rematara	2	0	1
rematà	2	0	remata	2	26	26
rematés	2	0	remates	2	1	1
rematí	2	0	remati	2	2	2
remeiarà	2	8	remeiara	2	0	8
remeià	2	0	remeia	2	13	13
remeiàrem	2	0	remeiarem	2	2	2
remeiés	2	4	remeies	2	0	4
rememorarà	2	2	rememorara	2	0	2
rememorà	2	2	rememora	2	17	19
rememorés	2	0	rememores	2	1	1
rememorí	2	0	rememori	2	1	1
remenà	2	1	remena	0	17	18
remenés	2	0	remenes	0	4	4
remení	2	0	remeni	2	3	3
remesclà	2	1	remescla	2	24	25
remesclés	2	0	remescles	2	44	44
remetré	2	45	remetre	2	739	784
remetés	2	28	remetes	2	0	28
remetí	2	0	remeti	2	122	122
remeí	2	0	remei	4	1074	1074
remodelà	2	2	remodela	2	2	4
remodelés	2	0	remodeles	2	1	1
remodelí	2	0	remodeli	2	1	1
remogués	2	1	remogues	2	0	1
remoguí	2	0	remogui	2	1	1
remolcarà	2	1	remolcara	2	0	1
remolcà	2	0	remolca	2	4	4
remolinarà	2	1	remolinara	2	0	1
remolinà	2	0	remolina	2	2	2
remolqués	2	1	remolques	2	0	1
remolquí	2	0	remolqui	2	1	1
remolà	2	1	remola	2	0	1
remorejà	2	0	remoreja	2	2	2
remouré	2	0	remoure	2	80	80
remuguejà	2	0	remugueja	2	1	1
remullà	2	0	remulla	4	1	1
remunerarà	2	1	remunerara	2	0	1
remunerà	2	0	remunera	2	10	10
remunerí	2	0	remuneri	2	5	5
remuntà	2	4	remunta	4	765	769
remuntàrem	2	0	remuntarem	2	1	1
remuntés	2	1	remuntes	4	0	1
remuntí	2	0	remunti	2	5	5
remà	2	6	rema	2	21	27
remàrem	2	0	remarem	2	1	1
remèn	2	0	remen	2	13	13
remès	2	289	remes	2	0	289
remés	2	3	remes	2	0	3
remí	2	0	remi	2	10	10
remís	0	0	remis	2	3	3
renacionalitzarà	2	1	renacionalitzara	2	0	1
renacionalitzà	2	0	renacionalitza	2	3	3
renacionalitzí	2	0	renacionalitzi	2	1	1
renaixés	2	1	renaixes	2	0	1
renderitzarà	2	27	renderitzara	2	0	27
renderitzà	2	0	renderitza	2	148	148
renderitzàreu	2	0	renderitzareu	2	1	1
renderitzí	2	0	renderitzi	2	7	7
rendibilitzarà	2	1	rendibilitzara	2	0	1
rendibilitzà	2	0	rendibilitza	2	1	1
rendibilitzí	2	0	rendibilitzi	2	3	3
rendirà	2	18	rendira	2	0	18
rendírem	2	1	rendirem	2	19	20
renegociarà	2	4	renegociara	2	0	4
renegocià	2	1	renegocia	2	2	3
renegociàrem	2	0	renegociarem	2	1	1
renegociés	2	4	renegocies	2	0	4
renegués	2	2	renegues	2	0	2
reneguí	2	0	renegui	2	1	1
renegà	2	1	renega	2	11	12
renegàrem	2	0	renegarem	2	1	1
renormalitzà	2	1	renormalitza	2	0	1
renovarà	2	29	renovara	2	0	29
renovà	2	18	renova	2	82	100
renovàrem	2	0	renovarem	2	5	5
renovés	2	18	renoves	2	0	18
renoví	2	0	renovi	2	55	55
rentarà	2	1	rentara	2	0	1
rentà	2	1	renta	2	67	68
rentés	2	3	rentes	2	12	15
rentí	2	0	renti	2	8	8
renunciarà	2	38	renunciara	2	0	38
renuncià	2	60	renuncia	2	120	180
renunciàrem	2	0	renunciarem	2	23	23
renunciés	2	56	renuncies	2	4	60
renuncií	2	1	renuncii	2	0	1
renyarà	2	2	renyara	2	0	2
renyinà	2	0	renyina	4	6	6
renyinés	2	0	renyines	4	14	14
renyirà	2	1	renyira	2	0	1
renyà	2	2	renya	2	25	27
renyés	2	0	renyes	2	1	1
renyí	2	0	renyi	2	6	6
renyís	2	0	renyis	2	5	5
renyó	4	2	renyo	2	1	3
renét	4	0	renet	4	1	1
renúncia	4	710	renuncia	2	120	830
renúncies	4	32	renuncies	2	4	36
reobrirà	2	10	reobrira	2	0	10
reobrí	2	7	reobri	2	30	37
reobrírem	2	0	reobrirem	2	8	8
reobrís	2	7	reobris	2	0	7
reocupà	2	2	reocupa	2	0	2
reocupàrem	2	0	reocuparem	2	1	1
reomplirà	2	1	reomplira	2	0	1
reordenarà	2	5	reordenara	2	0	5
reordenà	2	1	reordena	2	46	47
reordenàrem	2	0	reordenarem	2	1	1
reordenés	2	1	reordenes	2	0	1
reordení	2	0	reordeni	2	1	1
reorganitzarà	2	1	reorganitzara	2	0	1
reorganitzà	2	21	reorganitza	2	31	52
reorganitzàrem	2	0	reorganitzarem	2	1	1
reorganitzés	2	2	reorganitzes	2	0	2
reorganitzí	2	0	reorganitzi	2	10	10
reorientà	2	3	reorienta	2	3	6
reorientés	2	2	reorientes	2	0	2
reorientí	2	0	reorienti	2	6	6
repagarà	2	1	repagara	2	0	1
repararà	2	9	reparara	2	0	9
repartirà	2	22	repartira	2	0	22
repartírem	2	0	repartirem	2	4	4
reparà	2	7	repara	2	105	112
reparàrem	2	0	repararem	2	3	3
reparés	2	7	repares	2	0	7
reparí	2	0	repari	2	26	26
repassarà	2	1	repassara	2	0	1
repassà	2	2	repassa	2	18	20
repassàrem	2	0	repassarem	2	6	6
repassés	2	1	repasses	2	0	1
repassí	2	0	repassi	2	10	10
repatriarà	2	2	repatriara	2	0	2
repatrià	2	0	repatria	2	3	3
repatriés	2	2	repatries	2	0	2
repenjà	2	0	repenja	2	1	1
repensés	2	1	repenses	2	2	3
repensí	2	0	repensi	2	1	1
repercutirà	2	145	repercutira	2	0	145
repescà	2	0	repesca	4	37	37
repesqués	2	0	repesques	4	2	2
repetirà	2	96	repetira	2	0	96
repetírem	2	1	repetirem	2	25	26
repicà	2	0	repica	2	4	4
repintà	2	0	repinta	2	3	3
repintés	2	0	repintes	2	3	3
repiulà	2	0	repiula	2	1	1
repiulés	2	1	repiules	2	0	1
replanificarà	2	3	replanificara	2	0	3
replanificà	2	0	replanifica	2	8	8
replantegés	2	3	replanteges	2	0	3
replantegí	2	0	replantegi	2	28	28
replantejarà	2	3	replantejara	2	0	3
replantejà	2	2	replanteja	2	6	8
replantejàrem	2	0	replantejarem	2	1	1
replegarà	2	1	replegara	2	0	1
replegà	2	0	replega	4	31	31
replegàrem	2	0	replegarem	2	1	1
replicarà	2	4	replicara	2	0	4
replicà	2	15	replica	2	63	78
replicàreu	2	0	replicareu	2	1	1
repliqués	2	0	repliques	2	2	2
repliquí	2	0	repliqui	2	6	6
repoblà	2	0	repobla	2	2	2
repoblés	2	1	repobles	2	1	2
repolaritzà	2	0	repolaritza	2	1	1
reportarà	2	53	reportara	2	0	53
reportà	2	5	reporta	2	102	107
reportés	2	2	reportes	2	0	2
reportí	2	0	reporti	2	32	32
reposarà	2	4	reposara	2	1	5
reposicionà	2	0	reposiciona	2	2	2
reposà	2	1	reposa	2	61	62
reposàrem	2	0	reposarem	2	2	2
reposés	2	2	reposes	2	0	2
reposí	2	0	reposi	2	15	15
repreguntà	2	0	repregunta	4	2	2
reprendré	2	50	reprendre	2	2011	2061
reprengués	2	33	reprengues	2	0	33
reprenguí	2	0	reprengui	2	187	187
represalià	2	0	represalia	2	2	2
represaliés	2	0	represalies	2	1	1
representarà	2	338	representara	2	1	339
representà	2	157	representa	2	10834	10991
representàrem	2	0	representarem	2	6	6
representés	2	53	representes	2	11	64
representí	2	0	representi	2	368	368
represàlia	4	289	represalia	2	2	291
represàlies	4	349	represalies	2	1	350
reprimirà	2	3	reprimira	2	0	3
reprimírem	2	0	reprimirem	2	1	1
reprocessà	2	0	reprocessa	2	2	2
reproduírem	2	0	reproduirem	2	2	2
reproduíreu	2	0	reproduireu	2	1	1
reprogramà	2	0	reprograma	2	2	2
reprogramí	2	0	reprogrami	2	1	1
reprotxà	2	0	reprotxa	2	1	1
reprovà	2	0	reprova	4	6	6
reptarà	2	2	reptara	2	0	2
reptà	2	3	repta	2	16	19
reptés	2	0	reptes	2	4499	4499
reptí	2	0	repti	2	1	1
repudià	2	7	repudia	2	23	30
repudiés	2	3	repudies	2	0	3
repudií	2	1	repudii	2	0	1
repugnarà	2	0	repugnara	2	1	1
repugnà	2	0	repugna	2	22	22
repujà	2	0	repuja	2	1	1
repulsà	2	0	repulsa	4	77	77
repulsés	2	0	repulses	4	1	1
reputà	2	0	reputa	2	1	1
repèl	4	0	repel	4	2	2
repòrter	4	2	reporter	0	239	241
repòrters	4	6	reporters	0	161	167
requadrés	2	0	requadres	2	8	8
requalificà	2	0	requalifica	2	5	5
requerirà	2	466	requerira	2	0	466
requerírem	2	0	requerirem	2	2	2
requeríreu	2	0	requerireu	2	1	1
requestà	2	0	requesta	4	4	4
requisà	2	4	requisa	4	13	17
requisés	2	0	requises	4	5	5
requís	2	0	requis	2	2	2
resarà	2	3	resara	2	0	3
rescabalarà	2	1	rescabalara	2	0	1
rescabalà	2	0	rescabala	2	2	2
rescabalàrem	2	0	rescabalarem	2	1	1
rescatarà	2	4	rescatara	2	0	4
rescatà	2	8	rescata	2	62	70
rescatàrem	2	0	rescatarem	2	6	6
rescatàreu	2	0	rescatareu	2	1	1
rescatés	2	5	rescates	2	0	5
rescatí	2	0	rescati	2	6	6
reservarà	2	21	reservara	2	0	21
reservà	2	8	reserva	4	5693	5701
reservàrem	2	0	reservarem	2	6	6
reservés	2	10	reserves	4	5202	5212
reserví	2	0	reservi	2	77	77
resguardà	2	0	resguarda	2	1	1
residencià	2	0	residencia	2	22	22
residenciés	2	0	residencies	2	6	6
residirà	2	19	residira	2	0	19
residència	4	2944	residencia	2	22	2966
residències	4	292	residencies	2	6	298
resignarà	2	1	resignara	2	0	1
resignà	2	6	resigna	2	11	17
resignàrem	2	0	resignarem	2	2	2
resignés	2	2	resignes	2	0	2
resigní	2	0	resigni	2	6	6
resincronitzà	2	1	resincronitza	2	0	1
resinà	2	0	resina	4	150	150
resinés	2	0	resines	4	52	52
resistirà	2	26	resistira	2	1	27
resistírem	2	0	resistirem	2	7	7
resituarà	2	1	resituara	2	0	1
resituà	2	1	resitua	2	1	2
resoldré	2	6	resoldre	2	10482	10488
resolgués	2	67	resolgues	2	2	69
resolguí	2	0	resolgui	2	444	444
respectarà	2	164	respectara	2	1	165
respectà	2	2	respecta	2	5375	5377
respectàrem	2	0	respectarem	2	46	46
respectàreu	2	0	respectareu	2	2	2
respectés	2	106	respectes	2	268	374
respectí	2	0	respecti	2	1408	1408
respirarà	2	1	respirara	2	0	1
respirà	2	1	respira	2	140	141
respirés	2	4	respires	2	6	10
respirí	2	0	respiri	2	22	22
respondré	2	330	respondre	2	9506	9836
respongués	2	204	respongues	2	0	204
responguí	2	0	respongui	2	1076	1076
responsabilitzarà	2	16	responsabilitzara	2	0	16
responsabilitzà	2	0	responsabilitza	2	55	55
responsabilitzàrem	2	0	responsabilitzarem	2	2	2
responsabilitzés	2	6	responsabilitzes	2	3	9
responsabilitzí	2	0	responsabilitzi	2	43	43
ressaguí	2	0	ressagui	2	1	1
ressagà	2	0	ressaga	4	1	1
ressaltarà	2	51	ressaltara	2	0	51
ressaltà	2	0	ressalta	2	486	486
ressaltàrem	2	0	ressaltarem	2	1	1
ressaltés	2	5	ressaltes	2	0	5
ressaltí	2	0	ressalti	2	19	19
ressecà	2	0	resseca	0	6	6
resseguíreu	2	0	resseguireu	2	1	1
ressentirà	2	11	ressentira	2	0	11
ressentí	2	2	ressenti	2	7	9
ressentís	2	1	ressentis	2	0	1
ressenyà	2	3	ressenya	4	284	287
ressenyés	2	0	ressenyes	4	281	281
ressenyí	2	0	ressenyi	2	1	1
ressequí	2	0	ressequi	2	1	1
ressituà	2	0	ressitua	2	1	1
ressonarà	2	1	ressonara	2	0	1
ressonà	2	0	ressona	2	30	30
ressonés	2	2	ressones	2	0	2
ressoní	2	0	ressoni	2	9	9
ressopó	4	1	ressopo	2	0	1
ressorgirà	2	7	ressorgira	2	0	7
ressuscitarà	2	3	ressuscitara	2	0	3
ressuscità	2	5	ressuscita	2	18	23
ressuscités	2	0	ressuscites	2	1	1
ressuscití	2	0	ressusciti	2	7	7
restablirà	2	74	restablira	2	0	74
restablírem	2	0	restablirem	2	6	6
restablíreu	2	0	restablireu	2	2	2
restarà	2	121	restara	2	1	122
restaurarà	2	92	restaurara	2	0	92
restaurà	2	36	restaura	2	529	565
restauràrem	2	0	restaurarem	2	5	5
restauràreu	2	0	restaurareu	2	2	2
restaurés	2	22	restaures	2	10	32
restaurí	2	0	restauri	2	57	57
restringirà	2	22	restringira	2	0	22
restringírem	2	0	restringirem	2	1	1
restringíreu	2	0	restringireu	2	1	1
restà	2	112	resta	4	11674	11786
restàrem	2	1	restarem	2	5	6
restés	2	8	restes	4	2915	2923
restí	2	0	resti	2	64	64
resultarà	2	846	resultara	2	2	848
resultà	2	157	resulta	4	15554	15711
resultàrem	2	0	resultarem	2	4	4
resultés	2	186	resultes	4	392	578
resultí	2	0	resulti	2	1349	1349
resumirà	2	15	resumira	2	0	15
resumí	2	11	resumi	2	0	11
resumírem	2	0	resumirem	2	1	1
resumís	2	6	resumis	2	0	6
resà	2	1	resa	2	210	211
resàrem	2	0	resarem	2	1	1
resàreu	2	1	resareu	2	1	2
resés	2	2	reses	2	8	10
resí	2	0	resi	2	21	21
resín	2	0	resin	2	5	5
retallarà	2	31	retallara	2	0	31
retallà	2	3	retalla	2	445	448
retallàrem	2	0	retallarem	2	4	4
retallés	2	11	retalles	2	2	13
retallí	2	0	retalli	2	17	17
retalló	4	0	retallo	2	1	1
retardarà	2	68	retardara	2	0	68
retardà	2	19	retarda	2	176	195
retardàrem	2	0	retardarem	2	10	10
retardés	2	20	retardes	2	0	20
retardí	2	0	retardi	2	122	122
retindré	2	9	retindre	2	4	13
retingués	2	11	retingues	2	2	13
retinguí	2	0	retingui	2	28	28
retirarà	2	80	retirara	2	2	82
retirà	2	279	retira	2	422	701
retiràrem	2	0	retirarem	2	34	34
retiràreu	2	0	retirareu	2	4	4
retirés	2	212	retires	2	8	220
retirí	2	0	retiri	2	464	464
retià	0	0	retia	2	12	12
retocarà	2	1	retocara	2	0	1
retocà	2	0	retoca	2	6	6
retolà	2	1	retola	2	1	2
retoqués	2	1	retoques	2	0	1
retorcés	2	1	retorces	2	1	2
retornarà	2	228	retornara	2	1	229
retornà	2	245	retorna	2	3321	3566
retornàrem	2	0	retornarem	2	22	22
retornàreu	2	0	retornareu	2	1	1
retornés	2	67	retornes	2	2	69
retorní	2	0	retorni	2	235	235
retorçà	2	0	retorça	2	8	8
retractarà	2	1	retractara	2	0	1
retractà	2	3	retracta	2	9	12
retractés	2	4	retractes	2	1	5
retractí	2	0	retracti	2	14	14
retragués	2	2	retragues	2	0	2
retransmetré	2	0	retransmetre	2	108	108
retransmetés	2	3	retransmetes	2	0	3
retratarà	2	2	retratara	2	0	2
retratà	2	1	retrata	2	138	139
retratés	2	2	retrates	2	0	2
retrauré	2	2	retraure	2	2	4
retrià	2	0	retria	2	2	2
retroalimentà	2	0	retroalimenta	2	3	3
retrobà	2	4	retroba	2	24	28
retrobàrem	2	0	retrobarem	2	3	3
retrobàreu	2	0	retrobareu	2	1	1
retrobí	2	0	retrobi	2	4	4
retrocedirà	2	11	retrocedira	2	1	12
retrocedírem	2	0	retrocedirem	2	10	10
retrogradà	2	0	retrograda	2	2	2
retràctil	0	37	retractil	2	0	37
retré	2	3	retre	2	599	602
retrò	4	0	retro	0	63	63
retrògrad	0	62	retrograd	2	0	62
retrògrada	0	77	retrograda	2	2	79
retrògrades	0	29	retrogrades	2	0	29
retén	2	9	reten	2	11	20
retés	2	6	retes	2	2	8
retí	2	0	reti	2	13	13
retín	2	0	retin	2	2	2
reubicarà	2	1	reubicara	2	0	1
reubicà	2	3	reubica	2	6	9
reubiqués	2	3	reubiques	2	0	3
reunificarà	2	4	reunificara	2	0	4
reunificà	2	6	reunifica	2	3	9
reunifiqués	2	4	reunifiques	2	0	4
reunifiquí	2	0	reunifiqui	2	1	1
reunirà	2	306	reunira	2	1	307
reunírem	2	0	reunirem	2	60	60
reuníreu	2	0	reunireu	2	1	1
reutilitzarà	2	5	reutilitzara	2	0	5
reutilitzà	2	1	reutilitza	2	43	44
reutilitzí	2	0	reutilitzi	2	6	6
revalidà	2	5	revalida	2	4	9
revalidí	2	0	revalidi	2	1	1
revaloritzarà	2	1	revaloritzara	2	0	1
revaloritzà	2	0	revaloritza	2	9	9
revalorí	2	0	revalori	2	2	2
revaluarà	2	2	revaluara	2	0	2
revaluà	2	0	revalua	2	1	1
revelarà	2	56	revelara	2	0	56
revelà	2	62	revela	2	1179	1241
revelàrem	2	0	revelarem	2	3	3
revelés	2	22	reveles	2	1	23
revelí	2	0	reveli	2	66	66
revendré	2	0	revendre	2	24	24
revenguí	2	0	revengui	2	1	1
revengés	2	0	revenges	4	3	3
revengí	2	0	revengi	2	1	1
revenjà	2	1	revenja	4	169	170
reverberí	2	0	reverberi	2	1	1
revertirà	2	13	revertira	2	0	13
reverència	4	115	reverencia	2	0	115
reverències	4	13	reverencies	2	0	13
revestirà	2	41	revestira	2	0	41
reveuré	2	0	reveure	2	53	53
revifarà	2	2	revifara	2	0	2
revifà	2	2	revifa	2	6	8
revifés	2	2	revifes	2	0	2
revigoritzà	2	0	revigoritza	2	1	1
revigoritzí	2	0	revigoritzi	2	1	1
revindré	2	1	revindre	2	0	1
revisarà	2	160	revisara	2	2	162
reviscolà	2	2	reviscola	2	2	4
reviscolés	2	1	reviscoles	2	0	1
revisità	2	1	revisita	2	1	2
revisqués	2	1	revisques	2	0	1
revisquí	2	0	revisqui	2	3	3
revistà	2	1	revista	2	4222	4223
revistés	2	0	revistes	2	1210	1210
revisà	2	27	revisa	2	353	380
revisàrem	2	0	revisarem	2	51	51
revisàreu	2	0	revisareu	2	1	1
revisés	2	68	revises	2	7	75
revisí	2	0	revisi	2	432	432
revitalitzarà	2	2	revitalitzara	2	0	2
revitalitzà	2	2	revitalitza	2	2	4
revitalitzàrem	2	0	revitalitzarem	2	1	1
revitalitzés	2	1	revitalitzes	2	0	1
revitalitzí	2	0	revitalitzi	2	7	7
reviuré	2	0	reviure	2	251	251
revocarà	2	10	revocara	2	0	10
revocà	2	6	revoca	2	60	66
revoltarà	2	2	revoltara	2	0	2
revoltà	2	4	revolta	2	1524	1528
revoltés	2	3	revoltes	2	389	392
revoltó	4	2	revolto	2	2	4
revolucionarà	2	11	revolucionara	2	0	11
revolucionà	2	8	revoluciona	2	3	11
revolucionària	0	418	revolucionaria	2	22	440
revolucionàries	0	174	revolucionaries	2	3	177
revolucionés	2	1	revoluciones	2	1	2
revolucioní	2	0	revolucioni	2	1	1
revolà	2	0	revola	2	2	2
revoqués	2	18	revoques	2	0	18
revoquí	2	0	revoqui	2	34	34
revàlida	4	3	revalida	2	4	7
revès	2	0	reves	4	3	3
revénen	2	0	revenen	2	3	3
revéngui	2	0	revengui	2	1	1
revénguin	2	0	revenguin	2	2	2
revés	2	500	reves	4	3	503
revéu	2	0	reveu	2	2	2
riallà	2	0	rialla	4	46	46
riallés	2	0	rialles	4	234	234
ribagorçà	0	1	ribagorça	4	24	25
ricà	2	0	rica	4	1491	1491
ridiculitzarà	2	1	ridiculitzara	2	0	1
ridiculitzà	2	1	ridiculitza	2	20	21
ridiculitzés	2	1	ridiculitzes	2	0	1
ridiculitzí	2	0	ridiculitzi	2	1	1
rifés	2	0	rifes	4	1	1
rigués	2	4	rigues	2	2	6
riguí	2	0	rigui	2	12	12
rimarà	2	1	rimara	2	0	1
rimà	2	0	rima	4	156	156
rimés	2	0	rimes	4	55	55
rimí	2	0	rimi	2	4	4
riojà	0	3	rioja	4	77	80
riqués	2	0	riques	0	761	761
riquí	2	0	riqui	2	1	1
riscós	0	0	riscos	4	6390	6390
rissà	2	0	rissa	2	3	3
ritmés	2	0	ritmes	2	331	331
ritmí	2	0	ritmi	2	1	1
riuré	2	3	riure	4	644	647
rivalitzarà	2	0	rivalitzara	2	1	1
rivalitzà	2	3	rivalitza	2	16	19
rivalitzí	2	0	rivalitzi	2	1	1
robarà	2	7	robara	2	0	7
robà	2	4	roba	4	2301	2305
robàrem	2	0	robarem	2	5	5
robés	2	9	robes	4	142	151
robí	2	50	robi	2	24	74
rodamón	4	64	rodamon	4	3	67
rodarà	2	2	rodara	2	0	2
rodegí	2	0	rodegi	2	1	1
rodejà	2	3	rodeja	4	42	45
rodejàrem	2	0	rodejarem	2	1	1
rodolà	2	0	rodola	2	2	2
rodolí	2	2	rodoli	2	1	3
rodà	2	10	roda	4	1193	1203
rodí	2	0	rodi	2	43	43
roentà	2	0	roenta	2	1	1
rogés	2	0	roges	4	88	88
roinà	2	0	roina	4	3	3
rojà	2	0	roja	4	1021	1021
rojós	0	0	rojos	0	132	132
rollà	2	0	rolla	2	8	8
rollí	2	0	rolli	2	1	1
rolà	2	0	rola	2	1	1
rolés	2	0	roles	2	4	4
romandré	2	18	romandre	2	3909	3927
romangués	2	62	romangues	2	2	64
romanguí	2	0	romangui	2	223	223
romanitzà	2	1	romanitza	2	2	3
romanès	0	809	romanes	4	526	1335
romanés	0	3	romanes	4	526	529
rombòedre	4	1	romboedre	4	2	3
rombòedres	4	0	romboedres	4	1	1
rompré	2	1	rompre	2	12	13
rompí	2	0	rompi	2	1	1
romànic	0	172	romanic	4	0	172
roncà	2	0	ronca	0	26	26
rondarà	2	6	rondara	2	0	6
rondinarà	2	2	rondinara	2	0	2
rondinà	2	0	rondina	2	3	3
rondinés	2	0	rondines	2	1	1
rondà	2	0	ronda	4	3549	3549
rondés	2	0	rondes	4	480	480
rondí	2	0	rondi	2	2	2
rondín	2	0	rondin	2	2	2
rondó	4	84	rondo	2	13	97
ronyà	2	0	ronya	4	9	9
ronyó	4	149	ronyo	2	0	149
roscà	2	0	rosca	4	59	59
rosegarà	2	1	rosegara	2	0	1
rosegués	2	1	rosegues	2	0	1
roseguí	2	0	rosegui	2	1	1
rosegà	2	0	rosega	2	12	12
rosegó	4	4	rosego	2	2	6
rosqués	2	0	rosques	4	25	25
rossegà	2	0	rossega	2	1	1
rossejà	2	0	rosseja	2	1	1
rossellonès	0	2	rossellones	4	0	2
rostà	2	0	rosta	0	5	5
rostés	2	0	rostes	0	3	3
rosà	2	2	rosa	4	1447	1449
rosés	2	3	roses	4	426	429
rosí	2	0	rosi	2	6	6
rosó	4	0	roso	2	1	1
rotarà	2	2	rotara	2	0	2
rotllés	2	0	rotlles	2	66	66
rotà	2	1	rota	4	68	69
rotària	0	0	rotaria	2	2	2
rotés	2	2	rotes	4	4	6
rotí	2	0	roti	2	17	17
rotó	4	5	roto	2	1	6
rovellà	2	0	rovella	2	1	1
rovellí	2	0	rovelli	2	15	15
roín	0	6	roin	2	5	11
ruandès	0	441	ruandes	0	1	442
ruandés	0	3	ruandes	0	1	4
ruboritzà	2	0	ruboritza	2	3	3
rubricarà	2	1	rubricara	2	0	1
rubricà	2	1	rubrica	2	4	5
rubriqués	2	0	rubriques	2	1	1
rubriquí	2	0	rubriqui	2	2	2
ruixarà	2	1	ruixara	2	0	1
ruixà	2	0	ruixa	4	12	12
ruixés	2	1	ruixes	4	0	1
ruixó	4	1	ruixo	2	1	2
rullí	2	0	rulli	2	2	2
rumià	2	0	rumia	2	6	6
rumiàrem	2	0	rumiarem	2	1	1
rumiés	2	0	rumies	2	1	1
rumií	2	0	rumii	2	1	1
rumorejà	2	1	rumoreja	2	51	52
rutilà	2	0	rutila	2	1	1
rutilí	2	0	rutili	4	3	3
rutllarà	2	1	rutllara	2	0	1
rutllà	2	6	rutlla	4	9	15
rutllí	2	0	rutlli	2	2	2
rutló	4	2	rutlo	2	0	2
ruà	0	0	rua	4	23	23
ràbia	4	349	rabia	2	10	359
ràbies	4	1	rabies	2	1	2
ràdio	4	3339	radio	2	764	4103
ràfega	4	95	rafega	4	1	96
ràfegues	4	72	rafegues	4	0	72
rància	0	8	rancia	2	3	11
ràncies	0	4	rancies	2	0	4
ràpel	4	20	rapel	2	1	21
ràpida	0	7045	rapida	2	9	7054
ràpides	0	943	rapides	2	0	943
rècord	0	1512	record	4	1867	3379
rècords	4	311	records	4	1675	1986
rècula	4	1	recula	2	17	18
rèdit	4	13	redit	2	2	15
rèdits	4	21	redits	2	0	21
rèflex	0	40	reflex	0	736	776
règia	0	17	regia	2	119	136
règies	0	4	regies	2	0	4
règim	4	11173	regim	2	18	11191
rèmol	4	15	remol	2	0	15
rèmols	4	1	remols	2	0	1
rènec	0	0	renec	4	1	1
rènecs	0	0	renecs	4	4	4
rènega	0	0	renega	2	11	11
rèplica	4	403	replica	2	63	466
rèpliques	4	162	repliques	2	2	164
rètol	4	198	retol	2	0	198
rètor	4	1	retor	4	1	2
rèvola	4	0	revola	2	2	2
rés	4	29	res	4	27489	27518
rínxol	4	17	rinxol	4	0	17
rínxols	4	46	rinxols	4	0	46
ròdol	4	2	rodol	2	0	2
ròssa	4	0	rossa	0	453	453
ròssec	4	70	rossec	4	0	70
ròssecs	4	1	rossecs	4	0	1
ròssega	4	0	rossega	2	1	1
ròsses	4	0	rosses	0	30	30
rúbrica	4	926	rubrica	2	4	930
rúbriques	4	264	rubriques	2	1	265
rúpia	4	4	rupia	4	65	69
rúpies	4	9	rupies	4	36	45
rútil	4	16	rutil	2	6	22
sabotegés	2	3	saboteges	2	0	3
sabotegí	2	0	sabotegi	2	1	1
sabotejà	2	0	saboteja	2	11	11
sabotejàrem	2	0	sabotejarem	2	1	1
sabré	2	53	sabre	4	135	188
sabés	2	182	sabes	4	9	191
saciarà	2	1	saciara	2	0	1
sacià	2	0	sacia	2	1	1
sacralitzà	2	0	sacralitza	2	1	1
sacrificarà	2	21	sacrificara	2	0	21
sacrificà	2	9	sacrifica	2	86	95
sacrificàrem	2	0	sacrificarem	2	10	10
sacrifiqués	2	6	sacrifiques	2	3	9
sacrifiquí	2	0	sacrifiqui	2	33	33
sacsegés	2	4	sacseges	2	2	6
sacsegí	2	0	sacsegi	2	6	6
sacsejarà	2	5	sacsejara	2	1	6
sacsejà	2	3	sacseja	2	58	61
sacsó	4	1	sacso	2	0	1
sacà	2	0	saca	4	67	67
sadollarà	2	1	sadollara	2	0	1
sadollà	2	1	sadolla	0	3	4
safrà	0	61	safra	4	0	61
saginà	2	0	sagina	2	1	1
sagnarà	2	14	sagnara	2	0	14
sagnà	2	0	sagna	2	66	66
sagnés	2	0	sagnes	2	3	3
sagní	2	0	sagni	2	7	7
salarà	2	1	salara	2	0	1
saldarà	2	3	saldara	2	0	3
saldà	2	1	salda	2	17	18
saldàrem	2	0	saldarem	2	1	1
saldés	2	3	saldes	4	2	5
saldí	2	0	saldi	2	13	13
salinà	2	0	salina	4	59	59
salinàs	2	0	salinas	4	56	56
salinés	2	0	salines	4	90	90
salivà	2	0	saliva	4	76	76
salivés	2	0	salives	4	1	1
sallà	2	0	salla	2	16	16
sallés	2	1	salles	2	3	4
salmorrà	2	0	salmorra	4	46	46
salmorrés	2	0	salmorres	4	3	3
salmòdia	4	7	salmodia	2	0	7
salparà	2	1	salpara	2	0	1
salpebrà	2	0	salpebra	2	1	1
salpà	2	57	salpa	4	13	70
salpàrem	2	0	salparem	2	2	2
salpés	2	8	salpes	4	4	12
salpí	2	0	salpi	2	1	1
salsà	2	0	salsa	4	244	244
salsés	2	0	salses	4	46	46
saltarà	2	52	saltara	2	1	53
saltà	2	22	salta	4	854	876
saltàrem	2	0	saltarem	2	6	6
saltàreu	2	0	saltareu	2	3	3
saltés	2	9	saltes	2	8	17
saltí	2	0	salti	2	28	28
saludarà	2	2	saludara	2	0	2
saludà	2	4	saluda	2	215	219
saludàrem	2	0	saludarem	2	3	3
saludés	2	3	saludes	4	2	5
saludí	2	0	saludi	2	21	21
salvaguardarà	2	22	salvaguardara	2	0	22
salvaguardà	2	1	salvaguarda	4	1261	1262
salvaguardàrem	2	0	salvaguardarem	2	2	2
salvaguardés	2	1	salvaguardes	4	396	397
salvaguardí	2	0	salvaguardi	2	63	63
salvarà	2	92	salvara	2	2	94
salvàrem	2	1	salvarem	2	26	27
salvàreu	2	0	salvareu	2	1	1
salvés	2	20	salves	4	43	63
salzadellà	0	0	salzadella	4	2	2
salà	2	0	sala	4	3753	3753
salés	2	0	sales	4	989	989
salín	2	0	salin	2	178	178
saló	4	960	salo	4	31	991
samoà	0	19	samoa	4	269	288
sanarà	2	1	sanara	2	0	1
sancionarà	2	10	sancionara	2	0	10
sancionà	2	2	sanciona	2	52	54
sancionàrem	2	0	sancionarem	2	3	3
sancionés	2	2	sanciones	2	2	4
sancioní	2	0	sancioni	2	42	42
sanegés	2	1	saneges	2	0	1
sanegí	2	0	sanegi	2	1	1
sanejarà	2	1	sanejara	2	0	1
sanejà	2	0	saneja	4	7	7
santificà	2	0	santifica	2	3	3
santifiquí	2	0	santifiqui	2	1	1
sanà	2	22	sana	0	677	699
sanés	2	0	sanes	0	190	190
saní	2	0	sani	2	29	29
saorrà	0	0	saorra	4	1	1
saquegí	2	0	saquegi	2	2	2
saquejarà	2	1	saquejara	2	0	1
saquejà	2	16	saqueja	2	21	37
saqués	2	0	saques	4	10	10
saquí	2	0	saqui	2	1	1
saragossà	0	3	saragossa	4	240	243
sargés	4	0	sarges	4	1	1
sarrí	0	0	sarri	4	2	2
satiritzà	2	2	satiritza	2	13	15
satisféu	2	0	satisfeu	2	3	3
saturarà	2	1	saturara	2	0	1
saturà	2	0	satura	2	32	32
saturí	2	0	saturi	4	5	5
savoià	0	2	savoia	4	235	237
saxòfon	4	76	saxofon	4	40	116
saxòfons	4	12	saxofons	4	11	23
saxó	0	104	saxo	4	56	160
secarà	2	0	secara	2	1	1
seccionà	2	0	secciona	2	2	2
seccionés	2	0	secciones	2	2	2
secretà	2	0	secreta	0	888	888
secretària	4	496	secretaria	2	1429	1925
secretàries	4	24	secretaries	2	81	105
secretés	2	0	secretes	0	394	394
secularitzà	2	2	secularitza	2	0	2
secundarà	2	247	secundara	2	0	247
secundà	2	1	secunda	2	1314	1315
secundàrem	2	0	secundarem	2	229	229
secundària	0	2178	secundaria	2	84	2262
secundàries	0	531	secundaries	2	3	534
secundés	2	30	secundes	2	0	30
secà	2	44	seca	4	591	635
sedimentà	2	0	sedimenta	2	1	1
sedimentària	0	37	sedimentaria	2	1	38
sedimentàries	0	77	sedimentaries	2	0	77
sedà	2	0	seda	4	631	631
sedés	2	0	sedes	4	30	30
sedí	2	0	sedi	2	1	1
segarà	2	0	segara	2	2	2
segellarà	2	6	segellara	2	0	6
segellà	2	2	segella	2	14	16
segellés	2	1	segelles	2	0	1
segellí	2	0	segelli	2	4	4
segmentà	2	0	segmenta	2	5	5
segmentària	0	2	segmentaria	2	0	2
segovià	2	1	segovia	2	16	17
segregarà	2	1	segregara	2	0	1
segreguí	2	0	segregui	2	1	1
segregà	2	0	segrega	2	13	13
segrestà	2	4	segresta	2	47	51
segrestàrem	2	0	segrestarem	2	1	1
segrestés	2	3	segrestes	2	3	6
segrestí	2	0	segresti	2	14	14
seguirà	2	880	seguira	2	2	882
segués	2	1	segues	4	0	1
seguírem	2	0	seguirem	2	428	428
seguíreu	2	0	seguireu	2	14	14
seguís	2	198	seguis	2	6	204
segà	2	1	sega	4	176	177
segó	4	9	sego	2	0	9
seixanta-quatrè	0	2	seixanta-quatre	3	26	28
seixanta-quatré	0	0	seixanta-quatre	3	26	26
seleccionarà	2	140	seleccionara	2	1	141
seleccionà	2	20	selecciona	2	4243	4263
seleccionàrem	2	0	seleccionarem	2	5	5
seleccionàreu	2	0	seleccionareu	2	16	16
seleccionés	2	6	selecciones	2	25	31
seleccioní	2	0	seleccioni	2	201	201
semarà	2	0	semara	2	1	1
semblarà	2	117	semblara	2	5	122
semblà	2	29	sembla	2	31852	31881
semblàrem	2	0	semblarem	2	2	2
semblàreu	2	0	semblareu	2	1	1
semblés	2	118	sembles	2	185	303
semblí	2	0	sembli	2	724	724
sembrarà	2	1	sembrara	2	1	2
sembrà	2	0	sembra	4	229	229
sembràrem	2	0	sembrarem	2	3	3
sembrés	2	1	sembres	4	19	20
sembrí	2	0	sembri	2	20	20
semidéu	4	14	semideu	4	0	14
semidéus	4	7	semideus	4	0	7
semà	2	0	sema	0	12	12
semí	2	0	semi	2	107	107
sensibilitzarà	2	2	sensibilitzara	2	0	2
sensibilitzà	2	0	sensibilitza	2	6	6
sensibilitzés	2	1	sensibilitzes	2	0	1
sensibilitzí	2	0	sensibilitzi	2	7	7
sentencià	2	10	sentencia	2	20	30
sentenciés	2	0	sentencies	2	6	6
sentirà	2	126	sentira	2	2	128
sentència	4	2267	sentencia	2	20	2287
sentències	4	1215	sentencies	2	6	1221
sentí	2	63	senti	2	530	593
sentírem	2	0	sentirem	2	73	73
sentíreu	2	0	sentireu	2	24	24
senyalarà	2	1	senyalara	2	0	1
senyalitzarà	2	1	senyalitzara	2	1	2
senyalitzà	2	0	senyalitza	2	4	4
senyalitzí	2	0	senyalitzi	2	1	1
senyalà	2	49	senyala	4	74	123
senyalés	2	4	senyales	4	3	7
senyalí	2	0	senyali	2	1	1
senyà	2	0	senya	4	4	4
senyés	2	0	senyes	4	7	7
senzillà	2	0	senzilla	0	2267	2267
senzillés	2	0	senzilles	0	644	644
senés	0	0	senes	4	12	12
separarà	2	20	separara	2	0	20
separà	2	68	separa	2	941	1009
separàrem	2	0	separarem	2	10	10
separés	2	31	separes	2	4	35
separí	2	0	separi	2	71	71
sepultarà	2	1	sepultara	2	0	1
sepultàrem	2	0	sepultarem	2	1	1
sepultí	2	0	sepulti	2	1	1
sequés	2	0	seques	0	277	277
sequí	2	0	sequi	2	1	1
seqüencià	2	0	seqüencia	2	5	5
seqüenciàrem	2	0	seqüenciarem	2	1	1
seqüenciés	2	0	seqüencies	2	4	4
seqüència	4	2613	seqüencia	2	5	2618
seqüències	4	1099	seqüencies	2	4	1103
serialitzà	2	1	serialitza	2	6	7
serigrafià	2	0	serigrafia	4	16	16
serigrafiés	2	0	serigrafies	4	9	9
serià	2	1	seria	2	25070	25071
seriés	2	0	series	2	330	330
sermonegés	2	1	sermoneges	2	0	1
sermonegí	2	0	sermonegi	2	1	1
sermonejarà	2	1	sermonejara	2	0	1
sermonejà	2	0	sermoneja	2	5	5
serosà	0	0	serosa	4	16	16
serpejà	2	0	serpeja	2	1	1
serpentejà	2	1	serpenteja	2	15	16
serratellà	0	0	serratella	4	2	2
serrés	2	0	serres	4	142	142
serrí	2	0	serri	2	3	3
servirà	2	825	servira	2	3	828
servà	2	0	serva	4	18	18
servés	2	0	serves	4	5	5
serví	2	527	servi	2	49	576
servírem	2	0	servirem	2	18	18
servíreu	2	0	servireu	2	3	3
servís	2	114	servis	2	11	125
seríem	2	177	seriem	2	12	189
seríeu	2	17	serieu	2	9	26
sestà	2	0	sesta	4	1	1
sestí	2	0	sesti	2	1	1
setanta-quatrè	0	1	setanta-quatre	3	14	15
setanta-quatré	0	0	setanta-quatre	3	14	14
setià	2	1	setia	2	1	2
setzè	0	64	setze	3	747	811
setzé	0	1	setze	3	747	748
setí	4	23	seti	4	57	80
seuré	2	7	seure	2	401	408
sevillà	0	7	sevilla	4	867	874
sextà	0	0	sexta	0	46	46
sexualitzà	2	0	sexualitza	2	1	1
sexà	2	1	sexa	2	0	1
sexés	2	0	sexes	2	731	731
sexí	2	0	sexi	2	29	29
sienès	0	2	sienes	4	0	2
sigil·lí	2	0	sigil·li	2	1	1
signarà	2	126	signara	2	1	127
significarà	2	451	significara	2	0	451
significà	2	51	significa	2	16107	16158
signifiqués	2	33	signifiques	2	4	37
signifiquí	2	0	signifiqui	2	261	261
signà	2	197	signa	4	308	505
signàrem	2	0	signarem	2	30	30
signés	2	90	signes	2	1471	1561
signí	2	0	signi	2	116	116
silenciarà	2	7	silenciara	2	0	7
silencià	2	2	silencia	2	134	136
silenciés	2	2	silencies	2	0	2
siliconà	2	0	silicona	4	84	84
siliconés	2	0	silicones	4	7	7
sillà	0	0	silla	4	114	114
siluetà	2	0	silueta	4	109	109
siluetés	2	0	siluetes	4	44	44
siluetí	2	0	silueti	2	1	1
silvestrè	4	0	silvestre	4	340	340
silvestré	4	0	silvestre	4	340	340
silà	4	5	sila	4	16	21
simbolitzarà	2	2	simbolitzara	2	0	2
simbolitzà	2	1	simbolitza	2	360	361
simbolitzés	2	2	simbolitzes	2	0	2
simbolitzí	2	0	simbolitzi	2	4	4
simpatitzà	2	4	simpatitza	2	18	22
simpatitzés	2	1	simpatitzes	2	1	2
simpatitzí	2	0	simpatitzi	2	5	5
simplificarà	2	113	simplificara	2	0	113
simplificà	2	3	simplifica	2	265	268
simplificàrem	2	0	simplificarem	2	4	4
simplifiqués	2	8	simplifiques	2	1	9
simplifiquí	2	0	simplifiqui	2	76	76
simularà	2	5	simulara	2	0	5
simultaniejarà	2	1	simultaniejara	2	0	1
simulà	2	1	simula	2	202	203
simulés	2	2	simules	2	1	3
simulí	2	0	simuli	2	5	5
sincerà	2	0	sincera	0	665	665
sincerés	2	0	sinceres	0	286	286
sincronitzarà	2	22	sincronitzara	2	1	23
sincronitzà	2	1	sincronitza	2	380	381
sincronitzés	2	1	sincronitzes	2	0	1
sincronitzí	2	0	sincronitzi	2	6	6
sindicà	2	0	sindica	2	3	3
singlà	2	0	singla	2	2	2
singlés	2	0	singles	2	258	258
singularitzà	2	0	singularitza	2	2	2
sinteritzà	2	0	sinteritza	2	2	2
sintetitzarà	2	4	sintetitzara	2	0	4
sintetitzà	2	11	sintetitza	2	80	91
sintetitzí	2	0	sintetitzi	2	3	3
sintonitzà	2	1	sintonitza	2	10	11
sintonitzí	2	0	sintonitzi	2	4	4
sipà	2	0	sipa	2	7	7
sipés	2	0	sipes	2	2	2
sipí	2	0	sipi	2	3	3
siracusà	0	2	siracusa	4	92	94
sirgà	2	0	sirga	4	9	9
sirventès	4	3	sirventes	4	0	3
sirà	4	4	sira	4	9	13
sistematitzà	2	0	sistematitza	2	2	2
situarà	2	134	situara	2	0	134
situà	2	63	situa	2	1621	1684
situàrem	2	0	situarem	2	11	11
situés	2	18	situes	2	1	19
soanyès	0	0	soanyes	4	1	1
soanyés	0	0	soanyes	4	1	1
sobrarà	2	1	sobrara	2	0	1
sobreactuà	2	0	sobreactua	2	1	1
sobrecarregarà	2	4	sobrecarregara	2	0	4
sobrecarreguí	2	0	sobrecarregui	2	11	11
sobrecarregà	2	0	sobrecarrega	2	11	11
sobrecarregàreu	2	0	sobrecarregareu	2	1	1
sobrecàrrega	4	234	sobrecarrega	2	11	245
sobrecàrregues	4	14	sobrecarregues	2	0	14
sobrediagnòstic	4	11	sobrediagnostic	2	0	11
sobreentendré	2	0	sobreentendre	2	3	3
sobreentengués	2	1	sobreentengues	2	0	1
sobreescalfí	2	0	sobreescalfi	2	2	2
sobreescrigués	2	0	sobreescrigues	2	1	1
sobreescriguí	2	0	sobreescrigui	2	13	13
sobreescriuré	2	0	sobreescriure	2	311	311
sobreestimulà	2	0	sobreestimula	2	2	2
sobreestimà	2	3	sobreestima	2	11	14
sobreestimés	2	0	sobreestimes	2	3	3
sobreestimí	2	0	sobreestimi	2	2	2
sobreexplotà	2	0	sobreexplota	2	2	2
sobreexplotí	2	0	sobreexploti	2	1	1
sobreexposà	2	0	sobreexposa	2	3	3
sobrenomenà	2	0	sobrenomena	2	2	2
sobrepassarà	2	23	sobrepassara	2	0	23
sobrepassà	2	5	sobrepassa	2	210	215
sobrepassàrem	2	0	sobrepassarem	2	5	5
sobrepassàreu	2	0	sobrepassareu	2	1	1
sobrepassés	2	8	sobrepasses	2	0	8
sobrepassí	2	0	sobrepassi	2	50	50
sobreposarà	2	1	sobreposara	2	0	1
sobreposà	2	0	sobreposa	2	22	22
sobreposí	2	0	sobreposi	2	3	3
sobrepugés	2	0	sobrepuges	4	3	3
sobrepujà	2	0	sobrepuja	4	10	10
sobresaltarà	2	1	sobresaltara	2	0	1
sobresaltà	2	0	sobresalta	2	3	3
sobresaturà	2	0	sobresatura	2	2	2
sobreseuré	2	0	sobreseure	2	5	5
sobrevalorà	2	0	sobrevalora	2	7	7
sobrevalorés	2	0	sobrevalores	2	1	1
sobrevindré	2	1	sobrevindre	2	1	2
sobrevinguí	2	0	sobrevingui	2	2	2
sobrevisqués	2	24	sobrevisques	2	0	24
sobrevisquí	2	0	sobrevisqui	2	68	68
sobreviuré	2	8	sobreviure	2	2436	2444
sobrevolà	2	7	sobrevola	2	12	19
sobrevolàrem	2	0	sobrevolarem	2	1	1
sobrevolés	2	1	sobrevoles	2	0	1
sobrevolí	2	0	sobrevoli	2	4	4
sobrà	2	0	sobra	4	171	171
sobrés	2	4	sobres	4	412	416
sobrí	2	0	sobri	2	98	98
sobtà	2	0	sobta	2	8	8
sobtí	2	0	sobti	2	1	1
socarràrem	2	0	socarrarem	2	1	1
socialitzà	2	1	socialitza	2	4	5
sodomitzà	2	0	sodomitza	2	1	1
sofisticà	2	0	sofistica	2	1	1
sofrirà	2	130	sofrira	2	0	130
sofrà	2	0	sofra	4	2	2
sofrés	2	0	sofres	4	2	2
sofrí	2	19	sofri	2	3	22
sofrírem	2	0	sofrirem	2	33	33
sofríreu	2	0	sofrireu	2	1	1
sofrís	2	26	sofris	2	0	26
sofística	0	1	sofistica	2	1	2
sofístiques	0	1	sofistiques	2	0	1
sogués	2	0	sogues	4	3	3
sogà	2	0	soga	4	66	66
solaparà	2	3	solapara	2	0	3
solapà	2	0	solapa	4	55	55
solapés	2	1	solapes	4	6	7
solapí	2	0	solapi	2	7	7
solarà	2	0	solara	2	1	1
solcà	2	0	solca	2	4	4
soldà	2	289	solda	2	6	295
soldí	2	0	soldi	2	2	2
solguí	2	0	solgui	2	2	2
solidaritzarà	2	1	solidaritzara	2	0	1
solidaritzà	2	0	solidaritza	2	17	17
solidaritzés	2	1	solidaritzes	2	0	1
solidaritzí	2	0	solidaritzi	2	4	4
solidificà	2	5	solidifica	2	17	22
solidifiqués	2	1	solidifiques	2	0	1
solidifiquí	2	0	solidifiqui	2	4	4
solidà	2	0	solida	2	2	2
solidària	0	453	solidaria	2	0	453
solidàries	0	61	solidaries	2	1	62
solidí	2	0	solidi	2	5	5
sollevà	2	0	solleva	2	1	1
sollà	2	0	solla	2	4	4
soltà	2	2	solta	0	83	85
soltés	2	0	soltes	0	66	66
soltí	2	0	solti	2	17	17
solucionarà	2	121	solucionara	2	0	121
solucionà	2	4	soluciona	2	458	462
solucionàrem	2	0	solucionarem	2	53	53
solucionés	2	16	soluciones	2	0	16
solucioní	2	0	solucioni	2	126	126
sol·licitarà	2	97	sol·licitara	2	0	97
sol·licità	2	34	sol·licita	2	1442	1476
sol·licitàrem	2	0	sol·licitarem	2	45	45
sol·licités	2	75	sol·licites	2	0	75
sol·licití	2	0	sol·liciti	2	338	338
sol·lícit	0	9	sol·licit	2	0	9
sol·lícita	0	8	sol·licita	2	1442	1450
solés	2	0	soles	0	578	578
solí	2	3	soli	2	21	24
somiarà	2	1	somiara	2	0	1
somiquejà	2	1	somiqueja	2	0	1
somià	2	1	somia	2	84	85
somiés	2	0	somies	2	7	7
somií	2	1	somii	2	0	1
somnià	2	1	somnia	2	14	15
somniés	2	0	somnies	2	5	5
somriguí	2	0	somrigui	2	9	9
somriuré	2	0	somriure	4	460	460
sonarà	2	41	sonara	2	2	43
sondegés	2	2	sondeges	2	0	2
sondegí	2	0	sondegi	2	1	1
sondejà	2	0	sondeja	2	5	5
sondà	2	0	sonda	4	761	761
sondés	2	0	sondes	4	241	241
sondí	2	0	sondi	2	1	1
sonà	2	5	sona	2	889	894
sonés	2	21	sones	2	23	44
soní	2	0	soni	2	103	103
soparà	2	5	sopara	2	1	6
soplujà	2	0	sopluja	2	1	1
sopà	2	0	sopa	4	317	317
sopàrem	2	0	soparem	2	7	7
sopés	2	0	sopes	4	54	54
sopí	2	0	sopi	2	3	3
sorgirà	2	104	sorgira	2	1	105
sorità	0	0	sorita	4	2	2
sorollà	2	0	sorolla	4	17	17
sorprendré	2	10	sorprendre	2	1025	1035
sorprengués	2	3	sorprengues	2	0	3
sorprenguí	2	0	sorprengui	2	62	62
sorrà	2	0	sorra	4	1354	1354
sorrés	2	0	sorres	4	177	177
sortegí	2	0	sortegi	2	3	3
sortejarà	2	1	sortejara	2	0	1
sortejà	2	1	sorteja	2	2	3
sortirà	2	458	sortira	2	1	459
sortírem	2	0	sortirem	2	168	168
sortíreu	2	0	sortireu	2	8	8
soscavarà	2	45	soscavara	2	0	45
soscavà	2	1	soscava	2	352	353
soscavàrem	2	0	soscavarem	2	6	6
soscavés	2	5	soscaves	2	0	5
soscaví	2	0	soscavi	2	78	78
sospesarà	2	4	sospesara	2	0	4
sospesà	2	1	sospesa	2	16	17
sospesàrem	2	0	sospesarem	2	2	2
sospesés	2	1	sospeses	2	4	5
sospesí	2	0	sospesi	2	7	7
sospirà	2	2	sospira	2	10	12
sospirí	2	0	sospiri	2	4	4
sospitarà	2	4	sospitara	2	1	5
sospità	2	9	sospita	4	858	867
sospités	2	10	sospites	4	474	484
sospití	2	0	sospiti	2	33	33
sostindré	2	4	sostindre	2	8	12
sostingués	2	6	sostingues	2	4	10
sostinguí	2	0	sostingui	2	39	39
sostragués	2	1	sostragues	2	0	1
sostrauré	2	0	sostraure	2	2	2
sostrés	2	0	sostres	4	300	300
soterrà	2	0	soterra	2	1	1
soterràrem	2	0	soterrarem	2	1	1
soterrés	2	1	soterres	2	0	1
sotmetré	2	88	sotmetre	2	2447	2535
sotmetés	2	54	sotmetes	2	0	54
sotmetí	2	0	sotmeti	2	293	293
sotsobrés	2	1	sotsobres	2	1	2
sotssecretària	4	9	sotssecretaria	4	2	11
sovintegés	2	0	sovinteges	2	1	1
sovintejà	2	1	sovinteja	2	2	3
suarà	2	0	suara	2	5	5
suavitzarà	2	11	suavitzara	2	0	11
suavitzà	2	1	suavitza	2	96	97
suavitzés	2	3	suavitzes	2	0	3
suavitzí	2	0	suavitzi	2	18	18
subalternà	2	0	subalterna	0	7	7
subcontractà	2	0	subcontracta	2	11	11
subcontractés	2	1	subcontractes	2	10	11
subcontractí	2	0	subcontracti	2	2	2
subdividirà	2	1	subdividira	2	0	1
subestimà	2	5	subestima	2	93	98
subestimés	2	1	subestimes	2	10	11
subestimí	2	0	subestimi	2	20	20
subhastarà	2	3	subhastara	2	0	3
subhastà	2	0	subhasta	4	326	326
subhastés	2	2	subhastes	4	248	250
subhastí	2	0	subhasti	2	4	4
subjectarà	2	2	subjectara	2	0	2
subjectivà	2	0	subjectiva	0	119	119
subjectivés	2	0	subjectives	0	59	59
subjectà	2	0	subjecta	2	639	639
subjectés	2	0	subjectes	2	2041	2041
subjectí	2	0	subjecti	2	1	1
subjugués	2	1	subjugues	2	0	1
subjuguí	2	0	subjugui	2	2	2
subjugà	2	3	subjuga	2	3	6
sublevarà	2	1	sublevara	2	1	2
sublevà	2	0	subleva	2	1	1
sublimà	2	0	sublima	2	7	7
sublimés	2	1	sublimes	2	0	1
sublimí	2	0	sublimi	2	4	4
submergirà	2	3	submergira	2	0	3
subministrarà	2	21	subministrara	2	0	21
subministrà	2	5	subministra	2	263	268
subministràrem	2	0	subministrarem	2	3	3
subministrés	2	7	subministres	2	16	23
subministrí	2	0	subministri	2	37	37
submón	4	20	submon	4	3	23
subordinarà	2	4	subordinara	2	0	4
subordinà	2	1	subordina	2	33	34
subordinàrem	2	0	subordinarem	2	1	1
subordiní	2	0	subordini	2	10	10
subornarà	2	1	subornara	2	0	1
subornà	2	1	suborna	2	4	5
subratllarà	2	24	subratllara	2	0	24
subratllà	2	4	subratlla	2	1531	1535
subratllàrem	2	0	subratllarem	2	12	12
subratllés	2	5	subratlles	2	0	5
subratllí	2	0	subratlli	2	111	111
subroguí	2	0	subrogui	2	1	1
subscriguí	2	0	subscrigui	2	60	60
subscriuré	2	3	subscriure	2	793	796
subsecretària	4	6	subsecretaria	4	2	8
subsecretàries	4	0	subsecretaries	4	2	2
subsidiària	0	303	subsidiaria	2	4	307
subsidiàries	0	77	subsidiaries	2	2	79
subsistirà	2	10	subsistira	2	0	10
substancià	2	0	substancia	2	9	9
substanciés	2	0	substancies	2	24	24
substantivà	2	0	substantiva	0	88	88
substantivés	2	0	substantives	0	56	56
substituírem	2	0	substituirem	2	18	18
substituíreu	2	0	substituireu	2	1	1
substància	4	1563	substancia	2	9	1572
substàncies	4	4981	substancies	2	24	5005
subsumirà	2	1	subsumira	2	0	1
subsòl	4	104	subsol	4	6	110
subsòls	4	3	subsols	4	0	3
subtitulà	2	1	subtitula	2	2	3
subvalorà	2	0	subvalora	2	1	1
subvencionarà	2	8	subvencionara	2	0	8
subvencionà	2	1	subvenciona	2	70	71
subvencionés	2	2	subvenciones	2	0	2
subvencioní	2	0	subvencioni	2	29	29
succionà	2	0	succiona	2	4	4
succionés	2	2	succiones	2	0	2
sucumbirà	2	4	sucumbira	2	0	4
sucumbírem	2	0	sucumbirem	2	2	2
sucà	2	3	suca	2	10	13
suecà	0	0	sueca	4	2480	2480
sufixés	2	0	sufixes	0	7	7
sufocarà	2	1	sufocara	2	0	1
sufocà	2	1	sufoca	2	10	11
sufoqués	2	1	sufoques	2	0	1
sufoquí	2	0	sufoqui	2	1	1
sufragarà	2	11	sufragara	2	0	11
sufragués	2	2	sufragues	2	0	2
sufraguí	2	0	sufragui	2	7	7
sufragà	2	1	sufraga	2	12	13
suggerirà	2	25	suggerira	2	0	25
suggerírem	2	0	suggerirem	2	5	5
sulfatà	2	0	sulfata	2	1	1
sulfatés	2	0	sulfates	2	2	2
sulfonà	2	0	sulfona	4	4	4
sulfonés	2	0	sulfones	4	6	6
sulfoní	2	0	sulfoni	2	2	2
sullà	2	0	sulla	0	8	8
sullí	2	0	sulli	2	1	1
sumarià	2	0	sumaria	2	24	24
sumarà	2	42	sumara	2	1	43
sumaríem	2	1	sumariem	2	0	1
sumirà	2	9	sumira	2	0	9
sumà	2	7	suma	4	3323	3330
sumàrem	2	0	sumarem	2	4	4
sumària	0	30	sumaria	2	24	54
sumàries	0	45	sumaries	2	0	45
sumés	2	12	sumes	4	976	988
sumí	2	0	sumi	2	77	77
sumírem	2	0	sumirem	2	1	1
sumís	2	1	sumis	2	1	2
supeditarà	2	1	supeditara	2	0	1
supedità	2	0	supedita	2	22	22
supeditàrem	2	0	supeditarem	2	3	3
supedití	2	0	supediti	2	14	14
superarà	2	123	superara	2	0	123
superposarà	2	8	superposara	2	0	8
superposà	2	2	superposa	2	120	122
superposí	2	0	superposi	2	8	8
supervisarà	2	74	supervisara	2	1	75
supervisà	2	45	supervisa	2	295	340
supervisàrem	2	0	supervisarem	2	28	28
supervisés	2	18	supervises	2	0	18
supervisí	2	0	supervisi	2	114	114
superà	2	59	supera	2	879	938
superàrem	2	0	superarem	2	45	45
superàreu	2	0	superareu	2	1	1
superés	2	44	superes	2	7	51
superí	2	1	superi	2	306	307
suplantarà	2	4	suplantara	2	0	4
suplantà	2	0	suplanta	2	14	14
suplantés	2	1	suplantes	2	1	2
suplantí	2	0	suplanti	2	1	1
suplementà	2	2	suplementa	2	3	5
suplementària	0	329	suplementaria	2	1	330
suplementàries	0	259	suplementaries	2	0	259
suplicarà	2	1	suplicara	2	0	1
suplicà	2	1	suplica	2	33	34
supliqués	2	1	supliques	2	2	3
supliquí	2	0	supliqui	2	8	8
suportarà	2	22	suportara	2	1	23
suportà	2	5	suporta	2	566	571
suportàrem	2	0	suportarem	2	9	9
suportés	2	5	suportes	2	2	7
suportí	2	0	suporti	2	39	39
suposarà	2	834	suposara	2	1	835
suposà	2	57	suposa	2	7792	7849
suposàrem	2	0	suposarem	2	8	8
suposés	2	43	suposes	2	6	49
suposí	2	0	suposi	2	429	429
suprimirà	2	306	suprimira	2	0	306
suprimírem	2	0	suprimirem	2	10	10
suprimíreu	2	0	suprimireu	2	17	17
supurà	2	0	supura	2	1	1
surarà	2	0	surara	2	1	1
surfejà	2	0	surfeja	2	4	4
surà	2	0	sura	4	54	54
surés	2	0	sures	4	7	7
surí	2	1	suri	2	18	19
suscitarà	2	41	suscitara	2	0	41
suscità	2	3	suscita	2	576	579
suscitàrem	2	0	suscitarem	2	1	1
suscités	2	7	suscites	2	0	7
suscití	2	0	susciti	2	40	40
suspendré	2	6	suspendre	2	1457	1463
suspengués	2	40	suspengues	2	0	40
suspenguí	2	0	suspengui	2	149	149
sustentarà	2	8	sustentara	2	0	8
sustentà	2	0	sustenta	2	255	255
sustentàrem	2	0	sustentarem	2	1	1
sustentés	2	4	sustentes	2	0	4
sustentí	2	0	sustenti	2	39	39
suturà	2	1	sutura	4	36	37
suturés	2	0	sutures	4	19	19
suturí	2	0	suturi	2	1	1
suà	2	0	sua	2	23	23
suàreu	2	0	suareu	2	1	1
sués	2	0	sues	2	14	14
suí	2	2	sui	4	150	152
suïcidarà	2	1	suïcidara	2	1	2
suïcidà	2	25	suïcida	0	274	299
suïcidés	2	12	suïcides	0	346	358
suïcidí	2	0	suïcidi	2	604	604
sàlica	0	16	salica	2	0	16
sàlics	0	5	salics	4	0	5
sàmara	4	2	samara	4	80	82
sèiem	2	2	seiem	2	15	17
sèieu	2	0	seieu	2	45	45
sènons	0	2	senons	4	1	3
sèrie	4	23616	serie	2	131	23747
sèries	4	1580	series	2	330	1910
sèu	4	57	seu	4	204197	204254
sèus	4	8	seus	4	98993	99001
sèver	4	0	sever	4	393	393
sèvers	4	0	severs	4	167	167
sé	2	11976	se	5	63903	75879
séc	4	0	sec	4	732	732
sécs	4	0	secs	0	417	417
séiem	2	0	seiem	2	15	15
séieu	2	0	seieu	2	45	45
séver	4	0	sever	4	393	393
sévers	4	0	severs	4	167	167
sí	4	20036	si	1	208062	228098
sílur	4	0	silur	4	4	4
sílurs	4	0	silurs	4	12	12
síncope	4	18	sincope	2	0	18
síncopes	4	3	sincopes	2	0	3
síndic	4	11	sindic	2	0	11
síndica	4	1	sindica	2	3	4
sís	4	11	sis	4	13700	13711
sòl	4	3250	sol	4	13513	16763
sòlid	0	2141	solid	2	69	2210
sòlida	0	2253	solida	2	2	2255
sòlides	0	781	solides	2	0	781
sòls	4	674	sols	4	33606	34280
sòtil	4	0	sotil	0	4	4
sòviet	4	1	soviet	4	257	258
sòviets	4	3	soviets	4	92	95
sóc	2	12583	soc	2	479	13062
són	2	152371	son	3	1759	154130
súper	0	276	super	2	795	1071
súpera	0	1	supera	2	879	880
súperes	0	0	superes	2	7	7
súplica	4	38	suplica	2	33	71
súpliques	4	33	supliques	2	2	35
tabulà	2	0	tabula	2	28	28
tabulés	2	0	tabules	2	1	1
tacarà	2	4	tacara	2	0	4
tacà	2	0	taca	4	348	348
tacàrem	2	0	tacarem	2	1	1
tacó	4	12	taco	2	18	30
tafanejà	2	0	tafaneja	2	1	1
talarà	2	0	talara	2	1	1
talaverà	0	0	talavera	4	18	18
tallarà	2	30	tallara	2	0	30
tallà	2	6	talla	4	750	756
tallàrem	2	0	tallarem	2	11	11
tallés	2	20	talles	4	143	163
tallí	2	0	talli	2	46	46
tal·lí	0	0	tal·li	4	20	20
talà	2	0	tala	4	403	403
talés	2	0	tales	4	193	193
talí	2	0	tali	2	28	28
talís	4	0	talis	2	2	2
tamboriní	2	0	tamborini	2	8	8
tamisà	2	0	tamisa	2	4	4
tancarà	2	268	tancara	2	5	273
tancà	2	84	tanca	4	2707	2791
tancàrem	2	0	tancarem	2	36	36
tancàreu	2	0	tancareu	2	8	8
tancó	4	0	tanco	2	68	68
tangó	4	0	tango	4	136	136
tanqués	2	69	tanques	4	276	345
tanquí	2	0	tanqui	2	300	300
taparà	2	6	tapara	2	0	6
tapià	2	0	tapia	2	11	11
tapió	4	0	tapio	2	7	7
taponà	2	0	tapona	2	1	1
tapà	2	2	tapa	4	403	405
tapàrem	2	0	taparem	2	1	1
tapàreu	2	0	tapareu	2	1	1
tapés	2	8	tapes	4	73	81
tapí	2	0	tapi	2	9	9
tapís	4	80	tapis	4	4	84
taquigrafià	2	0	taquigrafia	4	31	31
taqués	2	3	taques	4	505	508
taquí	2	0	taqui	2	11	11
taquín	2	0	taquin	2	15	15
taral·lejà	2	0	taral·leja	2	2	2
tararà	2	1	tarara	2	0	1
tardarà	2	24	tardara	2	0	24
tardàrem	2	0	tardarem	2	3	3
tardàreu	2	0	tardareu	2	1	1
tardés	2	0	tardes	4	82	82
tardí	2	0	tardi	2	14	14
tarifà	2	0	tarifa	4	460	460
tarifària	0	20	tarifaria	2	0	20
tarifàries	0	34	tarifaries	2	0	34
tarifés	2	1	tarifes	4	1066	1067
tartamudegés	2	0	tartamudeges	2	2	2
tartamudejà	2	0	tartamudeja	2	1	1
tarà	2	0	tara	4	168	168
tarós	0	0	taros	4	2	2
tascà	2	0	tasca	4	10160	10160
tascó	4	12	tasco	2	0	12
tasqués	2	0	tasques	4	6523	6523
tastarà	2	2	tastara	2	0	2
tastà	2	0	tasta	2	23	23
tastàrem	2	0	tastarem	2	2	2
tastés	2	1	tastes	2	1	2
tastí	2	0	tasti	2	5	5
tatuà	2	0	tatua	2	1	1
tatxà	2	0	tatxa	4	19	19
tatxés	2	0	tatxes	4	1	1
tatà	4	0	tata	4	88	88
taulà	2	0	taula	4	9441	9441
taulés	2	0	taules	4	2454	2454
taurí	0	7	tauri	0	35	42
tavellà	2	0	tavella	4	2	2
tavellés	2	0	tavelles	4	1	1
taxà	2	0	taxa	4	4554	4554
taxés	2	0	taxes	4	2627	2627
taxí	2	0	taxi	2	321	321
taxó	4	33	taxo	2	0	33
tebà	0	12	teba	0	0	12
teclegés	2	0	tecleges	2	2	2
teclegí	2	0	teclegi	2	4	4
teclejà	2	0	tecleja	2	22	22
teixírem	2	0	teixirem	2	1	1
telecomandés	2	0	telecomandes	4	2	2
telefonà	2	2	telefona	2	17	19
telefonàrem	2	0	telefonarem	2	1	1
telefonés	2	0	telefones	2	3	3
telefoní	2	0	telefoni	2	4	4
telegrafià	2	4	telegrafia	4	32	36
teleportà	2	0	teleporta	2	6	6
televisarà	2	1	televisara	2	0	1
televisà	2	0	televisa	2	14	14
televisí	2	0	televisi	2	4	4
telà	2	0	tela	4	446	446
telèfon	4	2836	telefon	2	11	2847
telés	2	0	teles	4	161	161
telí	2	0	teli	2	1	1
teló	4	690	telo	2	2	692
tematitzà	2	0	tematitza	2	1	1
temerà	2	3	temera	2	0	3
temperà	2	0	tempera	2	4	4
temprà	2	1	tempra	2	1	2
temptarà	2	0	temptara	2	1	1
temptejà	2	1	tempteja	2	1	2
temptà	2	2	tempta	2	18	20
temptés	2	2	temptes	2	1	3
temptí	2	0	tempti	2	7	7
temérem	2	0	temerem	2	1	1
temés	2	8	temes	4	12434	12442
temí	2	0	temi	2	50	50
tenallà	2	0	tenalla	4	14	14
tenallés	2	0	tenalles	4	14	14
tendirà	2	52	tendira	2	1	53
tendrà	2	8	tendra	0	52	60
tendré	2	1	tendre	0	54	55
tendírem	2	0	tendirem	2	3	3
tengués	2	4	tengues	2	0	4
tenguí	2	0	tengui	2	8	8
tensà	2	0	tensa	0	84	84
tensés	2	0	tenses	0	69	69
tenyirà	2	1	tenyira	2	0	1
teoritzà	2	13	teoritza	2	33	46
terbolinà	2	0	terbolina	4	1	1
tercés	2	0	terces	0	2	2
tercí	2	0	terci	2	2	2
teresà	0	0	teresa	4	339	339
tergiversarà	2	1	tergiversara	2	0	1
tergiversà	2	0	tergiversa	2	8	8
tergiversí	2	0	tergiversi	2	7	7
termenejà	2	0	termeneja	2	1	1
terminarà	2	2	terminara	2	0	2
terminà	2	5	termina	2	22	27
terminés	2	1	termines	2	0	1
terminí	2	0	termini	4	17406	17406
termòmetre	4	90	termometre	2	0	90
termòmetres	4	56	termometres	2	0	56
terrassà	4	0	terrassa	4	263	263
terroritzarà	2	1	terroritzara	2	0	1
terroritzà	2	1	terroritza	2	20	21
terroritzés	2	0	terroritzes	2	2	2
terroritzí	2	0	terroritzi	2	2	2
terrossós	0	0	terrossos	4	8	8
terrà	2	3	terra	4	16697	16700
terrè	0	2	terre	2	56	58
terré	0	2	terre	2	56	58
terrés	2	0	terres	4	5949	5949
terrí	2	0	terri	4	16	16
terçà	2	0	terça	4	3	3
terçó	0	2	terço	2	0	2
testamentària	0	5	testamentaria	4	1	6
testamentàries	0	9	testamentaries	4	0	9
testegí	2	0	testegi	2	1	1
testejà	2	0	testeja	2	1	1
testificarà	2	5	testificara	2	0	5
testificà	2	6	testifica	2	88	94
testificàrem	2	0	testificarem	2	1	1
testifiqués	2	2	testifiques	2	0	2
testifiquí	2	0	testifiqui	2	3	3
testimoniarà	2	2	testimoniara	2	0	2
testimonià	2	1	testimonia	2	42	43
testimoniés	2	0	testimonies	2	2	2
testà	2	1	testa	0	27	28
testés	2	0	testes	0	2	2
testí	2	0	testi	2	3	3
testó	4	0	testo	2	1	1
tesí	2	0	tesi	2	948	948
tetràedre	4	97	tetraedre	4	39	136
tetràedres	4	18	tetraedres	4	11	29
teulà	2	0	teula	4	84	84
teulés	2	0	teules	4	64	64
texturitzà	2	0	texturitza	2	1	1
texturà	2	0	textura	4	610	610
texturés	2	0	textures	4	257	257
tibarà	2	1	tibara	2	0	1
tiberí	0	0	tiberi	4	124	124
tibà	2	0	tiba	2	4	4
tibàrem	2	0	tibarem	2	1	1
tibés	2	0	tibes	2	3	3
tibí	2	0	tibi	4	13	13
tigré	4	10	tigre	4	355	365
tigrés	4	0	tigres	4	244	244
timbrà	2	0	timbra	2	2	2
timbrés	2	0	timbres	2	32	32
tindré	2	468	tindre	2	453	921
tingués	2	1573	tingues	2	245	1818
tinguí	2	0	tingui	2	8795	8795
tintà	2	0	tinta	4	521	521
tintés	2	0	tintes	4	67	67
tintí	2	0	tinti	2	1	1
tinyà	2	0	tinya	2	14	14
tipificà	2	1	tipifica	2	28	29
tipifiqués	2	1	tipifiques	2	0	1
tipifiquí	2	0	tipifiqui	2	3	3
tiranitzarà	2	1	tiranitzara	2	0	1
tiranitzà	2	0	tiranitza	2	5	5
tiranitzí	2	0	tiranitzi	2	1	1
tirarà	2	61	tirara	2	1	62
tirà	2	172	tira	4	659	831
tiràrem	2	0	tirarem	2	39	39
tirés	2	42	tires	4	247	289
tirí	2	0	tiri	2	184	184
tiró	4	0	tiro	2	88	88
titllà	2	8	titlla	4	87	95
titllés	2	1	titlles	4	4	5
titllí	2	0	titlli	2	16	16
titlés	2	0	titles	4	5	5
titubegí	2	0	titubegi	2	2	2
titubejà	2	0	titubeja	2	12	12
titubà	2	0	tituba	2	18	18
titularà	2	2	titulara	2	0	2
titulà	2	9	titula	2	110	119
titulés	2	1	titules	2	0	1
titulí	2	0	tituli	2	4	4
tità	2	263	tita	4	9	272
tités	2	0	tites	4	2	2
tití	2	15	titi	2	3	18
titís	4	4	titis	2	0	4
tivissà	0	0	tivissa	4	7	7
tocarà	2	88	tocara	2	1	89
tocà	2	48	toca	4	1690	1738
tocàrem	2	1	tocarem	2	8	9
tocàreu	2	0	tocareu	2	1	1
todolellà	0	0	todolella	4	2	2
togà	0	0	toga	4	40	40
toixà	0	0	toixa	4	2	2
tolerarà	2	76	tolerara	2	0	76
tolerà	2	4	tolera	2	147	151
toleràrem	2	0	tolerarem	2	49	49
toleràreu	2	0	tolerareu	2	1	1
tolerés	2	8	toleres	2	0	8
tolerí	2	0	toleri	2	36	36
tomarà	2	0	tomara	2	17	17
tombarà	2	1	tombara	2	2	3
tombà	2	5	tomba	4	1471	1476
tombés	2	0	tombes	4	799	799
tombí	2	0	tombi	2	4	4
tomà	2	1	toma	2	13	14
tomés	2	0	tomes	4	5	5
tomí	2	0	tomi	2	9	9
tondòs	2	0	tondos	4	2	2
tongués	2	0	tongues	2	8	8
tonificà	2	0	tonifica	2	1	1
tonsurà	2	0	tonsura	4	10	10
toparà	2	8	topara	2	0	8
topà	2	20	topa	2	66	86
topàrem	2	0	toparem	2	11	11
topés	2	1	topes	2	4	5
topí	2	3	topi	2	14	17
toqués	2	34	toques	4	49	83
toquí	2	0	toqui	2	116	116
torbà	2	1	torba	4	217	218
torbés	2	0	torbes	4	13	13
torcerà	2	1	torcera	2	0	1
torcà	2	0	torca	2	5	5
torcí	2	0	torci	2	1	1
toregí	2	0	toregi	2	1	1
torejà	2	0	toreja	2	1	1
tornarà	2	1278	tornara	2	20	1298
tornà	2	1027	torna	4	4963	5990
tornàrem	2	2	tornarem	2	701	703
tornàreu	2	0	tornareu	2	33	33
tornària	0	0	tornaria	2	480	480
tornàries	0	0	tornaries	2	17	17
tornàveu	2	0	tornaveu	4	1	1
tornès	0	2	tornes	4	204	206
tornés	2	478	tornes	4	204	682
torní	2	0	torni	2	2292	2292
torpedinarà	2	1	torpedinara	2	0	1
torpedinà	2	0	torpedina	2	3	3
torpediní	2	0	torpedini	2	2	2
torqués	2	0	torques	4	4	4
torretà	0	0	torreta	4	167	167
torrojà	0	0	torroja	4	7	7
torrà	2	0	torra	4	10	10
torràrem	2	0	torrarem	2	2	2
torrés	2	0	torres	4	1333	1333
torrí	2	0	torri	2	8	8
torturarà	2	4	torturara	2	0	4
torturà	2	0	tortura	4	1521	1521
torturàrem	2	0	torturarem	2	1	1
torturàreu	2	0	torturareu	2	1	1
torturés	2	4	tortures	4	421	425
torturí	2	0	torturi	2	11	11
torçà	2	1	torça	2	14	15
toró	4	0	toro	4	297	297
toscà	2	24	tosca	0	95	119
toscós	0	0	toscos	0	12	12
tosqués	2	0	tosques	0	3	3
tossirà	2	1	tossira	2	0	1
tossà	2	0	tossa	4	13	13
tosà	0	0	tosa	4	28	28
totalitzà	2	0	totalitza	2	8	8
tovà	2	0	tova	0	252	252
tovés	2	0	toves	0	151	151
trabucà	2	1	trabuca	2	0	1
tractarà	2	626	tractara	2	4	630
tractà	2	64	tracta	2	35829	35893
tractàrem	2	0	tractarem	2	305	305
tractàreu	2	0	tractareu	2	1	1
tractés	2	460	tractes	2	362	822
tractí	2	0	tracti	2	2001	2001
tracés	2	4	traces	4	291	295
trací	2	0	traci	0	55	55
traduírem	2	0	traduirem	2	2	2
traduíreu	2	0	traduireu	2	2	2
traficà	2	0	trafica	4	28	28
trafiqués	2	2	trafiques	4	5	7
trafiquí	2	0	trafiqui	2	4	4
tragarà	2	1	tragara	2	0	1
traginés	2	1	tragines	4	0	1
tragué	2	16	trague	2	5	21
tragués	2	35	tragues	2	9	44
tragà	2	0	traga	2	3	3
tragí	4	1	tragi	4	0	1
trairà	2	9	traira	2	0	9
trairé	2	5	traire	2	0	5
trametré	2	0	trametre	2	80	80
trametí	2	0	trameti	2	3	3
tramitarà	2	18	tramitara	2	0	18
tramità	2	0	tramita	2	48	48
tramitàrem	2	0	tramitarem	2	5	5
tramités	2	8	tramites	2	0	8
tramití	2	0	tramiti	2	27	27
trampejà	2	1	trampeja	2	2	3
tramuntí	2	0	tramunti	2	2	2
tramà	2	0	trama	4	667	667
tramès	2	70	trames	4	102	172
tramés	2	3	trames	4	102	105
tranquil·litzarà	2	13	tranquil·litzara	2	0	13
tranquil·litzà	2	0	tranquil·litza	2	122	122
tranquil·litzàrem	2	0	tranquil·litzarem	2	2	2
tranquil·litzés	2	5	tranquil·litzes	2	0	5
tranquil·litzí	2	0	tranquil·litzi	2	49	49
transaccioní	2	0	transaccioni	2	1	1
transcendirà	2	2	transcendira	2	0	2
transcodificà	2	0	transcodifica	2	21	21
transcriguí	2	0	transcrigui	2	4	4
transcriuré	2	0	transcriure	2	88	88
transferirà	2	43	transferira	2	0	43
transferírem	2	0	transferirem	2	5	5
transferíreu	2	0	transferireu	2	2	2
transfigurà	2	0	transfigura	2	1	1
transfondré	2	0	transfondre	2	1	1
transformarà	2	66	transformara	2	0	66
transformà	2	59	transforma	2	560	619
transformàrem	2	1	transformarem	2	5	6
transformés	2	23	transformes	2	2	25
transformí	2	0	transformi	2	118	118
transigirà	2	3	transigira	2	0	3
transigírem	2	0	transigirem	2	4	4
transitarà	2	1	transitara	2	0	1
transità	2	1	transita	2	33	34
transitària	0	0	transitaria	2	1	1
transití	2	0	transiti	2	7	7
transliterà	2	0	translitera	2	6	6
transmetré	2	285	transmetre	2	2726	3011
transmetés	2	69	transmetes	2	0	69
transmetí	2	0	transmeti	2	420	420
transmigrés	2	1	transmigres	2	0	1
transmutà	2	0	transmuta	2	1	1
transmutí	2	0	transmuti	2	1	1
transparentà	2	0	transparenta	2	4	4
transparentés	2	0	transparentes	2	1	1
transparentí	2	0	transparenti	2	5	5
transpirà	2	0	transpira	2	4	4
transpirés	2	1	transpires	2	0	1
transportarà	2	15	transportara	2	0	15
transportà	2	7	transporta	2	270	277
transportàrem	2	0	transportarem	2	2	2
transportés	2	6	transportes	2	9	15
transportí	2	0	transporti	2	36	36
transposarà	2	14	transposara	2	0	14
transposà	2	0	transposa	2	86	86
transposàrem	2	0	transposarem	2	1	1
transposés	2	2	transposes	2	0	2
transposí	2	0	transposi	2	52	52
transposó	4	4	transposo	2	0	4
transvasà	2	0	transvasa	2	1	1
transvasí	2	0	transvasi	2	1	1
trapezòedre	4	1	trapezoedre	4	3	4
trapezòedres	4	2	trapezoedres	4	0	2
trasbalsà	2	0	trasbalsa	2	3	3
trasbalsí	2	0	trasbalsi	2	1	1
traslladarà	2	69	traslladara	2	3	72
traslladà	2	392	trasllada	2	284	676
traslladàrem	2	1	traslladarem	2	11	12
traslladàreu	2	0	traslladareu	2	1	1
traslladés	2	85	trasllades	2	35	120
traslladí	2	0	traslladi	2	118	118
traspassarà	2	7	traspassara	2	0	7
traspassà	2	4	traspassa	2	83	87
traspassés	2	6	traspasses	2	1	7
traspassí	2	0	traspassi	2	14	14
trasplantà	2	0	trasplanta	2	4	4
traspostà	2	0	trasposta	2	3	3
traspuà	2	0	traspua	2	14	14
trastegí	2	0	trastegi	2	1	1
trastocarà	2	3	trastocara	2	0	3
trastocà	2	1	trastoca	2	8	9
trastoqués	2	1	trastoques	2	0	1
trastornarà	2	1	trastornara	2	0	1
trastornà	2	1	trastorna	2	10	11
trastorní	2	0	trastorni	2	4	4
traumatitzà	2	1	traumatitza	2	3	4
traumatitzí	2	0	traumatitzi	2	1	1
trauré	2	68	traure	2	92	160
travessarà	2	23	travessara	2	5	28
travessà	2	65	travessa	4	1138	1203
travessàrem	2	0	travessarem	2	4	4
travessàreu	2	0	travessareu	2	1	1
travessés	2	13	travesses	2	22	35
travessí	2	0	travessi	2	45	45
travestí	0	2	travesti	0	7	9
travestís	0	0	travestis	0	2	2
travà	2	3	trava	4	49	52
travès	2	15	traves	4	590	605
través	2	30727	traves	4	590	31317
travéssem	2	0	travessem	2	129	129
travésseu	2	0	travesseu	2	5	5
traví	2	0	travi	2	2	2
traçarà	2	7	traçara	2	0	7
traçà	2	8	traça	4	630	638
traçàrem	2	0	traçarem	2	2	2
traçós	0	0	traços	4	231	231
traíem	2	0	traiem	2	101	101
traíeu	2	0	traieu	2	60	60
traírem	2	0	trairem	2	4	4
traíreu	2	0	traireu	2	5	5
treballarà	2	284	treballara	2	5	289
treballà	2	647	treballa	2	2584	3231
treballàrem	2	0	treballarem	2	305	305
treballàreu	2	0	treballareu	2	4	4
treballés	2	93	treballes	2	121	214
treballí	2	0	treballi	2	459	459
tremolarà	2	1	tremolara	2	1	2
tremolà	2	0	tremola	2	27	27
tremolés	2	2	tremoles	2	5	7
tremolí	2	0	tremoli	2	8	8
tremoló	4	0	tremolo	2	15	15
trempés	2	1	trempes	4	1	2
tremà	2	0	trema	4	1	1
tremé	2	0	treme	2	3	3
tremís	2	5	tremis	2	0	5
trencarà	2	43	trencara	2	2	45
trencà	2	74	trenca	4	458	532
trencàrem	2	0	trencarem	2	7	7
trencàreu	2	0	trencareu	2	1	1
trenqués	2	40	trenques	4	16	56
trenquí	2	0	trenqui	2	110	110
trenta-quatrè	0	1	trenta-quatre	3	49	50
trenta-quatré	0	0	trenta-quatre	3	49	49
trenà	2	0	trena	4	21	21
trenés	2	0	trenes	4	24	24
trení	2	0	treni	2	1	1
trepitgés	2	5	trepitges	2	2	7
trepitgí	2	0	trepitgi	2	9	9
trepitjarà	2	3	trepitjara	2	0	3
trepitjà	2	1	trepitja	2	41	42
trepitjàrem	2	0	trepitjarem	2	1	1
trepà	2	0	trepa	4	5	5
trescà	2	1	tresca	4	2	3
tretzè	0	63	tretze	3	1104	1167
tretzé	0	1	tretze	3	1104	1105
triangulà	2	0	triangula	2	4	4
triangulí	2	0	trianguli	2	25	25
triarà	2	69	triara	2	0	69
tributarà	2	1	tributara	2	0	1
tributà	2	0	tributa	2	4	4
tributària	0	208	tributaria	2	3	211
tributàries	0	123	tributaries	2	0	123
tributí	2	0	tributi	2	2	2
tribú	4	61	tribu	4	2934	2995
trigarà	2	242	trigara	2	0	242
trigués	2	15	trigues	4	10	25
triguí	2	0	trigui	2	97	97
trigà	2	22	triga	4	342	364
trigàrem	2	0	trigarem	2	48	48
trigàreu	2	0	trigareu	2	7	7
trincà	2	0	trinca	4	11	11
trinxà	2	0	trinxa	4	3	3
trinxàrem	2	0	trinxarem	2	1	1
trinxàreu	2	0	trinxareu	2	1	1
trinà	2	0	trina	0	19	19
triní	2	0	trini	2	1	1
triomfarà	2	19	triomfara	2	0	19
triomfà	2	4	triomfa	2	37	41
triomfàrem	2	0	triomfarem	2	9	9
triomfàreu	2	0	triomfareu	2	1	1
triomfés	2	10	triomfes	2	0	10
triomfí	2	0	triomfi	2	52	52
triplicarà	2	4	triplicara	2	0	4
triplicà	2	2	triplica	2	12	14
tripliquí	2	0	tripliqui	2	3	3
triplà	4	2	tripla	0	1	3
trisecà	2	0	triseca	2	1	1
tritllejà	2	0	tritlleja	2	1	1
triturarà	2	1	triturara	2	0	1
triturà	2	1	tritura	2	7	8
triturés	2	0	tritures	2	1	1
trivialitzà	2	0	trivialitza	2	6	6
trivialitzés	2	1	trivialitzes	2	0	1
trivialitzí	2	0	trivialitzi	2	6	6
trià	2	25	tria	4	1339	1364
triàrem	2	0	triarem	2	20	20
triàreu	2	1	triareu	2	3	4
triés	2	36	tries	4	50	86
trobarà	2	584	trobara	2	7	591
trobà	2	409	troba	4	21966	22375
trobàrem	2	5	trobarem	2	636	641
trobàreu	2	0	trobareu	2	579	579
trobés	2	210	trobes	4	341	551
trobí	2	2	trobi	2	1354	1356
troià	0	75	troia	4	307	382
trompà	2	0	trompa	0	157	157
trompés	2	0	trompes	0	82	82
trontollarà	2	2	trontollara	2	0	2
trontollà	2	1	trontolla	2	17	18
trontollés	2	3	trontolles	2	0	3
trontollí	2	0	trontolli	2	4	4
tronà	2	1	trona	4	73	74
tronés	2	0	trones	4	1	1
troní	2	0	troni	2	1	1
tropà	4	0	tropa	4	195	195
trossejà	2	0	trosseja	2	5	5
trossà	2	0	trossa	4	2	2
trotà	2	0	trota	2	2	2
trucarà	2	21	trucara	2	0	21
trucà	2	14	truca	4	386	400
trucàrem	2	0	trucarem	2	16	16
trucàreu	2	0	trucareu	2	2	2
trufà	2	0	trufa	4	1	1
trufés	2	0	trufes	4	4	4
trullí	2	0	trulli	2	7	7
trumfà	2	0	trumfa	4	2	2
trumfés	2	0	trumfes	4	4	4
truncarà	2	4	truncara	2	0	4
truncà	2	2	trunca	2	30	32
truncàrem	2	0	truncarem	2	1	1
truqués	2	14	truques	4	41	55
truquí	2	0	truqui	2	87	87
tràfic	4	4666	trafic	2	3	4669
tràmit	4	346	tramit	2	0	346
trànsit	4	7109	transit	2	77	7186
trànsits	4	91	transits	2	1	92
trèmol	0	10	tremol	2	0	10
trèmolo	4	44	tremolo	2	15	59
trémolo	4	1	tremolo	2	15	16
tríada	4	87	triada	4	677	764
tríades	4	35	triades	4	249	284
tríplica	4	0	triplica	2	12	12
trítons	4	0	tritons	4	17	17
tudà	2	0	tuda	2	1	1
tufà	2	0	tufa	2	4	4
tupà	2	0	tupa	2	1	1
tupè	4	3	tupe	2	0	3
tupès	4	1	tupes	2	0	1
tupés	2	1	tupes	2	0	1
tupí	2	11	tupi	2	5	16
tupís	4	2	tupis	2	0	2
turbinà	2	0	turbina	4	140	140
turbinés	2	0	turbines	4	125	125
turmentarà	2	2	turmentara	2	0	2
turmentà	2	0	turmenta	2	17	17
turmentàrem	2	0	turmentarem	2	1	1
turmentés	2	0	turmentes	2	2	2
turmentí	2	0	turmenti	2	2	2
turquès	0	14	turques	0	829	843
turqués	0	0	turques	0	829	829
tussés	2	0	tusses	2	2	2
tussí	2	4	tussi	2	3	7
tustà	2	0	tusta	4	1	1
tutelà	2	0	tutela	4	364	364
tutelés	2	0	tuteles	4	7	7
tutoritzà	2	0	tutoritza	2	1	1
tuàreg	0	1	tuareg	0	55	56
tuàregs	0	0	tuaregs	0	53	53
tàbac	4	3	tabac	4	3564	3567
tàbacs	4	0	tabacs	4	25	25
tàlem	4	19	talem	2	3	22
tàler	4	2	taler	0	1	3
tàlers	4	6	talers	0	0	6
tàmara	4	0	tamara	4	49	49
tàper	4	0	taper	0	5	5
tàpera	4	2	tapera	0	1	3
tàperes	4	8	taperes	0	0	8
tàpers	4	1	tapers	0	1	2
tàxons	4	129	taxons	4	22	151
tènder	4	5	tender	4	13	18
tènders	4	0	tenders	4	1	1
tènia	4	26	tenia	2	17942	17968
tènies	4	8	tenies	2	346	354
tèster	4	0	tester	4	4	4
tèsters	4	0	testers	4	8	8
té	2	80441	te	4	2807	83248
ténia	4	0	tenia	2	17942	17942
ténies	4	0	tenies	2	346	346
tíl·ler	4	0	til·ler	4	7	7
tíl·lers	4	0	til·lers	4	6	6
tòs	4	2	tos	4	136	138
tòt	4	0	tot	3	128469	128469
tòts	4	0	tots	3	123910	123910
túber	4	0	tuber	4	2	2
túnel	4	1170	tunel	2	20	1190
túrons	0	0	turons	4	718	718
ubicarà	2	11	ubicara	2	0	11
ubicà	2	7	ubica	2	149	156
ubiqués	2	2	ubiques	2	0	2
ubiquí	2	0	ubiqui	2	2	2
ucà	2	0	uca	2	40	40
udolà	2	0	udola	2	1	1
ufanegí	2	0	ufanegi	2	1	1
ufanejà	2	0	ufaneja	2	1	1
ufanà	2	0	ufana	4	3	3
ufà	0	11	ufa	4	19	30
ugí	2	0	ugi	2	1	1
ujà	2	0	uja	2	2	2
ulcerarà	2	1	ulcerara	2	0	1
ullí	2	0	ulli	2	2	2
ultimarà	2	8	ultimara	2	0	8
ultimà	2	0	ultima	2	100	100
ultimàrem	2	0	ultimarem	2	2	2
ultimés	2	2	ultimes	2	11	13
ultimí	2	0	ultimi	2	13	13
ultracongelà	2	0	ultracongela	2	1	1
ultradretà	0	10	ultradreta	4	21	31
ultrapassà	2	1	ultrapassa	2	17	18
ultrapassí	2	0	ultrapassi	2	1	1
ultratgés	2	0	ultratges	4	10	10
ultratjà	2	0	ultratja	2	1	1
ultrà	2	0	ultra	0	164	164
ultrés	2	0	ultres	0	24	24
unglà	2	0	ungla	4	35	35
unglés	2	0	ungles	4	212	212
unificarà	2	9	unificara	2	0	9
unificà	2	11	unifica	2	59	70
unificàrem	2	0	unificarem	2	1	1
unifiqués	2	5	unifiques	2	0	5
unifiquí	2	0	unifiqui	2	25	25
uniformitzarà	2	1	uniformitzara	2	0	1
uniformitzà	2	0	uniformitza	2	3	3
uniformà	2	0	uniforma	2	2	2
uniformés	2	0	uniformes	2	871	871
uniformí	2	0	uniformi	2	1	1
unirà	2	113	unira	2	2	115
universalitzés	2	1	universalitzes	2	0	1
untà	2	0	unta	2	11	11
untó	4	0	unto	2	3	3
unè	0	0	une	4	66	66
uné	0	0	une	4	66	66
unírem	2	0	unirem	2	17	17
uníreu	2	0	unireu	2	6	6
urbanitzà	2	0	urbanitza	2	2	2
urpà	2	0	urpa	4	65	65
urpés	2	0	urpes	4	157	157
usarà	2	441	usara	2	3	444
usufructuària	0	1	usufructuaria	2	0	1
usurparà	2	0	usurpara	2	1	1
usurpà	2	6	usurpa	2	8	14
usurpàrem	2	0	usurparem	2	1	1
usurpés	2	2	usurpes	2	1	3
usurpí	2	0	usurpi	2	7	7
usà	2	81	usa	2	4250	4331
usàrem	2	0	usarem	2	31	31
usàreu	2	0	usareu	2	10	10
usés	2	42	uses	2	24	66
usí	2	0	usi	2	327	327
utilitzarà	2	1460	utilitzara	2	2	1462
utilitzà	2	236	utilitza	2	12582	12818
utilitzàrem	2	0	utilitzarem	2	200	200
utilitzàreu	2	0	utilitzareu	2	45	45
utilitzés	2	177	utilitzes	2	94	271
utilitzí	2	0	utilitzi	2	1334	1334
vaccinà	2	0	vaccina	2	2	2
vaccinés	2	0	vaccines	2	2	2
vacil·larà	2	9	vacil·lara	2	0	9
vacil·là	2	4	vacil·la	2	35	39
vacil·làrem	2	0	vacil·larem	2	7	7
vacil·lés	2	2	vacil·les	2	0	2
vacil·lí	2	0	vacil·li	2	7	7
vacunarà	2	1	vacunara	2	0	1
vacunà	2	0	vacuna	4	419	419
vacunàrem	2	0	vacunarem	2	1	1
vacunés	2	1	vacunes	4	664	665
vacuní	2	0	vacuni	2	3	3
vacà	2	0	vaca	4	432	432
vagabundegí	2	0	vagabundegi	2	1	1
vagarejà	2	0	vagareja	2	1	1
vagués	2	0	vagues	4	549	549
vaguí	2	0	vagui	2	2	2
vagà	2	1	vaga	4	1710	1711
vagó	4	139	vago	2	2	141
valdré	2	0	valdre	2	46	46
valentinés	0	0	valentines	4	1	1
valgués	2	11	valgues	2	0	11
valguí	2	0	valgui	2	188	188
validarà	2	7	validara	2	0	7
validà	2	0	valida	2	114	114
validàrem	2	0	validarem	2	1	1
validàreu	2	0	validareu	2	1	1
validés	2	2	valides	2	0	2
validí	2	0	validi	2	14	14
valletà	0	0	valleta	4	3	3
vallromanès	0	0	vallromanes	4	4	4
vallromanés	0	0	vallromanes	4	4	4
valorarà	2	74	valorara	2	1	75
valoritzà	2	0	valoritza	2	1	1
valorà	2	9	valora	2	419	428
valoràrem	2	0	valorarem	2	14	14
valorés	2	20	valores	2	12	32
valorí	2	0	valori	2	98	98
valsés	2	0	valses	2	7	7
vampiritzà	2	0	vampiritza	2	1	1
vanaglorià	2	0	vanagloria	2	5	5
vanaglòria	4	2	vanagloria	2	5	7
vantà	2	1	vanta	2	4	5
vanà	2	0	vana	0	80	80
vanés	2	0	vanes	0	55	55
vaporitzà	2	0	vaporitza	2	12	12
vaporitzí	2	0	vaporitzi	2	1	1
vaqués	2	0	vaques	4	836	836
variarà	2	59	variara	2	0	59
variolà	2	0	variola	4	6	6
varià	2	11	varia	2	1327	1338
variés	2	2	varies	2	59	61
varií	2	1	varii	2	0	1
varà	2	10	vara	0	143	153
varés	2	0	vares	2	186	186
varí	2	0	vari	2	4	4
vaticinà	2	0	vaticina	2	2	2
vaticiní	2	0	vaticini	2	1	1
vectoritzà	2	0	vectoritza	2	7	7
vedellà	2	0	vedella	4	206	206
vedellés	2	0	vedelles	4	52	52
vedà	2	0	veda	4	72	72
vedés	2	0	vedes	4	37	37
vedí	2	0	vedi	2	1	1
vegetarià	0	72	vegetaria	2	0	72
vegetà	2	0	vegeta	2	34	34
vegà	0	14	vega	4	209	223
vehiculà	2	0	vehicula	2	3	3
veiés	2	304	veies	2	24	328
velarà	2	0	velara	2	1	1
velà	2	0	vela	4	415	415
velés	2	0	veles	4	159	159
velí	2	0	veli	2	2	2
vencerà	2	26	vencera	2	0	26
vencérem	2	0	vencerem	2	20	20
vencés	2	8	vences	2	0	8
vencí	2	0	venci	2	54	54
vendré	2	13	vendre	2	3434	3447
venerà	2	1	venera	4	103	104
venerés	2	2	veneres	4	2	4
venerí	2	0	veneri	2	5	5
vengués	2	31	vengues	2	1	32
venguí	2	0	vengui	2	60	60
venguís	4	0	venguis	2	5	5
vengés	2	2	venges	4	0	2
vengí	2	0	vengi	2	65	65
venjarà	2	5	venjara	2	1	6
venjà	2	2	venja	4	34	36
venjàrem	2	0	venjarem	2	5	5
ventallà	2	0	ventalla	4	1	1
ventallés	2	0	ventalles	4	1	1
ventarà	2	1	ventara	2	0	1
ventejà	2	0	venteja	2	1	1
ventilà	2	0	ventila	2	4	4
ventilés	2	0	ventiles	2	1	1
ventilí	2	0	ventili	2	4	4
ventà	2	0	venta	2	75	75
ventàrem	2	0	ventarem	2	1	1
ventés	2	0	ventes	2	33	33
ventí	2	0	venti	2	1	1
verdejà	2	0	verdeja	2	1	1
veremà	2	1	verema	4	37	38
veremés	2	0	veremes	4	4	4
veremí	2	0	veremi	2	1	1
vergonyés	2	0	vergonyes	4	12	12
verificarà	2	61	verificara	2	0	61
verificà	2	3	verifica	2	394	397
verificàrem	2	0	verificarem	2	39	39
verifiqués	2	14	verifiques	2	0	14
verifiquí	2	0	verifiqui	2	74	74
verinà	2	0	verina	2	1	1
verolà	2	0	verola	4	216	216
verolés	2	0	veroles	4	2	2
verolí	2	0	veroli	4	1	1
versallès	0	1	versalles	4	211	212
versallés	0	0	versalles	4	211	211
versarà	2	26	versara	2	0	26
versionà	2	2	versiona	2	1	3
versionés	2	1	versiones	2	6	7
versà	2	0	versa	2	314	314
versés	2	4	verses	2	2	6
versí	2	0	versi	2	29	29
vertebrà	2	1	vertebra	2	4	5
vertebrés	2	1	vertebres	2	3	4
vertisòl	4	0	vertisol	4	1	1
vertisòls	4	1	vertisols	4	0	1
verí	4	409	veri	4	5	414
vescós	0	0	vescos	4	1	1
vesprejà	2	0	vespreja	2	2	2
vessarà	2	1	vessara	2	0	1
vessà	2	1	vessa	4	28	29
vessàrem	2	0	vessarem	2	2	2
vessés	2	4	vesses	2	3	7
vessí	2	1	vessi	2	8	9
vestirà	2	2	vestira	2	0	2
vestírem	2	0	vestirem	2	1	1
vesà	2	0	vesa	2	10	10
vesés	2	0	veses	2	1	1
vesí	2	0	vesi	2	1	1
vetarà	2	1	vetara	2	0	1
veterà	0	309	vetera	4	2	311
vetlarà	2	1	vetlara	2	0	1
vetllarà	2	107	vetllara	2	0	107
vetllà	2	2	vetlla	4	39	41
vetllàrem	2	0	vetllarem	2	67	67
vetllés	2	16	vetlles	4	4	20
vetllí	2	0	vetlli	2	133	133
vetlà	2	0	vetla	4	6	6
vetà	2	2	veta	4	63	65
vetés	2	4	vetes	4	40	44
vetí	2	0	veti	2	5	5
vetó	4	0	veto	2	830	830
veuré	2	179	veure	2	37693	37872
vexà	2	0	vexa	2	1	1
vexí	2	0	vexi	2	1	1
viatgés	2	31	viatges	4	2392	2423
viatgí	2	0	viatgi	2	52	52
viatjarà	2	68	viatjara	2	0	68
viatjà	2	238	viatja	2	461	699
viatjàrem	2	1	viatjarem	2	11	12
vibrarà	2	1	vibrara	2	0	1
vibrà	2	0	vibra	4	22	22
vibrés	2	1	vibres	4	0	1
vibrí	2	0	vibri	2	4	4
vicesecretària	4	1	vicesecretaria	4	0	1
vicià	2	0	vicia	2	4	4
victimitzí	2	0	victimitzi	2	1	1
vicària	0	3	vicaria	4	11	14
vicàries	0	0	vicaries	4	1	1
vidrés	2	0	vidres	2	196	196
vidrí	2	0	vidri	2	1	1
vigilarà	2	75	vigilara	2	0	75
vigilà	2	3	vigila	2	298	301
vigilàrem	2	0	vigilarem	2	78	78
vigilàreu	2	0	vigilareu	2	5	5
vigilés	2	28	vigiles	2	9	37
vigilí	2	0	vigili	2	153	153
vigirà	2	1	vigira	2	0	1
vigoritzà	2	0	vigoritza	2	1	1
vila-secà	4	0	vila-seca	4	6	6
vilatà	0	18	vilata	4	2	20
vilavellà	0	0	vilavella	4	2	2
vilellà	0	0	vilella	4	11	11
vilipendià	2	0	vilipendia	2	2	2
vil·là	4	3	vil·la	4	196	199
vilà	0	38	vila	4	2100	2138
vinclés	2	0	vincles	2	1581	1581
vincularà	2	22	vinculara	2	0	22
vinculà	2	5	vincula	2	236	241
vinculàrem	2	0	vincularem	2	4	4
vinculés	2	9	vincules	2	0	9
vinculí	2	0	vinculi	2	91	91
vindré	2	91	vindre	2	102	193
vingués	2	144	vingues	2	6	150
vinguí	2	0	vingui	2	691	691
vinificà	2	0	vinifica	2	1	1
vint-i-quatrè	0	12	vint-i-quatre	3	282	294
vint-i-quatré	0	1	vint-i-quatre	3	282	283
vinyetà	2	0	vinyeta	4	62	62
vinyetés	2	0	vinyetes	4	62	62
violarà	2	12	violara	2	0	12
violentà	2	0	violenta	0	736	736
violentés	2	0	violentes	0	418	418
violentí	2	0	violenti	2	2	2
violà	2	5	viola	4	851	856
violàrem	2	0	violarem	2	2	2
violàreu	2	0	violareu	2	1	1
violés	2	11	violes	4	44	55
violí	2	777	violi	2	73	850
violó	4	3	violo	2	0	3
virolà	2	0	virola	2	3	3
virtualitzés	2	0	virtualitzes	2	1	1
virí	2	0	viri	2	6	6
viró	0	1	viro	2	2	3
viscós	0	41	viscos	4	1	42
visibilitzà	2	1	visibilitza	2	4	5
visionà	2	1	visiona	2	0	1
visionària	0	41	visionaria	2	0	41
visionàries	0	16	visionaries	2	1	17
visioní	2	0	visioni	2	2	2
visitarà	2	71	visitara	2	2	73
visità	2	175	visita	4	3803	3978
visitàrem	2	0	visitarem	2	14	14
visités	2	50	visites	4	1353	1403
visití	2	0	visiti	2	118	118
visqués	2	48	visques	4	2	50
visquí	2	0	visqui	2	171	171
vistabellà	0	0	vistabella	4	4	4
vistós	0	20	vistos	2	257	277
visualitzarà	2	41	visualitzara	2	0	41
visualitzà	2	1	visualitza	2	1395	1396
visualitzàreu	2	0	visualitzareu	2	21	21
visualitzés	2	3	visualitzes	2	0	3
visualitzí	2	0	visualitzi	2	21	21
visés	2	0	vises	2	4	4
visí	2	0	visi	2	6	6
visó	4	11	viso	2	11	22
vitel·lí	0	7	vitel·li	4	26	33
viuré	2	32	viure	4	7172	7204
vivificà	2	0	vivifica	2	2	2
vivència	4	16	vivencia	2	0	16
vivències	4	38	vivencies	2	0	38
vivífica	0	0	vivifica	2	2	2
viària	0	940	viaria	2	2	942
viàries	0	107	viaries	2	0	107
viàtic	4	6	viatic	2	0	6
viés	2	0	vies	4	4972	4972
vií	2	0	vii	2	1593	1593
vió	4	4	vio	2	1	5
vocalitzà	2	0	vocalitza	2	2	2
vociferà	2	0	vocifera	2	2	2
voguí	2	0	vogui	2	1	1
vogà	2	0	voga	4	29	29
vogís	2	0	vogis	4	1	1
volarà	2	17	volara	2	0	17
volatilitzà	2	0	volatilitza	2	2	2
volcà	4	648	volca	0	2	650
voleià	2	0	voleia	2	1	1
voletejà	2	0	voleteja	2	2	2
voleí	2	0	volei	2	1	1
voltarà	2	1	voltara	2	0	1
voltejà	2	1	volteja	2	16	17
voltà	2	0	volta	4	2204	2204
voltés	2	0	voltes	4	621	621
voltí	2	0	volti	2	3	3
volà	2	57	vola	4	215	272
volàrem	2	0	volarem	2	8	8
volàreu	2	0	volareu	2	1	1
volés	2	18	voles	2	8	26
volí	2	1	voli	2	24	25
vomitarà	2	1	vomitara	2	0	1
vomità	2	0	vomita	2	7	7
vomités	2	1	vomites	2	2	3
vomití	2	0	vomiti	2	2	2
vorejarà	2	1	vorejara	2	0	1
vorejà	2	1	voreja	2	63	64
vorejàrem	2	0	vorejarem	2	2	2
voretés	2	0	voretes	4	1	1
vorà	2	4	vora	4	4917	4921
voré	2	0	vore	2	39	39
votarà	2	922	votara	2	0	922
votà	2	36	vota	2	389	425
votàrem	2	0	votarem	2	1888	1888
votàreu	2	0	votareu	2	4	4
votés	2	180	votes	2	14	194
votí	2	0	voti	2	700	700
vuitanta-quatrè	0	1	vuitanta-quatre	3	16	17
vuitanta-quatré	0	0	vuitanta-quatre	3	16	16
vulnerarà	2	3	vulnerara	2	0	3
vulnerà	2	0	vulnera	2	112	112
vulnerària	0	0	vulneraria	2	6	6
vulnerés	2	1	vulneres	2	0	1
vulnerí	2	0	vulneri	2	23	23
vàlid	0	4313	valid	2	13	4326
vàlida	0	2749	valida	2	114	2863
vàlides	0	794	valides	2	0	794
vàrem	2	242	varem	2	54	296
vàreu	2	171	vareu	2	34	205
vària	0	6	varia	2	1327	1333
vàries	0	178	varies	2	59	237
vèiem	2	66	veiem	2	3386	3452
vèieu	2	3	veieu	2	540	543
vènia	4	19	venia	2	703	722
vènies	4	0	venies	2	14	14
vèrtebra	4	60	vertebra	2	4	64
vèrtebres	4	194	vertebres	2	3	197
véiem	2	0	veiem	2	3386	3386
véieu	2	0	veieu	2	540	540
vénc	2	1	venc	2	28	29
vénda	4	0	venda	4	3552	3552
véndes	4	1	vendes	4	2341	2342
vénen	2	1495	venen	2	852	2347
véngui	2	0	vengui	2	60	60
vénguin	2	0	venguin	2	71	71
vénguis	2	0	venguis	2	5	5
véns	2	107	vens	2	117	224
vérem	2	1	verem	2	1	2
vés	2	1766	ves	2	441	2207
véu	2	3	veu	4	12172	12175
vígil	0	0	vigil	2	5	5
vòlei	4	8	volei	2	1	9
vòmit	4	33	vomit	2	1	34
vós	5	870	vos	4	173	1043
xacó	4	1	xaco	2	0	1
xafardegí	2	0	xafardegi	2	1	1
xafardejà	2	0	xafardeja	2	1	1
xafà	2	0	xafa	2	2	2
xafés	2	0	xafes	4	1	1
xalà	2	0	xala	4	1	1
xamà	2	4	xama	2	0	4
xapà	2	0	xapa	4	40	40
xapés	2	0	xapes	4	19	19
xapó	4	0	xapo	2	1	1
xarpó	4	0	xarpo	2	2	2
xarrupà	2	0	xarrupa	2	5	5
xarrà	2	0	xarra	2	4	4
xarugués	2	0	xarugues	0	1	1
xaró	0	1	xaro	4	11	12
xatejà	2	0	xateja	2	12	12
xatejàreu	2	0	xatejareu	2	1	1
xató	4	1	xato	0	6	7
xaí	2	0	xai	4	156	156
xelvà	0	0	xelva	4	3	3
xeresà	0	1	xeresa	4	4	5
xeringués	2	0	xeringues	4	77	77
xeringà	2	0	xeringa	4	64	64
xerocòpies	4	1	xerocopies	2	0	1
xerografià	2	0	xerografia	4	2	2
xerrarà	2	2	xerrara	2	0	2
xerricà	2	0	xerrica	2	1	1
xerrà	2	0	xerra	4	8	8
xerràrem	2	0	xerrarem	2	4	4
xerrés	2	0	xerres	4	2	2
xerrí	2	0	xerri	4	2	2
xerà	0	2	xera	4	6	8
xerès	4	31	xeres	4	0	31
xifrarà	2	1	xifrara	2	0	1
xifrà	2	2	xifra	4	2891	2893
xifràrem	2	0	xifrarem	2	1	1
xifrés	2	1	xifres	4	4226	4227
xifrí	2	0	xifri	2	6	6
xilografià	2	0	xilografia	4	31	31
xilografiés	2	0	xilografies	4	45	45
xilè	0	154	xile	4	1217	1371
xilé	0	0	xile	4	1217	1217
xilòfon	4	41	xilofon	4	0	41
xilòfons	4	6	xilofons	4	0	6
xinà	2	0	xina	4	13517	13517
xinès	0	2939	xines	4	8	2947
xiné	4	0	xine	2	6	6
xinés	2	41	xines	4	8	49
xipollejà	2	0	xipolleja	2	5	5
xipollà	2	0	xipolla	2	1	1
xirivellà	0	0	xirivella	4	7	7
xisclà	2	0	xiscla	2	9	9
xisclés	2	0	xiscles	2	13	13
xisclí	2	0	xiscli	2	1	1
xiscló	0	0	xisclo	2	1	1
xità	2	0	xita	2	1	1
xiulà	2	0	xiula	2	12	12
xiulés	2	1	xiules	2	0	1
xiulí	2	0	xiuli	2	2	2
xiuxiuegés	2	0	xiuxiueges	2	1	1
xiuxiuegí	2	0	xiuxiuegi	2	1	1
xiuxiuejarà	2	1	xiuxiuejara	2	0	1
xiuxiuejà	2	0	xiuxiueja	2	10	10
xiuxiuà	2	0	xiuxiua	2	1	1
xivatà	2	0	xivata	2	2	2
xivà	2	0	xiva	4	96	96
xivés	2	0	xives	2	1	1
xocarà	2	8	xocara	2	1	9
xocà	2	7	xoca	2	185	192
xocàrem	2	0	xocarem	2	3	3
xollà	2	0	xolla	0	6	6
xopà	2	0	xopa	0	15	15
xopés	2	0	xopes	0	2	2
xoqués	2	6	xoques	2	0	6
xoquí	2	0	xoqui	2	8	8
xuclarà	2	1	xuclara	2	0	1
xuclà	2	0	xucla	4	13	13
xuclàrem	2	0	xuclarem	2	1	1
xuclés	2	2	xucles	4	1	3
xuclí	2	0	xucli	2	1	1
xulillà	0	0	xulilla	4	2	2
xumà	2	1	xuma	2	2	3
xumí	2	2	xumi	2	2	4
xuplà	2	3	xupla	2	0	3
xupló	4	1	xuplo	2	0	1
xutà	2	0	xuta	4	23	23
xutés	2	0	xutes	4	1	1
xutí	2	0	xuti	2	3	3
xèric	0	1	xeric	4	3	4
xèrics	0	3	xerics	4	0	3
xèrif	4	430	xerif	4	31	461
xèrifs	4	10	xerifs	4	1	11
xòfer	4	8	xofer	4	94	102
xòfera	4	0	xofera	4	3	3
xòferes	4	0	xoferes	4	1	1
xòfers	4	0	xofers	4	21	21
zairès	0	36	zaires	4	0	36
zamorà	0	0	zamora	4	76	76
zelí	2	0	zeli	2	1	1
zigzaguejà	2	0	zigzagueja	2	2	2
zulú	0	9	zulu	0	141	150
zulús	0	8	zulus	0	53	61
zèfir	4	3	zefir	2	0	3
àfrica	4	10717	africa	2	182	10899
àlaba	4	34	alaba	2	15	49
àlan	4	0	alan	4	761	761
àlana	4	0	alana	4	10	10
àlida	4	0	alida	0	13	13
àneu	4	13	aneu	2	1200	1213
ànimes	4	268	animes	2	15	283
àpia	4	4	apia	4	32	36
àrreu	4	0	arreu	4	3223	3223
àrtemis	4	41	artemis	4	64	105
àstrid	4	5	astrid	4	100	105
àvila	4	57	avila	2	9	66
èdgar	4	0	edgar	4	258	258
èlia	4	3	elia	4	41	44
èlies	4	0	elies	4	69	69
èric	4	6	eric	4	868	874
èsquil	4	30	esquil	2	1	31
énguera	4	4	enguera	4	0	4
íngrid	4	22	ingrid	4	102	124
íria	4	0	iria	2	9	9
òlt	4	10	olt	4	14	24
òscar	4	48	oscar	4	669	717
òscars	4	2	oscars	4	49	51
óros	4	0	oros	4	10	10
úbeda	4	7	ubeda	4	1	8
àcar	4	10	acar	2	4	14
àcid	0	2024	acid	2	57	2081
àcida	0	128	acida	2	0	128
àcides	0	48	acides	2	0	48
àfon	0	0	afon	2	12	12
àfona	0	0	afona	2	3	3
àgama	0	0	agama	4	4	4
àgames	0	0	agames	4	1	1
àgape	4	2	agape	4	0	2
àgnats	0	2	agnats	4	3	5
àlans	4	0	alans	4	33	33
àlep	4	2	alep	4	259	261
àlger	0	0	alger	4	193	193
àlien	4	19	alien	2	99	118
àliens	4	2	aliens	0	257	259
àlies	4	720	alies	2	9	729
àmel	0	0	amel	2	10	10
àmela	0	0	amela	2	2	2
àmplia	0	7117	amplia	2	935	8052
àmplies	0	1279	amplies	2	6	1285
àncora	4	298	ancora	2	99	397
àncores	4	79	ancores	2	3	82
ànega	4	1	anega	2	0	1
ànet	4	0	anet	4	9	9
ànets	4	0	anets	4	1	1
àngstrom	4	4	angstrom	4	5	9
àngstroms	4	7	angstroms	4	1	8
ànim	4	1378	anim	2	3	1381
ànima	4	1061	anima	2	605	1666
ànsia	4	130	ansia	2	2	132
ànsies	4	40	ansies	2	0	40
àpoca	4	1	apoca	2	0	1
àrbitra	4	0	arbitra	2	4	4
àrbitre	4	388	arbitre	2	10	398
àrbitres	4	93	arbitres	2	0	93
àrcades	4	1	arcades	4	85	86
àrides	0	130	arides	4	0	130
àrtic	0	1194	artic	2	8	1202
àspies	4	0	aspies	2	7	7
àster	4	2	aster	4	8	10
àstur	0	1	astur	0	8	9
àsturs	0	2	asturs	0	1	3
àt	7	0	at	4	707	707
àtac	4	0	atac	4	6654	6654
àtacs	4	0	atacs	4	5130	5130
àtropa	0	0	atropa	2	6	6
àugur	4	12	augur	2	4	16
àusona	0	0	ausona	4	1	1
àvar	0	22	avar	0	35	57
àvara	0	1	avara	0	17	18
àvares	0	0	avares	0	1	1
àvars	0	59	avars	0	21	80
àvia	4	645	avia	2	34	679
àvid	0	68	avid	2	7	75
àvida	0	25	avida	2	3	28
àvides	0	6	avides	2	0	6
àvies	4	65	avies	2	0	65
àxons	4	9	axons	4	22	31
èfedra	4	0	efedra	4	1	1
èmbol	4	14	embol	2	0	14
èmula	4	0	emula	2	44	44
èster	4	55	ester	4	43	98
èsters	4	64	esters	4	1	65
èxplicit	4	0	explicit	2	8	8
és	2	720021	es	4	627928	1347949
ésser	2	2457	esser	4	77	2534
éssers	4	4185	essers	4	4	4189
íncub	4	1	incub	2	0	1
íncube	4	5	incube	2	0	5
íncubes	4	3	incubes	2	0	3
índex	4	3548	index	2	182	3730
índic	0	554	indic	2	2	556
índica	0	12	indica	2	5636	5648
índiques	0	4	indiques	2	1	5
ínsula	4	5	insula	4	11	16
íntegra	0	179	integra	2	385	564
íntegre	0	139	integre	2	0	139
íntegres	0	33	integres	2	0	33
íntim	0	193	intim	2	0	193
íntima	0	132	intima	4	2	134
íntimes	0	67	intimes	4	5	72
írrita	0	0	irrita	2	52	52
òbvia	0	446	obvia	2	17	463
òbvies	0	216	obvies	2	4	220
òliba	4	13	oliba	4	14	27
òlibes	4	7	olibes	4	0	7
òpera	4	3251	opera	2	1618	4869
òperes	4	641	operes	2	3	644
òptim	0	456	optim	2	0	456
òptima	0	629	optima	2	4	633
òptimes	0	174	optimes	2	2	176
òrbita	4	2227	orbita	2	161	2388
òrbites	4	552	orbites	2	1	553
òrtic	0	1	ortic	2	0	1
òvul	4	89	ovul	2	0	89
òxford	4	3	oxford	4	1037	1040
òxid	4	416	oxid	2	1	417
ós	4	641	os	4	1363	2004
óssa	4	40	ossa	4	13	53
óssos	4	265	ossos	4	1075	1340
úlcera	4	47	ulcera	2	0	47
úlceres	4	68	ulceres	2	0	68
últim	0	13970	ultim	2	8	13978
última	0	13513	ultima	2	100	13613
últimes	0	4260	ultimes	2	11	4271
ús	2	30279	us	5	18670	48949
