diacritic_pos	diacritic_freq	no_diacritic_pos	no_diacritic_freq	total_freq	cnt	detected
4	0	4	158	158	0	2
4	228	4	11	239	1	1
4	17	4	3	20	2	1
4	0	2	2	2	3	2
4	0	4	5	5	4	2
4	0	4	5	5	5	2
4	4	0	0	4	6	0
4	1	2	1	2	7	0
4	0	2	0	0	8	2
4	367	4	0	367	9	0
4	13	4	45	58	10	0
4	0	4	1	1	11	2
4	11	4	846	857	12	0
4	35	4	33	68	13	0
4	18	0	0	18	14	1
4	0	2	28	28	15	2
4	2	4	3	5	16	0
4	3	2	1	4	17	0
4	5	4	353	358	18	1
4	0	2	0	0	19	2
4	1	0	2832	2833	20	0
4	0	4	0	0	21	2
4	0	4	0	0	22	2
4	9	4	986	995	23	0
4	0	4	986	986	24	2
4	146	2	893	1039	25	0
4	0	2	2	2	26	2
4	0	2	14	14	27	2
4	9	4	18	27	28	0
4	0	4	18	18	29	2
4	9	2	4	13	30	1
4	3	2	80	83	31	0
4	0	2	624	624	32	2
4	7	4	521	528	33	0
4	0	2	0	0	34	2
4	21	4	327	348	35	0
4	12094	4	723	12817	36	1
4	7	2	3	10	37	0
4	28	2	43	71	38	0
4	4	2	0	4	39	0
4	44	4	504	548	40	0
4	0	2	0	0	41	2
4	34	4	32	66	42	1
4	2	4	278	280	43	0
4	0	2	8	8	44	2
4	0	4	0	0	45	2
4	7	4	0	7	46	1
4	0	4	1671	1671	47	2
4	0	4	41	41	48	2
4	0	2	1	1	49	2
4	32	2	6	38	50	0
4	0	4	1	1	51	2
4	0	2	0	0	52	2
4	7	4	22	29	53	1
4	0	4	0	0	54	2
4	0	4	0	0	55	2
4	0	0	39	39	56	2
4	0	4	1	1	57	2
4	0	2	2	2	58	2
4	0	4	37	37	59	2
4	0	4	4	4	60	2
4	0	2	0	0	61	2
4	122	2	3	125	62	1
4	6	2	34	40	63	0
4	5	4	116	121	64	0
4	0	4	9	9	65	2
4	3	2	1	4	66	0
4	5	4	11	16	67	0
4	27	0	2834	2861	68	1
4	0	4	197	197	69	2
4	0	2	0	0	70	2
4	1	2	9	10	71	1
4	9	2	1	10	72	0
4	0	2	70	70	73	2
4	1	2	1	2	74	0
4	2	2	0	2	75	0
4	1	2	24	25	76	1
4	20	4	12	32	77	0
4	0	2	0	0	78	2
4	28	4	0	28	79	0
4	3	2	0	3	80	1
4	0	4	12	12	81	2
4	1	0	2	3	82	0
4	0	2	5	5	83	2
4	0	0	178	178	84	2
4	0	4	0	0	85	2
4	1	2	20	21	86	1
4	0	4	576	576	87	2
4	0	4	2	2	88	2
4	0	4	67	67	89	2
4	21	2	4	25	90	0
4	0	4	60	60	91	2
4	11	4	6	17	92	1
4	18	4	5	23	93	0
4	0	2	0	0	94	2
4	0	4	16	16	95	2
4	0	2	0	0	96	2
4	0	2	0	0	97	2
4	0	2	1	1	98	2
4	6	4	5	11	99	0
4	1	4	278	279	100	0
4	0	2	1	1	101	2
4	7	4	0	7	102	0
4	6	2	13	19	103	0
4	0	4	5	5	104	2
4	6	2	4	10	105	0
4	0	4	1	1	106	2
4	12	4	29	41	107	1
4	2	4	5	7	108	0
4	1	4	19	20	109	0
4	0	2	7	7	110	2
4	0	4	0	0	111	2
4	0	4	3	3	112	2
4	0	4	0	0	113	2
4	0	2	0	0	114	2
4	0	2	139	139	115	2
4	245	2	474	719	116	0
4	82	2	3	85	117	0
4	2	2	0	2	118	0
4	3	4	16	19	119	0
4	0	2	0	0	120	2
4	1	4	23	24	121	0
4	0	2	0	0	122	2
4	0	4	0	0	123	2
4	0	2	0	0	124	2
4	0	4	0	0	125	2
4	3	2	88	91	126	0
4	6	4	24	30	127	0
4	0	2	75	75	128	2
4	1	2	27	28	129	1
4	0	2	5	5	130	2
4	0	2	0	0	131	2
4	0	2	3	3	132	2
4	40	4	15	55	133	1
4	1	4	7742	7743	134	0
4	0	0	17	17	135	2
4	0	2	12	12	136	2
4	0	2	0	0	137	2
4	4	4	51	55	138	0
4	4744	4	253	4997	139	0
4	1	2	35	36	140	1
4	711	2	89	800	141	0
4	7	4	15	22	142	0
4	0	2	0	0	143	2
4	298	4	1361	1659	144	0
4	44	2	45	89	145	0
4	2	2	13	15	146	1
4	4	4	2	6	147	0
4	0	4	35	35	148	2
4	3	4	239	242	149	1
4	0	4	239	239	150	2
4	2	4	7	9	151	1
4	1153	4	559	1712	152	0
4	0	4	100	100	153	2
4	0	4	17468	17468	154	2
4	0	2	139	139	155	2
4	0	4	17468	17468	156	2
4	153	4	27552	27705	157	1
4	1	2	2	3	158	1
4	4	4	3	7	159	1
4	0	4	33	33	160	2
4	0	4	4	4	161	2
4	0	2	3	3	162	2
4	0	2	9	9	163	2
4	7	4	10134	10141	164	0
4	0	4	39	39	165	2
4	0	4	245	245	166	2
4	1	4	11790	11791	167	0
4	0	0	5	5	168	2
4	122	4	75	197	169	0
4	458	4	742	1200	170	1
4	21	2	10	31	171	0
4	4	2	4	8	172	0
4	1	2	1	2	173	1
4	2	4	17	19	174	1
4	0	2	6	6	175	2
4	2	2	5	7	176	1
4	30	4	5	35	177	0
4	41	2	25	66	178	0
4	0	4	17	17	179	2
4	0	2	4	4	180	2
4	0	4	50	50	181	2
4	10	2	1	11	182	1
4	6	2	4	10	183	1
4	0	4	0	0	184	2
4	6	4	68	74	185	0
4	0	4	49	49	186	2
4	470	2	33	503	187	0
4	31	4	35	66	188	1
4	17	2	7	24	189	0
4	17	2	21	38	190	1
4	3	2	1	4	191	0
4	0	2	2	2	192	2
4	0	4	102	102	193	2
4	25	2	2	27	194	0
4	11	4	222	233	195	0
4	0	4	162	162	196	2
4	0	4	1374	1374	197	2
4	5	4	9581	9586	198	1
4	0	4	99	99	199	2
4	13	2	7	20	200	1
4	0	2	2	2	201	2
4	8	2	3906	3914	202	0
4	4	2	0	4	203	0
4	5	2	0	5	204	1
4	0	2	2	2	205	2
4	0	2	0	0	206	2
4	0	4	0	0	207	2
4	1	2	224	225	208	0
4	74	2	4	78	209	1
4	0	2	51	51	210	2
4	3	4	22	25	211	1
4	3	2	37	40	212	0
4	0	2	0	0	213	2
4	7362	4	15766	23128	214	1
4	0	2	0	0	215	2
4	0	4	0	0	216	2
4	6	4	41	47	217	1
4	0	4	13	13	218	2
4	2	4	134	136	219	1
4	54	2	0	54	220	0
4	64	4	210	274	221	0
4	1	2	0	1	222	1
4	17	4	10498	10515	223	1
4	1	4	0	1	224	0
4	6	2	9	15	225	1
4	0	2	1	1	226	2
4	14	2	0	14	227	0
4	0	4	21	21	228	2
4	0	2	0	0	229	2
4	17	2	0	17	230	0
4	4	4	0	4	231	0
4	121	4	8807	8928	232	0
4	0	4	151	151	233	2
4	70	2	0	70	234	0
4	0	4	1	1	235	2
4	3	4	25	28	236	0
4	0	4	0	0	237	2
4	0	2	9	9	238	2
4	168	2	23	191	239	0
4	0	4	265	265	240	2
4	0	2	0	0	241	2
4	1	2	130	131	242	1
4	1	2	1	2	243	1
4	0	2	99	99	244	2
4	0	4	2539	2539	245	2
4	62	2	12	74	246	0
4	0	4	24	24	247	2
4	2	2	9	11	248	0
4	3	2	11	14	249	0
4	1	0	78	79	250	0
4	4	4	44	48	251	1
4	2	2	20	22	252	0
4	1	2	31	32	253	1
4	1	4	20	21	254	0
4	1	0	64	65	255	0
4	0	4	824	824	256	2
4	0	4	305	305	257	2
4	0	2	4	4	258	2
4	13	4	0	13	259	0
4	0	4	0	0	260	2
4	9	4	49	58	261	0
4	426	4	1721	2147	262	0
4	1	4	0	1	263	0
4	7	2	1	8	264	1
4	0	2	135	135	265	2
4	26	2	11	37	266	0
4	0	4	17	17	267	2
4	0	2	0	0	268	2
4	147	4	290	437	269	1
4	2	4	0	2	270	1
4	0	4	0	0	271	2
4	15	2	8	23	272	0
4	0	2	2	2	273	2
4	7	4	56	63	274	0
4	50	4	37	87	275	0
4	0	2	1	1	276	2
4	26	4	361	387	277	0
4	5	4	101	106	278	1
4	446	2	173	619	279	0
4	40	2	0	40	280	0
4	0	4	4	4	281	2
4	0	2	0	0	282	2
4	24	2	18	42	283	0
4	0	2	0	0	284	2
4	0	4	0	0	285	2
4	0	0	214	214	286	2
4	726	2	18	744	287	0
4	33338	2	101	33439	288	0
4	0	4	0	0	289	2
4	0	2	0	0	290	2
4	0	4	2	2	291	2
4	0	2	91	91	292	2
4	24	4	0	24	293	1
4	0	2	2	2	294	2
4	0	2	0	0	295	2
4	0	2	0	0	296	2
4	0	4	0	0	297	2
4	0	2	0	0	298	2
4	0	4	8	8	299	2
4	1	4	5	6	300	0
4	0	4	0	0	301	2
4	1	2	2	3	302	1
4	0	4	3	3	303	2
4	3	4	0	3	304	0
4	1	4	3	4	305	1
4	1	4	8	9	306	1
4	3	4	1	4	307	1
4	0	4	378	378	308	2
4	0	4	416	416	309	2
4	0	4	28	28	310	2
4	2	2	24	26	311	1
4	8	4	12	20	312	1
4	0	2	0	0	313	2
4	4	2	1	5	314	0
4	15	4	17	32	315	1
4	2	4	0	2	316	0
4	24	2	0	24	317	1
4	0	2	26	26	318	2
4	7	4	12212	12219	319	1
4	88	4	16	104	320	1
4	4	2	0	4	321	0
4	212	4	1013	1225	322	1
4	3	2	126	129	323	1
4	2	2	1	3	324	0
4	0	4	18	18	325	2
4	0	0	23	23	326	2
4	0	4	2	2	327	2
4	0	4	54	54	328	2
4	7	4	26	33	329	0
4	0	2	0	0	330	2
4	0	0	0	0	331	2
4	0	4	0	0	332	2
4	0	4	0	0	333	2
4	0	4	0	0	334	2
4	0	4	9	9	335	2
4	4	4	1	5	336	0
4	88	2	19	107	337	0
4	1	2	0	1	338	1
4	0	2	0	0	339	2
4	4	4	273	277	340	1
4	5	2	9	14	341	1
4	0	2	1	1	342	2
4	4	4	1	5	343	0
4	8	4	28	36	344	1
4	9	2	5	14	345	0
4	0	2	5	5	346	2
4	0	0	0	0	347	2
4	2	4	19	21	348	0
4	72	2	43	115	349	0
4	2	2	622	624	350	0
4	0	2	0	0	351	2
4	36	4	3250	3286	352	0
4	445	4	2402	2847	353	1
4	43	4	2402	2445	354	0
4	1088	2	12	1100	355	1
4	0	0	0	0	356	2
4	20	4	1063	1083	357	1
4	12	2	1	13	358	1
4	3	4	0	3	359	1
4	4	2	109	113	360	0
4	0	2	26	26	361	2
4	366	4	309	675	362	0
4	6	4	12	18	363	0
4	56	4	20	76	364	1
4	281	4	9	290	365	0
4	19	4	261	280	366	0
4	0	4	296	296	367	2
4	1059	4	25	1084	368	0
4	181	2	274	455	369	0
4	14161	0	1864	16025	370	0
4	3	4	0	3	371	0
4	2	4	97	99	372	0
4	0	4	25	25	373	2
4	444	2	5	449	374	0
4	0	4	1	1	375	2
4	1	4	1	2	376	1
4	3	0	0	3	377	0
4	0	4	21	21	378	2
4	4	2	1042	1046	379	0
4	0	4	78	78	380	2
4	0	4	3654	3654	381	2
4	12	2	4	16	382	1
4	178	2	9	187	383	0
4	11	2	43	54	384	0
4	0	2	0	0	385	2
4	153	2	698	851	386	0
4	25	4	85	110	387	1
4	0	4	0	0	388	2
4	26	4	146	172	389	1
4	1	2	2	3	390	0
4	0	4	1	1	391	2
4	0	4	7	7	392	2
4	126	4	45	171	393	1
4	2	4	58	60	394	1
4	1	4	0	1	395	1
4	0	4	0	0	396	2
4	8	4	0	8	397	1
4	2	4	0	2	398	0
4	2	4	0	2	399	0
4	567	0	1664	2231	400	0
4	0	4	1	1	401	2
4	21	4	1203	1224	402	0
4	0	2	4	4	403	2
4	3	2	2	5	404	1
4	0	2	1	1	405	2
4	0	4	1	1	406	2
4	0	2	1	1	407	2
4	0	2	10	10	408	2
4	0	4	651	651	409	2
4	28	4	71	99	410	0
4	3	2	4	7	411	0
4	3	2	67	70	412	0
4	0	4	10	10	413	2
4	2632	2	283	2915	414	0
4	165	4	1501	1666	415	0
4	0	2	0	0	416	2
4	34	4	2	36	417	0
4	5	2	0	5	418	0
4	4	2	0	4	419	1
4	1	2	3	4	420	1
4	0	4	44	44	421	2
4	0	2	0	0	422	2
4	2	2	1205	1207	423	0
4	78	2	5577	5655	424	0
4	5866	4	582	6448	425	1
4	0	4	14	14	426	2
4	3	4	851	854	427	0
4	0	4	0	0	428	2
4	0	2	1	1	429	2
4	0	2	6	6	430	2
4	53	4	0	53	431	1
4	0	2	0	0	432	2
4	1220	2	7	1227	433	0
4	0	2	0	0	434	2
4	316	2	61	377	435	0
4	23	2	1	24	436	0
4	0	4	0	0	437	2
4	0	4	86	86	438	2
4	22	2	2	24	439	0
4	0	4	251	251	440	2
4	2	2	63	65	441	1
4	12	4	8	20	442	0
4	5	4	209	214	443	1
4	1	4	59	60	444	0
4	0	4	861	861	445	2
4	2	2	0	2	446	1
4	0	2	10	10	447	2
4	0	4	5	5	448	2
4	0	2	0	0	449	2
4	1	2	50	51	450	0
4	19	2	71	90	451	1
4	1	4	2	3	452	1
4	7074	0	7	7081	453	0
4	0	4	0	0	454	2
4	396	2	31	427	455	0
4	501	2	82	583	456	1
4	0	4	11	11	457	2
4	0	2	18	18	458	2
4	0	2	18	18	459	2
4	0	4	0	0	460	2
4	0	4	3	3	461	2
4	52	2	65	117	462	0
4	23	4	7	30	463	1
4	15	0	0	15	464	0
4	4	2	0	4	465	1
4	0	4	80	80	466	2
4	0	4	0	0	467	2
4	0	2	6	6	468	2
4	0	0	109	109	469	2
4	15	2	7	22	470	1
4	0	4	8	8	471	2
4	0	4	0	0	472	2
4	3	4	0	3	473	1
4	1	4	26	27	474	0
4	0	2	0	0	475	2
4	0	2	2	2	476	2
4	2	4	0	2	477	0
4	7	0	45	52	478	0
4	115	2	0	115	479	0
4	1	4	6	7	480	1
4	3	2	3	6	481	0
4	0	4	71	71	482	2
4	2	4	1192	1194	483	0
4	11	4	1192	1203	484	0
4	189	2	9	198	485	0
4	1	4	16	17	486	1
4	2464	4	5769	8233	487	0
4	0	4	5435	5435	488	2
4	1	2	0	1	489	1
4	9	2	0	9	490	0
4	24	4	29	53	491	1
4	0	4	4	4	492	2
4	2	4	65	67	493	0
4	0	4	7	7	494	2
4	0	4	0	0	495	2
4	21	2	0	21	496	0
4	0	2	710	710	497	2
4	0	4	5	5	498	2
4	12	4	168	180	499	0
4	0	2	0	0	500	2
4	13	4	0	13	501	1
4	0	4	26	26	502	2
4	0	4	1337	1337	503	2
4	0	2	429	429	504	2
4	40	0	259	299	505	1
4	0	4	107	107	506	2
4	0	2	20	20	507	2
4	10	4	40	50	508	0
4	24	2	131	155	509	1
4	39	4	0	39	510	0
4	6	4	61	67	511	1
4	0	4	197	197	512	2
4	8	4	5	13	513	1
4	0	4	1	1	514	2
4	11	0	2	13	515	1
4	6	0	7	13	516	1
4	0	4	1	1	517	2
4	59	4	23	82	518	1
4	2	2	318	320	519	1
4	1	2	1	2	520	0
4	294	2	81	375	521	1
4	42	2	16	58	522	0
4	73	2	60	133	523	0
4	2	4	12	14	524	1
4	0	4	1	1	525	2
4	2	4	572	574	526	1
4	0	2	404	404	527	2
4	0	4	3	3	528	2
4	8	2	275	283	529	0
4	6	4	444	450	530	0
4	0	4	5	5	531	2
4	18	0	5893	5911	532	1
4	20	2	800	820	533	0
4	12	4	19	31	534	0
4	0	2	101	101	535	2
4	0	4	5	5	536	2
4	6	2	404	410	537	1
4	13	4	84	97	538	0
4	0	4	0	0	539	2
4	1	2	21	22	540	0
4	146	2	2	148	541	0
4	0	2	21	21	542	2
4	581	4	4975	5556	543	0
4	0	4	17	17	544	2
4	0	2	0	0	545	2
4	0	2	0	0	546	2
4	20	2	0	20	547	0
4	1	4	10	11	548	1
4	1	4	4	5	549	0
4	3	4	13	16	550	0
4	1	2	0	1	551	1
4	24	4	3	27	552	0
4	0	0	4	4	553	2
4	0	2	0	0	554	2
4	1	4	2	3	555	0
4	159	2	21	180	556	0
4	3	2	151	154	557	1
4	17	4	215	232	558	0
4	1	4	366	367	559	0
4	0	4	5	5	560	2
4	415	2	22	437	561	1
4	0	4	4	4	562	2
4	0	2	0	0	563	2
4	0	4	3	3	564	2
4	9	2	1	10	565	0
4	2	4	1	3	566	1
4	248	4	20	268	567	0
4	448	4	84	532	568	0
4	3	4	0	3	569	0
4	0	4	6	6	570	2
4	0	4	3	3	571	2
4	0	2	3	3	572	2
4	0	2	0	0	573	2
4	7	4	0	7	574	0
4	5	2	0	5	575	0
4	0	4	64	64	576	2
4	1	4	23	24	577	1
4	1031	4	4	1035	578	1
4	13	0	25	38	579	0
4	0	2	0	0	580	2
4	57	4	0	57	581	1
4	15	2	11	26	582	0
4	27	2	0	27	583	0
4	55	0	6	61	584	0
4	5	4	33	38	585	1
4	1	4	1	2	586	1
4	2	2	24	26	587	0
4	0	4	1	1	588	2
4	4	2	0	4	589	0
4	0	4	0	0	590	2
4	0	4	1248	1248	591	2
4	9	4	0	9	592	0
4	4	2	0	4	593	1
4	0	4	2	2	594	2
4	0	4	0	0	595	2
4	3	4	0	3	596	0
4	0	2	0	0	597	2
4	12	4	31	43	598	1
4	0	4	100	100	599	2
4	2	2	6	8	600	1
4	0	4	64	64	601	2
4	10	4	0	10	602	0
4	0	2	1106	1106	603	2
4	0	4	7368	7368	604	2
4	4	2	22	26	605	1
4	0	4	1083	1083	606	2
4	6	2	0	6	607	0
4	0	2	3	3	608	2
4	0	2	2	2	609	2
4	5	2	0	5	610	0
4	12	4	76	88	611	0
4	3	4	76	79	612	0
2	0	2	0	0	613	2
2	0	2	0	0	614	2
2	0	2	0	0	615	2
2	0	2	0	0	616	2
2	0	2	0	0	617	2
2	0	2	0	0	618	2
2	0	2	0	0	619	2
2	0	2	0	0	620	2
2	0	2	0	0	621	2
2	0	2	0	0	622	2
2	0	2	0	0	623	2
2	0	2	0	0	624	2
2	0	2	0	0	625	2
2	0	2	0	0	626	2
2	0	2	0	0	627	2
2	0	2	0	0	628	2
2	0	2	0	0	629	2
2	0	2	0	0	630	2
2	0	2	0	0	631	2
2	0	2	0	0	632	2
2	0	2	0	0	633	2
2	0	2	0	0	634	2
2	0	2	0	0	635	2
2	0	2	0	0	636	2
2	0	2	0	0	637	2
2	0	2	0	0	638	2
2	0	2	0	0	639	2
2	0	2	0	0	640	2
2	0	2	0	0	641	2
2	0	2	0	0	642	2
2	4	2	0	4	643	0
2	1	2	124	125	644	1
2	0	2	1	1	645	2
2	0	2	0	0	646	2
2	6	2	1	7	647	1
2	0	2	7	7	648	2
2	1	2	0	1	649	0
2	0	2	0	0	650	2
2	0	2	0	0	651	2
2	0	2	3	3	652	2
2	0	2	0	0	653	2
2	0	2	0	0	654	2
2	0	2	0	0	655	2
2	0	2	1	1	656	2
2	0	2	0	0	657	2
2	0	2	0	0	658	2
2	0	2	0	0	659	2
2	0	2	0	0	660	2
2	0	2	0	0	661	2
2	0	2	0	0	662	2
2	0	2	0	0	663	2
2	0	2	0	0	664	2
2	0	2	0	0	665	2
2	0	2	0	0	666	2
2	0	2	0	0	667	2
2	0	2	0	0	668	2
2	0	2	0	0	669	2
2	0	2	0	0	670	2
2	0	2	0	0	671	2
2	0	2	0	0	672	2
2	0	2	0	0	673	2
2	0	2	0	0	674	2
2	0	2	0	0	675	2
2	0	2	0	0	676	2
2	0	2	5	5	677	2
2	0	2	0	0	678	2
2	0	2	0	0	679	2
2	0	2	0	0	680	2
2	0	2	3	3	681	2
2	65	2	6	71	682	0
2	302	2	420	722	683	1
2	0	2	32	32	684	2
2	0	2	6	6	685	2
2	163	2	11	174	686	1
2	0	2	307	307	687	2
2	9	2	0	9	688	0
2	0	2	0	0	689	2
2	0	2	0	0	690	2
2	0	2	0	0	691	2
2	0	2	0	0	692	2
2	0	2	0	0	693	2
2	0	2	0	0	694	2
2	0	2	0	0	695	2
2	0	2	0	0	696	2
2	0	2	0	0	697	2
2	0	2	0	0	698	2
2	0	2	0	0	699	2
2	0	2	0	0	700	2
2	0	2	0	0	701	2
2	0	2	0	0	702	2
2	0	2	0	0	703	2
2	0	2	0	0	704	2
2	0	2	0	0	705	2
2	0	2	0	0	706	2
2	0	2	0	0	707	2
2	0	2	0	0	708	2
2	0	2	0	0	709	2
2	0	2	0	0	710	2
2	0	2	0	0	711	2
2	0	2	0	0	712	2
2	0	2	0	0	713	2
2	0	2	0	0	714	2
2	0	2	0	0	715	2
2	0	2	0	0	716	2
2	0	2	0	0	717	2
2	0	2	0	0	718	2
2	0	2	0	0	719	2
2	0	2	0	0	720	2
2	0	2	0	0	721	2
2	0	2	0	0	722	2
2	0	2	0	0	723	2
2	0	2	0	0	724	2
2	0	2	0	0	725	2
2	0	2	0	0	726	2
2	0	2	0	0	727	2
2	0	2	0	0	728	2
2	0	2	0	0	729	2
2	0	2	0	0	730	2
2	0	2	0	0	731	2
2	0	2	0	0	732	2
2	0	2	0	0	733	2
2	0	2	0	0	734	2
2	0	2	0	0	735	2
2	0	2	0	0	736	2
2	0	2	0	0	737	2
2	129	2	0	129	738	0
2	3	2	0	3	739	0
2	14	2	1665	1679	740	1
2	0	2	1	1	741	2
2	0	2	0	0	742	2
2	40	2	0	40	743	1
2	1	2	419	420	744	1
2	0	2	0	0	745	2
2	0	2	0	0	746	2
2	0	2	0	0	747	2
2	0	2	0	0	748	2
2	0	2	0	0	749	2
2	0	2	0	0	750	2
2	0	2	0	0	751	2
2	0	2	0	0	752	2
2	0	2	0	0	753	2
2	1	2	202	203	754	0
2	0	2	0	0	755	2
2	0	2	0	0	756	2
2	0	2	0	0	757	2
2	0	2	0	0	758	2
2	0	2	0	0	759	2
2	0	2	0	0	760	2
2	1	2	0	1	761	0
2	0	2	6	6	762	2
4	0	2	0	0	763	2
2	0	2	0	0	764	2
2	0	2	0	0	765	2
2	0	2	0	0	766	2
2	0	2	0	0	767	2
2	0	2	0	0	768	2
2	0	2	0	0	769	2
2	1	2	0	1	770	0
2	21	2	9	30	771	1
2	0	2	1	1	772	2
2	0	2	0	0	773	2
2	11	2	0	11	774	1
2	0	2	4	4	775	2
2	0	2	0	0	776	2
2	0	2	0	0	777	2
2	0	2	0	0	778	2
2	0	2	0	0	779	2
2	0	2	0	0	780	2
2	0	2	0	0	781	2
2	0	2	0	0	782	2
2	0	2	0	0	783	2
2	0	2	0	0	784	2
2	0	2	0	0	785	2
2	0	2	0	0	786	2
2	0	2	0	0	787	2
2	0	2	0	0	788	2
2	0	2	0	0	789	2
2	0	2	0	0	790	2
2	0	2	0	0	791	2
2	0	2	0	0	792	2
2	0	2	0	0	793	2
2	0	2	0	0	794	2
2	0	2	0	0	795	2
2	0	2	0	0	796	2
2	0	2	0	0	797	2
2	0	2	0	0	798	2
2	0	2	0	0	799	2
2	0	2	0	0	800	2
2	0	2	0	0	801	2
2	0	2	0	0	802	2
2	0	2	0	0	803	2
2	0	2	0	0	804	2
2	0	2	0	0	805	2
2	0	2	0	0	806	2
2	0	2	0	0	807	2
2	0	2	0	0	808	2
2	0	2	0	0	809	2
2	0	2	0	0	810	2
2	0	2	0	0	811	2
2	0	2	0	0	812	2
2	0	2	0	0	813	2
2	0	2	0	0	814	2
2	0	2	0	0	815	2
2	0	2	0	0	816	2
2	0	2	0	0	817	2
2	0	2	1	1	818	2
2	0	2	0	0	819	2
2	0	2	0	0	820	2
2	0	2	28	28	821	2
2	0	2	0	0	822	2
2	0	2	0	0	823	2
2	0	2	0	0	824	2
2	0	2	0	0	825	2
2	0	2	0	0	826	2
2	0	2	0	0	827	2
2	0	2	0	0	828	2
2	0	2	0	0	829	2
2	1	2	0	1	830	1
2	0	2	0	0	831	2
2	0	2	0	0	832	2
2	0	2	0	0	833	2
2	0	2	0	0	834	2
2	0	2	0	0	835	2
2	0	2	0	0	836	2
2	0	2	0	0	837	2
2	0	2	0	0	838	2
2	0	2	0	0	839	2
2	0	2	0	0	840	2
2	0	2	0	0	841	2
2	0	2	0	0	842	2
2	0	2	0	0	843	2
2	0	2	0	0	844	2
2	0	2	0	0	845	2
2	0	2	0	0	846	2
2	0	2	0	0	847	2
2	0	2	0	0	848	2
2	0	2	0	0	849	2
2	0	2	0	0	850	2
2	0	2	0	0	851	2
2	0	2	0	0	852	2
2	0	2	0	0	853	2
2	0	2	0	0	854	2
2	0	2	0	0	855	2
2	0	2	0	0	856	2
2	0	2	0	0	857	2
2	0	2	0	0	858	2
2	0	2	0	0	859	2
2	0	2	0	0	860	2
2	0	2	0	0	861	2
2	0	2	0	0	862	2
2	0	2	0	0	863	2
2	0	2	0	0	864	2
2	0	2	0	0	865	2
2	8	2	0	8	866	0
2	7	2	97	104	867	1
2	0	2	1	1	868	2
2	0	2	0	0	869	2
2	0	2	0	0	870	2
2	0	2	0	0	871	2
2	0	2	0	0	872	2
2	0	2	0	0	873	2
2	0	2	0	0	874	2
2	0	2	0	0	875	2
2	0	2	0	0	876	2
2	0	2	0	0	877	2
2	0	2	0	0	878	2
2	0	2	0	0	879	2
2	0	2	0	0	880	2
2	0	2	0	0	881	2
2	0	2	0	0	882	2
2	0	2	0	0	883	2
2	0	2	0	0	884	2
2	0	2	0	0	885	2
2	0	2	0	0	886	2
2	11	2	1	12	887	0
2	0	2	0	0	888	2
2	0	2	0	0	889	2
2	0	2	0	0	890	2
2	0	2	3	3	891	2
2	0	2	0	0	892	2
2	0	2	0	0	893	2
2	0	2	0	0	894	2
2	0	2	0	0	895	2
2	0	2	0	0	896	2
2	0	2	0	0	897	2
2	0	2	0	0	898	2
2	0	2	0	0	899	2
2	0	2	0	0	900	2
2	0	2	0	0	901	2
2	15	2	0	15	902	0
4	0	2	0	0	903	2
2	0	2	0	0	904	2
2	0	2	0	0	905	2
2	0	2	0	0	906	2
2	0	2	0	0	907	2
2	0	2	2	2	908	2
2	0	2	0	0	909	2
2	0	2	0	0	910	2
2	0	2	32	32	911	2
2	0	2	2	2	912	2
2	0	2	0	0	913	2
2	3	2	0	3	914	0
2	0	2	18	18	915	2
2	0	2	0	0	916	2
2	0	2	0	0	917	2
2	0	2	0	0	918	2
2	1	2	1	2	919	1
2	0	2	9	9	920	2
2	280	2	0	280	921	0
2	5	2	1620	1625	922	1
2	0	2	141	141	923	2
2	0	2	0	0	924	2
2	85	2	1	86	925	0
2	0	2	637	637	926	2
2	0	2	0	0	927	2
2	0	2	0	0	928	2
2	0	2	0	0	929	2
2	0	2	0	0	930	2
2	0	2	0	0	931	2
2	0	2	0	0	932	2
2	0	2	0	0	933	2
2	0	2	0	0	934	2
2	0	2	0	0	935	2
2	0	2	0	0	936	2
2	0	2	0	0	937	2
2	0	2	0	0	938	2
2	0	2	0	0	939	2
2	0	2	0	0	940	2
2	0	2	0	0	941	2
2	0	2	0	0	942	2
2	0	2	0	0	943	2
2	0	2	0	0	944	2
2	0	2	0	0	945	2
2	0	2	0	0	946	2
2	0	2	0	0	947	2
2	0	2	0	0	948	2
2	0	2	0	0	949	2
2	0	2	0	0	950	2
2	0	2	0	0	951	2
2	0	2	0	0	952	2
2	0	2	0	0	953	2
2	0	2	0	0	954	2
2	0	2	0	0	955	2
2	0	2	0	0	956	2
2	0	2	0	0	957	2
2	0	2	0	0	958	2
2	0	2	0	0	959	2
2	0	2	0	0	960	2
2	0	2	0	0	961	2
2	0	2	0	0	962	2
2	0	2	0	0	963	2
2	3	2	2	5	964	0
2	0	2	9	9	965	2
2	0	2	0	0	966	2
2	0	2	0	0	967	2
2	0	2	0	0	968	2
2	0	2	0	0	969	2
2	0	2	0	0	970	2
2	0	2	0	0	971	2
2	0	2	0	0	972	2
2	0	2	1	1	973	2
2	0	2	0	0	974	2
2	0	2	0	0	975	2
2	0	2	0	0	976	2
2	0	2	0	0	977	2
2	0	2	0	0	978	2
2	0	2	0	0	979	2
2	0	2	1	1	980	2
2	0	2	0	0	981	2
2	0	2	0	0	982	2
2	0	2	0	0	983	2
2	0	2	0	0	984	2
2	0	2	0	0	985	2
2	0	2	0	0	986	2
2	0	2	0	0	987	2
2	0	2	0	0	988	2
2	0	2	0	0	989	2
2	0	2	0	0	990	2
2	0	2	0	0	991	2
2	0	2	0	0	992	2
2	0	2	0	0	993	2
2	5	2	1	6	994	0
2	13	2	98	111	995	1
2	0	2	0	0	996	2
2	0	2	0	0	997	2
2	0	2	0	0	998	2
2	0	2	4	4	999	2
2	0	2	0	0	1000	2
2	0	2	23	23	1001	2
2	0	2	0	0	1002	2
2	0	2	0	0	1003	2
2	0	2	0	0	1004	2
2	0	2	5	5	1005	2
2	0	2	0	0	1006	2
2	0	2	0	0	1007	2
2	0	2	0	0	1008	2
2	0	2	0	0	1009	2
2	0	2	0	0	1010	2
2	0	2	1	1	1011	2
2	0	2	0	0	1012	2
2	0	2	0	0	1013	2
2	0	2	0	0	1014	2
2	0	2	1	1	1015	2
2	0	2	0	0	1016	2
2	0	2	0	0	1017	2
2	0	2	12	12	1018	2
2	0	2	24	24	1019	2
2	0	2	0	0	1020	2
2	0	2	0	0	1021	2
2	0	2	0	0	1022	2
2	0	2	0	0	1023	2
2	0	2	0	0	1024	2
2	0	2	7	7	1025	2
2	0	2	0	0	1026	2
2	0	2	0	0	1027	2
2	0	2	0	0	1028	2
2	0	2	0	0	1029	2
2	0	2	0	0	1030	2
2	0	2	0	0	1031	2
2	0	2	0	0	1032	2
2	0	2	0	0	1033	2
2	0	2	0	0	1034	2
2	0	2	0	0	1035	2
2	0	2	0	0	1036	2
2	0	2	0	0	1037	2
2	0	4	0	0	1038	2
2	0	2	2	2	1039	2
2	0	2	0	0	1040	2
2	0	2	0	0	1041	2
2	0	2	0	0	1042	2
2	0	2	0	0	1043	2
2	0	2	0	0	1044	2
2	0	2	0	0	1045	2
2	0	2	0	0	1046	2
2	0	2	0	0	1047	2
2	0	2	0	0	1048	2
2	0	2	0	0	1049	2
2	0	2	0	0	1050	2
2	0	2	0	0	1051	2
2	0	2	0	0	1052	2
2	0	2	0	0	1053	2
2	0	2	0	0	1054	2
2	0	2	0	0	1055	2
2	0	2	0	0	1056	2
2	0	2	0	0	1057	2
2	0	2	0	0	1058	2
2	0	2	0	0	1059	2
2	0	2	0	0	1060	2
2	0	2	0	0	1061	2
2	0	2	0	0	1062	2
2	0	2	0	0	1063	2
2	0	2	0	0	1064	2
2	0	2	0	0	1065	2
2	0	2	0	0	1066	2
2	0	2	0	0	1067	2
2	0	2	0	0	1068	2
2	0	2	0	0	1069	2
2	0	2	0	0	1070	2
2	0	2	0	0	1071	2
2	0	2	0	0	1072	2
2	0	2	0	0	1073	2
2	0	2	0	0	1074	2
2	0	2	0	0	1075	2
2	0	2	0	0	1076	2
2	0	2	0	0	1077	2
2	0	2	0	0	1078	2
2	0	2	0	0	1079	2
2	0	2	0	0	1080	2
2	0	2	0	0	1081	2
2	0	2	0	0	1082	2
2	0	2	0	0	1083	2
2	0	4	16	16	1084	2
2	0	2	0	0	1085	2
2	0	2	0	0	1086	2
2	2	4	0	2	1087	0
2	0	2	6	6	1088	2
2	0	2	60	60	1089	2
2	3	2	0	3	1090	0
2	0	2	1	1	1091	2
2	0	2	0	0	1092	2
2	0	2	1	1	1093	2
2	0	2	0	0	1094	2
2	0	2	0	0	1095	2
2	0	2	0	0	1096	2
2	0	2	0	0	1097	2
2	16	2	0	16	1098	0
2	0	2	0	0	1099	2
2	0	2	0	0	1100	2
2	0	2	1	1	1101	2
2	0	2	0	0	1102	2
2	0	2	0	0	1103	2
2	0	2	0	0	1104	2
2	104	2	1	105	1105	0
2	32	2	0	32	1106	0
2	0	2	71	71	1107	2
2	0	2	0	0	1108	2
2	0	2	0	0	1109	2
2	0	2	5	5	1110	2
2	0	2	0	0	1111	2
2	0	2	0	0	1112	2
2	0	2	0	0	1113	2
2	0	2	0	0	1114	2
2	0	2	0	0	1115	2
2	0	2	0	0	1116	2
2	0	2	0	0	1117	2
2	0	2	0	0	1118	2
2	0	2	0	0	1119	2
2	0	2	0	0	1120	2
2	0	2	0	0	1121	2
2	0	2	0	0	1122	2
2	1	2	0	1	1123	0
2	0	2	73	73	1124	2
2	0	2	1	1	1125	2
2	0	2	0	0	1126	2
2	0	2	0	0	1127	2
2	0	4	6	6	1128	2
2	0	2	0	0	1129	2
2	0	2	0	0	1130	2
2	0	2	1	1	1131	2
2	0	2	0	0	1132	2
2	0	2	0	0	1133	2
2	0	2	0	0	1134	2
2	3	2	0	3	1135	0
2	1	2	107	108	1136	1
2	0	2	0	0	1137	2
2	0	2	0	0	1138	2
2	7	2	1	8	1139	0
2	0	2	75	75	1140	2
2	0	2	0	0	1141	2
2	0	2	0	0	1142	2
2	0	2	0	0	1143	2
2	0	2	0	0	1144	2
2	0	2	0	0	1145	2
2	0	2	0	0	1146	2
2	775	2	15	790	1147	0
2	0	2	0	0	1148	2
2	0	2	0	0	1149	2
2	0	2	0	0	1150	2
2	0	2	0	0	1151	2
2	0	2	0	0	1152	2
2	0	2	0	0	1153	2
2	0	2	0	0	1154	2
2	0	2	0	0	1155	2
2	0	2	0	0	1156	2
2	0	2	0	0	1157	2
2	0	2	0	0	1158	2
2	0	2	0	0	1159	2
2	684	2	8265	8949	1160	1
2	0	2	256	256	1161	2
2	0	2	14	14	1162	2
2	303	2	204	507	1163	0
2	0	2	1398	1398	1164	2
2	0	2	0	0	1165	2
2	0	4	7	7	1166	2
2	0	2	0	0	1167	2
2	0	2	0	0	1168	2
2	0	2	0	0	1169	2
2	0	2	0	0	1170	2
2	0	2	0	0	1171	2
2	0	2	0	0	1172	2
2	0	2	0	0	1173	2
2	0	2	0	0	1174	2
2	0	2	0	0	1175	2
2	0	2	0	0	1176	2
2	0	2	0	0	1177	2
2	0	2	0	0	1178	2
2	0	2	0	0	1179	2
2	0	2	0	0	1180	2
2	0	2	0	0	1181	2
2	0	2	0	0	1182	2
2	0	2	0	0	1183	2
2	0	2	0	0	1184	2
2	0	2	0	0	1185	2
2	0	2	0	0	1186	2
2	0	2	0	0	1187	2
2	0	2	0	0	1188	2
2	0	2	0	0	1189	2
2	0	2	0	0	1190	2
2	0	2	0	0	1191	2
2	0	2	0	0	1192	2
2	0	2	0	0	1193	2
2	0	2	0	0	1194	2
2	0	2	0	0	1195	2
2	0	2	0	0	1196	2
2	0	2	1	1	1197	2
2	0	2	1	1	1198	2
2	0	2	0	0	1199	2
2	0	2	0	0	1200	2
2	0	2	0	0	1201	2
2	0	2	0	0	1202	2
2	0	2	0	0	1203	2
2	0	2	0	0	1204	2
2	0	2	0	0	1205	2
2	0	2	0	0	1206	2
2	0	2	0	0	1207	2
2	0	2	0	0	1208	2
2	0	2	0	0	1209	2
2	0	2	0	0	1210	2
2	0	2	0	0	1211	2
2	0	2	0	0	1212	2
2	0	2	0	0	1213	2
2	0	2	0	0	1214	2
2	0	2	0	0	1215	2
2	0	2	0	0	1216	2
2	8	2	2	10	1217	1
2	0	2	2	2	1218	2
2	0	2	0	0	1219	2
2	1	2	0	1	1220	1
2	0	2	0	0	1221	2
2	0	2	0	0	1222	2
2	0	2	0	0	1223	2
2	0	2	0	0	1224	2
2	0	2	0	0	1225	2
2	0	2	0	0	1226	2
2	0	2	0	0	1227	2
2	0	2	0	0	1228	2
2	0	2	0	0	1229	2
2	0	2	0	0	1230	2
2	0	2	0	0	1231	2
2	0	2	0	0	1232	2
2	0	2	0	0	1233	2
2	0	2	0	0	1234	2
2	0	2	0	0	1235	2
2	0	2	0	0	1236	2
2	0	2	0	0	1237	2
2	0	2	0	0	1238	2
2	0	2	0	0	1239	2
2	0	2	0	0	1240	2
2	0	2	0	0	1241	2
2	0	2	0	0	1242	2
2	0	2	0	0	1243	2
2	0	2	0	0	1244	2
2	0	2	0	0	1245	2
2	0	2	0	0	1246	2
2	0	2	0	0	1247	2
2	0	2	1	1	1248	2
2	0	2	0	0	1249	2
2	0	2	0	0	1250	2
2	0	2	0	0	1251	2
2	0	2	0	0	1252	2
2	0	2	0	0	1253	2
2	0	2	0	0	1254	2
2	0	2	0	0	1255	2
2	0	2	0	0	1256	2
2	0	2	0	0	1257	2
2	0	2	0	0	1258	2
2	0	2	0	0	1259	2
2	0	2	0	0	1260	2
2	0	2	0	0	1261	2
2	0	2	0	0	1262	2
2	0	2	0	0	1263	2
2	0	2	0	0	1264	2
2	0	2	0	0	1265	2
2	0	2	0	0	1266	2
2	0	2	0	0	1267	2
2	0	2	0	0	1268	2
2	0	2	0	0	1269	2
2	0	2	0	0	1270	2
2	0	2	0	0	1271	2
2	3	2	27	30	1272	1
2	0	2	0	0	1273	2
2	0	2	0	0	1274	2
2	1	2	1	2	1275	1
2	0	2	3	3	1276	2
2	0	2	0	0	1277	2
2	0	2	0	0	1278	2
2	0	2	0	0	1279	2
2	0	2	0	0	1280	2
2	0	2	1	1	1281	2
2	0	2	0	0	1282	2
2	0	2	0	0	1283	2
2	0	2	0	0	1284	2
2	0	2	0	0	1285	2
2	0	2	0	0	1286	2
2	0	2	0	0	1287	2
2	0	2	0	0	1288	2
2	0	2	0	0	1289	2
2	0	2	0	0	1290	2
2	0	2	0	0	1291	2
2	0	2	0	0	1292	2
2	0	2	0	0	1293	2
2	0	2	0	0	1294	2
2	0	2	0	0	1295	2
2	0	2	0	0	1296	2
2	0	2	0	0	1297	2
2	0	2	0	0	1298	2
2	0	2	0	0	1299	2
2	0	2	0	0	1300	2
2	2	2	0	2	1301	0
2	0	2	0	0	1302	2
2	0	2	0	0	1303	2
2	0	2	0	0	1304	2
2	0	2	0	0	1305	2
2	0	2	0	0	1306	2
2	0	2	0	0	1307	2
2	1	2	0	1	1308	0
2	0	2	8	8	1309	2
2	0	2	0	0	1310	2
2	0	2	0	0	1311	2
2	3	2	1	4	1312	0
2	0	2	0	0	1313	2
2	0	2	0	0	1314	2
2	0	2	6	6	1315	2
2	0	2	0	0	1316	2
2	0	2	0	0	1317	2
2	0	2	1	1	1318	2
2	0	2	0	0	1319	2
2	0	2	0	0	1320	2
2	0	2	11	11	1321	2
2	0	2	0	0	1322	2
2	0	2	0	0	1323	2
2	1	2	4	5	1324	1
2	0	2	1	1	1325	2
2	0	2	0	0	1326	2
2	0	2	0	0	1327	2
2	0	2	0	0	1328	2
2	0	2	0	0	1329	2
2	0	2	0	0	1330	2
2	0	2	0	0	1331	2
2	0	2	0	0	1332	2
2	0	2	0	0	1333	2
2	0	2	0	0	1334	2
2	0	2	0	0	1335	2
2	0	2	0	0	1336	2
2	0	2	0	0	1337	2
2	0	2	0	0	1338	2
2	0	2	0	0	1339	2
2	0	2	0	0	1340	2
2	0	2	0	0	1341	2
2	0	2	0	0	1342	2
2	0	2	0	0	1343	2
2	0	2	3	3	1344	2
2	0	2	0	0	1345	2
2	0	2	0	0	1346	2
2	0	2	0	0	1347	2
2	0	4	2	2	1348	2
2	0	2	0	0	1349	2
2	0	2	0	0	1350	2
2	0	2	0	0	1351	2
2	0	2	0	0	1352	2
2	0	2	0	0	1353	2
2	0	2	0	0	1354	2
2	0	2	0	0	1355	2
2	0	2	0	0	1356	2
2	0	2	0	0	1357	2
2	0	2	0	0	1358	2
2	0	2	0	0	1359	2
2	0	2	0	0	1360	2
2	0	2	0	0	1361	2
2	0	2	0	0	1362	2
2	0	2	0	0	1363	2
2	0	2	0	0	1364	2
2	0	2	0	0	1365	2
2	0	2	0	0	1366	2
2	0	2	0	0	1367	2
2	0	2	0	0	1368	2
2	0	2	0	0	1369	2
2	0	2	0	0	1370	2
2	0	2	0	0	1371	2
2	0	2	0	0	1372	2
2	4	2	0	4	1373	0
2	0	2	0	0	1374	2
2	0	2	0	0	1375	2
2	0	2	0	0	1376	2
2	0	2	0	0	1377	2
2	0	2	0	0	1378	2
2	0	2	0	0	1379	2
2	0	2	0	0	1380	2
2	0	2	0	0	1381	2
2	0	2	0	0	1382	2
2	0	2	0	0	1383	2
2	0	2	0	0	1384	2
2	0	2	0	0	1385	2
2	0	2	0	0	1386	2
2	0	2	1	1	1387	2
2	0	2	0	0	1388	2
2	0	2	0	0	1389	2
2	0	2	0	0	1390	2
2	0	2	0	0	1391	2
4	0	2	0	0	1392	2
2	0	2	22	22	1393	2
2	0	2	6	6	1394	2
2	0	2	0	0	1395	2
2	2	2	1	3	1396	0
2	0	2	21	21	1397	2
2	0	2	0	0	1398	2
2	0	2	0	0	1399	2
2	0	2	0	0	1400	2
2	0	2	0	0	1401	2
2	37	2	0	37	1402	0
2	0	2	4	4	1403	2
2	0	2	4	4	1404	2
2	110	2	0	110	1405	0
2	22	2	170	192	1406	1
2	0	2	5	5	1407	2
2	0	2	0	0	1408	2
2	19	2	0	19	1409	0
2	0	2	193	193	1410	2
2	21	2	0	21	1411	0
2	3	2	112	115	1412	1
2	0	2	0	0	1413	2
2	0	2	0	0	1414	2
2	1	2	0	1	1415	0
2	299	2	4	303	1416	0
2	205	2	2622	2827	1417	1
2	1	2	188	189	1418	1
2	0	2	5	5	1419	2
2	286	2	43	329	1420	0
2	0	2	1011	1011	1421	2
2	0	2	0	0	1422	2
2	2	2	0	2	1423	1
2	0	2	0	0	1424	2
2	0	2	0	0	1425	2
2	0	2	2	2	1426	2
2	0	2	4	4	1427	2
2	4	2	0	4	1428	0
2	1	2	20	21	1429	1
2	0	2	0	0	1430	2
2	0	2	0	0	1431	2
4	2	2	1	3	1432	0
4	1	2	0	1	1433	0
2	0	2	8	8	1434	2
2	0	2	2	2	1435	2
2	0	2	0	0	1436	2
2	0	2	0	0	1437	2
2	0	2	0	0	1438	2
2	0	2	0	0	1439	2
2	0	2	0	0	1440	2
2	0	2	0	0	1441	2
2	0	2	0	0	1442	2
2	0	2	0	0	1443	2
2	0	2	0	0	1444	2
2	0	2	0	0	1445	2
2	0	2	0	0	1446	2
2	0	2	0	0	1447	2
2	0	2	0	0	1448	2
2	0	2	2	2	1449	2
2	0	2	0	0	1450	2
2	0	2	0	0	1451	2
2	0	2	0	0	1452	2
2	0	2	0	0	1453	2
4	1	2	1	2	1454	0
2	0	2	0	0	1455	2
2	0	2	0	0	1456	2
2	0	2	0	0	1457	2
2	0	2	0	0	1458	2
2	0	2	0	0	1459	2
2	0	2	0	0	1460	2
2	0	2	0	0	1461	2
2	0	2	0	0	1462	2
2	0	2	0	0	1463	2
2	0	2	0	0	1464	2
2	0	2	0	0	1465	2
2	0	2	0	0	1466	2
2	0	2	0	0	1467	2
2	0	2	0	0	1468	2
2	0	2	0	0	1469	2
2	0	2	0	0	1470	2
4	32	2	0	32	1471	0
4	0	2	0	0	1472	2
2	0	2	0	0	1473	2
2	0	2	0	0	1474	2
2	0	2	0	0	1475	2
2	0	2	0	0	1476	2
2	0	2	2	2	1477	2
2	0	2	0	0	1478	2
2	0	2	0	0	1479	2
2	0	2	0	0	1480	2
2	0	2	1	1	1481	2
2	0	2	0	0	1482	2
2	0	2	2	2	1483	2
2	0	2	0	0	1484	2
2	0	2	0	0	1485	2
2	0	2	0	0	1486	2
2	0	2	0	0	1487	2
2	0	2	0	0	1488	2
2	0	2	0	0	1489	2
2	0	2	0	0	1490	2
2	0	2	0	0	1491	2
2	0	2	0	0	1492	2
2	0	2	0	0	1493	2
2	0	2	0	0	1494	2
2	0	2	0	0	1495	2
2	0	2	0	0	1496	2
2	0	2	0	0	1497	2
2	0	2	0	0	1498	2
2	0	2	0	0	1499	2
2	0	2	0	0	1500	2
2	0	2	0	0	1501	2
2	0	2	0	0	1502	2
2	0	2	0	0	1503	2
2	0	2	0	0	1504	2
2	0	2	0	0	1505	2
2	0	2	0	0	1506	2
2	0	2	0	0	1507	2
2	0	2	0	0	1508	2
2	0	2	0	0	1509	2
2	0	2	4	4	1510	2
2	0	2	0	0	1511	2
2	0	2	0	0	1512	2
2	0	2	0	0	1513	2
2	0	2	0	0	1514	2
2	0	2	0	0	1515	2
2	0	2	0	0	1516	2
2	0	2	0	0	1517	2
2	0	2	1	1	1518	2
2	0	2	0	0	1519	2
2	0	2	0	0	1520	2
2	0	2	0	0	1521	2
2	0	2	0	0	1522	2
2	1	2	0	1	1523	0
2	0	2	0	0	1524	2
2	0	2	0	0	1525	2
2	6	2	12	18	1526	1
2	0	2	0	0	1527	2
2	0	2	0	0	1528	2
2	1	2	0	1	1529	1
2	0	2	2	2	1530	2
2	2	2	0	2	1531	0
2	0	2	11	11	1532	2
2	0	2	0	0	1533	2
2	0	2	0	0	1534	2
2	0	2	0	0	1535	2
2	0	2	3	3	1536	2
2	77	2	0	77	1537	0
2	0	2	18	18	1538	2
2	0	2	0	0	1539	2
2	0	2	0	0	1540	2
2	0	2	0	0	1541	2
2	0	2	0	0	1542	2
2	0	2	0	0	1543	2
2	0	2	0	0	1544	2
2	0	2	0	0	1545	2
2	0	2	0	0	1546	2
2	0	2	0	0	1547	2
2	0	2	0	0	1548	2
2	0	2	0	0	1549	2
2	0	2	0	0	1550	2
2	0	2	0	0	1551	2
2	0	2	0	0	1552	2
2	0	2	0	0	1553	2
2	0	2	0	0	1554	2
2	0	2	0	0	1555	2
2	0	2	0	0	1556	2
2	0	2	0	0	1557	2
2	0	2	0	0	1558	2
2	0	2	0	0	1559	2
2	0	2	0	0	1560	2
2	0	2	0	0	1561	2
2	0	2	0	0	1562	2
2	0	2	0	0	1563	2
2	0	2	0	0	1564	2
2	0	2	0	0	1565	2
2	0	2	0	0	1566	2
2	0	2	0	0	1567	2
2	0	2	0	0	1568	2
2	0	2	0	0	1569	2
2	0	2	0	0	1570	2
2	0	2	0	0	1571	2
2	0	2	0	0	1572	2
2	0	2	0	0	1573	2
2	0	2	0	0	1574	2
2	0	2	0	0	1575	2
2	0	2	0	0	1576	2
2	0	2	1	1	1577	2
2	0	2	0	0	1578	2
2	0	2	0	0	1579	2
2	0	2	0	0	1580	2
2	0	2	0	0	1581	2
2	3	2	0	3	1582	0
2	0	2	44	44	1583	2
2	0	2	0	0	1584	2
2	0	2	0	0	1585	2
2	1	2	0	1	1586	0
2	0	2	6	6	1587	2
2	0	2	0	0	1588	2
2	0	2	0	0	1589	2
2	0	2	0	0	1590	2
2	0	2	0	0	1591	2
2	0	2	0	0	1592	2
2	0	2	0	0	1593	2
2	0	2	0	0	1594	2
2	0	2	0	0	1595	2
2	0	2	0	0	1596	2
2	0	2	0	0	1597	2
2	0	2	0	0	1598	2
2	0	2	0	0	1599	2
2	0	2	0	0	1600	2
2	0	2	0	0	1601	2
2	0	2	0	0	1602	2
2	0	2	0	0	1603	2
2	0	2	0	0	1604	2
2	0	2	0	0	1605	2
2	0	2	0	0	1606	2
2	75	2	0	75	1607	0
2	0	2	0	0	1608	2
2	0	2	0	0	1609	2
2	0	2	0	0	1610	2
2	0	2	0	0	1611	2
2	0	2	0	0	1612	2
2	0	2	0	0	1613	2
2	0	2	0	0	1614	2
2	0	2	0	0	1615	2
2	0	2	0	0	1616	2
2	0	2	0	0	1617	2
2	0	2	0	0	1618	2
2	0	2	0	0	1619	2
2	0	2	0	0	1620	2
2	0	2	0	0	1621	2
2	23	2	0	23	1622	1
2	0	2	19	19	1623	2
2	0	2	0	0	1624	2
2	14	2	1	15	1625	1
2	0	2	0	0	1626	2
2	7	2	0	7	1627	0
2	0	2	0	0	1628	2
2	0	2	0	0	1629	2
2	0	2	0	0	1630	2
2	0	2	0	0	1631	2
2	1	2	0	1	1632	1
2	0	2	0	0	1633	2
2	0	2	0	0	1634	2
2	1	2	0	1	1635	1
2	0	2	0	0	1636	2
2	0	2	0	0	1637	2
2	0	2	0	0	1638	2
2	0	2	0	0	1639	2
2	0	2	0	0	1640	2
2	0	2	0	0	1641	2
2	0	2	0	0	1642	2
2	0	2	0	0	1643	2
2	0	2	0	0	1644	2
2	0	2	0	0	1645	2
2	0	2	0	0	1646	2
2	0	2	0	0	1647	2
2	7	2	0	7	1648	0
2	6	2	76	82	1649	1
2	0	2	2	2	1650	2
2	0	2	0	0	1651	2
2	9	2	3	12	1652	0
2	0	2	12	12	1653	2
2	2	2	0	2	1654	0
2	0	2	12	12	1655	2
2	0	2	1	1	1656	2
2	0	2	0	0	1657	2
2	1	2	0	1	1658	0
2	0	2	3	3	1659	2
2	65	2	4	69	1660	0
2	77	2	525	602	1661	1
2	0	2	10	10	1662	2
2	0	2	0	0	1663	2
2	30	2	9	39	1664	1
2	0	2	146	146	1665	2
2	0	2	0	0	1666	2
2	0	2	0	0	1667	2
2	0	2	0	0	1668	2
2	0	2	0	0	1669	2
2	0	2	0	0	1670	2
2	0	2	0	0	1671	2
2	0	2	0	0	1672	2
2	0	2	0	0	1673	2
2	0	2	0	0	1674	2
2	0	2	0	0	1675	2
2	0	2	0	0	1676	2
2	0	2	1	1	1677	2
2	3	2	0	3	1678	0
2	0	2	0	0	1679	2
2	0	2	0	0	1680	2
2	0	2	0	0	1681	2
2	0	2	0	0	1682	2
2	0	2	0	0	1683	2
2	0	2	0	0	1684	2
2	0	2	0	0	1685	2
2	0	2	0	0	1686	2
2	0	2	0	0	1687	2
2	0	2	0	0	1688	2
2	0	2	0	0	1689	2
2	0	2	0	0	1690	2
2	0	2	0	0	1691	2
2	0	2	0	0	1692	2
2	0	2	0	0	1693	2
2	0	2	0	0	1694	2
2	0	2	0	0	1695	2
2	0	2	0	0	1696	2
2	0	2	0	0	1697	2
2	0	2	0	0	1698	2
2	0	2	0	0	1699	2
2	0	2	0	0	1700	2
2	1273	2	4	1277	1701	0
2	0	2	1554	1554	1702	2
2	1	2	21	22	1703	1
2	9	2	0	9	1704	0
2	34	2	166	200	1705	1
2	0	2	3	3	1706	2
2	0	2	1	1	1707	2
2	7	2	2	9	1708	1
2	0	2	14	14	1709	2
2	0	2	0	0	1710	2
2	0	2	2	2	1711	2
2	0	2	0	0	1712	2
2	0	2	0	0	1713	2
2	0	2	0	0	1714	2
2	0	2	0	0	1715	2
2	8	2	0	8	1716	0
2	1	2	59	60	1717	1
2	0	2	9	9	1718	2
2	0	2	0	0	1719	2
2	2	2	0	2	1720	0
2	0	2	18	18	1721	2
2	0	2	0	0	1722	2
2	0	2	0	0	1723	2
2	0	2	0	0	1724	2
2	0	2	0	0	1725	2
2	0	2	0	0	1726	2
2	0	2	0	0	1727	2
2	0	2	0	0	1728	2
2	0	2	0	0	1729	2
2	0	2	0	0	1730	2
2	0	2	0	0	1731	2
2	0	2	0	0	1732	2
2	0	2	2	2	1733	2
2	0	2	0	0	1734	2
2	0	2	0	0	1735	2
2	0	2	0	0	1736	2
2	0	2	0	0	1737	2
2	0	2	0	0	1738	2
2	0	2	0	0	1739	2
2	0	2	0	0	1740	2
2	40	2	1	41	1741	0
2	0	2	0	0	1742	2
2	0	2	0	0	1743	2
2	0	2	0	0	1744	2
2	0	2	0	0	1745	2
2	0	2	0	0	1746	2
2	0	2	0	0	1747	2
2	0	2	0	0	1748	2
2	0	2	0	0	1749	2
2	0	2	0	0	1750	2
2	0	2	0	0	1751	2
2	0	2	0	0	1752	2
2	0	2	0	0	1753	2
2	0	2	0	0	1754	2
2	0	2	0	0	1755	2
2	0	2	0	0	1756	2
2	0	2	0	0	1757	2
2	0	2	0	0	1758	2
2	0	2	0	0	1759	2
2	81	2	112	193	1760	1
2	0	2	14	14	1761	2
2	0	2	0	0	1762	2
2	55	2	5	60	1763	0
2	0	2	106	106	1764	2
2	0	2	0	0	1765	2
2	0	2	1	1	1766	2
2	0	2	0	0	1767	2
2	0	2	0	0	1768	2
2	1	2	1	2	1769	1
2	0	2	1	1	1770	2
2	0	2	0	0	1771	2
2	0	2	0	0	1772	2
2	0	2	0	0	1773	2
2	0	2	0	0	1774	2
2	0	2	0	0	1775	2
2	0	2	0	0	1776	2
2	0	2	0	0	1777	2
2	0	2	0	0	1778	2
2	0	2	0	0	1779	2
2	0	2	0	0	1780	2
2	0	2	0	0	1781	2
2	0	2	0	0	1782	2
2	0	2	0	0	1783	2
4	0	2	0	0	1784	2
2	0	2	0	0	1785	2
2	0	2	0	0	1786	2
2	0	2	0	0	1787	2
2	0	2	0	0	1788	2
2	0	2	0	0	1789	2
2	0	2	0	0	1790	2
2	0	2	0	0	1791	2
2	0	2	0	0	1792	2
2	0	2	0	0	1793	2
2	0	2	0	0	1794	2
2	0	2	0	0	1795	2
2	0	2	0	0	1796	2
2	0	2	0	0	1797	2
2	0	2	1	1	1798	2
2	0	2	0	0	1799	2
2	0	2	0	0	1800	2
2	0	2	0	0	1801	2
2	0	2	0	0	1802	2
2	0	2	0	0	1803	2
2	0	2	0	0	1804	2
2	0	2	0	0	1805	2
2	75	2	1	76	1806	0
2	9	2	1	10	1807	0
2	1	2	445	446	1808	1
2	1	2	1	2	1809	1
2	0	2	0	0	1810	2
2	2	2	22	24	1811	0
2	0	2	10	10	1812	2
2	12	2	732	744	1813	1
2	0	2	18	18	1814	2
2	0	2	1	1	1815	2
2	22	2	16	38	1816	0
2	0	2	156	156	1817	2
2	0	2	0	0	1818	2
2	0	2	0	0	1819	2
2	0	2	0	0	1820	2
2	0	2	0	0	1821	2
2	0	2	0	0	1822	2
2	0	2	0	0	1823	2
2	0	2	0	0	1824	2
2	0	2	0	0	1825	2
2	0	2	0	0	1826	2
2	0	2	0	0	1827	2
2	0	2	0	0	1828	2
2	0	2	0	0	1829	2
2	0	2	0	0	1830	2
2	0	2	0	0	1831	2
2	0	2	2	2	1832	2
2	0	2	0	0	1833	2
2	0	2	0	0	1834	2
2	0	2	0	0	1835	2
2	0	2	0	0	1836	2
2	0	2	3	3	1837	2
2	0	2	0	0	1838	2
2	0	2	0	0	1839	2
2	0	2	0	0	1840	2
2	0	2	0	0	1841	2
2	1	2	0	1	1842	0
2	0	2	0	0	1843	2
2	0	2	0	0	1844	2
2	0	2	0	0	1845	2
2	0	2	0	0	1846	2
2	0	2	0	0	1847	2
2	0	2	0	0	1848	2
2	0	2	0	0	1849	2
2	0	2	0	0	1850	2
2	6	2	0	6	1851	0
2	4	2	100	104	1852	1
2	0	2	0	0	1853	2
2	0	2	0	0	1854	2
2	5	2	0	5	1855	0
2	0	2	30	30	1856	2
2	0	2	1	1	1857	2
2	0	2	0	0	1858	2
2	0	2	0	0	1859	2
2	0	2	5	5	1860	2
2	0	2	0	0	1861	2
2	0	2	0	0	1862	2
2	0	2	0	0	1863	2
2	0	2	3	3	1864	2
2	0	2	0	0	1865	2
2	0	2	0	0	1866	2
2	0	2	0	0	1867	2
2	0	2	0	0	1868	2
2	0	2	0	0	1869	2
2	0	2	0	0	1870	2
2	0	2	0	0	1871	2
2	0	2	0	0	1872	2
2	0	2	0	0	1873	2
2	0	2	0	0	1874	2
2	156	2	0	156	1875	0
2	1	0	8002	8003	1876	1
2	0	2	2	2	1877	2
2	0	2	11	11	1878	2
2	10	0	1171	1181	1879	0
2	0	2	160	160	1880	2
2	173	2	0	173	1881	0
2	2	2	1771	1773	1882	1
2	0	2	9	9	1883	2
2	0	2	3	3	1884	2
2	7	2	7	14	1885	0
2	0	2	117	117	1886	2
2	294	2	3	297	1887	0
2	137	2	1770	1907	1888	1
2	0	2	95	95	1889	2
2	0	2	0	0	1890	2
4	0	2	78	78	1891	2
4	0	2	1	1	1892	2
2	141	2	13	154	1893	1
2	0	2	0	0	1894	2
2	0	2	0	0	1895	2
2	0	2	0	0	1896	2
2	0	2	0	0	1897	2
2	0	2	0	0	1898	2
2	0	2	0	0	1899	2
2	0	2	0	0	1900	2
2	0	2	0	0	1901	2
2	0	2	0	0	1902	2
2	0	2	0	0	1903	2
2	0	2	1	1	1904	2
2	0	2	0	0	1905	2
2	45	2	0	45	1906	0
2	9	2	0	9	1907	1
2	0	2	17	17	1908	2
2	0	2	0	0	1909	2
2	25	2	0	25	1910	0
2	0	2	0	0	1911	2
2	0	2	0	0	1912	2
2	0	2	0	0	1913	2
2	0	2	0	0	1914	2
2	0	2	0	0	1915	2
2	0	2	0	0	1916	2
2	0	2	0	0	1917	2
2	0	2	0	0	1918	2
2	0	2	0	0	1919	2
2	0	2	0	0	1920	2
2	0	2	0	0	1921	2
2	0	2	0	0	1922	2
2	0	2	0	0	1923	2
2	0	2	5	5	1924	2
2	0	2	0	0	1925	2
2	0	2	0	0	1926	2
2	0	2	0	0	1927	2
2	0	2	0	0	1928	2
2	0	2	0	0	1929	2
2	0	2	0	0	1930	2
2	0	2	0	0	1931	2
2	0	2	0	0	1932	2
2	0	2	0	0	1933	2
2	0	2	0	0	1934	2
2	0	2	0	0	1935	2
2	0	2	0	0	1936	2
2	0	2	0	0	1937	2
2	0	2	0	0	1938	2
2	0	2	0	0	1939	2
2	0	2	0	0	1940	2
2	8	2	0	8	1941	0
2	13	2	152	165	1942	1
2	0	2	4	4	1943	2
2	0	2	0	0	1944	2
2	6	2	0	6	1945	0
2	0	2	14	14	1946	2
2	0	2	0	0	1947	2
2	0	2	0	0	1948	2
2	0	2	0	0	1949	2
2	0	2	0	0	1950	2
2	0	2	0	0	1951	2
2	0	2	0	0	1952	2
2	0	2	0	0	1953	2
2	0	4	0	0	1954	2
2	1	2	0	1	1955	0
2	0	2	2	2	1956	2
2	0	2	0	0	1957	2
2	0	2	0	0	1958	2
2	1	2	0	1	1959	1
2	0	2	0	0	1960	2
2	0	2	0	0	1961	2
2	0	2	0	0	1962	2
2	0	2	0	0	1963	2
2	0	2	0	0	1964	2
2	13	2	0	13	1965	0
2	59	2	425	484	1966	1
2	0	2	1	1	1967	2
2	0	2	0	0	1968	2
2	13	2	7	20	1969	0
2	0	2	58	58	1970	2
0	0	2	0	0	1971	2
0	0	2	2	2	1972	2
0	0	2	0	0	1973	2
2	49	2	0	49	1974	0
2	26	2	382	408	1975	1
2	0	2	12	12	1976	2
2	0	2	0	0	1977	2
2	20	2	2	22	1978	0
2	0	2	251	251	1979	2
2	0	2	0	0	1980	2
2	0	4	0	0	1981	2
2	0	2	0	0	1982	2
2	0	4	1	1	1983	2
2	0	2	0	0	1984	2
2	0	2	0	0	1985	2
2	0	2	0	0	1986	2
2	0	2	7	7	1987	2
2	0	2	0	0	1988	2
2	0	2	0	0	1989	2
2	0	2	0	0	1990	2
2	0	2	1	1	1991	2
2	0	2	0	0	1992	2
2	0	2	0	0	1993	2
2	0	2	0	0	1994	2
2	0	2	0	0	1995	2
2	0	2	0	0	1996	2
2	0	2	0	0	1997	2
2	0	2	0	0	1998	2
2	0	2	0	0	1999	2
2	0	2	0	0	2000	2
2	0	4	0	0	2001	2
2	0	2	0	0	2002	2
2	0	2	0	0	2003	2
2	0	4	0	0	2004	2
2	0	2	0	0	2005	2
2	8	2	0	8	2006	0
2	0	2	65	65	2007	2
2	0	2	0	0	2008	2
2	0	2	0	0	2009	2
2	4	2	1	5	2010	0
2	0	2	38	38	2011	2
2	0	2	0	0	2012	2
2	0	2	0	0	2013	2
2	0	2	0	0	2014	2
2	0	2	0	0	2015	2
2	0	2	0	0	2016	2
2	0	2	0	0	2017	2
2	23	2	0	23	2018	0
2	0	2	4	4	2019	2
2	0	2	0	0	2020	2
2	0	2	0	0	2021	2
2	4	2	0	4	2022	0
2	0	2	1	1	2023	2
2	0	2	0	0	2024	2
2	0	2	0	0	2025	2
2	0	2	0	0	2026	2
2	0	2	0	0	2027	2
2	0	2	0	0	2028	2
2	0	2	0	0	2029	2
2	0	2	0	0	2030	2
2	0	2	0	0	2031	2
2	0	2	0	0	2032	2
2	0	2	0	0	2033	2
2	0	2	0	0	2034	2
2	0	2	0	0	2035	2
2	0	2	0	0	2036	2
2	0	2	0	0	2037	2
2	0	2	0	0	2038	2
2	0	2	0	0	2039	2
2	0	2	0	0	2040	2
2	0	2	0	0	2041	2
2	0	0	4	4	2042	2
2	0	2	0	0	2043	2
2	0	2	0	0	2044	2
2	0	0	5	5	2045	2
2	0	2	0	0	2046	2
2	5	2	0	5	2047	0
2	4	2	33	37	2048	1
2	0	2	1	1	2049	2
2	0	2	0	0	2050	2
2	5	2	1	6	2051	0
2	0	2	14	14	2052	2
2	26	2	0	26	2053	0
2	0	0	492	492	2054	2
2	0	2	0	0	2055	2
2	0	2	0	0	2056	2
2	6	0	51	57	2057	0
2	0	2	17	17	2058	2
2	0	2	0	0	2059	2
2	0	2	0	0	2060	2
2	0	2	0	0	2061	2
2	0	2	0	0	2062	2
2	0	2	0	0	2063	2
2	0	2	0	0	2064	2
2	24	2	2284	2308	2065	0
2	29	2	0	29	2066	0
2	1	2	140	141	2067	1
2	0	2	0	0	2068	2
2	0	2	0	0	2069	2
2	0	2	0	0	2070	2
2	0	2	0	0	2071	2
2	0	2	0	0	2072	2
2	0	2	0	0	2073	2
2	13	2	0	13	2074	0
2	8	2	295	303	2075	1
2	0	2	0	0	2076	2
2	0	2	0	0	2077	2
2	3	2	4	7	2078	0
2	0	2	29	29	2079	2
2	0	2	0	0	2080	2
2	4	2	44	48	2081	1
2	0	2	1	1	2082	2
2	0	2	0	0	2083	2
2	0	2	6	6	2084	2
2	0	2	3	3	2085	2
2	0	2	0	0	2086	2
2	0	2	0	0	2087	2
2	0	2	0	0	2088	2
2	0	2	0	0	2089	2
2	0	2	0	0	2090	2
2	0	2	0	0	2091	2
2	0	2	0	0	2092	2
2	0	2	13	13	2093	2
2	0	2	0	0	2094	2
2	0	2	0	0	2095	2
2	0	2	0	0	2096	2
2	0	2	0	0	2097	2
2	0	2	0	0	2098	2
2	0	2	2	2	2099	2
2	0	2	0	0	2100	2
2	0	2	1	1	2101	2
2	0	2	0	0	2102	2
2	0	2	0	0	2103	2
2	0	2	0	0	2104	2
2	0	2	0	0	2105	2
2	0	2	0	0	2106	2
2	0	2	0	0	2107	2
2	0	2	0	0	2108	2
2	0	2	0	0	2109	2
2	0	2	0	0	2110	2
2	0	2	0	0	2111	2
2	0	2	0	0	2112	2
2	0	2	0	0	2113	2
2	0	2	0	0	2114	2
2	0	2	0	0	2115	2
2	0	2	0	0	2116	2
2	0	2	0	0	2117	2
2	0	2	0	0	2118	2
2	0	2	0	0	2119	2
2	0	2	0	0	2120	2
2	0	2	0	0	2121	2
2	0	2	0	0	2122	2
2	0	2	0	0	2123	2
2	0	2	0	0	2124	2
2	0	2	0	0	2125	2
2	0	2	0	0	2126	2
2	0	2	0	0	2127	2
2	72	2	2	74	2128	0
2	0	2	0	0	2129	2
2	0	2	0	0	2130	2
2	0	2	0	0	2131	2
2	0	2	0	0	2132	2
2	0	2	0	0	2133	2
2	0	2	0	0	2134	2
2	0	2	0	0	2135	2
2	0	2	0	0	2136	2
2	0	2	0	0	2137	2
2	0	2	0	0	2138	2
2	0	2	0	0	2139	2
2	0	2	0	0	2140	2
2	90	2	438	528	2141	1
2	1	2	47	48	2142	1
2	0	2	24	24	2143	2
2	51	2	114	165	2144	0
2	0	4	143	143	2145	2
2	0	2	0	0	2146	2
2	0	2	0	0	2147	2
2	0	2	0	0	2148	2
2	0	2	0	0	2149	2
2	0	2	0	0	2150	2
2	0	2	0	0	2151	2
2	719	2	0	719	2152	0
2	180	2	1178	1358	2153	1
2	0	2	188	188	2154	2
2	0	2	1	1	2155	2
2	423	2	1	424	2156	1
2	0	2	2131	2131	2157	2
2	2	2	0	2	2158	0
2	1	2	0	1	2159	0
2	0	2	0	0	2160	2
2	0	2	0	0	2161	2
2	0	2	0	0	2162	2
2	0	2	0	0	2163	2
2	0	2	0	0	2164	2
2	0	2	0	0	2165	2
2	0	2	0	0	2166	2
2	0	2	0	0	2167	2
2	0	2	0	0	2168	2
2	0	2	0	0	2169	2
2	0	2	0	0	2170	2
2	0	2	0	0	2171	2
2	2	2	9	11	2172	1
2	0	2	3	3	2173	2
2	0	2	0	0	2174	2
2	0	2	4	4	2175	2
2	0	2	0	0	2176	2
2	0	2	0	0	2177	2
2	1	2	0	1	2178	0
2	1	2	21	22	2179	1
2	0	2	0	0	2180	2
2	0	2	0	0	2181	2
2	1	2	1	2	2182	1
2	0	2	3	3	2183	2
2	1	2	47	48	2184	1
2	0	2	0	0	2185	2
2	0	2	1	1	2186	2
2	3	2	5	8	2187	1
2	0	2	2	2	2188	2
2	0	2	0	0	2189	2
2	1	2	7	8	2190	1
2	0	2	0	0	2191	2
2	0	2	0	0	2192	2
2	0	2	0	0	2193	2
2	0	2	0	0	2194	2
2	0	2	0	0	2195	2
2	0	2	0	0	2196	2
2	0	2	0	0	2197	2
2	0	2	0	0	2198	2
2	0	2	0	0	2199	2
2	0	2	0	0	2200	2
2	81	2	1	82	2201	0
2	0	2	8	8	2202	2
2	0	2	1	1	2203	2
2	1	4	3093	3094	2204	0
2	0	2	1	1	2205	2
2	1	2	0	1	2206	0
2	7	4	6100	6107	2207	1
2	0	2	1	1	2208	2
2	0	2	1	1	2209	2
2	0	2	0	0	2210	2
2	0	2	1	1	2211	2
2	0	2	14	14	2212	2
2	0	2	0	0	2213	2
2	1	2	0	1	2214	0
2	0	2	4	4	2215	2
2	0	2	0	0	2216	2
2	0	2	0	0	2217	2
2	0	2	0	0	2218	2
2	0	2	139	139	2219	2
2	0	4	2	2	2220	2
2	0	2	0	0	2221	2
2	0	2	0	0	2222	2
4	1	2	0	1	2223	1
4	0	2	0	0	2224	2
2	0	2	0	0	2225	2
2	0	2	0	0	2226	2
2	0	2	0	0	2227	2
2	0	2	3	3	2228	2
2	0	2	0	0	2229	2
2	0	2	0	0	2230	2
2	0	2	0	0	2231	2
2	0	2	1	1	2232	2
2	0	2	0	0	2233	2
2	0	2	0	0	2234	2
2	0	2	0	0	2235	2
2	0	2	0	0	2236	2
2	0	2	0	0	2237	2
2	0	2	0	0	2238	2
2	0	2	0	0	2239	2
2	0	2	0	0	2240	2
2	17	2	1	18	2241	0
2	0	2	1	1	2242	2
2	0	2	1	1	2243	2
2	0	2	0	0	2244	2
2	0	2	0	0	2245	2
2	0	2	0	0	2246	2
2	0	2	0	0	2247	2
2	0	2	0	0	2248	2
2	0	2	0	0	2249	2
2	0	2	0	0	2250	2
2	0	2	0	0	2251	2
2	18	2	0	18	2252	0
2	14	2	577	591	2253	1
2	0	2	6	6	2254	2
2	0	2	0	0	2255	2
2	5	2	0	5	2256	0
2	0	2	43	43	2257	2
2	6	4	13	19	2258	1
6	18	4	13	31	2259	0
7	682	7	29	711	2260	0
7	7	7	0	7	2261	0
4	7	4	1	8	2262	0
0	5	2	0	5	2263	0
0	14	2	4	18	2264	0
0	8	2	0	8	2265	0
2	0	2	0	0	2266	2
2	0	2	0	0	2267	2
2	0	2	0	0	2268	2
2	0	2	0	0	2269	2
2	0	2	0	0	2270	2
2	0	2	0	0	2271	2
2	0	2	0	0	2272	2
2	0	2	0	0	2273	2
2	0	2	0	0	2274	2
2	0	2	0	0	2275	2
2	0	2	0	0	2276	2
2	0	2	2	2	2277	2
2	0	2	0	0	2278	2
2	0	2	0	0	2279	2
2	0	2	0	0	2280	2
2	0	2	0	0	2281	2
2	0	2	0	0	2282	2
2	0	2	0	0	2283	2
2	0	2	0	0	2284	2
2	0	2	20	20	2285	2
2	0	2	0	0	2286	2
2	0	2	0	0	2287	2
2	3	2	2	5	2288	1
2	0	2	0	0	2289	2
2	0	2	0	0	2290	2
2	0	2	0	0	2291	2
2	0	2	0	0	2292	2
2	0	2	0	0	2293	2
2	0	2	0	0	2294	2
2	0	2	0	0	2295	2
2	1	2	0	1	2296	0
2	0	2	0	0	2297	2
2	0	2	0	0	2298	2
2	0	2	10	10	2299	2
2	0	2	0	0	2300	2
2	0	2	0	0	2301	2
2	0	2	0	0	2302	2
2	0	2	0	0	2303	2
2	0	2	0	0	2304	2
2	0	2	0	0	2305	2
2	0	2	0	0	2306	2
2	0	2	0	0	2307	2
2	0	2	0	0	2308	2
2	0	2	0	0	2309	2
2	0	2	0	0	2310	2
2	0	2	0	0	2311	2
2	0	2	0	0	2312	2
2	0	2	0	0	2313	2
2	0	2	0	0	2314	2
2	0	2	0	0	2315	2
2	0	2	0	0	2316	2
2	0	2	0	0	2317	2
2	0	2	0	0	2318	2
2	0	2	0	0	2319	2
2	0	2	0	0	2320	2
2	0	2	2	2	2321	2
2	0	2	0	0	2322	2
2	0	2	0	0	2323	2
2	0	2	0	0	2324	2
2	0	2	0	0	2325	2
2	0	2	0	0	2326	2
2	4	2	1	5	2327	0
2	5	2	129	134	2328	1
2	0	2	1	1	2329	2
2	0	2	0	0	2330	2
2	3	2	2	5	2331	0
2	0	2	28	28	2332	2
2	0	2	1	1	2333	2
2	0	2	0	0	2334	2
2	0	2	0	0	2335	2
2	0	2	0	0	2336	2
2	0	2	0	0	2337	2
2	0	2	0	0	2338	2
2	0	2	0	0	2339	2
2	0	2	0	0	2340	2
2	0	2	0	0	2341	2
2	0	2	0	0	2342	2
2	0	2	0	0	2343	2
2	0	2	0	0	2344	2
2	1	2	1	2	2345	1
2	0	2	0	0	2346	2
2	0	2	0	0	2347	2
2	0	2	1	1	2348	2
2	0	2	3	3	2349	2
2	195	2	0	195	2350	0
2	0	2	9	9	2351	2
2	0	2	0	0	2352	2
2	80	2	0	80	2353	0
2	0	2	11	11	2354	2
2	0	2	0	0	2355	2
2	0	2	0	0	2356	2
2	1	2	0	1	2357	1
2	0	2	0	0	2358	2
2	0	2	0	0	2359	2
2	0	2	0	0	2360	2
2	0	2	0	0	2361	2
2	746	2	0	746	2362	0
2	54	2	5730	5784	2363	1
2	0	2	0	0	2364	2
2	0	2	0	0	2365	2
2	55	2	45	100	2366	0
2	0	2	410	410	2367	2
2	432	2	4	436	2368	0
2	0	2	49	49	2369	2
2	0	2	10	10	2370	2
2	0	2	0	0	2371	2
2	0	2	0	0	2372	2
2	0	2	0	0	2373	2
2	0	2	0	0	2374	2
2	0	2	0	0	2375	2
2	0	2	0	0	2376	2
2	0	2	0	0	2377	2
2	0	2	0	0	2378	2
2	0	2	0	0	2379	2
2	0	2	0	0	2380	2
2	0	2	0	0	2381	2
2	0	2	0	0	2382	2
2	0	2	0	0	2383	2
2	0	2	0	0	2384	2
2	0	2	0	0	2385	2
2	0	2	0	0	2386	2
2	0	2	0	0	2387	2
2	0	2	0	0	2388	2
2	0	2	0	0	2389	2
2	0	2	0	0	2390	2
2	0	2	0	0	2391	2
2	0	2	0	0	2392	2
2	0	2	0	0	2393	2
2	0	2	0	0	2394	2
2	0	2	0	0	2395	2
2	0	2	0	0	2396	2
2	0	2	0	0	2397	2
2	0	2	0	0	2398	2
2	0	2	0	0	2399	2
2	0	2	0	0	2400	2
2	0	2	0	0	2401	2
2	0	2	0	0	2402	2
2	0	2	0	0	2403	2
2	0	2	0	0	2404	2
2	0	2	0	0	2405	2
2	0	2	0	0	2406	2
2	12	2	0	12	2407	0
2	0	2	22	22	2408	2
2	0	2	0	0	2409	2
2	0	2	0	0	2410	2
2	2	2	0	2	2411	0
2	0	2	7	7	2412	2
2	0	2	0	0	2413	2
2	0	2	0	0	2414	2
2	0	2	0	0	2415	2
2	0	2	0	0	2416	2
2	0	2	0	0	2417	2
2	0	2	0	0	2418	2
2	7	2	0	7	2419	0
2	0	2	0	0	2420	2
2	0	2	1	1	2421	2
2	0	2	0	0	2422	2
2	0	2	0	0	2423	2
2	0	2	0	0	2424	2
2	0	2	0	0	2425	2
2	0	2	0	0	2426	2
2	0	2	0	0	2427	2
2	0	2	0	0	2428	2
2	0	2	0	0	2429	2
2	0	2	0	0	2430	2
2	0	2	0	0	2431	2
2	2	2	58	60	2432	1
2	0	2	3	3	2433	2
2	0	2	0	0	2434	2
2	1	2	4	5	2435	0
2	0	2	7	7	2436	2
2	0	2	1	1	2437	2
2	0	2	0	0	2438	2
2	0	2	0	0	2439	2
2	0	2	0	0	2440	2
2	0	2	0	0	2441	2
2	0	2	0	0	2442	2
2	0	2	0	0	2443	2
0	364	4	7	371	2444	1
0	1	4	7	8	2445	0
2	0	2	0	0	2446	2
2	0	2	0	0	2447	2
2	0	2	0	0	2448	2
2	0	2	0	0	2449	2
2	0	2	0	0	2450	2
2	0	2	0	0	2451	2
2	0	2	0	0	2452	2
2	0	2	0	0	2453	2
2	0	2	0	0	2454	2
2	0	2	0	0	2455	2
2	0	2	0	0	2456	2
2	0	2	0	0	2457	2
2	0	2	0	0	2458	2
2	2	2	0	2	2459	1
2	0	2	0	0	2460	2
2	0	2	0	0	2461	2
2	0	2	0	0	2462	2
2	0	2	0	0	2463	2
2	0	2	0	0	2464	2
2	0	2	0	0	2465	2
2	0	2	0	0	2466	2
2	0	2	0	0	2467	2
2	0	2	0	0	2468	2
2	0	2	0	0	2469	2
2	0	2	0	0	2470	2
2	0	2	2	2	2471	2
2	0	2	0	0	2472	2
2	0	2	0	0	2473	2
2	0	2	0	0	2474	2
2	0	2	0	0	2475	2
2	0	2	0	0	2476	2
2	0	2	0	0	2477	2
2	0	2	0	0	2478	2
2	0	2	0	0	2479	2
2	0	2	0	0	2480	2
2	0	2	0	0	2481	2
2	0	2	0	0	2482	2
2	1	2	0	1	2483	0
2	28	2	3	31	2484	1
2	0	2	0	0	2485	2
2	0	2	0	0	2486	2
2	0	2	0	0	2487	2
2	0	2	0	0	2488	2
2	0	2	0	0	2489	2
2	0	2	0	0	2490	2
2	0	2	0	0	2491	2
2	0	2	0	0	2492	2
2	0	2	0	0	2493	2
2	0	2	0	0	2494	2
2	0	2	0	0	2495	2
2	0	2	0	0	2496	2
2	0	2	0	0	2497	2
2	0	2	0	0	2498	2
2	0	2	0	0	2499	2
2	0	2	0	0	2500	2
2	0	2	9	9	2501	2
2	0	2	0	0	2502	2
2	0	2	0	0	2503	2
2	0	2	1	1	2504	2
2	0	2	0	0	2505	2
2	1	2	0	1	2506	0
2	0	2	0	0	2507	2
2	0	2	0	0	2508	2
2	0	2	0	0	2509	2
2	0	2	0	0	2510	2
2	0	2	0	0	2511	2
2	0	2	0	0	2512	2
2	0	2	25	25	2513	2
2	0	2	0	0	2514	2
2	0	2	1	1	2515	2
2	2	2	2	4	2516	0
2	0	2	4	4	2517	2
2	14	2	1	15	2518	0
2	433	2	4081	4514	2519	1
2	0	2	3	3	2520	2
2	0	2	0	0	2521	2
2	23	2	0	23	2522	1
2	0	2	148	148	2523	2
2	0	2	0	0	2524	2
2	0	2	0	0	2525	2
2	0	2	0	0	2526	2
2	0	2	0	0	2527	2
2	0	2	0	0	2528	2
2	0	2	0	0	2529	2
2	0	2	0	0	2530	2
2	0	2	0	0	2531	2
2	0	2	0	0	2532	2
2	0	2	0	0	2533	2
2	0	2	0	0	2534	2
2	0	2	0	0	2535	2
2	0	2	0	0	2536	2
2	0	0	2	2	2537	2
2	0	2	0	0	2538	2
2	0	2	0	0	2539	2
2	0	0	2	2	2540	2
2	0	2	0	0	2541	2
2	0	2	0	0	2542	2
2	0	2	0	0	2543	2
2	0	2	0	0	2544	2
2	0	2	0	0	2545	2
2	0	2	0	0	2546	2
2	0	2	0	0	2547	2
2	0	2	0	0	2548	2
2	0	2	0	0	2549	2
2	0	2	0	0	2550	2
2	0	2	0	0	2551	2
2	0	2	0	0	2552	2
2	0	2	0	0	2553	2
2	0	2	0	0	2554	2
2	0	2	0	0	2555	2
2	0	2	0	0	2556	2
2	0	2	0	0	2557	2
2	0	2	0	0	2558	2
2	0	2	0	0	2559	2
2	0	2	0	0	2560	2
2	0	2	0	0	2561	2
2	0	2	0	0	2562	2
2	0	2	0	0	2563	2
2	0	2	0	0	2564	2
2	0	2	0	0	2565	2
2	0	2	0	0	2566	2
2	0	2	0	0	2567	2
2	0	2	0	0	2568	2
2	0	2	0	0	2569	2
2	0	2	0	0	2570	2
2	0	2	0	0	2571	2
2	0	2	0	0	2572	2
2	1	2	0	1	2573	0
2	2	2	17	19	2574	1
2	0	2	0	0	2575	2
2	0	2	0	0	2576	2
2	0	2	0	0	2577	2
2	1	2	3	4	2578	1
2	2	2	0	2	2579	0
2	1	2	23	24	2580	1
2	0	2	1	1	2581	2
2	0	2	0	0	2582	2
2	0	2	7	7	2583	2
2	0	2	5	5	2584	2
2	0	2	0	0	2585	2
2	0	2	0	0	2586	2
2	0	2	0	0	2587	2
2	0	2	0	0	2588	2
2	0	2	0	0	2589	2
2	0	2	0	0	2590	2
2	0	2	0	0	2591	2
2	0	2	0	0	2592	2
2	0	2	0	0	2593	2
2	0	2	0	0	2594	2
2	0	2	0	0	2595	2
2	0	2	0	0	2596	2
2	0	2	0	0	2597	2
2	0	2	0	0	2598	2
2	0	2	0	0	2599	2
2	1	2	3	4	2600	1
2	0	2	0	0	2601	2
2	0	2	0	0	2602	2
2	0	2	0	0	2603	2
2	0	2	0	0	2604	2
2	0	2	0	0	2605	2
2	0	2	0	0	2606	2
2	0	2	0	0	2607	2
2	0	2	0	0	2608	2
2	0	2	0	0	2609	2
2	0	2	0	0	2610	2
2	0	2	0	0	2611	2
2	0	2	23	23	2612	2
2	0	2	0	0	2613	2
2	0	2	0	0	2614	2
2	0	2	612	612	2615	2
2	0	2	0	0	2616	2
2	0	2	0	0	2617	2
2	0	2	0	0	2618	2
2	0	2	0	0	2619	2
2	0	2	0	0	2620	2
2	0	2	0	0	2621	2
2	0	2	0	0	2622	2
2	0	2	0	0	2623	2
2	0	2	0	0	2624	2
2	0	2	0	0	2625	2
2	0	2	0	0	2626	2
2	0	2	0	0	2627	2
2	0	2	0	0	2628	2
2	0	2	0	0	2629	2
2	0	2	0	0	2630	2
2	0	2	0	0	2631	2
2	0	2	0	0	2632	2
2	0	2	0	0	2633	2
2	0	2	0	0	2634	2
2	0	2	0	0	2635	2
2	1305	2	182	1487	2636	0
2	0	2	0	0	2637	2
2	0	2	0	0	2638	2
2	0	2	0	0	2639	2
2	0	2	0	0	2640	2
2	41	2	0	41	2641	0
2	0	2	397	397	2642	2
2	0	2	38	38	2643	2
2	0	2	0	0	2644	2
2	10	2	1	11	2645	1
2	0	2	100	100	2646	2
2	0	2	0	0	2647	2
2	0	2	0	0	2648	2
2	0	2	0	0	2649	2
2	0	2	0	0	2650	2
2	0	2	0	0	2651	2
2	0	2	0	0	2652	2
2	0	2	0	0	2653	2
2	0	2	0	0	2654	2
2	0	2	0	0	2655	2
2	3	2	2	5	2656	1
2	0	2	1	1	2657	2
2	0	2	0	0	2658	2
2	0	2	0	0	2659	2
2	0	2	0	0	2660	2
2	0	2	0	0	2661	2
2	0	2	0	0	2662	2
2	0	2	0	0	2663	2
2	0	2	0	0	2664	2
2	0	2	0	0	2665	2
2	0	2	2	2	2666	2
2	0	2	0	0	2667	2
2	0	2	0	0	2668	2
2	0	2	0	0	2669	2
2	0	2	0	0	2670	2
2	0	2	0	0	2671	2
2	0	2	0	0	2672	2
2	0	2	0	0	2673	2
2	0	2	0	0	2674	2
2	0	2	0	0	2675	2
2	62	2	4	66	2676	0
2	32	2	1000	1032	2677	1
2	0	2	39	39	2678	2
2	0	2	5	5	2679	2
2	32	2	68	100	2680	0
2	0	2	129	129	2681	2
2	0	2	0	0	2682	2
2	0	2	0	0	2683	2
2	0	2	0	0	2684	2
2	0	2	0	0	2685	2
2	0	2	0	0	2686	2
2	0	2	0	0	2687	2
2	0	2	0	0	2688	2
2	0	2	0	0	2689	2
2	0	2	0	0	2690	2
2	0	2	0	0	2691	2
2	0	2	0	0	2692	2
2	0	2	0	0	2693	2
2	0	2	0	0	2694	2
2	0	2	0	0	2695	2
2	0	2	0	0	2696	2
2	0	2	0	0	2697	2
2	0	2	0	0	2698	2
2	0	2	0	0	2699	2
2	0	2	0	0	2700	2
2	0	2	0	0	2701	2
2	0	2	0	0	2702	2
2	0	2	0	0	2703	2
2	0	2	0	0	2704	2
2	0	2	0	0	2705	2
2	0	2	0	0	2706	2
2	0	2	0	0	2707	2
2	0	2	0	0	2708	2
2	0	2	0	0	2709	2
2	0	2	0	0	2710	2
2	0	2	0	0	2711	2
2	0	2	0	0	2712	2
2	0	2	0	0	2713	2
2	0	2	0	0	2714	2
2	0	2	0	0	2715	2
2	0	2	0	0	2716	2
2	0	2	0	0	2717	2
2	0	2	0	0	2718	2
2	0	2	0	0	2719	2
2	0	2	0	0	2720	2
2	0	2	0	0	2721	2
2	0	2	0	0	2722	2
2	0	2	0	0	2723	2
2	0	2	0	0	2724	2
2	0	2	0	0	2725	2
2	0	2	0	0	2726	2
2	0	2	0	0	2727	2
2	0	2	0	0	2728	2
2	0	2	0	0	2729	2
2	0	2	0	0	2730	2
2	0	2	0	0	2731	2
2	0	2	0	0	2732	2
2	0	2	0	0	2733	2
2	0	2	0	0	2734	2
2	0	2	0	0	2735	2
2	0	2	0	0	2736	2
2	0	2	0	0	2737	2
2	0	2	0	0	2738	2
2	0	2	0	0	2739	2
2	0	2	0	0	2740	2
2	0	2	3	3	2741	2
2	0	2	0	0	2742	2
2	0	2	0	0	2743	2
2	0	2	2	2	2744	2
2	0	2	11	11	2745	2
2	0	2	0	0	2746	2
2	0	2	0	0	2747	2
2	0	2	0	0	2748	2
2	0	2	0	0	2749	2
2	0	2	0	0	2750	2
2	0	2	0	0	2751	2
2	0	2	0	0	2752	2
2	0	2	0	0	2753	2
2	0	2	0	0	2754	2
2	0	2	0	0	2755	2
2	0	2	0	0	2756	2
2	0	2	0	0	2757	2
2	0	2	0	0	2758	2
2	0	2	0	0	2759	2
2	0	2	0	0	2760	2
2	0	2	0	0	2761	2
2	0	2	0	0	2762	2
2	0	2	0	0	2763	2
2	0	2	0	0	2764	2
2	0	2	0	0	2765	2
2	0	2	0	0	2766	2
2	0	2	0	0	2767	2
2	0	2	37	37	2768	2
2	0	2	0	0	2769	2
2	0	2	0	0	2770	2
2	0	2	18	18	2771	2
2	0	2	0	0	2772	2
2	0	2	1	1	2773	2
2	0	2	0	0	2774	2
2	0	2	0	0	2775	2
2	1	2	48	49	2776	1
2	0	2	0	0	2777	2
2	0	2	0	0	2778	2
2	0	2	1	1	2779	2
2	0	2	6	6	2780	2
2	0	2	0	0	2781	2
2	0	2	0	0	2782	2
2	0	2	0	0	2783	2
2	0	2	0	0	2784	2
2	0	2	0	0	2785	2
2	1	2	1	2	2786	1
2	0	2	0	0	2787	2
2	0	2	0	0	2788	2
2	0	2	0	0	2789	2
2	0	2	0	0	2790	2
2	0	2	0	0	2791	2
2	0	2	0	0	2792	2
2	0	2	0	0	2793	2
2	0	2	0	0	2794	2
2	0	2	0	0	2795	2
2	0	2	0	0	2796	2
2	16	2	0	16	2797	0
2	0	2	0	0	2798	2
2	0	2	2	2	2799	2
2	0	2	0	0	2800	2
2	0	2	0	0	2801	2
2	0	2	0	0	2802	2
2	0	2	0	0	2803	2
2	0	2	23	23	2804	2
2	0	2	0	0	2805	2
2	0	2	0	0	2806	2
2	0	2	0	0	2807	2
2	0	2	33	33	2808	2
2	0	2	0	0	2809	2
2	0	2	0	0	2810	2
2	0	2	0	0	2811	2
2	0	2	0	0	2812	2
2	0	2	0	0	2813	2
2	0	2	0	0	2814	2
2	0	2	0	0	2815	2
2	0	2	0	0	2816	2
2	0	2	0	0	2817	2
2	0	2	0	0	2818	2
2	0	2	0	0	2819	2
2	0	2	0	0	2820	2
2	1	2	0	1	2821	0
2	1	2	42	43	2822	1
2	0	2	0	0	2823	2
2	0	2	0	0	2824	2
2	0	2	1	1	2825	2
2	0	2	2	2	2826	2
2	0	2	0	0	2827	2
2	0	2	0	0	2828	2
2	0	2	0	0	2829	2
2	0	2	0	0	2830	2
2	0	2	0	0	2831	2
2	0	2	0	0	2832	2
2	0	2	0	0	2833	2
2	0	2	0	0	2834	2
2	0	2	0	0	2835	2
2	0	2	0	0	2836	2
2	0	2	0	0	2837	2
2	0	2	0	0	2838	2
2	0	2	0	0	2839	2
2	0	2	0	0	2840	2
2	0	2	0	0	2841	2
2	0	2	0	0	2842	2
2	0	2	0	0	2843	2
2	0	2	0	0	2844	2
2	1	2	0	1	2845	0
2	1	2	17	18	2846	1
2	0	2	0	0	2847	2
2	0	2	0	0	2848	2
2	1	2	0	1	2849	1
2	0	2	0	0	2850	2
2	0	2	0	0	2851	2
2	0	2	0	0	2852	2
2	0	2	0	0	2853	2
2	0	2	0	0	2854	2
2	0	2	0	0	2855	2
2	0	2	0	0	2856	2
2	0	2	0	0	2857	2
2	0	2	0	0	2858	2
2	0	2	0	0	2859	2
2	0	2	0	0	2860	2
2	0	2	0	0	2861	2
2	0	2	0	0	2862	2
2	0	2	0	0	2863	2
2	0	2	10	10	2864	2
2	0	2	0	0	2865	2
2	0	2	0	0	2866	2
2	0	2	0	0	2867	2
2	0	2	0	0	2868	2
2	0	2	0	0	2869	2
2	0	2	0	0	2870	2
2	0	2	0	0	2871	2
2	0	2	0	0	2872	2
2	0	2	0	0	2873	2
2	0	2	0	0	2874	2
2	0	2	0	0	2875	2
2	0	2	2	2	2876	2
2	0	2	0	0	2877	2
2	0	2	0	0	2878	2
2	0	2	0	0	2879	2
2	0	2	3	3	2880	2
0	0	2	0	0	2881	2
2	0	2	0	0	2882	2
2	0	2	1	1	2883	2
2	0	2	0	0	2884	2
2	0	2	0	0	2885	2
2	0	2	0	0	2886	2
2	0	2	0	0	2887	2
2	0	2	0	0	2888	2
2	0	2	1	1	2889	2
2	0	2	0	0	2890	2
2	0	2	0	0	2891	2
2	0	2	1	1	2892	2
2	0	2	0	0	2893	2
2	157	2	2	159	2894	0
2	13	2	3542	3555	2895	1
2	0	2	0	0	2896	2
2	0	2	0	0	2897	2
2	43	2	83	126	2898	1
2	0	2	439	439	2899	2
2	0	2	0	0	2900	2
2	0	4	0	0	2901	2
2	0	2	0	0	2902	2
2	0	2	0	0	2903	2
2	0	4	0	0	2904	2
2	0	2	0	0	2905	2
2	0	2	0	0	2906	2
2	0	2	3	3	2907	2
2	0	2	0	0	2908	2
2	0	2	0	0	2909	2
2	0	2	0	0	2910	2
2	0	2	0	0	2911	2
2	0	2	17	17	2912	2
2	0	2	1	1	2913	2
2	0	2	0	0	2914	2
2	0	2	0	0	2915	2
2	0	2	0	0	2916	2
2	3	2	0	3	2917	0
2	2	2	1	3	2918	0
2	0	2	4	4	2919	2
2	2	2	49	51	2920	1
2	0	2	0	0	2921	2
2	0	2	0	0	2922	2
2	0	2	0	0	2923	2
2	0	2	0	0	2924	2
2	0	2	0	0	2925	2
2	0	2	0	0	2926	2
2	0	2	0	0	2927	2
2	0	2	0	0	2928	2
2	0	2	0	0	2929	2
2	0	2	0	0	2930	2
2	0	2	0	0	2931	2
2	0	2	0	0	2932	2
2	0	2	0	0	2933	2
2	0	2	0	0	2934	2
0	0	4	0	0	2935	2
2	5	2	0	5	2936	0
2	0	2	40	40	2937	2
2	80	2	0	80	2938	0
2	9	2	252	261	2939	1
2	0	2	3	3	2940	2
2	0	2	0	0	2941	2
2	0	2	0	0	2942	2
2	0	2	0	0	2943	2
2	0	2	0	0	2944	2
2	0	2	0	0	2945	2
2	0	2	0	0	2946	2
2	0	2	0	0	2947	2
2	0	2	0	0	2948	2
2	0	2	0	0	2949	2
2	0	2	0	0	2950	2
2	0	2	0	0	2951	2
2	0	2	0	0	2952	2
2	0	2	0	0	2953	2
2	0	2	0	0	2954	2
2	0	2	0	0	2955	2
2	0	2	0	0	2956	2
2	0	2	0	0	2957	2
2	0	2	0	0	2958	2
2	0	2	0	0	2959	2
2	0	2	0	0	2960	2
2	0	2	0	0	2961	2
2	0	2	0	0	2962	2
2	0	2	0	0	2963	2
2	0	2	0	0	2964	2
2	0	2	0	0	2965	2
2	0	2	0	0	2966	2
2	0	2	0	0	2967	2
2	0	2	0	0	2968	2
2	0	2	0	0	2969	2
2	0	2	0	0	2970	2
2	0	2	0	0	2971	2
2	0	2	0	0	2972	2
4	0	2	0	0	2973	2
2	13	2	0	13	2974	0
2	6	2	367	373	2975	1
2	0	2	3	3	2976	2
2	0	2	0	0	2977	2
2	7	2	0	7	2978	1
2	0	2	27	27	2979	2
2	0	2	0	0	2980	2
2	0	2	0	0	2981	2
2	0	2	0	0	2982	2
2	0	2	43	43	2983	2
2	0	2	0	0	2984	2
2	0	2	0	0	2985	2
2	0	2	0	0	2986	2
2	0	2	2	2	2987	2
4	0	2	6	6	2988	2
2	18	2	1	19	2989	0
2	7	2	224	231	2990	1
2	0	2	6	6	2991	2
2	0	2	0	0	2992	2
2	5	2	13	18	2993	0
2	0	2	19	19	2994	2
2	0	2	0	0	2995	2
2	0	2	0	0	2996	2
2	0	2	0	0	2997	2
2	0	2	0	0	2998	2
2	0	2	0	0	2999	2
2	0	2	0	0	3000	2
2	0	2	0	0	3001	2
2	21	2	0	21	3002	0
2	0	2	55	55	3003	2
2	0	2	0	0	3004	2
2	0	2	0	0	3005	2
2	1	2	0	1	3006	1
2	0	2	10	10	3007	2
2	0	2	0	0	3008	2
2	0	2	0	0	3009	2
2	0	2	0	0	3010	2
2	0	2	0	0	3011	2
2	0	2	0	0	3012	2
2	0	2	0	0	3013	2
2	0	2	0	0	3014	2
2	0	2	0	0	3015	2
2	0	2	0	0	3016	2
2	0	2	0	0	3017	2
2	0	2	0	0	3018	2
2	0	2	0	0	3019	2
2	0	2	0	0	3020	2
2	0	2	0	0	3021	2
2	0	2	0	0	3022	2
2	1	2	0	1	3023	0
2	0	2	1	1	3024	2
2	0	2	0	0	3025	2
2	0	2	0	0	3026	2
2	0	2	0	0	3027	2
2	0	2	0	0	3028	2
2	1	2	0	1	3029	0
2	0	2	0	0	3030	2
2	0	2	0	0	3031	2
2	0	2	0	0	3032	2
2	0	2	0	0	3033	2
2	0	2	0	0	3034	2
2	0	2	0	0	3035	2
2	0	2	0	0	3036	2
4	7826	2	37	7863	3037	0
4	4013	2	18	4031	3038	0
4	9	4	0	9	3039	1
4	0	4	0	0	3040	2
2	0	2	0	0	3041	2
2	0	2	0	0	3042	2
2	0	2	0	0	3043	2
2	0	2	0	0	3044	2
2	0	2	0	0	3045	2
2	0	2	0	0	3046	2
4	0	2	0	0	3047	2
2	0	2	0	0	3048	2
2	1	4	88	89	3049	1
2	0	2	0	0	3050	2
2	0	2	0	0	3051	2
2	0	4	3	3	3052	2
2	0	2	0	0	3053	2
2	0	2	0	0	3054	2
2	0	2	0	0	3055	2
2	0	2	0	0	3056	2
2	0	2	0	0	3057	2
2	0	2	0	0	3058	2
2	0	2	0	0	3059	2
2	0	2	0	0	3060	2
2	0	2	0	0	3061	2
2	0	2	0	0	3062	2
2	0	2	0	0	3063	2
2	0	2	0	0	3064	2
2	0	2	0	0	3065	2
2	0	2	0	0	3066	2
2	0	2	0	0	3067	2
2	0	2	0	0	3068	2
2	0	2	0	0	3069	2
2	0	2	0	0	3070	2
2	0	2	0	0	3071	2
2	0	2	0	0	3072	2
2	0	2	0	0	3073	2
2	0	2	0	0	3074	2
2	0	2	0	0	3075	2
2	0	2	0	0	3076	2
2	0	2	0	0	3077	2
2	0	2	0	0	3078	2
2	0	2	0	0	3079	2
2	0	2	0	0	3080	2
2	0	2	0	0	3081	2
2	0	2	0	0	3082	2
0	0	4	2	2	3083	2
2	0	2	0	0	3084	2
2	0	2	1	1	3085	2
2	1	2	0	1	3086	1
2	0	2	3	3	3087	2
2	0	2	0	0	3088	2
2	0	2	0	0	3089	2
0	0	4	0	0	3090	2
2	0	2	0	0	3091	2
2	0	4	16	16	3092	2
2	0	2	0	0	3093	2
2	0	2	0	0	3094	2
2	0	4	2	2	3095	2
2	0	2	0	0	3096	2
4	0	2	0	0	3097	2
2	7	2	0	7	3098	0
2	0	2	0	0	3099	2
2	0	2	0	0	3100	2
2	0	2	0	0	3101	2
2	0	2	0	0	3102	2
2	0	2	0	0	3103	2
2	0	2	0	0	3104	2
2	7	2	30	37	3105	1
2	0	2	1	1	3106	2
2	0	2	0	0	3107	2
2	3	2	0	3	3108	1
2	0	2	5	5	3109	2
2	0	2	7	7	3110	2
2	0	2	0	0	3111	2
2	0	2	1	1	3112	2
2	0	2	0	0	3113	2
2	0	2	0	0	3114	2
2	0	2	0	0	3115	2
2	0	2	0	0	3116	2
2	0	2	0	0	3117	2
2	0	2	0	0	3118	2
2	0	2	0	0	3119	2
2	0	2	0	0	3120	2
2	0	2	0	0	3121	2
2	0	2	0	0	3122	2
2	0	2	0	0	3123	2
2	55	2	0	55	3124	0
2	38	2	919	957	3125	1
2	0	2	11	11	3126	2
2	0	2	3	3	3127	2
2	56	2	15	71	3128	0
2	0	2	163	163	3129	2
2	0	2	0	0	3130	2
2	0	2	0	0	3131	2
2	0	2	0	0	3132	2
2	0	2	0	0	3133	2
2	0	2	0	0	3134	2
2	0	2	0	0	3135	2
2	0	2	0	0	3136	2
2	0	2	1	1	3137	2
2	0	2	0	0	3138	2
2	1	2	4	5	3139	1
2	0	2	0	0	3140	2
2	0	2	0	0	3141	2
2	3	4	22	25	3142	1
2	0	2	0	0	3143	2
2	0	2	0	0	3144	2
2	0	4	0	0	3145	2
2	97091	2	42	97133	3146	0
5	280892	2	36	280928	3147	0
2	0	2	0	0	3148	2
2	0	2	0	0	3149	2
2	1	2	0	1	3150	0
2	0	2	0	0	3151	2
2	0	2	1	1	3152	2
2	0	2	0	0	3153	2
2	0	2	0	0	3154	2
2	0	2	0	0	3155	2
2	0	2	0	0	3156	2
2	0	2	0	0	3157	2
2	0	2	2	2	3158	2
2	0	2	0	0	3159	2
2	0	2	0	0	3160	2
2	0	2	0	0	3161	2
2	0	2	0	0	3162	2
2	0	2	0	0	3163	2
2	0	2	0	0	3164	2
2	0	2	0	0	3165	2
2	0	2	0	0	3166	2
2	0	2	0	0	3167	2
2	0	2	0	0	3168	2
2	21	2	0	21	3169	0
2	4	2	113	117	3170	1
2	0	2	5	5	3171	2
2	0	2	0	0	3172	2
2	44	2	0	44	3173	0
2	0	2	198	198	3174	2
2	0	2	0	0	3175	2
2	0	2	0	0	3176	2
2	0	2	0	0	3177	2
2	0	2	0	0	3178	2
2	0	2	0	0	3179	2
2	0	2	0	0	3180	2
2	1852	2	9	1861	3181	0
2	230	4	35355	35585	3182	1
2	0	2	151	151	3183	2
2	0	2	13	13	3184	2
2	179	4	9178	9357	3185	1
2	0	2	1168	1168	3186	2
2	3	2	0	3	3187	0
2	11	2	61	72	3188	1
2	0	2	4	4	3189	2
2	0	2	0	0	3190	2
2	3	2	7	10	3191	0
2	0	2	4	4	3192	2
2	0	2	0	0	3193	2
2	1	2	2	3	3194	1
2	0	2	0	0	3195	2
2	0	2	0	0	3196	2
2	0	2	3	3	3197	2
2	95	2	1	96	3198	0
2	0	2	0	0	3199	2
2	1	2	0	1	3200	1
2	0	2	0	0	3201	2
2	0	2	0	0	3202	2
2	0	2	0	0	3203	2
2	0	2	0	0	3204	2
2	2	2	1826	1828	3205	1
2	0	2	11	11	3206	2
2	0	2	2	2	3207	2
2	21	2	6	27	3208	0
2	1	2	272	273	3209	0
2	0	2	0	0	3210	2
2	0	2	0	0	3211	2
2	0	2	0	0	3212	2
2	0	2	0	0	3213	2
2	2	2	15	17	3214	1
2	0	2	0	0	3215	2
2	0	2	0	0	3216	2
2	0	2	1	1	3217	2
2	0	2	2	2	3218	2
2	0	2	0	0	3219	2
2	0	2	0	0	3220	2
2	0	2	0	0	3221	2
2	0	2	0	0	3222	2
2	0	2	0	0	3223	2
2	0	2	0	0	3224	2
2	0	2	0	0	3225	2
2	0	2	0	0	3226	2
2	0	2	0	0	3227	2
2	0	2	0	0	3228	2
2	0	2	0	0	3229	2
2	0	2	0	0	3230	2
4	0	4	0	0	3231	2
2	0	2	0	0	3232	2
2	4	4	1686	1690	3233	1
2	0	2	1	1	3234	2
2	0	2	0	0	3235	2
2	0	4	626	626	3236	2
2	0	2	2	2	3237	2
2	0	2	7	7	3238	2
0	1	4	0	1	3239	1
2	0	2	0	0	3240	2
2	0	2	0	0	3241	2
2	0	2	0	0	3242	2
2	0	2	0	0	3243	2
2	0	2	0	0	3244	2
2	0	2	0	0	3245	2
2	0	2	0	0	3246	2
2	0	4	4	4	3247	2
2	0	2	0	0	3248	2
2	0	2	0	0	3249	2
2	0	4	2	2	3250	2
2	0	2	1	1	3251	2
4	0	2	0	0	3252	2
0	0	4	4	4	3253	2
0	0	4	14	14	3254	2
2	10	2	0	10	3255	0
2	4	4	0	4	3256	1
2	0	2	6	6	3257	2
2	2	4	507	509	3258	1
2	0	2	2	2	3259	2
2	0	2	0	0	3260	2
0	0	4	2	2	3261	2
2	0	2	0	0	3262	2
2	0	2	0	0	3263	2
2	0	2	0	0	3264	2
2	0	2	0	0	3265	2
2	0	2	0	0	3266	2
2	0	2	0	0	3267	2
2	0	2	0	0	3268	2
2	10	2	86	96	3269	1
2	0	2	1	1	3270	2
2	0	2	0	0	3271	2
2	0	2	0	0	3272	2
2	0	2	15	15	3273	2
2	0	2	0	0	3274	2
2	0	2	0	0	3275	2
2	0	2	0	0	3276	2
2	0	2	0	0	3277	2
2	0	2	0	0	3278	2
2	0	2	0	0	3279	2
2	0	2	0	0	3280	2
2	0	2	0	0	3281	2
2	0	2	0	0	3282	2
2	0	2	0	0	3283	2
2	0	2	0	0	3284	2
2	0	2	0	0	3285	2
2	0	2	0	0	3286	2
2	0	2	0	0	3287	2
2	0	2	0	0	3288	2
2	0	2	0	0	3289	2
2	0	2	0	0	3290	2
2	0	2	0	0	3291	2
2	0	2	0	0	3292	2
2	0	2	0	0	3293	2
2	0	2	0	0	3294	2
2	0	2	2	2	3295	2
2	0	2	0	0	3296	2
2	0	2	0	0	3297	2
2	0	2	0	0	3298	2
2	0	2	0	0	3299	2
2	0	2	0	0	3300	2
2	0	2	0	0	3301	2
2	0	2	0	0	3302	2
2	0	2	0	0	3303	2
2	0	2	0	0	3304	2
2	0	2	0	0	3305	2
2	0	2	0	0	3306	2
2	0	2	0	0	3307	2
2	0	2	0	0	3308	2
2	0	2	0	0	3309	2
2	0	2	0	0	3310	2
2	0	2	0	0	3311	2
2	0	2	0	0	3312	2
2	0	2	0	0	3313	2
2	0	2	0	0	3314	2
2	0	2	0	0	3315	2
2	0	2	0	0	3316	2
2	0	2	0	0	3317	2
2	0	2	0	0	3318	2
2	0	2	0	0	3319	2
2	0	2	0	0	3320	2
2	0	2	0	0	3321	2
2	0	2	0	0	3322	2
2	0	2	0	0	3323	2
2	0	2	0	0	3324	2
2	0	2	0	0	3325	2
2	0	2	0	0	3326	2
2	0	2	0	0	3327	2
0	0	4	3	3	3328	2
4	252	4	15	267	3329	0
4	1	0	0	1	3330	1
2	8	4	26	34	3331	0
2	0	2	30	30	3332	2
4	0	4	71	71	3333	2
4	5	4	35	40	3334	0
2	0	2	0	0	3335	2
2	0	2	12	12	3336	2
2	0	2	0	0	3337	2
2	0	2	0	0	3338	2
2	0	2	0	0	3339	2
2	0	2	0	0	3340	2
2	39	2	0	39	3341	0
2	2	2	2259	2261	3342	1
2	1	2	10	11	3343	1
2	0	2	0	0	3344	2
2	4	2	96	100	3345	0
2	0	2	0	0	3346	2
2	0	2	0	0	3347	2
2	0	2	0	0	3348	2
2	0	2	0	0	3349	2
2	0	2	0	0	3350	2
2	0	2	0	0	3351	2
2	0	2	0	0	3352	2
2	0	2	0	0	3353	2
2	0	2	0	0	3354	2
2	0	2	0	0	3355	2
2	0	2	0	0	3356	2
2	0	2	0	0	3357	2
2	0	2	0	0	3358	2
2	14	2	0	14	3359	0
2	0	2	1	1	3360	2
2	0	2	0	0	3361	2
2	1	4	14	15	3362	1
2	0	2	0	0	3363	2
2	0	2	0	0	3364	2
2	0	4	0	0	3365	2
2	0	2	0	0	3366	2
2	10	2	0	10	3367	0
2	6	4	1477	1483	3368	1
2	0	2	2	2	3369	2
2	0	2	0	0	3370	2
2	3	4	289	292	3371	0
2	0	2	8	8	3372	2
2	0	2	0	0	3373	2
2	0	2	0	0	3374	2
2	0	2	0	0	3375	2
2	0	2	1	1	3376	2
2	0	2	0	0	3377	2
2	0	2	0	0	3378	2
2	0	2	0	0	3379	2
2	0	2	0	0	3380	2
2	0	2	0	0	3381	2
2	0	2	0	0	3382	2
2	0	2	0	0	3383	2
2	0	2	0	0	3384	2
2	0	2	0	0	3385	2
2	0	2	0	0	3386	2
2	0	2	0	0	3387	2
2	0	2	0	0	3388	2
2	0	2	0	0	3389	2
2	0	2	0	0	3390	2
2	0	2	0	0	3391	2
2	0	2	0	0	3392	2
2	0	2	0	0	3393	2
2	0	2	0	0	3394	2
2	0	2	0	0	3395	2
2	0	2	0	0	3396	2
2	0	2	0	0	3397	2
2	0	2	0	0	3398	2
2	0	2	0	0	3399	2
2	0	2	0	0	3400	2
2	0	2	0	0	3401	2
2	0	2	0	0	3402	2
0	0	4	7	7	3403	2
4	0	2	0	0	3404	2
4	0	2	0	0	3405	2
2	0	2	0	0	3406	2
2	0	2	0	0	3407	2
2	0	2	0	0	3408	2
2	0	2	0	0	3409	2
2	0	2	0	0	3410	2
2	0	2	9	9	3411	2
2	0	2	0	0	3412	2
2	1	2	0	1	3413	0
2	4	2	173	177	3414	0
2	0	2	0	0	3415	2
2	0	2	0	0	3416	2
2	1	2	200	201	3417	0
2	0	2	2	2	3418	2
2	20	2	0	20	3419	0
2	10	2	546	556	3420	1
2	0	2	5	5	3421	2
2	0	2	3	3	3422	2
0	5677	2	21	5698	3423	0
0	463	2	2	465	3424	0
2	8	2	26	34	3425	0
2	0	2	37	37	3426	2
2	20	2	1	21	3427	0
2	10	2	443	453	3428	1
2	0	2	1	1	3429	2
2	0	2	0	0	3430	2
2	1	2	0	1	3431	0
2	0	2	6	6	3432	2
2	32	2	43	75	3433	1
2	0	2	0	0	3434	2
2	0	2	0	0	3435	2
0	196	2	1	197	3436	0
2	0	2	99	99	3437	2
0	0	2	1	1	3438	2
2	3	2	9	12	3439	0
2	0	2	4	4	3440	2
2	0	2	0	0	3441	2
2	0	4	0	0	3442	2
2	0	2	0	0	3443	2
2	0	2	0	0	3444	2
2	0	4	0	0	3445	2
2	0	2	0	0	3446	2
2	0	2	0	0	3447	2
2	0	2	0	0	3448	2
2	0	2	0	0	3449	2
2	0	2	0	0	3450	2
2	0	2	0	0	3451	2
2	0	2	0	0	3452	2
2	0	2	0	0	3453	2
2	17	2	0	17	3454	0
2	0	2	0	0	3455	2
2	0	2	0	0	3456	2
2	0	2	0	0	3457	2
2	0	2	0	0	3458	2
2	0	2	0	0	3459	2
2	0	2	0	0	3460	2
2	9	2	2	11	3461	0
2	0	2	15	15	3462	2
2	20	2	92	112	3463	1
2	0	2	0	0	3464	2
2	0	2	0	0	3465	2
2	0	2	0	0	3466	2
2	0	2	0	0	3467	2
2	0	2	0	0	3468	2
2	0	2	0	0	3469	2
2	0	2	0	0	3470	2
2	0	2	0	0	3471	2
2	0	2	0	0	3472	2
2	0	2	1	1	3473	2
2	0	2	0	0	3474	2
2	0	2	0	0	3475	2
2	0	2	0	0	3476	2
2	0	2	0	0	3477	2
2	0	2	0	0	3478	2
2	0	2	0	0	3479	2
2	0	2	0	0	3480	2
2	0	2	0	0	3481	2
2	0	2	0	0	3482	2
2	0	2	0	0	3483	2
2	0	2	0	0	3484	2
2	0	2	0	0	3485	2
2	0	4	0	0	3486	2
2	0	2	0	0	3487	2
2	0	2	0	0	3488	2
2	0	4	0	0	3489	2
2	0	2	0	0	3490	2
2	0	2	0	0	3491	2
2	0	2	4	4	3492	2
2	0	2	0	0	3493	2
2	0	2	0	0	3494	2
2	0	2	0	0	3495	2
2	0	2	0	0	3496	2
2	0	2	0	0	3497	2
2	5	2	0	5	3498	0
2	0	2	2	2	3499	2
2	0	2	0	0	3500	2
2	0	2	0	0	3501	2
2	0	2	0	0	3502	2
2	0	2	0	0	3503	2
2	0	2	1	1	3504	2
2	0	2	0	0	3505	2
2	1	2	0	1	3506	1
2	6	2	1	7	3507	0
2	0	2	21	21	3508	2
2	29	2	0	29	3509	0
2	1	2	54	55	3510	1
2	0	2	3	3	3511	2
2	0	2	0	0	3512	2
2	0	2	0	0	3513	2
2	0	2	0	0	3514	2
2	0	2	0	0	3515	2
2	0	2	0	0	3516	2
2	0	2	0	0	3517	2
2	0	2	1	1	3518	2
2	72	2	0	72	3519	0
2	41	2	445	486	3520	1
2	0	2	14	14	3521	2
2	0	2	5	5	3522	2
2	50	2	0	50	3523	1
2	0	2	208	208	3524	2
2	0	2	0	0	3525	2
2	0	2	0	0	3526	2
2	0	2	0	0	3527	2
2	0	2	0	0	3528	2
2	0	2	0	0	3529	2
2	0	2	0	0	3530	2
2	0	2	0	0	3531	2
2	0	2	0	0	3532	2
2	33	2	10	43	3533	1
2	0	2	0	0	3534	2
2	0	2	0	0	3535	2
2	1	2	0	1	3536	0
2	0	2	0	0	3537	2
2	0	2	3	3	3538	2
2	0	2	0	0	3539	2
2	0	2	0	0	3540	2
2	0	2	0	0	3541	2
2	0	2	0	0	3542	2
4	0	2	1	1	3543	2
2	0	2	0	0	3544	2
2	0	2	0	0	3545	2
2	0	2	0	0	3546	2
2	0	2	0	0	3547	2
2	0	2	0	0	3548	2
2	0	2	0	0	3549	2
2	0	2	0	0	3550	2
2	0	2	4	4	3551	2
2	0	2	0	0	3552	2
2	0	2	0	0	3553	2
2	0	2	1	1	3554	2
2	0	2	1	1	3555	2
2	0	2	0	0	3556	2
2	0	2	0	0	3557	2
2	0	2	0	0	3558	2
2	0	2	0	0	3559	2
2	0	2	0	0	3560	2
2	0	2	0	0	3561	2
2	0	2	0	0	3562	2
2	0	2	0	0	3563	2
2	0	2	0	0	3564	2
2	0	2	0	0	3565	2
2	0	2	0	0	3566	2
2	0	2	0	0	3567	2
2	7	2	1	8	3568	0
2	0	2	4	4	3569	2
2	5	2	0	5	3570	0
2	18	2	248	266	3571	1
2	0	2	0	0	3572	2
2	0	2	0	0	3573	2
2	0	2	0	0	3574	2
2	0	2	0	0	3575	2
2	0	2	0	0	3576	2
2	0	2	0	0	3577	2
2	0	2	0	0	3578	2
2	0	2	0	0	3579	2
2	1	2	0	1	3580	0
2	31	2	0	31	3581	0
2	14	2	414	428	3582	1
2	0	2	11	11	3583	2
2	0	2	1	1	3584	2
2	18	2	6	24	3585	0
2	0	2	85	85	3586	2
2	0	2	3	3	3587	2
2	0	2	0	0	3588	2
2	0	2	0	0	3589	2
2	0	2	0	0	3590	2
2	0	2	0	0	3591	2
6	40	4	606	646	3592	0
6	2	4	606	608	3593	1
2	0	2	0	0	3594	2
2	0	2	0	0	3595	2
2	0	2	0	0	3596	2
2	0	2	0	0	3597	2
2	0	2	0	0	3598	2
2	0	2	0	0	3599	2
2	0	2	0	0	3600	2
2	0	2	0	0	3601	2
2	0	2	0	0	3602	2
2	0	2	0	0	3603	2
2	0	2	0	0	3604	2
2	0	2	0	0	3605	2
2	0	2	0	0	3606	2
2	0	4	74	74	3607	2
2	0	2	0	0	3608	2
2	0	2	0	0	3609	2
2	0	4	43	43	3610	2
2	0	2	0	0	3611	2
4	4	2	0	4	3612	0
6	0	6	2	2	3613	2
2	0	2	0	0	3614	2
2	0	4	2	2	3615	2
2	0	2	0	0	3616	2
2	0	2	0	0	3617	2
2	0	4	2	2	3618	2
2	0	2	0	0	3619	2
0	0	4	15	15	3620	2
2	0	2	0	0	3621	2
2	0	2	0	0	3622	2
2	0	2	0	0	3623	2
2	0	2	0	0	3624	2
2	0	2	0	0	3625	2
2	0	2	0	0	3626	2
2	0	2	0	0	3627	2
2	0	2	0	0	3628	2
2	0	2	0	0	3629	2
2	0	2	0	0	3630	2
2	0	2	0	0	3631	2
2	0	2	0	0	3632	2
2	26	2	0	26	3633	0
2	0	2	0	0	3634	2
2	0	2	0	0	3635	2
2	0	2	0	0	3636	2
2	0	2	0	0	3637	2
2	16	2	0	16	3638	0
2	2	0	225	227	3639	1
2	0	2	1	1	3640	2
2	0	2	1	1	3641	2
4	1	2	6	7	3642	0
4	0	2	0	0	3643	2
2	0	0	43	43	3644	2
2	0	2	3	3	3645	2
2	0	2	0	0	3646	2
2	0	2	0	0	3647	2
2	0	2	0	0	3648	2
2	0	2	0	0	3649	2
2	0	2	0	0	3650	2
2	0	2	0	0	3651	2
2	0	2	0	0	3652	2
2	0	2	0	0	3653	2
2	8	4	207	215	3654	1
2	0	2	1	1	3655	2
2	0	2	0	0	3656	2
2	7	4	0	7	3657	0
2	0	2	39	39	3658	2
4	0	2	2	2	3659	2
0	0	4	7	7	3660	2
2	0	2	0	0	3661	2
2	0	2	0	0	3662	2
2	0	2	0	0	3663	2
2	0	2	0	0	3664	2
2	0	2	0	0	3665	2
2	0	2	0	0	3666	2
2	0	2	0	0	3667	2
2	0	0	12	12	3668	2
2	0	2	0	0	3669	2
2	0	2	0	0	3670	2
2	0	0	2	2	3671	2
2	0	2	0	0	3672	2
0	0	4	2498	2498	3673	2
2	0	2	0	0	3674	2
2	0	2	0	0	3675	2
2	0	2	0	0	3676	2
2	0	2	0	0	3677	2
2	0	2	0	0	3678	2
2	0	2	0	0	3679	2
2	0	2	0	0	3680	2
2	0	2	0	0	3681	2
2	0	2	0	0	3682	2
2	0	2	0	0	3683	2
2	0	2	0	0	3684	2
2	0	2	0	0	3685	2
2	0	2	0	0	3686	2
2	0	2	0	0	3687	2
2	0	2	0	0	3688	2
2	0	2	0	0	3689	2
2	0	2	0	0	3690	2
2	0	2	0	0	3691	2
2	0	2	0	0	3692	2
2	1	2	0	1	3693	1
2	0	2	0	0	3694	2
2	0	2	0	0	3695	2
2	0	2	0	0	3696	2
2	0	2	1	1	3697	2
2	0	2	0	0	3698	2
2	0	2	0	0	3699	2
2	0	4	30	30	3700	2
2	0	2	0	0	3701	2
2	0	2	0	0	3702	2
2	0	4	18	18	3703	2
2	0	2	0	0	3704	2
2	2	2	0	2	3705	0
2	0	2	0	0	3706	2
2	0	2	0	0	3707	2
2	0	2	0	0	3708	2
2	0	2	0	0	3709	2
2	0	2	0	0	3710	2
2	0	2	0	0	3711	2
2	2	2	0	2	3712	1
2	0	2	12	12	3713	2
2	12	2	144	156	3714	1
2	0	2	0	0	3715	2
2	0	2	0	0	3716	2
2	0	2	0	0	3717	2
2	0	2	0	0	3718	2
2	0	2	0	0	3719	2
2	0	2	0	0	3720	2
2	0	2	0	0	3721	2
2	0	2	0	0	3722	2
2	0	2	0	0	3723	2
2	0	2	0	0	3724	2
2	0	2	0	0	3725	2
2	0	2	0	0	3726	2
2	1	2	0	1	3727	1
2	0	2	0	0	3728	2
4	0	4	0	0	3729	2
4	0	4	0	0	3730	2
2	0	2	0	0	3731	2
2	0	2	0	0	3732	2
2	0	2	0	0	3733	2
2	0	2	0	0	3734	2
2	0	2	0	0	3735	2
2	0	2	0	0	3736	2
2	0	2	0	0	3737	2
2	0	2	3	3	3738	2
2	0	2	0	0	3739	2
2	0	2	0	0	3740	2
2	0	2	0	0	3741	2
2	0	2	0	0	3742	2
2	0	2	0	0	3743	2
2	0	2	0	0	3744	2
2	0	2	0	0	3745	2
2	39	4	1245	1284	3746	0
4	0	4	0	0	3747	2
2	0	2	0	0	3748	2
2	0	2	0	0	3749	2
2	0	2	0	0	3750	2
2	0	2	0	0	3751	2
2	0	2	0	0	3752	2
2	0	2	0	0	3753	2
2	0	2	0	0	3754	2
2	0	2	0	0	3755	2
2	13	2	0	13	3756	0
2	0	2	0	0	3757	2
2	0	2	0	0	3758	2
2	0	2	0	0	3759	2
2	0	2	0	0	3760	2
2	0	2	0	0	3761	2
2	0	2	0	0	3762	2
2	19	7	584	603	3763	1
2	0	2	2	2	3764	2
2	0	2	0	0	3765	2
4	114	2	9	123	3766	0
4	10	2	1	11	3767	0
4	313	4	67	380	3768	0
2	0	2	5	5	3769	2
4	7	4	67	74	3770	1
0	1	2	4	5	3771	1
4	2	2	7	9	3772	0
2	0	2	0	0	3773	2
2	0	2	0	0	3774	2
2	22	2	1	23	3775	0
2	0	2	0	0	3776	2
2	0	2	0	0	3777	2
2	0	2	0	0	3778	2
2	5	2	34	39	3779	0
2	0	2	46	46	3780	2
2	17	2	1298	1315	3781	1
2	0	2	6	6	3782	2
2	0	2	0	0	3783	2
2	1	2	0	1	3784	0
2	0	2	4	4	3785	2
2	0	2	0	0	3786	2
2	0	2	0	0	3787	2
2	1	2	0	1	3788	1
2	0	2	6	6	3789	2
2	0	2	0	0	3790	2
2	0	2	0	0	3791	2
2	0	2	0	0	3792	2
2	0	2	0	0	3793	2
2	0	2	0	0	3794	2
2	0	2	0	0	3795	2
2	0	2	0	0	3796	2
2	0	4	127	127	3797	2
2	0	2	0	0	3798	2
2	0	2	0	0	3799	2
2	0	4	38	38	3800	2
2	0	2	0	0	3801	2
2	0	2	0	0	3802	2
2	0	2	1	1	3803	2
2	0	2	0	0	3804	2
2	0	2	0	0	3805	2
2	0	2	0	0	3806	2
2	0	2	0	0	3807	2
2	0	2	0	0	3808	2
2	0	2	0	0	3809	2
2	0	2	0	0	3810	2
2	0	2	0	0	3811	2
2	0	2	0	0	3812	2
2	0	2	0	0	3813	2
2	0	2	0	0	3814	2
2	0	2	0	0	3815	2
2	0	2	0	0	3816	2
2	0	2	1	1	3817	2
2	0	2	0	0	3818	2
2	0	2	0	0	3819	2
2	0	2	0	0	3820	2
2	0	2	0	0	3821	2
2	0	2	0	0	3822	2
2	0	2	0	0	3823	2
2	0	2	0	0	3824	2
2	0	2	0	0	3825	2
2	0	2	0	0	3826	2
2	0	2	0	0	3827	2
2	0	2	0	0	3828	2
2	0	2	0	0	3829	2
2	0	2	3	3	3830	2
2	0	2	0	0	3831	2
2	0	2	0	0	3832	2
2	0	2	0	0	3833	2
2	0	2	0	0	3834	2
2	0	2	0	0	3835	2
2	0	2	0	0	3836	2
2	0	2	0	0	3837	2
2	0	2	0	0	3838	2
2	0	2	0	0	3839	2
2	0	2	0	0	3840	2
2	0	2	0	0	3841	2
2	0	2	0	0	3842	2
2	0	2	0	0	3843	2
2	0	2	0	0	3844	2
2	0	2	0	0	3845	2
2	0	2	0	0	3846	2
2	0	2	0	0	3847	2
2	0	2	0	0	3848	2
2	0	2	1	1	3849	2
2	0	2	0	0	3850	2
2	0	2	0	0	3851	2
2	1	2	0	1	3852	0
2	0	2	0	0	3853	2
2	0	2	0	0	3854	2
2	0	2	0	0	3855	2
2	0	2	0	0	3856	2
2	0	2	0	0	3857	2
2	0	2	0	0	3858	2
2	0	2	0	0	3859	2
2	0	2	0	0	3860	2
2	0	2	0	0	3861	2
2	0	2	0	0	3862	2
2	0	2	0	0	3863	2
2	0	2	0	0	3864	2
2	0	2	0	0	3865	2
2	0	2	0	0	3866	2
2	0	2	0	0	3867	2
2	0	2	0	0	3868	2
2	0	2	0	0	3869	2
2	0	2	0	0	3870	2
2	0	0	64	64	3871	2
2	0	2	1	1	3872	2
2	0	0	194	194	3873	2
2	0	2	0	0	3874	2
2	0	2	0	0	3875	2
2	0	2	0	0	3876	2
2	0	4	0	0	3877	2
2	0	2	0	0	3878	2
2	0	2	0	0	3879	2
2	0	4	0	0	3880	2
2	0	2	0	0	3881	2
2	0	2	0	0	3882	2
2	0	2	0	0	3883	2
2	0	2	0	0	3884	2
2	0	2	0	0	3885	2
2	0	2	0	0	3886	2
2	0	2	0	0	3887	2
2	0	2	0	0	3888	2
2	0	2	0	0	3889	2
2	0	4	2	2	3890	2
2	0	2	0	0	3891	2
2	0	2	0	0	3892	2
2	0	4	10	10	3893	2
2	0	2	1	1	3894	2
2	0	2	0	0	3895	2
2	0	2	0	0	3896	2
2	0	2	0	0	3897	2
2	0	2	0	0	3898	2
2	0	2	1	1	3899	2
2	0	2	0	0	3900	2
2	0	2	0	0	3901	2
2	0	2	0	0	3902	2
2	0	2	0	0	3903	2
2	1	4	39	40	3904	1
2	0	2	0	0	3905	2
2	0	2	0	0	3906	2
2	0	2	2	2	3907	2
2	1	2	0	1	3908	1
2	0	2	1	1	3909	2
2	0	2	0	0	3910	2
2	3	2	4	7	3911	1
2	0	2	0	0	3912	2
2	0	2	0	0	3913	2
2	0	2	0	0	3914	2
2	0	2	0	0	3915	2
2	0	2	0	0	3916	2
2	0	2	0	0	3917	2
2	0	2	0	0	3918	2
2	0	2	0	0	3919	2
2	0	2	0	0	3920	2
2	0	2	0	0	3921	2
2	0	2	0	0	3922	2
2	0	2	0	0	3923	2
2	0	2	0	0	3924	2
2	0	2	0	0	3925	2
2	0	2	0	0	3926	2
2	0	2	0	0	3927	2
2	0	2	0	0	3928	2
2	0	2	0	0	3929	2
2	0	2	0	0	3930	2
2	0	2	0	0	3931	2
2	0	2	0	0	3932	2
2	0	2	26	26	3933	2
2	0	2	0	0	3934	2
2	0	2	0	0	3935	2
2	0	2	1	1	3936	2
2	0	2	2	2	3937	2
2	0	2	0	0	3938	2
2	2	2	13	15	3939	1
2	0	2	0	0	3940	2
2	0	2	0	0	3941	2
2	0	2	1	1	3942	2
2	0	2	17	17	3943	2
4	0	0	230	230	3944	2
4	0	0	90	90	3945	2
2	0	2	0	0	3946	2
2	0	2	4	4	3947	2
2	0	2	0	0	3948	2
2	0	2	0	0	3949	2
2	0	2	2	2	3950	2
2	0	2	0	0	3951	2
4	0	4	0	0	3952	2
2	0	2	0	0	3953	2
2	0	2	0	0	3954	2
2	0	2	0	0	3955	2
2	0	2	0	0	3956	2
2	0	2	0	0	3957	2
2	0	2	0	0	3958	2
2	0	2	0	0	3959	2
2	0	2	1	1	3960	2
2	0	2	0	0	3961	2
2	0	2	0	0	3962	2
2	0	2	0	0	3963	2
2	0	2	0	0	3964	2
4	1	4	4	5	3965	1
2	0	2	0	0	3966	2
2	0	2	2	2	3967	2
2	0	2	0	0	3968	2
2	0	2	0	0	3969	2
2	0	2	0	0	3970	2
2	0	2	1	1	3971	2
2	24	4	2652	2676	3972	1
2	0	2	65	65	3973	2
2	19	2	0	19	3974	0
2	41	4	6951	6992	3975	1
2	0	2	2	2	3976	2
2	0	2	0	0	3977	2
2	0	2	0	0	3978	2
2	0	2	1	1	3979	2
2	0	2	0	0	3980	2
2	0	2	0	0	3981	2
2	0	2	0	0	3982	2
2	0	2	1	1	3983	2
2	0	2	0	0	3984	2
2	0	2	0	0	3985	2
2	0	2	1	1	3986	2
2	0	2	0	0	3987	2
2	0	2	0	0	3988	2
2	1	2	0	1	3989	1
2	0	2	0	0	3990	2
2	0	2	1	1	3991	2
2	0	2	0	0	3992	2
2	0	2	0	0	3993	2
2	0	2	0	0	3994	2
2	0	2	0	0	3995	2
4	0	4	0	0	3996	2
4	0	4	0	0	3997	2
4	0	4	0	0	3998	2
4	0	4	0	0	3999	2
2	1	2	0	1	4000	1
2	3	4	60	63	4001	0
2	0	2	0	0	4002	2
2	0	2	0	0	4003	2
2	1	4	19	20	4004	1
2	0	2	0	0	4005	2
2	0	2	0	0	4006	2
2	0	2	0	0	4007	2
2	0	2	0	0	4008	2
2	0	2	0	0	4009	2
2	0	2	0	0	4010	2
2	0	2	0	0	4011	2
2	0	2	0	0	4012	2
2	0	0	204	204	4013	2
2	0	2	0	0	4014	2
2	0	0	991	991	4015	2
2	0	2	0	0	4016	2
2	0	2	0	0	4017	2
2	2	4	0	2	4018	1
2	0	2	0	0	4019	2
2	0	2	0	0	4020	2
2	0	4	1	1	4021	2
2	0	2	0	0	4022	2
2	0	2	0	0	4023	2
2	0	2	0	0	4024	2
2	0	2	1	1	4025	2
2	0	2	0	0	4026	2
2	0	2	0	0	4027	2
2	0	2	0	0	4028	2
2	0	2	0	0	4029	2
2	0	2	0	0	4030	2
2	0	2	0	0	4031	2
2	0	2	0	0	4032	2
2	0	2	0	0	4033	2
2	0	2	0	0	4034	2
2	0	2	0	0	4035	2
2	0	2	0	0	4036	2
2	0	4	802	802	4037	2
2	0	2	0	0	4038	2
2	0	2	0	0	4039	2
2	1	4	14	15	4040	1
2	0	2	0	0	4041	2
2	0	2	0	0	4042	2
2	0	2	0	0	4043	2
2	0	2	0	0	4044	2
2	0	2	0	0	4045	2
2	0	2	0	0	4046	2
2	0	2	0	0	4047	2
2	0	2	0	0	4048	2
2	0	2	0	0	4049	2
2	0	2	0	0	4050	2
2	0	2	0	0	4051	2
2	0	2	0	0	4052	2
2	0	2	0	0	4053	2
2	0	2	0	0	4054	2
2	0	2	0	0	4055	2
2	0	2	0	0	4056	2
2	0	2	0	0	4057	2
2	0	2	0	0	4058	2
2	0	2	0	0	4059	2
2	0	2	0	0	4060	2
2	0	2	0	0	4061	2
2	0	2	0	0	4062	2
2	0	2	0	0	4063	2
2	0	2	0	0	4064	2
2	0	2	0	0	4065	2
2	0	2	0	0	4066	2
2	0	2	9	9	4067	2
2	0	2	0	0	4068	2
2	0	2	0	0	4069	2
2	0	2	1	1	4070	2
2	0	2	0	0	4071	2
2	0	2	0	0	4072	2
2	0	2	0	0	4073	2
2	0	2	0	0	4074	2
2	0	2	0	0	4075	2
2	0	2	0	0	4076	2
2	0	2	0	0	4077	2
2	0	2	0	0	4078	2
2	0	2	0	0	4079	2
2	0	2	0	0	4080	2
2	0	2	0	0	4081	2
2	0	2	0	0	4082	2
2	0	2	0	0	4083	2
2	0	2	0	0	4084	2
2	0	2	2	2	4085	2
2	0	2	0	0	4086	2
2	0	2	1	1	4087	2
2	0	2	0	0	4088	2
2	0	2	0	0	4089	2
2	0	2	0	0	4090	2
2	0	2	0	0	4091	2
2	2	2	0	2	4092	0
2	0	2	6	6	4093	2
2	0	2	0	0	4094	2
2	0	2	0	0	4095	2
2	0	2	0	0	4096	2
2	0	2	5	5	4097	2
2	0	2	0	0	4098	2
2	0	2	0	0	4099	2
2	0	2	0	0	4100	2
2	0	2	0	0	4101	2
2	0	2	0	0	4102	2
2	0	2	0	0	4103	2
2	0	2	0	0	4104	2
2	0	2	0	0	4105	2
2	0	2	0	0	4106	2
2	0	2	0	0	4107	2
2	0	2	0	0	4108	2
2	0	2	0	0	4109	2
2	0	2	0	0	4110	2
2	0	2	0	0	4111	2
2	0	2	0	0	4112	2
2	0	2	0	0	4113	2
2	0	2	0	0	4114	2
2	0	2	0	0	4115	2
2	0	2	0	0	4116	2
2	0	2	0	0	4117	2
2	0	2	0	0	4118	2
2	0	2	0	0	4119	2
2	0	2	0	0	4120	2
2	0	2	0	0	4121	2
2	0	2	0	0	4122	2
2	0	2	0	0	4123	2
2	0	2	0	0	4124	2
2	0	2	0	0	4125	2
2	0	2	0	0	4126	2
2	0	2	0	0	4127	2
2	0	2	0	0	4128	2
2	0	2	0	0	4129	2
2	0	2	0	0	4130	2
2	0	2	0	0	4131	2
2	0	2	0	0	4132	2
2	0	2	0	0	4133	2
2	0	2	0	0	4134	2
2	0	2	0	0	4135	2
2	0	2	6	6	4136	2
2	0	2	0	0	4137	2
2	0	2	0	0	4138	2
2	0	2	0	0	4139	2
2	0	2	0	0	4140	2
2	0	2	0	0	4141	2
2	0	2	0	0	4142	2
2	0	2	0	0	4143	2
2	0	2	0	0	4144	2
2	0	2	0	0	4145	2
2	0	2	0	0	4146	2
2	0	2	0	0	4147	2
2	0	2	0	0	4148	2
2	1	2	0	1	4149	0
2	0	2	5	5	4150	2
2	0	2	0	0	4151	2
2	0	2	0	0	4152	2
2	0	2	0	0	4153	2
2	0	2	0	0	4154	2
2	0	2	0	0	4155	2
2	0	2	0	0	4156	2
2	0	2	0	0	4157	2
2	0	2	0	0	4158	2
2	0	2	0	0	4159	2
2	0	2	0	0	4160	2
2	0	2	0	0	4161	2
2	0	2	0	0	4162	2
2	0	2	2	2	4163	2
2	0	2	0	0	4164	2
2	0	2	0	0	4165	2
2	0	2	19	19	4166	2
2	0	2	2	2	4167	2
2	0	2	0	0	4168	2
2	0	2	0	0	4169	2
2	1	2	1	2	4170	1
2	0	2	0	0	4171	2
2	0	2	0	0	4172	2
2	0	2	0	0	4173	2
2	0	2	0	0	4174	2
2	0	2	0	0	4175	2
2	0	2	0	0	4176	2
2	0	2	0	0	4177	2
2	0	2	0	0	4178	2
2	0	2	0	0	4179	2
2	0	2	0	0	4180	2
2	1	2	0	1	4181	0
2	0	2	37	37	4182	2
2	0	2	1	1	4183	2
2	0	2	0	0	4184	2
2	0	2	4	4	4185	2
2	0	2	14	14	4186	2
2	0	2	0	0	4187	2
2	0	2	0	0	4188	2
2	0	2	0	0	4189	2
2	0	2	0	0	4190	2
2	0	2	0	0	4191	2
2	0	2	0	0	4192	2
2	224	2	1	225	4193	0
2	6	2	0	6	4194	0
2	0	2	45	45	4195	2
2	0	2	1	1	4196	2
2	0	2	0	0	4197	2
2	0	2	0	0	4198	2
2	0	2	2	2	4199	2
2	57	2	935	992	4200	1
2	1	2	19	20	4201	1
2	0	2	0	0	4202	2
2	87	2	6	93	4203	0
2	0	2	0	0	4204	2
2	0	2	0	0	4205	2
2	0	2	2	2	4206	2
2	0	2	0	0	4207	2
2	0	2	0	0	4208	2
2	0	2	0	0	4209	2
2	0	2	0	0	4210	2
2	1	2	0	1	4211	0
2	1	2	4	5	4212	1
2	0	2	0	0	4213	2
2	0	2	0	0	4214	2
2	1	2	0	1	4215	1
2	0	2	0	0	4216	2
2	0	2	0	0	4217	2
2	0	2	0	0	4218	2
2	0	2	0	0	4219	2
2	0	2	0	0	4220	2
2	0	2	0	0	4221	2
2	0	2	0	0	4222	2
2	0	2	0	0	4223	2
2	0	2	0	0	4224	2
2	0	2	0	0	4225	2
2	0	2	0	0	4226	2
2	0	2	0	0	4227	2
2	0	2	0	0	4228	2
2	0	2	0	0	4229	2
2	0	2	0	0	4230	2
2	0	2	0	0	4231	2
2	0	2	0	0	4232	2
2	0	2	0	0	4233	2
2	0	2	0	0	4234	2
2	0	2	0	0	4235	2
2	0	2	0	0	4236	2
2	0	2	0	0	4237	2
2	0	2	0	0	4238	2
2	0	2	0	0	4239	2
2	0	2	0	0	4240	2
2	0	2	0	0	4241	2
2	0	2	0	0	4242	2
2	0	2	3	3	4243	2
2	0	2	11	11	4244	2
2	0	2	0	0	4245	2
2	0	2	0	0	4246	2
2	0	2	0	0	4247	2
2	0	2	0	0	4248	2
2	0	2	0	0	4249	2
2	0	2	0	0	4250	2
2	0	2	0	0	4251	2
2	0	2	0	0	4252	2
2	0	2	0	0	4253	2
2	0	2	0	0	4254	2
2	0	2	0	0	4255	2
2	0	2	0	0	4256	2
2	0	2	0	0	4257	2
2	0	2	0	0	4258	2
2	0	2	0	0	4259	2
2	0	2	0	0	4260	2
2	0	2	0	0	4261	2
2	0	2	0	0	4262	2
2	0	2	0	0	4263	2
2	0	2	0	0	4264	2
2	0	2	0	0	4265	2
2	0	4	5	5	4266	2
2	0	2	0	0	4267	2
2	0	2	0	0	4268	2
2	0	4	0	0	4269	2
2	0	2	0	0	4270	2
2	0	2	0	0	4271	2
2	0	2	0	0	4272	2
2	0	2	0	0	4273	2
2	0	2	0	0	4274	2
2	0	2	0	0	4275	2
2	0	2	0	0	4276	2
2	0	4	67	67	4277	2
2	0	2	0	0	4278	2
2	0	2	0	0	4279	2
2	0	2	0	0	4280	2
2	0	2	0	0	4281	2
0	4	2	12	16	4282	0
4	0	4	0	0	4283	2
4	0	4	0	0	4284	2
0	0	2	12	12	4285	2
7	78	2	34	112	4286	0
2	7	4	98	105	4287	0
2	1	2	244	245	4288	1
2	0	2	0	0	4289	2
2	0	2	0	0	4290	2
2	0	2	0	0	4291	2
2	0	2	0	0	4292	2
2	0	2	0	0	4293	2
2	0	2	0	0	4294	2
2	152	2	2	154	4295	0
2	19	2	681	700	4296	1
2	0	2	101	101	4297	2
2	0	2	0	0	4298	2
2	40	2	2	42	4299	1
2	0	2	235	235	4300	2
2	0	2	0	0	4301	2
2	0	2	0	0	4302	2
2	0	2	0	0	4303	2
2	0	2	0	0	4304	2
2	0	2	0	0	4305	2
2	0	2	0	0	4306	2
2	0	2	0	0	4307	2
2	0	2	0	0	4308	2
2	0	2	0	0	4309	2
2	0	2	0	0	4310	2
2	0	2	0	0	4311	2
2	0	2	0	0	4312	2
2	0	2	0	0	4313	2
2	0	2	1	1	4314	2
2	0	2	0	0	4315	2
2	0	2	0	0	4316	2
2	0	2	0	0	4317	2
2	0	2	12	12	4318	2
2	0	2	0	0	4319	2
2	0	2	0	0	4320	2
2	0	2	0	0	4321	2
2	0	2	0	0	4322	2
2	0	2	0	0	4323	2
2	0	2	0	0	4324	2
2	0	2	0	0	4325	2
2	0	2	0	0	4326	2
2	0	2	0	0	4327	2
2	0	2	0	0	4328	2
2	0	2	0	0	4329	2
2	0	2	0	0	4330	2
2	2	2	0	2	4331	0
2	4	2	99	103	4332	1
2	0	2	0	0	4333	2
2	0	2	0	0	4334	2
2	0	2	3	3	4335	2
2	0	2	0	0	4336	2
0	0	4	371	371	4337	2
2	0	2	0	0	4338	2
2	0	4	80	80	4339	2
2	0	2	0	0	4340	2
2	0	2	0	0	4341	2
2	0	4	101	101	4342	2
2	0	2	0	0	4343	2
2	0	2	0	0	4344	2
2	0	2	0	0	4345	2
2	0	2	0	0	4346	2
2	0	2	0	0	4347	2
2	0	2	0	0	4348	2
0	0	4	4	4	4349	2
2	0	2	0	0	4350	2
2	0	2	0	0	4351	2
2	0	2	0	0	4352	2
2	0	2	0	0	4353	2
2	0	2	0	0	4354	2
2	0	2	0	0	4355	2
4	0	4	11	11	4356	2
2	0	2	0	0	4357	2
2	0	2	0	0	4358	2
2	0	2	0	0	4359	2
2	0	2	0	0	4360	2
2	0	2	0	0	4361	2
2	0	2	0	0	4362	2
2	0	2	0	0	4363	2
2	0	2	0	0	4364	2
2	0	2	0	0	4365	2
2	0	2	0	0	4366	2
2	0	2	0	0	4367	2
2	0	2	0	0	4368	2
2	0	2	0	0	4369	2
2	0	4	54	54	4370	2
2	0	2	0	0	4371	2
2	0	2	0	0	4372	2
2	0	4	48	48	4373	2
2	0	2	1	1	4374	2
2	0	2	0	0	4375	2
2	0	2	2	2	4376	2
2	0	2	0	0	4377	2
2	0	2	0	0	4378	2
2	0	2	0	0	4379	2
2	0	2	0	0	4380	2
4	90	2	2	92	4381	0
4	1	2	0	1	4382	0
2	0	2	0	0	4383	2
2	0	2	43	43	4384	2
2	0	2	0	0	4385	2
2	0	2	0	0	4386	2
2	0	2	0	0	4387	2
2	0	2	0	0	4388	2
2	0	2	0	0	4389	2
2	0	2	0	0	4390	2
2	0	2	0	0	4391	2
2	0	2	0	0	4392	2
2	0	2	0	0	4393	2
2	0	2	0	0	4394	2
2	0	2	0	0	4395	2
2	0	2	0	0	4396	2
2	0	2	0	0	4397	2
2	0	2	0	0	4398	2
2	0	2	0	0	4399	2
2	0	2	0	0	4400	2
0	54	4	723	777	4401	0
2	0	2	0	0	4402	2
2	0	4	371	371	4403	2
2	0	2	0	0	4404	2
2	0	2	0	0	4405	2
2	0	4	24	24	4406	2
2	0	2	0	0	4407	2
2	0	2	0	0	4408	2
2	0	2	0	0	4409	2
2	0	2	0	0	4410	2
2	0	2	0	0	4411	2
2	0	2	0	0	4412	2
2	0	2	0	0	4413	2
0	0	4	18	18	4414	2
2	0	2	0	0	4415	2
2	0	2	0	0	4416	2
2	0	2	0	0	4417	2
2	0	2	0	0	4418	2
2	0	2	0	0	4419	2
2	0	2	0	0	4420	2
2	0	2	0	0	4421	2
2	0	2	0	0	4422	2
2	0	2	0	0	4423	2
2	0	2	0	0	4424	2
2	0	2	0	0	4425	2
2	0	2	0	0	4426	2
0	3	2	0	3	4427	0
4	8	2	0	8	4428	0
4	1	2	0	1	4429	1
2	0	2	0	0	4430	2
2	0	2	45	45	4431	2
2	0	2	1	1	4432	2
2	0	2	0	0	4433	2
2	0	2	1	1	4434	2
2	0	2	0	0	4435	2
2	0	2	0	0	4436	2
2	2	2	4	6	4437	1
2	0	2	0	0	4438	2
2	0	2	0	0	4439	2
2	1	2	0	1	4440	1
2	0	2	0	0	4441	2
2	0	2	0	0	4442	2
2	0	2	0	0	4443	2
2	0	2	0	0	4444	2
2	0	2	0	0	4445	2
2	0	2	0	0	4446	2
2	0	2	0	0	4447	2
2	96	2	0	96	4448	0
2	18	2	605	623	4449	1
2	0	2	14	14	4450	2
2	0	2	0	0	4451	2
2	19	2	15	34	4452	0
2	0	2	126	126	4453	2
2	3	2	0	3	4454	0
2	2	2	10	12	4455	1
2	0	2	1	1	4456	2
2	0	2	0	0	4457	2
2	0	2	0	0	4458	2
2	0	2	3	3	4459	2
2	0	2	0	0	4460	2
2	0	2	0	0	4461	2
2	0	2	0	0	4462	2
2	0	2	0	0	4463	2
2	0	2	0	0	4464	2
2	0	2	1	1	4465	2
2	2	2	0	2	4466	0
2	0	2	13	13	4467	2
2	0	2	0	0	4468	2
2	0	2	0	0	4469	2
2	0	2	0	0	4470	2
2	0	2	1	1	4471	2
2	8	2	0	8	4472	0
2	5	2	0	5	4473	0
2	12	2	8	20	4474	1
2	0	2	0	0	4475	2
2	0	2	0	0	4476	2
2	6	2	0	6	4477	0
2	0	2	2	2	4478	2
2	10	0	235	245	4479	1
2	0	2	0	0	4480	2
2	0	2	0	0	4481	2
2	1	0	67	68	4482	0
2	0	2	7	7	4483	2
2	0	2	0	0	4484	2
2	0	2	0	0	4485	2
2	0	2	0	0	4486	2
2	0	2	0	0	4487	2
2	0	2	0	0	4488	2
2	0	2	0	0	4489	2
2	32	2	1	33	4490	0
2	281	2	3109	3390	4491	1
2	0	2	30	30	4492	2
2	0	2	2	2	4493	2
2	24	2	20	44	4494	0
2	0	2	31	31	4495	2
2	0	2	0	0	4496	2
2	0	2	7	7	4497	2
2	0	2	0	0	4498	2
2	0	2	0	0	4499	2
2	0	2	0	0	4500	2
2	0	2	0	0	4501	2
2	0	2	0	0	4502	2
2	0	2	1	1	4503	2
2	0	2	0	0	4504	2
2	0	2	0	0	4505	2
2	0	2	0	0	4506	2
2	0	2	0	0	4507	2
2	0	2	0	0	4508	2
2	0	2	0	0	4509	2
2	0	2	0	0	4510	2
2	0	2	0	0	4511	2
2	0	2	0	0	4512	2
2	0	2	0	0	4513	2
2	11	2	0	11	4514	0
2	26	2	92	118	4515	1
2	0	2	2	2	4516	2
2	0	2	2	2	4517	2
2	7	2	0	7	4518	0
2	0	2	9	9	4519	2
2	0	2	0	0	4520	2
2	0	2	0	0	4521	2
2	0	2	0	0	4522	2
2	0	2	0	0	4523	2
2	0	2	0	0	4524	2
2	0	2	0	0	4525	2
2	0	2	0	0	4526	2
2	0	2	0	0	4527	2
2	0	2	0	0	4528	2
2	0	2	0	0	4529	2
2	0	2	0	0	4530	2
2	0	2	0	0	4531	2
2	0	2	2	2	4532	2
2	0	2	0	0	4533	2
2	0	2	0	0	4534	2
2	0	2	0	0	4535	2
2	0	2	0	0	4536	2
2	0	2	0	0	4537	2
2	0	2	0	0	4538	2
2	0	2	0	0	4539	2
2	0	2	2	2	4540	2
2	0	2	0	0	4541	2
2	0	2	0	0	4542	2
2	0	2	0	0	4543	2
2	0	2	0	0	4544	2
2	0	4	55	55	4545	2
2	0	2	0	0	4546	2
2	0	2	0	0	4547	2
2	0	4	74	74	4548	2
2	0	4	103	103	4549	2
2	0	2	0	0	4550	2
2	0	2	0	0	4551	2
2	0	2	0	0	4552	2
2	0	2	0	0	4553	2
2	0	4	0	0	4554	2
2	0	2	0	0	4555	2
2	0	2	0	0	4556	2
2	0	4	0	0	4557	2
2	0	2	0	0	4558	2
0	0	4	2	2	4559	2
2	2	2	0	2	4560	0
2	0	2	60	60	4561	2
2	0	2	1	1	4562	2
2	0	2	0	0	4563	2
2	2	2	0	2	4564	0
2	0	2	20	20	4565	2
2	3	2	0	3	4566	0
2	5	2	103	108	4567	1
2	0	2	2	2	4568	2
2	0	2	0	0	4569	2
2	6	2	0	6	4570	0
2	0	2	21	21	4571	2
2	0	2	0	0	4572	2
2	0	2	0	0	4573	2
2	0	2	0	0	4574	2
2	0	2	0	0	4575	2
2	0	2	0	0	4576	2
2	0	2	0	0	4577	2
2	0	2	0	0	4578	2
2	0	2	1	1	4579	2
2	0	2	0	0	4580	2
2	0	2	0	0	4581	2
2	0	2	0	0	4582	2
2	0	2	0	0	4583	2
4	0	4	0	0	4584	2
4	0	4	0	0	4585	2
4	0	4	7	7	4586	2
4	0	4	7	7	4587	2
2	0	2	0	0	4588	2
2	0	2	97	97	4589	2
2	0	2	0	0	4590	2
2	0	2	0	0	4591	2
2	0	2	0	0	4592	2
2	0	2	5	5	4593	2
4	54	4	0	54	4594	1
4	42	4	0	42	4595	1
2	28	2	1	29	4596	0
2	15	2	227	242	4597	1
2	0	2	1	1	4598	2
2	0	2	0	0	4599	2
2	12	2	0	12	4600	0
2	0	2	60	60	4601	2
2	54	2	6	60	4602	0
2	323	2	627	950	4603	1
2	0	2	11	11	4604	2
2	0	2	0	0	4605	2
2	67	2	2	69	4606	0
2	0	2	1	1	4607	2
2	0	2	0	0	4608	2
2	0	4	1	1	4609	2
2	0	2	0	0	4610	2
2	0	2	0	0	4611	2
2	0	4	0	0	4612	2
2	0	2	0	0	4613	2
2	0	2	0	0	4614	2
2	0	2	0	0	4615	2
2	0	2	0	0	4616	2
2	0	2	0	0	4617	2
2	0	2	0	0	4618	2
2	0	2	0	0	4619	2
4	0	4	26	26	4620	2
4	0	4	0	0	4621	2
2	860	4	4	864	4622	0
2	4	4	57	61	4623	0
4	0	4	4	4	4624	2
4	0	4	0	0	4625	2
2	2	2	0	2	4626	0
2	0	2	20	20	4627	2
2	0	2	0	0	4628	2
2	0	2	0	0	4629	2
2	3	2	0	3	4630	1
2	0	2	4	4	4631	2
2	0	2	0	0	4632	2
2	0	2	2	2	4633	2
2	0	2	0	0	4634	2
2	0	2	0	0	4635	2
2	0	2	0	0	4636	2
2	0	2	1	1	4637	2
2	28	2	0	28	4638	0
2	5	2	9	14	4639	0
2	0	2	38	38	4640	2
2	1	2	282	283	4641	1
2	0	2	3	3	4642	2
2	0	2	0	0	4643	2
2	1	2	0	1	4644	0
2	1	2	0	1	4645	1
2	0	2	3	3	4646	2
2	2	2	5	7	4647	1
2	0	2	0	0	4648	2
2	0	2	1	1	4649	2
2	0	2	0	0	4650	2
2	0	2	1	1	4651	2
2	0	2	0	0	4652	2
2	0	2	0	0	4653	2
2	0	2	0	0	4654	2
2	0	2	0	0	4655	2
2	0	2	0	0	4656	2
2	0	2	0	0	4657	2
2	0	2	0	0	4658	2
2	0	2	0	0	4659	2
2	0	2	0	0	4660	2
2	0	2	0	0	4661	2
2	0	2	0	0	4662	2
2	0	2	0	0	4663	2
2	0	2	0	0	4664	2
2	0	2	0	0	4665	2
2	0	2	0	0	4666	2
2	0	2	0	0	4667	2
2	0	2	0	0	4668	2
2	0	2	0	0	4669	2
2	0	2	0	0	4670	2
2	0	2	0	0	4671	2
2	0	2	0	0	4672	2
2	0	2	0	0	4673	2
2	0	2	0	0	4674	2
2	0	2	0	0	4675	2
2	1	2	6	7	4676	1
2	0	2	1	1	4677	2
2	0	2	0	0	4678	2
2	1	2	0	1	4679	1
2	0	2	0	0	4680	2
2	0	2	0	0	4681	2
2	0	2	0	0	4682	2
2	0	2	0	0	4683	2
2	0	2	0	0	4684	2
2	0	2	0	0	4685	2
2	0	2	0	0	4686	2
2	0	2	0	0	4687	2
2	0	2	4	4	4688	2
2	0	2	0	0	4689	2
2	0	2	0	0	4690	2
2	0	2	0	0	4691	2
2	0	2	0	0	4692	2
2	0	2	0	0	4693	2
2	0	2	1	1	4694	2
2	0	2	0	0	4695	2
2	0	2	0	0	4696	2
2	0	2	0	0	4697	2
2	0	2	0	0	4698	2
2	0	2	0	0	4699	2
2	0	2	0	0	4700	2
2	0	2	4	4	4701	2
2	0	2	5	5	4702	2
2	0	2	3	3	4703	2
2	0	2	1	1	4704	2
2	0	2	2	2	4705	2
2	0	2	1	1	4706	2
2	0	2	0	0	4707	2
2	0	2	0	0	4708	2
2	0	2	0	0	4709	2
2	0	2	0	0	4710	2
2	0	2	0	0	4711	2
2	0	2	0	0	4712	2
2	0	2	0	0	4713	2
2	0	2	0	0	4714	2
2	0	2	0	0	4715	2
2	0	2	1	1	4716	2
2	0	2	0	0	4717	2
2	0	2	21	21	4718	2
2	0	2	0	0	4719	2
2	0	2	0	0	4720	2
2	0	2	0	0	4721	2
2	0	2	0	0	4722	2
2	0	2	0	0	4723	2
2	0	2	0	0	4724	2
2	0	2	0	0	4725	2
2	0	2	1	1	4726	2
2	100	2	0	100	4727	0
2	0	2	500	500	4728	2
2	4	2	0	4	4729	0
2	0	2	40	40	4730	2
2	0	2	0	0	4731	2
2	0	2	0	0	4732	2
2	0	2	0	0	4733	2
2	0	2	3	3	4734	2
2	0	4	163	163	4735	2
2	0	2	0	0	4736	2
2	2	2	0	2	4737	0
2	0	2	52	52	4738	2
2	0	2	0	0	4739	2
2	0	2	0	0	4740	2
2	0	2	1	1	4741	2
2	0	2	1	1	4742	2
2	0	2	1	1	4743	2
2	0	4	1815	1815	4744	2
2	0	2	0	0	4745	2
2	0	2	0	0	4746	2
2	0	2	0	0	4747	2
2	0	2	0	0	4748	2
2	0	2	0	0	4749	2
2	0	2	0	0	4750	2
2	0	2	0	0	4751	2
2	0	2	0	0	4752	2
2	0	2	0	0	4753	2
2	0	2	0	0	4754	2
2	0	2	5	5	4755	2
2	0	2	0	0	4756	2
2	0	2	0	0	4757	2
2	0	2	0	0	4758	2
2	0	2	0	0	4759	2
2	2	2	2	4	4760	1
2	0	2	3	3	4761	2
2	0	2	0	0	4762	2
2	0	2	0	0	4763	2
2	0	2	0	0	4764	2
2	0	2	0	0	4765	2
2	0	2	0	0	4766	2
2	0	2	0	0	4767	2
2	0	2	0	0	4768	2
2	0	2	0	0	4769	2
2	0	2	0	0	4770	2
2	0	2	0	0	4771	2
2	0	2	0	0	4772	2
2	0	2	0	0	4773	2
2	0	2	0	0	4774	2
2	0	2	0	0	4775	2
2	0	2	0	0	4776	2
2	0	2	0	0	4777	2
2	0	2	0	0	4778	2
2	0	2	0	0	4779	2
2	0	2	0	0	4780	2
2	0	2	0	0	4781	2
2	0	2	0	0	4782	2
2	0	2	0	0	4783	2
2	0	2	0	0	4784	2
2	0	2	0	0	4785	2
2	7	2	0	7	4786	0
2	6	2	192	198	4787	1
2	0	2	2	2	4788	2
2	0	2	0	0	4789	2
2	12	2	3	15	4790	0
2	0	2	38	38	4791	2
2	0	2	0	0	4792	2
2	0	2	0	0	4793	2
2	0	2	0	0	4794	2
2	0	2	0	0	4795	2
2	0	2	0	0	4796	2
2	0	2	0	0	4797	2
2	0	2	0	0	4798	2
2	1	2	0	1	4799	0
2	0	2	27	27	4800	2
2	0	2	0	0	4801	2
2	0	2	0	0	4802	2
2	0	2	0	0	4803	2
2	0	2	4	4	4804	2
2	0	2	0	0	4805	2
2	0	2	0	0	4806	2
2	0	2	0	0	4807	2
2	0	2	0	0	4808	2
2	0	2	0	0	4809	2
2	0	2	0	0	4810	2
2	0	2	1	1	4811	2
2	1	2	0	1	4812	0
2	0	2	1	1	4813	2
2	0	2	0	0	4814	2
2	0	2	0	0	4815	2
2	0	2	0	0	4816	2
2	0	2	0	0	4817	2
2	0	2	1	1	4818	2
2	0	2	1	1	4819	2
2	0	2	0	0	4820	2
2	0	2	0	0	4821	2
2	1	2	0	1	4822	0
2	0	2	0	0	4823	2
2	0	2	0	0	4824	2
2	0	2	3	3	4825	2
2	0	2	0	0	4826	2
2	0	2	0	0	4827	2
2	0	2	0	0	4828	2
2	0	2	0	0	4829	2
2	0	2	0	0	4830	2
2	0	2	0	0	4831	2
2	0	2	0	0	4832	2
2	0	2	0	0	4833	2
2	0	2	0	0	4834	2
2	0	2	0	0	4835	2
2	0	2	0	0	4836	2
2	0	2	0	0	4837	2
2	0	2	0	0	4838	2
2	0	2	0	0	4839	2
2	0	2	0	0	4840	2
2	0	2	0	0	4841	2
2	0	2	0	0	4842	2
2	0	2	0	0	4843	2
2	0	2	0	0	4844	2
2	0	2	0	0	4845	2
2	0	2	0	0	4846	2
2	0	2	0	0	4847	2
2	0	2	1	1	4848	2
2	0	2	0	0	4849	2
2	5	2	0	5	4850	0
2	9	4	170	179	4851	1
2	0	2	6	6	4852	2
2	0	2	0	0	4853	2
2	3	4	4	7	4854	1
2	0	2	16	16	4855	2
2	0	2	0	0	4856	2
2	0	2	1	1	4857	2
2	0	2	0	0	4858	2
2	0	2	0	0	4859	2
2	0	2	1	1	4860	2
2	0	2	0	0	4861	2
2	0	2	0	0	4862	2
2	0	2	0	0	4863	2
2	0	2	0	0	4864	2
2	0	2	0	0	4865	2
2	0	2	0	0	4866	2
2	0	2	0	0	4867	2
2	0	2	0	0	4868	2
2	0	2	0	0	4869	2
2	0	2	0	0	4870	2
2	0	2	0	0	4871	2
2	0	2	0	0	4872	2
2	0	2	0	0	4873	2
2	0	2	0	0	4874	2
2	0	2	0	0	4875	2
2	0	2	0	0	4876	2
2	0	2	0	0	4877	2
2	0	2	0	0	4878	2
2	0	2	0	0	4879	2
2	0	2	0	0	4880	2
2	1	2	0	1	4881	0
2	0	2	33	33	4882	2
2	0	2	0	0	4883	2
2	0	2	0	0	4884	2
2	0	2	0	0	4885	2
2	0	2	0	0	4886	2
2	0	2	0	0	4887	2
2	0	2	0	0	4888	2
2	0	2	0	0	4889	2
2	0	2	0	0	4890	2
2	0	2	0	0	4891	2
2	0	2	0	0	4892	2
2	0	2	0	0	4893	2
2	0	2	0	0	4894	2
2	0	2	0	0	4895	2
2	0	2	0	0	4896	2
2	0	2	0	0	4897	2
2	0	2	0	0	4898	2
2	0	2	0	0	4899	2
2	0	2	0	0	4900	2
2	0	2	0	0	4901	2
2	0	2	0	0	4902	2
2	0	2	0	0	4903	2
2	0	2	0	0	4904	2
2	0	2	0	0	4905	2
2	0	2	0	0	4906	2
2	0	2	0	0	4907	2
2	0	2	0	0	4908	2
2	0	2	1	1	4909	2
2	0	2	0	0	4910	2
2	0	2	0	0	4911	2
2	0	2	0	0	4912	2
2	0	2	5	5	4913	2
2	0	2	0	0	4914	2
2	0	2	3	3	4915	2
2	0	2	0	0	4916	2
2	0	2	0	0	4917	2
2	0	2	0	0	4918	2
2	0	2	0	0	4919	2
2	0	2	0	0	4920	2
2	0	2	0	0	4921	2
2	0	2	0	0	4922	2
2	0	2	0	0	4923	2
2	0	2	0	0	4924	2
2	0	2	0	0	4925	2
2	0	2	0	0	4926	2
2	0	2	0	0	4927	2
2	0	2	0	0	4928	2
2	0	2	0	0	4929	2
2	0	2	0	0	4930	2
2	0	2	0	0	4931	2
2	0	2	0	0	4932	2
2	0	2	34	34	4933	2
2	0	2	1	1	4934	2
2	0	2	0	0	4935	2
2	0	2	1	1	4936	2
2	0	2	2	2	4937	2
2	0	2	0	0	4938	2
2	0	2	0	0	4939	2
2	0	2	0	0	4940	2
2	0	2	0	0	4941	2
2	0	2	0	0	4942	2
2	0	2	0	0	4943	2
2	0	2	0	0	4944	2
2	0	2	0	0	4945	2
2	0	2	0	0	4946	2
2	0	2	0	0	4947	2
2	0	2	0	0	4948	2
2	0	2	0	0	4949	2
2	0	2	0	0	4950	2
2	0	2	0	0	4951	2
2	0	2	0	0	4952	2
2	0	2	0	0	4953	2
2	0	2	0	0	4954	2
2	0	2	0	0	4955	2
2	0	2	0	0	4956	2
2	0	2	0	0	4957	2
2	0	2	0	0	4958	2
2	0	2	0	0	4959	2
2	0	2	0	0	4960	2
2	0	2	0	0	4961	2
2	0	2	0	0	4962	2
2	0	2	0	0	4963	2
2	0	2	0	0	4964	2
2	0	2	0	0	4965	2
2	0	2	0	0	4966	2
2	0	2	0	0	4967	2
2	0	2	0	0	4968	2
2	0	2	0	0	4969	2
2	0	2	0	0	4970	2
2	0	2	0	0	4971	2
2	0	2	0	0	4972	2
2	0	2	0	0	4973	2
2	0	2	0	0	4974	2
2	1	2	2	3	4975	1
2	0	2	0	0	4976	2
2	0	2	0	0	4977	2
2	0	2	0	0	4978	2
2	0	2	0	0	4979	2
2	37	2	0	37	4980	0
2	0	2	0	0	4981	2
2	0	2	0	0	4982	2
2	0	2	0	0	4983	2
2	0	2	0	0	4984	2
2	0	2	0	0	4985	2
2	0	2	0	0	4986	2
2	3	2	124	127	4987	1
2	0	2	3	3	4988	2
2	0	2	0	0	4989	2
2	0	2	0	0	4990	2
2	0	2	0	0	4991	2
2	0	2	0	0	4992	2
2	0	2	0	0	4993	2
2	0	2	0	0	4994	2
2	0	2	0	0	4995	2
2	1	2	0	1	4996	0
2	0	2	32	32	4997	2
2	0	2	0	0	4998	2
2	0	2	2	2	4999	2
2	0	2	0	0	5000	2
2	0	2	0	0	5001	2
2	0	2	0	0	5002	2
2	0	2	0	0	5003	2
2	0	2	0	0	5004	2
2	0	2	0	0	5005	2
2	3	2	1	4	5006	0
2	0	2	4	4	5007	2
2	0	2	0	0	5008	2
2	1	2	0	1	5009	1
2	0	2	0	0	5010	2
2	0	2	0	0	5011	2
2	0	2	0	0	5012	2
2	3	2	0	3	5013	0
2	3	4	0	3	5014	1
2	0	2	0	0	5015	2
2	19	4	63	82	5016	1
2	0	2	0	0	5017	2
2	0	2	0	0	5018	2
2	0	2	0	0	5019	2
2	0	2	0	0	5020	2
2	0	2	0	0	5021	2
2	0	2	0	0	5022	2
2	0	2	0	0	5023	2
2	0	2	0	0	5024	2
2	1029	2	0	1029	5025	0
2	40	2	5517	5557	5026	1
2	0	2	83	83	5027	2
2	0	2	1	1	5028	2
2	248	2	7	255	5029	0
2	0	2	1718	1718	5030	2
2	0	2	0	0	5031	2
2	0	2	1	1	5032	2
2	0	2	0	0	5033	2
2	0	2	0	0	5034	2
2	0	2	0	0	5035	2
2	0	2	0	0	5036	2
2	0	2	0	0	5037	2
2	0	2	0	0	5038	2
2	0	2	1	1	5039	2
2	0	2	0	0	5040	2
2	0	2	0	0	5041	2
2	0	2	0	0	5042	2
2	0	2	0	0	5043	2
2	0	2	0	0	5044	2
2	0	2	0	0	5045	2
2	0	2	0	0	5046	2
2	2	2	0	2	5047	0
2	11	2	31	42	5048	1
2	0	2	1	1	5049	2
2	0	2	0	0	5050	2
2	11	2	0	11	5051	0
2	0	2	11	11	5052	2
2	0	2	0	0	5053	2
2	0	2	0	0	5054	2
2	0	2	0	0	5055	2
2	0	2	0	0	5056	2
2	0	2	0	0	5057	2
2	0	2	0	0	5058	2
2	0	2	0	0	5059	2
2	0	2	0	0	5060	2
2	0	2	0	0	5061	2
2	0	2	0	0	5062	2
2	0	2	0	0	5063	2
2	0	2	0	0	5064	2
2	0	2	0	0	5065	2
2	0	2	0	0	5066	2
2	0	2	0	0	5067	2
2	0	2	0	0	5068	2
2	0	2	0	0	5069	2
2	0	2	0	0	5070	2
2	0	2	0	0	5071	2
2	0	2	0	0	5072	2
2	0	2	0	0	5073	2
2	0	2	0	0	5074	2
2	0	2	0	0	5075	2
2	0	2	0	0	5076	2
2	0	2	0	0	5077	2
2	0	2	0	0	5078	2
2	0	2	0	0	5079	2
2	0	2	0	0	5080	2
2	0	2	0	0	5081	2
2	0	2	0	0	5082	2
2	0	2	0	0	5083	2
2	0	2	0	0	5084	2
2	0	2	0	0	5085	2
2	0	2	0	0	5086	2
2	0	2	0	0	5087	2
2	0	2	0	0	5088	2
2	0	2	0	0	5089	2
2	0	2	0	0	5090	2
2	0	2	0	0	5091	2
2	0	2	0	0	5092	2
2	0	2	0	0	5093	2
2	0	2	0	0	5094	2
2	0	2	0	0	5095	2
2	0	2	0	0	5096	2
2	0	2	0	0	5097	2
2	0	2	0	0	5098	2
2	0	2	0	0	5099	2
2	0	2	0	0	5100	2
2	0	2	0	0	5101	2
2	0	2	0	0	5102	2
2	0	2	0	0	5103	2
2	0	2	0	0	5104	2
2	0	2	0	0	5105	2
2	0	2	0	0	5106	2
2	0	2	0	0	5107	2
2	0	2	0	0	5108	2
2	0	2	0	0	5109	2
2	0	2	0	0	5110	2
2	0	2	0	0	5111	2
2	0	2	0	0	5112	2
2	0	2	0	0	5113	2
2	0	2	0	0	5114	2
2	0	2	0	0	5115	2
2	0	2	0	0	5116	2
2	0	2	0	0	5117	2
2	0	2	0	0	5118	2
2	0	2	0	0	5119	2
2	0	2	0	0	5120	2
2	0	2	0	0	5121	2
2	0	2	0	0	5122	2
2	0	2	0	0	5123	2
2	0	2	0	0	5124	2
2	0	2	0	0	5125	2
2	405	2	0	405	5126	0
2	27	2	1270	1297	5127	1
2	0	2	23	23	5128	2
2	0	2	0	0	5129	2
2	43	2	2	45	5130	1
2	0	2	251	251	5131	2
2	0	2	0	0	5132	2
2	0	2	0	0	5133	2
2	0	2	0	0	5134	2
2	0	2	0	0	5135	2
2	0	2	0	0	5136	2
2	0	2	0	0	5137	2
2	0	2	0	0	5138	2
2	0	2	0	0	5139	2
2	0	2	1	1	5140	2
2	0	2	0	0	5141	2
2	0	2	0	0	5142	2
2	0	2	0	0	5143	2
2	0	2	0	0	5144	2
2	4	2	0	4	5145	0
2	0	2	0	0	5146	2
2	0	2	0	0	5147	2
2	0	2	0	0	5148	2
2	0	2	0	0	5149	2
2	0	2	2	2	5150	2
2	0	2	0	0	5151	2
2	0	2	0	0	5152	2
2	0	4	0	0	5153	2
2	0	2	0	0	5154	2
2	0	2	0	0	5155	2
2	0	4	0	0	5156	2
2	0	2	0	0	5157	2
2	0	2	0	0	5158	2
2	0	2	1	1	5159	2
2	0	2	0	0	5160	2
2	0	2	0	0	5161	2
2	0	2	0	0	5162	2
2	0	2	0	0	5163	2
2	2	4	640	642	5164	1
2	0	2	5	5	5165	2
2	0	2	0	0	5166	2
2	5	4	293	298	5167	0
2	0	2	51	51	5168	2
2	0	2	0	0	5169	2
2	0	2	0	0	5170	2
2	0	2	0	0	5171	2
2	0	2	0	0	5172	2
2	0	2	0	0	5173	2
4	1	4	1	2	5174	1
4	0	4	0	0	5175	2
2	0	2	0	0	5176	2
2	0	2	0	0	5177	2
2	0	2	0	0	5178	2
2	0	2	0	0	5179	2
2	0	2	0	0	5180	2
2	0	2	0	0	5181	2
2	0	2	0	0	5182	2
2	0	2	0	0	5183	2
2	0	2	0	0	5184	2
2	0	2	0	0	5185	2
2	0	2	0	0	5186	2
2	0	2	0	0	5187	2
2	24	2	1	25	5188	0
2	4	2	383	387	5189	1
2	0	2	10	10	5190	2
2	0	2	4	4	5191	2
2	7	2	3	10	5192	0
2	0	2	0	0	5193	2
2	0	2	0	0	5194	2
2	0	2	0	0	5195	2
2	0	2	0	0	5196	2
2	0	2	0	0	5197	2
2	0	2	0	0	5198	2
2	0	2	0	0	5199	2
2	0	2	16	16	5200	2
2	0	2	0	0	5201	2
2	0	2	0	0	5202	2
2	10	2	4330	4340	5203	1
2	19	2	2	21	5204	0
2	0	2	82	82	5205	2
2	0	2	0	0	5206	2
2	2	2	12	14	5207	1
2	0	2	0	0	5208	2
2	0	2	0	0	5209	2
2	0	2	0	0	5210	2
2	0	2	1	1	5211	2
2	0	2	0	0	5212	2
2	0	2	7	7	5213	2
2	0	2	0	0	5214	2
2	0	2	0	0	5215	2
2	1	2	0	1	5216	0
2	0	2	2	2	5217	2
2	1	2	0	1	5218	1
2	0	2	4	4	5219	2
2	0	2	0	0	5220	2
2	0	2	0	0	5221	2
2	0	2	2	2	5222	2
2	0	2	1	1	5223	2
2	0	2	0	0	5224	2
2	0	2	1	1	5225	2
2	0	2	0	0	5226	2
2	0	2	0	0	5227	2
2	0	2	0	0	5228	2
2	0	2	0	0	5229	2
2	0	2	0	0	5230	2
2	1	2	12	13	5231	1
2	0	2	1	1	5232	2
2	0	2	0	0	5233	2
2	0	2	0	0	5234	2
2	0	2	0	0	5235	2
2	0	2	0	0	5236	2
2	0	2	0	0	5237	2
2	0	2	0	0	5238	2
2	0	2	0	0	5239	2
2	0	2	0	0	5240	2
2	0	2	0	0	5241	2
4	0	2	0	0	5242	2
2	78	2	1	79	5243	0
2	44	2	275	319	5244	1
2	0	2	59	59	5245	2
2	0	2	1	1	5246	2
2	52	2	1	53	5247	0
2	0	2	309	309	5248	2
4	0	2	520	520	5249	2
2	16	2	0	16	5250	0
2	0	2	15	15	5251	2
2	0	2	0	0	5252	2
2	0	2	0	0	5253	2
2	0	2	0	0	5254	2
2	0	2	0	0	5255	2
2	0	2	0	0	5256	2
2	0	2	0	0	5257	2
2	0	2	0	0	5258	2
2	10	2	0	10	5259	0
2	2	2	0	2	5260	0
2	0	2	0	0	5261	2
2	0	2	0	0	5262	2
2	0	2	0	0	5263	2
2	0	2	0	0	5264	2
2	0	2	0	0	5265	2
2	0	2	0	0	5266	2
2	2	2	11	13	5267	1
2	0	2	0	0	5268	2
2	0	2	0	0	5269	2
2	1	2	0	1	5270	0
2	0	2	0	0	5271	2
2	25	2	252	277	5272	1
2	0	2	1	1	5273	2
2	0	2	0	0	5274	2
2	16	2	6	22	5275	0
2	0	2	22	22	5276	2
2	494	2	1	495	5277	0
2	0	2	0	0	5278	2
2	0	2	8	8	5279	2
2	0	2	0	0	5280	2
2	0	2	0	0	5281	2
2	0	2	0	0	5282	2
2	0	2	0	0	5283	2
2	136	2	1662	1798	5284	1
2	0	2	341	341	5285	2
2	0	2	0	0	5286	2
2	455	2	3	458	5287	0
2	0	2	1734	1734	5288	2
2	19	2	0	19	5289	0
2	7	2	296	303	5290	1
2	0	2	1	1	5291	2
2	0	2	0	0	5292	2
2	5	2	0	5	5293	0
2	0	2	63	63	5294	2
4	0	2	0	0	5295	2
4	0	2	0	0	5296	2
2	0	2	0	0	5297	2
2	0	2	0	0	5298	2
2	0	2	0	0	5299	2
2	0	2	0	0	5300	2
2	0	2	0	0	5301	2
2	0	2	0	0	5302	2
2	2	2	0	2	5303	0
2	0	2	1	1	5304	2
2	0	2	0	0	5305	2
2	2	2	53	55	5306	1
2	0	2	0	0	5307	2
2	0	2	0	0	5308	2
2	5	2	0	5	5309	0
2	0	2	9	9	5310	2
2	0	2	0	0	5311	2
2	0	2	0	0	5312	2
2	0	2	0	0	5313	2
2	0	2	5	5	5314	2
2	20	2	0	20	5315	0
2	11	2	1052	1063	5316	1
2	0	2	1	1	5317	2
2	0	2	1	1	5318	2
2	7	2	14	21	5319	0
2	0	2	62	62	5320	2
2	3	2	0	3	5321	0
2	2	2	26	28	5322	1
2	0	2	0	0	5323	2
2	0	2	0	0	5324	2
2	0	2	1	1	5325	2
2	0	2	1	1	5326	2
2	0	2	0	0	5327	2
2	0	2	0	0	5328	2
2	0	2	0	0	5329	2
2	0	2	0	0	5330	2
2	0	2	0	0	5331	2
2	0	2	0	0	5332	2
2	0	2	0	0	5333	2
2	0	2	3	3	5334	2
2	0	2	0	0	5335	2
2	0	2	0	0	5336	2
2	0	2	0	0	5337	2
2	0	2	0	0	5338	2
4	2	2	0	2	5339	0
4	0	2	0	0	5340	2
4	0	4	3	3	5341	2
4	0	4	0	0	5342	2
0	26	2	0	26	5343	0
0	14	2	2	16	5344	0
4	43	2	0	43	5345	0
4	1	2	0	1	5346	0
4	0	2	0	0	5347	2
2	0	2	0	0	5348	2
2	1	2	2	3	5349	1
2	0	2	0	0	5350	2
2	0	2	0	0	5351	2
2	0	2	0	0	5352	2
2	0	2	0	0	5353	2
2	0	2	0	0	5354	2
2	0	2	0	0	5355	2
2	0	2	0	0	5356	2
2	0	2	0	0	5357	2
2	0	2	0	0	5358	2
2	0	2	0	0	5359	2
2	0	2	0	0	5360	2
2	0	2	1	1	5361	2
2	0	2	0	0	5362	2
2	0	2	0	0	5363	2
2	0	2	0	0	5364	2
2	0	2	0	0	5365	2
2	0	2	0	0	5366	2
2	0	2	0	0	5367	2
2	0	2	0	0	5368	2
2	0	2	0	0	5369	2
2	0	2	0	0	5370	2
2	0	2	0	0	5371	2
2	0	2	0	0	5372	2
2	0	2	0	0	5373	2
2	0	2	0	0	5374	2
2	0	2	0	0	5375	2
2	0	2	0	0	5376	2
2	0	2	0	0	5377	2
2	0	2	0	0	5378	2
2	0	2	0	0	5379	2
2	0	2	0	0	5380	2
2	0	2	0	0	5381	2
2	0	2	0	0	5382	2
2	0	2	0	0	5383	2
2	0	2	0	0	5384	2
2	0	2	0	0	5385	2
2	0	2	0	0	5386	2
2	0	2	0	0	5387	2
2	0	2	0	0	5388	2
2	0	2	0	0	5389	2
2	0	2	0	0	5390	2
2	0	2	0	0	5391	2
2	0	2	0	0	5392	2
2	0	2	0	0	5393	2
2	0	2	0	0	5394	2
2	0	2	0	0	5395	2
2	0	2	0	0	5396	2
2	0	2	0	0	5397	2
2	0	2	0	0	5398	2
2	0	2	0	0	5399	2
2	0	2	0	0	5400	2
2	0	2	0	0	5401	2
0	33	4	1	34	5402	1
2	0	2	0	0	5403	2
2	1	2	0	1	5404	1
2	0	2	0	0	5405	2
2	0	2	0	0	5406	2
2	0	2	0	0	5407	2
2	0	2	0	0	5408	2
0	0	4	5	5	5409	2
2	3	2	0	3	5410	0
2	2	2	4	6	5411	1
2	0	2	0	0	5412	2
2	0	2	0	0	5413	2
0	492	2	9	501	5414	1
0	294	2	0	294	5415	0
2	2	2	0	2	5416	0
2	0	2	83	83	5417	2
2	0	2	0	0	5418	2
2	0	2	5	5	5419	2
2	0	2	0	0	5420	2
2	0	2	0	0	5421	2
2	0	2	1	1	5422	2
2	0	2	39	39	5423	2
2	0	2	0	0	5424	2
2	0	2	0	0	5425	2
2	0	2	0	0	5426	2
2	0	2	0	0	5427	2
2	0	2	2324	2324	5428	2
2	0	2	0	0	5429	2
2	0	2	0	0	5430	2
2	0	2	0	0	5431	2
2	0	2	0	0	5432	2
2	0	2	0	0	5433	2
2	0	2	0	0	5434	2
2	0	2	0	0	5435	2
2	0	2	0	0	5436	2
2	0	2	0	0	5437	2
2	0	2	0	0	5438	2
2	0	2	0	0	5439	2
2	0	2	0	0	5440	2
2	0	2	0	0	5441	2
2	0	2	0	0	5442	2
2	6	4	117	123	5443	1
2	0	2	0	0	5444	2
2	0	2	0	0	5445	2
2	0	2	0	0	5446	2
2	0	0	0	0	5447	2
2	0	2	0	0	5448	2
2	0	0	0	0	5449	2
2	0	2	0	0	5450	2
2	0	2	0	0	5451	2
2	0	2	0	0	5452	2
2	0	2	0	0	5453	2
2	0	4	7	7	5454	2
2	0	2	1	1	5455	2
2	0	4	9	9	5456	2
2	0	2	0	0	5457	2
2	0	2	0	0	5458	2
4	0	4	0	0	5459	2
4	0	4	0	0	5460	2
2	0	4	335	335	5461	2
2	0	2	0	0	5462	2
2	0	2	0	0	5463	2
4	0	2	4	4	5464	2
4	0	2	0	0	5465	2
2	0	4	52	52	5466	2
2	0	2	0	0	5467	2
0	0	4	2	2	5468	2
2	0	2	0	0	5469	2
2	0	4	2	2	5470	2
2	0	2	0	0	5471	2
2	0	2	0	0	5472	2
2	0	2	0	0	5473	2
2	325	2	0	325	5474	1
2	0	2	0	0	5475	2
2	0	4	367	367	5476	2
2	0	2	0	0	5477	2
2	0	2	0	0	5478	2
2	0	4	38	38	5479	2
2	0	2	0	0	5480	2
2	0	2	0	0	5481	2
2	0	4	4	4	5482	2
2	0	2	0	0	5483	2
2	0	2	0	0	5484	2
2	0	4	0	0	5485	2
2	0	2	0	0	5486	2
2	0	2	0	0	5487	2
2	0	2	0	0	5488	2
2	0	2	0	0	5489	2
2	0	2	0	0	5490	2
2	0	2	0	0	5491	2
2	0	2	0	0	5492	2
2	2	2	0	2	5493	0
2	50	2	482	532	5494	1
2	0	2	0	0	5495	2
2	0	2	0	0	5496	2
2	1	2	0	1	5497	1
2	0	2	12	12	5498	2
2	0	2	0	0	5499	2
2	0	2	0	0	5500	2
2	0	2	0	0	5501	2
2	0	2	0	0	5502	2
2	0	2	0	0	5503	2
2	0	2	0	0	5504	2
4	0	2	0	0	5505	2
4	0	2	0	0	5506	2
2	0	2	0	0	5507	2
2	0	2	0	0	5508	2
2	0	2	0	0	5509	2
2	0	2	0	0	5510	2
2	0	2	0	0	5511	2
2	0	2	0	0	5512	2
2	0	2	0	0	5513	2
2	0	2	0	0	5514	2
0	0	4	44	44	5515	2
0	2	4	44	46	5516	1
2	5	2	1	6	5517	0
2	0	2	0	0	5518	2
2	0	2	0	0	5519	2
2	0	2	0	0	5520	2
2	0	2	0	0	5521	2
2	0	2	0	0	5522	2
2	0	2	0	0	5523	2
2	3	4	2035	2038	5524	1
2	0	2	0	0	5525	2
2	0	2	0	0	5526	2
4	0	4	44	44	5527	2
4	0	4	8	8	5528	2
2	4	4	11196	11200	5529	0
2	0	2	18	18	5530	2
4	0	2	2	2	5531	2
2	0	2	0	0	5532	2
2	0	2	0	0	5533	2
2	0	2	1	1	5534	2
2	0	2	0	0	5535	2
2	0	2	0	0	5536	2
2	0	2	0	0	5537	2
2	0	2	0	0	5538	2
2	0	4	55	55	5539	2
2	0	2	0	0	5540	2
2	0	2	0	0	5541	2
4	48	4	104	152	5542	0
2	8	4	104	112	5543	0
2	0	2	2	2	5544	2
2	0	2	0	0	5545	2
2	0	2	0	0	5546	2
2	0	2	2	2	5547	2
2	0	2	0	0	5548	2
2	0	2	0	0	5549	2
2	0	2	0	0	5550	2
2	0	2	0	0	5551	2
2	0	4	133	133	5552	2
2	0	2	0	0	5553	2
2	0	2	0	0	5554	2
2	0	4	118	118	5555	2
2	0	2	0	0	5556	2
2	0	2	0	0	5557	2
2	0	2	0	0	5558	2
2	0	2	0	0	5559	2
2	0	2	0	0	5560	2
2	0	2	0	0	5561	2
2	0	2	0	0	5562	2
2	0	2	0	0	5563	2
2	0	2	0	0	5564	2
2	0	4	18	18	5565	2
2	0	2	0	0	5566	2
2	0	2	0	0	5567	2
2	0	2	0	0	5568	2
2	0	2	0	0	5569	2
2	0	2	0	0	5570	2
2	0	2	0	0	5571	2
2	0	2	0	0	5572	2
2	0	2	0	0	5573	2
2	0	2	0	0	5574	2
2	0	2	0	0	5575	2
2	0	2	0	0	5576	2
2	0	4	5	5	5577	2
2	0	2	0	0	5578	2
2	0	2	0	0	5579	2
2	0	4	0	0	5580	2
2	0	2	0	0	5581	2
2	0	2	0	0	5582	2
2	0	4	7	7	5583	2
2	0	2	0	0	5584	2
2	0	2	0	0	5585	2
2	0	4	1	1	5586	2
2	0	2	0	0	5587	2
2	0	2	0	0	5588	2
2	0	2	0	0	5589	2
2	0	2	0	0	5590	2
2	0	2	0	0	5591	2
2	0	2	0	0	5592	2
2	0	2	0	0	5593	2
2	0	4	220	220	5594	2
2	0	2	0	0	5595	2
2	0	2	0	0	5596	2
2	0	4	87	87	5597	2
4	17	2	0	17	5598	0
2	1	2	2	3	5599	1
2	0	2	1	1	5600	2
2	0	2	0	0	5601	2
2	0	2	10	10	5602	2
2	0	2	0	0	5603	2
2	0	2	0	0	5604	2
2	0	4	206	206	5605	2
2	0	2	0	0	5606	2
2	1	2	0	1	5607	0
2	4	2	21	25	5608	1
2	0	2	1	1	5609	2
2	0	2	0	0	5610	2
2	4	2	0	4	5611	0
2	0	2	8	8	5612	2
2	1	2	0	1	5613	0
2	0	2	2	2	5614	2
2	0	2	0	0	5615	2
2	0	2	0	0	5616	2
2	0	2	0	0	5617	2
2	0	2	1	1	5618	2
2	0	2	0	0	5619	2
2	0	2	0	0	5620	2
2	0	2	0	0	5621	2
2	0	2	0	0	5622	2
2	0	2	0	0	5623	2
2	0	2	0	0	5624	2
2	0	2	0	0	5625	2
2	0	2	0	0	5626	2
2	0	2	0	0	5627	2
2	0	2	0	0	5628	2
2	0	2	0	0	5629	2
2	0	2	0	0	5630	2
2	0	2	0	0	5631	2
2	0	2	0	0	5632	2
2	0	2	0	0	5633	2
2	0	2	0	0	5634	2
2	0	2	0	0	5635	2
2	0	2	0	0	5636	2
2	0	2	0	0	5637	2
2	0	2	0	0	5638	2
2	0	2	1	1	5639	2
2	0	2	0	0	5640	2
2	0	2	0	0	5641	2
2	0	2	0	0	5642	2
2	0	2	0	0	5643	2
2	0	2	0	0	5644	2
2	0	2	0	0	5645	2
2	0	2	0	0	5646	2
2	0	2	0	0	5647	2
2	0	2	0	0	5648	2
2	0	2	0	0	5649	2
2	1	2	0	1	5650	0
2	0	2	14	14	5651	2
2	0	2	0	0	5652	2
2	0	2	1	1	5653	2
2	2	2	0	2	5654	1
2	0	2	1	1	5655	2
2	0	2	0	0	5656	2
2	13	2	69	82	5657	1
2	0	2	0	0	5658	2
2	0	2	1	1	5659	2
2	1	2	1	2	5660	1
2	0	2	2	2	5661	2
2	0	2	0	0	5662	2
2	0	2	0	0	5663	2
2	0	2	0	0	5664	2
2	0	2	0	0	5665	2
2	0	2	0	0	5666	2
2	0	2	0	0	5667	2
2	0	2	0	0	5668	2
2	0	2	0	0	5669	2
2	0	2	0	0	5670	2
2	0	2	0	0	5671	2
2	0	2	0	0	5672	2
2	0	2	0	0	5673	2
2	0	2	0	0	5674	2
2	0	2	0	0	5675	2
2	0	2	0	0	5676	2
2	0	2	0	0	5677	2
2	0	2	0	0	5678	2
2	0	2	0	0	5679	2
2	0	2	0	0	5680	2
2	0	2	0	0	5681	2
2	0	2	0	0	5682	2
2	0	2	0	0	5683	2
2	0	2	0	0	5684	2
2	0	2	0	0	5685	2
2	0	2	0	0	5686	2
2	0	4	0	0	5687	2
2	0	2	0	0	5688	2
2	0	2	0	0	5689	2
2	0	4	0	0	5690	2
2	0	2	0	0	5691	2
2	1	2	1	2	5692	1
2	0	2	0	0	5693	2
2	0	2	0	0	5694	2
2	0	2	0	0	5695	2
2	0	2	0	0	5696	2
2	0	2	0	0	5697	2
2	2	2	0	2	5698	0
2	0	2	0	0	5699	2
2	0	2	0	0	5700	2
2	0	2	0	0	5701	2
2	0	2	0	0	5702	2
2	0	2	0	0	5703	2
2	0	2	0	0	5704	2
2	0	2	0	0	5705	2
2	0	2	0	0	5706	2
2	0	2	2	2	5707	2
2	0	2	0	0	5708	2
2	0	2	0	0	5709	2
2	0	2	0	0	5710	2
2	0	2	0	0	5711	2
2	4	2	25	29	5712	1
2	0	2	2	2	5713	2
2	0	2	0	0	5714	2
2	2	2	0	2	5715	1
2	0	2	3	3	5716	2
2	0	2	0	0	5717	2
2	0	2	0	0	5718	2
2	0	2	0	0	5719	2
2	0	2	0	0	5720	2
2	0	2	0	0	5721	2
2	0	2	0	0	5722	2
2	0	2	0	0	5723	2
2	0	2	0	0	5724	2
2	0	2	0	0	5725	2
2	0	2	0	0	5726	2
2	1	2	0	1	5727	0
2	0	2	0	0	5728	2
2	0	2	0	0	5729	2
2	0	2	0	0	5730	2
2	0	2	0	0	5731	2
2	0	2	0	0	5732	2
2	0	2	0	0	5733	2
2	0	2	0	0	5734	2
2	0	2	0	0	5735	2
2	0	2	0	0	5736	2
2	0	2	0	0	5737	2
2	0	2	0	0	5738	2
2	0	2	0	0	5739	2
2	0	2	0	0	5740	2
2	0	2	0	0	5741	2
2	0	2	0	0	5742	2
2	0	2	2	2	5743	2
2	0	2	0	0	5744	2
2	0	2	0	0	5745	2
2	0	2	0	0	5746	2
2	0	2	0	0	5747	2
2	0	2	0	0	5748	2
2	0	2	0	0	5749	2
2	0	2	0	0	5750	2
2	0	2	0	0	5751	2
2	0	2	0	0	5752	2
2	0	2	0	0	5753	2
2	1	2	0	1	5754	0
2	0	2	0	0	5755	2
2	0	2	0	0	5756	2
2	0	2	0	0	5757	2
2	0	2	0	0	5758	2
2	0	2	0	0	5759	2
2	0	2	0	0	5760	2
2	0	2	0	0	5761	2
2	0	2	0	0	5762	2
2	57	2	0	57	5763	0
2	5	2	123	128	5764	1
2	0	2	37	37	5765	2
2	0	2	0	0	5766	2
2	10	2	9	19	5767	0
2	0	2	53	53	5768	2
2	0	2	0	0	5769	2
2	0	2	0	0	5770	2
2	0	2	0	0	5771	2
2	0	2	0	0	5772	2
2	0	2	0	0	5773	2
2	0	2	0	0	5774	2
2	0	2	0	0	5775	2
2	0	2	0	0	5776	2
2	0	2	0	0	5777	2
2	0	2	0	0	5778	2
2	0	2	0	0	5779	2
2	0	2	0	0	5780	2
2	0	2	0	0	5781	2
2	0	2	0	0	5782	2
2	0	2	0	0	5783	2
2	0	2	0	0	5784	2
2	0	2	0	0	5785	2
2	0	2	0	0	5786	2
2	6	2	0	6	5787	0
2	0	2	17	17	5788	2
2	0	2	0	0	5789	2
2	0	2	0	0	5790	2
2	6	2	0	6	5791	1
2	0	2	22	22	5792	2
2	0	2	0	0	5793	2
2	0	2	0	0	5794	2
2	0	2	0	0	5795	2
2	0	2	0	0	5796	2
2	0	2	0	0	5797	2
2	0	2	0	0	5798	2
2	0	2	27	27	5799	2
2	0	2	0	0	5800	2
2	0	2	3	3	5801	2
2	0	2	0	0	5802	2
2	0	2	1	1	5803	2
2	0	2	0	0	5804	2
2	0	2	0	0	5805	2
2	0	2	0	0	5806	2
2	0	2	0	0	5807	2
2	0	2	0	0	5808	2
2	0	2	0	0	5809	2
2	0	2	0	0	5810	2
2	0	2	0	0	5811	2
2	0	2	0	0	5812	2
2	0	2	0	0	5813	2
2	19	2	0	19	5814	0
2	5	2	131	136	5815	0
2	0	2	1	1	5816	2
2	0	2	0	0	5817	2
2	0	2	0	0	5818	2
2	2	2	3	5	5819	1
2	0	2	0	0	5820	2
2	0	2	0	0	5821	2
2	0	2	0	0	5822	2
2	0	2	2	2	5823	2
2	0	2	0	0	5824	2
2	0	2	0	0	5825	2
2	0	2	0	0	5826	2
2	1	2	0	1	5827	1
2	0	2	0	0	5828	2
2	0	2	0	0	5829	2
2	0	2	0	0	5830	2
2	0	2	0	0	5831	2
2	0	2	0	0	5832	2
2	0	2	0	0	5833	2
2	0	2	0	0	5834	2
2	0	2	0	0	5835	2
2	0	2	0	0	5836	2
2	0	2	0	0	5837	2
2	0	2	0	0	5838	2
2	0	2	0	0	5839	2
2	0	2	0	0	5840	2
2	0	2	0	0	5841	2
2	0	2	0	0	5842	2
2	0	2	0	0	5843	2
2	0	2	0	0	5844	2
2	0	2	0	0	5845	2
2	0	2	0	0	5846	2
2	0	2	0	0	5847	2
2	5	2	2	7	5848	0
2	0	2	29	29	5849	2
2	0	2	0	0	5850	2
2	0	2	0	0	5851	2
2	0	2	0	0	5852	2
2	0	2	0	0	5853	2
2	0	2	0	0	5854	2
2	0	2	0	0	5855	2
2	0	2	0	0	5856	2
2	0	2	0	0	5857	2
2	0	2	0	0	5858	2
2	0	2	5	5	5859	2
2	0	2	0	0	5860	2
2	0	2	0	0	5861	2
2	0	2	0	0	5862	2
2	0	2	0	0	5863	2
2	0	2	0	0	5864	2
2	0	2	0	0	5865	2
2	0	2	0	0	5866	2
2	0	2	0	0	5867	2
2	2	2	0	2	5868	0
2	1	4	1	2	5869	1
2	0	2	6	6	5870	2
2	3	4	16	19	5871	1
2	0	2	2	2	5872	2
2	0	2	0	0	5873	2
4	0	2	0	0	5874	2
2	2	2	0	2	5875	0
2	11	2	24	35	5876	1
2	0	2	1	1	5877	2
2	0	2	1	1	5878	2
2	7	2	4	11	5879	0
2	0	2	16	16	5880	2
2	0	2	0	0	5881	2
2	0	2	0	0	5882	2
2	0	2	0	0	5883	2
2	0	2	0	0	5884	2
2	0	2	0	0	5885	2
2	0	2	0	0	5886	2
2	0	2	0	0	5887	2
2	0	2	0	0	5888	2
2	0	2	0	0	5889	2
2	0	2	0	0	5890	2
2	0	4	1	1	5891	2
2	0	2	0	0	5892	2
2	843	2	7	850	5893	0
2	933	2	4253	5186	5894	1
2	2	2	343	345	5895	1
2	0	2	11	11	5896	2
2	632	2	93	725	5897	0
2	0	2	2386	2386	5898	2
2	0	2	0	0	5899	2
2	0	2	0	0	5900	2
2	0	2	0	0	5901	2
2	0	2	0	0	5902	2
2	0	2	0	0	5903	2
2	0	2	0	0	5904	2
2	0	2	0	0	5905	2
2	0	2	0	0	5906	2
2	0	2	0	0	5907	2
2	0	2	0	0	5908	2
2	0	2	0	0	5909	2
2	0	2	0	0	5910	2
2	0	2	1	1	5911	2
2	0	2	0	0	5912	2
2	0	2	0	0	5913	2
2	0	2	0	0	5914	2
2	0	2	0	0	5915	2
2	0	2	0	0	5916	2
2	0	2	0	0	5917	2
2	0	2	6	6	5918	2
2	0	2	0	0	5919	2
2	0	2	0	0	5920	2
2	0	2	0	0	5921	2
2	0	2	0	0	5922	2
2	13	2	0	13	5923	0
2	2	2	89	91	5924	1
2	0	2	8	8	5925	2
2	0	2	0	0	5926	2
2	6	2	14	20	5927	0
2	0	2	13	13	5928	2
2	0	2	0	0	5929	2
2	0	2	4	4	5930	2
2	0	2	0	0	5931	2
2	0	2	0	0	5932	2
2	0	2	0	0	5933	2
2	0	2	13	13	5934	2
2	0	2	0	0	5935	2
2	0	2	0	0	5936	2
2	1	2	0	1	5937	0
2	0	2	0	0	5938	2
2	0	2	0	0	5939	2
2	0	2	0	0	5940	2
2	0	2	0	0	5941	2
2	0	2	0	0	5942	2
2	0	2	0	0	5943	2
2	0	2	0	0	5944	2
2	0	2	0	0	5945	2
2	0	2	0	0	5946	2
2	0	2	0	0	5947	2
2	0	2	0	0	5948	2
2	0	2	0	0	5949	2
2	0	2	0	0	5950	2
2	10	2	0	10	5951	0
2	0	2	0	0	5952	2
2	0	2	0	0	5953	2
2	0	2	0	0	5954	2
2	0	2	0	0	5955	2
2	0	2	0	0	5956	2
2	0	2	0	0	5957	2
2	0	2	0	0	5958	2
2	0	2	0	0	5959	2
2	0	2	0	0	5960	2
2	2	2	0	2	5961	0
2	0	2	9	9	5962	2
2	2	2	17	19	5963	1
2	0	2	0	0	5964	2
2	0	2	0	0	5965	2
2	0	2	0	0	5966	2
2	0	2	0	0	5967	2
2	0	2	0	0	5968	2
2	0	2	1	1	5969	2
2	0	2	2	2	5970	2
2	0	2	0	0	5971	2
2	0	2	1	1	5972	2
2	0	2	0	0	5973	2
2	0	2	0	0	5974	2
2	0	2	0	0	5975	2
2	0	2	0	0	5976	2
2	0	2	0	0	5977	2
2	0	2	0	0	5978	2
2	0	2	0	0	5979	2
2	0	2	0	0	5980	2
2	0	2	0	0	5981	2
2	0	2	0	0	5982	2
2	0	2	0	0	5983	2
2	0	2	0	0	5984	2
2	3	2	37	40	5985	1
2	0	2	0	0	5986	2
2	0	2	0	0	5987	2
2	1	2	1	2	5988	0
2	0	2	0	0	5989	2
2	0	2	0	0	5990	2
2	0	2	0	0	5991	2
2	0	2	0	0	5992	2
2	0	2	0	0	5993	2
2	0	2	0	0	5994	2
2	0	2	0	0	5995	2
2	0	2	0	0	5996	2
2	0	2	0	0	5997	2
2	9	2	0	9	5998	0
2	3	2	8	11	5999	0
2	0	2	26	26	6000	2
2	7	2	614	621	6001	1
2	0	2	2	2	6002	2
2	0	2	0	0	6003	2
4	0	2	0	0	6004	2
2	0	2	0	0	6005	2
2	0	2	0	0	6006	2
2	0	2	0	0	6007	2
2	0	2	0	0	6008	2
2	0	2	0	0	6009	2
2	0	2	0	0	6010	2
2	0	2	0	0	6011	2
2	0	2	0	0	6012	2
2	0	2	0	0	6013	2
2	0	2	0	0	6014	2
2	0	2	0	0	6015	2
2	0	2	0	0	6016	2
2	0	2	0	0	6017	2
2	0	2	0	0	6018	2
2	0	2	0	0	6019	2
2	0	2	0	0	6020	2
2	0	2	0	0	6021	2
2	0	2	0	0	6022	2
2	0	2	0	0	6023	2
2	0	2	0	0	6024	2
2	0	2	0	0	6025	2
2	0	2	0	0	6026	2
2	0	2	0	0	6027	2
2	0	2	0	0	6028	2
2	0	2	0	0	6029	2
2	0	2	7	7	6030	2
2	0	2	0	0	6031	2
2	0	2	0	0	6032	2
2	0	2	0	0	6033	2
2	1	2	2	3	6034	1
2	0	2	0	0	6035	2
2	0	4	66	66	6036	2
2	0	2	1	1	6037	2
2	0	4	17	17	6038	2
2	0	2	0	0	6039	2
2	0	2	0	0	6040	2
2	0	2	0	0	6041	2
2	0	2	0	0	6042	2
2	0	2	0	0	6043	2
2	0	2	0	0	6044	2
2	0	2	0	0	6045	2
2	0	2	0	0	6046	2
4	0	2	0	0	6047	2
2	0	2	0	0	6048	2
2	0	2	0	0	6049	2
2	0	2	0	0	6050	2
2	0	2	0	0	6051	2
2	0	2	0	0	6052	2
2	0	2	0	0	6053	2
2	0	2	0	0	6054	2
2	0	2	0	0	6055	2
2	0	2	0	0	6056	2
2	0	2	0	0	6057	2
2	0	2	0	0	6058	2
2	0	2	0	0	6059	2
2	0	2	0	0	6060	2
2	0	2	0	0	6061	2
2	0	2	0	0	6062	2
2	0	2	0	0	6063	2
2	0	2	0	0	6064	2
2	0	2	0	0	6065	2
2	0	2	0	0	6066	2
2	0	2	0	0	6067	2
2	0	2	0	0	6068	2
2	17	2	1	18	6069	0
2	6	2	42	48	6070	1
2	0	2	7	7	6071	2
2	0	2	0	0	6072	2
2	6	2	1	7	6073	0
2	0	2	22	22	6074	2
2	0	2	0	0	6075	2
2	0	2	0	0	6076	2
2	0	2	0	0	6077	2
2	0	2	0	0	6078	2
2	0	2	0	0	6079	2
2	0	2	0	0	6080	2
0	177	2	6	183	6081	0
0	0	2	0	0	6082	2
0	0	2	0	0	6083	2
2	0	2	0	0	6084	2
2	0	2	0	0	6085	2
2	0	2	0	0	6086	2
2	0	2	0	0	6087	2
2	0	2	0	0	6088	2
2	0	2	0	0	6089	2
0	98	4	31	129	6090	0
2	10	2	0	10	6091	0
2	0	2	0	0	6092	2
2	0	2	0	0	6093	2
2	0	2	0	0	6094	2
2	0	2	0	0	6095	2
2	0	2	0	0	6096	2
2	0	2	0	0	6097	2
2	3	2	94	97	6098	1
2	0	2	1	1	6099	2
2	0	2	0	0	6100	2
2	1	2	1	2	6101	1
2	0	2	16	16	6102	2
2	0	2	0	0	6103	2
2	0	4	1	1	6104	2
2	0	2	0	0	6105	2
2	0	4	4	4	6106	2
2	0	2	0	0	6107	2
2	0	2	0	0	6108	2
2	0	4	54	54	6109	2
2	0	2	0	0	6110	2
2	0	2	0	0	6111	2
2	0	2	0	0	6112	2
2	0	2	0	0	6113	2
2	0	2	0	0	6114	2
2	0	2	0	0	6115	2
4	124	4	15	139	6116	0
4	143	4	5	148	6117	0
0	0	0	0	0	6118	2
0	0	0	0	0	6119	2
2	10	2	0	10	6120	0
2	2	2	97	99	6121	1
2	0	2	0	0	6122	2
2	0	2	0	0	6123	2
2	1	2	1	2	6124	0
2	0	2	6	6	6125	2
4	3	4	202	205	6126	0
4	0	4	202	202	6127	2
2	0	2	0	0	6128	2
2	0	2	0	0	6129	2
2	0	2	0	0	6130	2
2	0	2	0	0	6131	2
2	0	2	0	0	6132	2
2	0	2	0	0	6133	2
2	66	2	1	67	6134	0
2	0	2	2	2	6135	2
2	0	2	0	0	6136	2
2	0	2	0	0	6137	2
2	0	2	0	0	6138	2
2	0	2	0	0	6139	2
2	0	2	0	0	6140	2
2	0	2	0	0	6141	2
2	0	2	0	0	6142	2
2	0	2	0	0	6143	2
2	0	4	5	5	6144	2
2	0	2	0	0	6145	2
2	0	2	0	0	6146	2
2	0	4	12	12	6147	2
2	0	2	0	0	6148	2
4	0	2	0	0	6149	2
2	0	2	0	0	6150	2
2	1	2	0	1	6151	1
2	0	2	0	0	6152	2
2	0	2	0	0	6153	2
4	1	2	0	1	6154	0
4	0	2	0	0	6155	2
2	0	2	0	0	6156	2
2	0	2	0	0	6157	2
2	4	2	0	4	6158	0
2	1	2	18	19	6159	1
2	0	2	0	0	6160	2
2	0	2	0	0	6161	2
2	0	2	2	2	6162	2
2	0	2	0	0	6163	2
4	87	2	18	105	6164	0
4	1	2	2	3	6165	1
2	0	2	0	0	6166	2
2	2	2	0	2	6167	1
2	0	2	1	1	6168	2
2	0	2	0	0	6169	2
2	0	2	0	0	6170	2
2	0	2	4	4	6171	2
2	0	2	0	0	6172	2
2	0	2	0	0	6173	2
2	0	2	0	0	6174	2
2	0	2	0	0	6175	2
2	0	2	0	0	6176	2
2	0	2	0	0	6177	2
2	0	2	0	0	6178	2
2	0	2	0	0	6179	2
2	0	2	0	0	6180	2
2	2	2	0	2	6181	0
2	2	2	453	455	6182	1
2	0	2	1	1	6183	2
2	0	2	0	0	6184	2
2	5	2	1	6	6185	1
2	0	2	32	32	6186	2
2	0	2	0	0	6187	2
2	0	2	0	0	6188	2
2	0	2	0	0	6189	2
2	0	2	7	7	6190	2
2	0	2	0	0	6191	2
2	0	2	0	0	6192	2
2	0	2	0	0	6193	2
2	0	2	0	0	6194	2
2	0	2	0	0	6195	2
2	0	2	0	0	6196	2
2	0	2	0	0	6197	2
2	0	2	0	0	6198	2
2	0	2	48	48	6199	2
2	0	2	0	0	6200	2
2	0	2	0	0	6201	2
2	0	2	45	45	6202	2
2	0	2	0	0	6203	2
2	12	2	1	13	6204	0
2	44	2	146	190	6205	1
2	1	2	7	8	6206	1
2	0	2	0	0	6207	2
2	15	2	4	19	6208	0
2	0	2	41	41	6209	2
2	1	2	0	1	6210	0
2	0	2	0	0	6211	2
2	0	2	0	0	6212	2
2	0	2	0	0	6213	2
2	0	2	1	1	6214	2
2	0	2	0	0	6215	2
2	0	2	0	0	6216	2
2	0	2	0	0	6217	2
2	0	2	0	0	6218	2
2	0	2	0	0	6219	2
2	0	2	0	0	6220	2
2	0	2	0	0	6221	2
2	0	2	0	0	6222	2
2	0	2	0	0	6223	2
2	0	2	0	0	6224	2
2	0	2	0	0	6225	2
2	0	2	0	0	6226	2
2	0	2	0	0	6227	2
2	0	2	0	0	6228	2
2	0	2	0	0	6229	2
2	0	2	0	0	6230	2
2	0	2	0	0	6231	2
2	0	2	0	0	6232	2
2	0	2	0	0	6233	2
2	0	2	0	0	6234	2
2	0	2	0	0	6235	2
2	0	2	0	0	6236	2
2	2	2	1	3	6237	0
2	0	2	4	4	6238	2
2	1	2	0	1	6239	0
2	5	2	17	22	6240	1
2	0	2	2	2	6241	2
2	0	2	0	0	6242	2
2	0	2	0	0	6243	2
2	0	2	0	0	6244	2
2	0	2	0	0	6245	2
2	0	2	0	0	6246	2
2	0	2	0	0	6247	2
2	0	2	0	0	6248	2
2	0	2	0	0	6249	2
2	12	2	11	23	6250	1
2	0	2	2	2	6251	2
2	0	2	1	1	6252	2
2	2	2	1	3	6253	1
2	0	2	2	2	6254	2
2	0	2	0	0	6255	2
2	0	2	0	0	6256	2
2	0	2	0	0	6257	2
2	0	2	0	0	6258	2
2	0	2	0	0	6259	2
2	0	2	0	0	6260	2
2	0	2	0	0	6261	2
2	0	2	0	0	6262	2
2	0	2	0	0	6263	2
2	0	2	0	0	6264	2
2	0	2	0	0	6265	2
2	0	2	0	0	6266	2
2	0	2	0	0	6267	2
2	0	2	2	2	6268	2
2	0	2	0	0	6269	2
2	0	2	0	0	6270	2
2	0	2	0	0	6271	2
2	0	2	0	0	6272	2
2	0	2	0	0	6273	2
2	0	2	0	0	6274	2
2	0	2	0	0	6275	2
2	0	2	0	0	6276	2
2	0	2	0	0	6277	2
2	0	2	0	0	6278	2
2	0	2	0	0	6279	2
2	0	2	0	0	6280	2
2	0	2	0	0	6281	2
2	0	2	0	0	6282	2
2	0	2	0	0	6283	2
2	0	2	0	0	6284	2
2	4	2	0	4	6285	0
2	17	2	203	220	6286	1
2	0	2	0	0	6287	2
2	0	2	0	0	6288	2
2	19	2	37	56	6289	1
2	0	2	7	7	6290	2
2	0	2	0	0	6291	2
2	0	2	0	0	6292	2
2	0	2	0	0	6293	2
2	0	2	0	0	6294	2
2	0	2	0	0	6295	2
2	0	2	0	0	6296	2
2	2	2	0	2	6297	0
2	0	2	52	52	6298	2
2	0	2	0	0	6299	2
2	0	2	0	0	6300	2
2	0	2	0	0	6301	2
2	0	2	0	0	6302	2
2	0	2	0	0	6303	2
2	0	2	0	0	6304	2
2	0	2	0	0	6305	2
2	0	2	0	0	6306	2
2	273	2	1	274	6307	0
2	69	2	1046	1115	6308	1
2	0	2	152	152	6309	2
2	0	2	9	9	6310	2
2	86	2	3	89	6311	0
2	0	2	608	608	6312	2
2	20	2	0	20	6313	0
2	0	2	95	95	6314	2
2	10	2	0	10	6315	0
2	2	2	787	789	6316	1
2	0	2	0	0	6317	2
2	0	2	0	0	6318	2
2	20	2	17	37	6319	0
2	0	2	30	30	6320	2
2	7	2	0	7	6321	0
2	0	2	0	0	6322	2
2	26	2	60	86	6323	1
2	0	2	1	1	6324	2
2	0	2	0	0	6325	2
2	2	2	1	3	6326	1
2	2	2	40	42	6327	0
2	0	2	0	0	6328	2
2	0	2	0	0	6329	2
2	1	2	2	3	6330	0
2	16	2	0	16	6331	0
2	72	2	2921	2993	6332	1
2	0	2	11	11	6333	2
2	0	2	0	0	6334	2
2	25	2	8	33	6335	1
2	0	2	166	166	6336	2
2	4	2	1	5	6337	0
2	0	2	11	11	6338	2
2	1	2	0	1	6339	0
2	0	2	1	1	6340	2
2	0	2	0	0	6341	2
2	0	2	0	0	6342	2
2	0	2	0	0	6343	2
2	0	2	2	2	6344	2
2	0	2	0	0	6345	2
2	0	2	0	0	6346	2
2	0	2	0	0	6347	2
2	0	2	0	0	6348	2
2	0	2	0	0	6349	2
2	0	2	0	0	6350	2
2	8	2	0	8	6351	0
2	2	0	177	179	6352	1
2	0	2	0	0	6353	2
2	0	2	0	0	6354	2
2	7	0	5	12	6355	0
2	0	2	15	15	6356	2
2	4	2	0	4	6357	0
2	0	2	11	11	6358	2
2	0	2	0	0	6359	2
2	0	2	0	0	6360	2
2	1	2	0	1	6361	1
2	0	2	0	0	6362	2
2	3	2	2	5	6363	1
2	0	2	9	9	6364	2
2	0	2	0	0	6365	2
2	0	2	1	1	6366	2
2	0	2	0	0	6367	2
2	0	2	0	0	6368	2
2	0	2	0	0	6369	2
2	0	2	0	0	6370	2
2	1	2	0	1	6371	0
2	26	2	42	68	6372	1
2	0	2	1	1	6373	2
2	0	2	0	0	6374	2
2	17	2	624	641	6375	0
2	0	2	0	0	6376	2
2	1	2	9	10	6377	1
2	0	2	0	0	6378	2
2	0	2	0	0	6379	2
2	1	2	0	1	6380	1
2	0	2	1	1	6381	2
2	0	2	0	0	6382	2
2	0	2	0	0	6383	2
2	0	2	0	0	6384	2
2	0	2	0	0	6385	2
2	0	2	0	0	6386	2
2	0	2	0	0	6387	2
2	130	2	0	130	6388	0
2	67	2	926	993	6389	1
2	0	2	20	20	6390	2
2	0	2	2	2	6391	2
2	23	2	1	24	6392	0
2	0	2	141	141	6393	2
2	0	2	0	0	6394	2
2	0	2	0	0	6395	2
2	0	2	0	0	6396	2
2	0	2	0	0	6397	2
2	0	2	0	0	6398	2
2	0	2	0	0	6399	2
2	1	2	0	1	6400	0
2	1	2	26	27	6401	1
2	0	2	0	0	6402	2
2	0	2	0	0	6403	2
2	3	2	0	3	6404	0
2	0	2	7	7	6405	2
2	97	2	0	97	6406	0
2	0	2	77	77	6407	2
2	0	2	6	6	6408	2
2	0	2	0	0	6409	2
2	0	2	1	1	6410	2
2	0	2	0	0	6411	2
2	0	2	0	0	6412	2
2	0	2	0	0	6413	2
2	0	2	0	0	6414	2
2	0	2	0	0	6415	2
2	30	2	0	30	6416	0
2	14	2	661	675	6417	1
2	0	2	2	2	6418	2
2	0	2	1	1	6419	2
2	13	2	3	16	6420	0
2	0	2	0	0	6421	2
2	0	2	0	0	6422	2
2	0	2	0	0	6423	2
2	0	2	0	0	6424	2
2	0	2	0	0	6425	2
2	0	2	0	0	6426	2
2	0	2	0	0	6427	2
2	0	2	0	0	6428	2
2	0	2	0	0	6429	2
2	0	2	0	0	6430	2
2	0	2	0	0	6431	2
2	0	2	0	0	6432	2
2	0	2	1	1	6433	2
2	0	2	0	0	6434	2
2	0	2	0	0	6435	2
2	0	2	0	0	6436	2
2	0	2	0	0	6437	2
2	12	2	0	12	6438	0
2	9	2	47	56	6439	1
2	0	2	0	0	6440	2
2	0	2	0	0	6441	2
2	1	2	0	1	6442	1
2	184	2	4	188	6443	1
2	0	2	2	2	6444	2
2	0	2	0	0	6445	2
2	22	2	0	22	6446	0
2	0	2	0	0	6447	2
2	0	2	0	0	6448	2
2	0	2	0	0	6449	2
2	0	2	0	0	6450	2
2	0	2	0	0	6451	2
2	0	2	1	1	6452	2
2	0	2	0	0	6453	2
2	0	2	0	0	6454	2
2	14	2	0	14	6455	0
2	0	2	0	0	6456	2
2	0	2	0	0	6457	2
2	0	2	0	0	6458	2
2	0	2	0	0	6459	2
2	0	2	1	1	6460	2
2	0	2	3	3	6461	2
2	0	2	0	0	6462	2
2	0	2	0	0	6463	2
2	0	2	0	0	6464	2
2	0	2	45	45	6465	2
2	0	2	0	0	6466	2
2	0	2	0	0	6467	2
2	0	2	0	0	6468	2
2	0	2	3	3	6469	2
2	0	2	0	0	6470	2
2	0	2	0	0	6471	2
2	0	2	0	0	6472	2
2	0	2	0	0	6473	2
2	0	2	0	0	6474	2
2	0	2	0	0	6475	2
2	0	2	0	0	6476	2
2	0	2	0	0	6477	2
2	0	2	0	0	6478	2
2	273	2	0	273	6479	0
2	0	2	36	36	6480	2
2	0	2	1	1	6481	2
2	4	2	48	52	6482	1
2	0	2	5	5	6483	2
4	0	2	0	0	6484	2
2	0	2	48	48	6485	2
2	0	2	5	5	6486	2
4	0	2	0	0	6487	2
2	0	2	0	0	6488	2
2	0	2	0	0	6489	2
2	0	2	0	0	6490	2
2	0	2	0	0	6491	2
2	0	2	0	0	6492	2
2	0	2	1	1	6493	2
2	0	2	0	0	6494	2
2	0	2	0	0	6495	2
2	0	2	0	0	6496	2
2	0	2	0	0	6497	2
2	0	2	0	0	6498	2
2	0	2	0	0	6499	2
2	0	2	0	0	6500	2
2	0	2	0	0	6501	2
2	0	2	0	0	6502	2
2	0	2	0	0	6503	2
2	1	2	0	1	6504	0
2	0	2	5	5	6505	2
2	0	2	0	0	6506	2
2	0	2	0	0	6507	2
2	1	2	1	2	6508	1
2	0	2	1	1	6509	2
2	0	2	0	0	6510	2
2	0	2	0	0	6511	2
2	0	2	0	0	6512	2
2	0	2	0	0	6513	2
2	0	2	0	0	6514	2
2	0	2	0	0	6515	2
2	0	2	0	0	6516	2
2	0	2	0	0	6517	2
2	19	2	1	20	6518	0
2	0	2	0	0	6519	2
2	0	2	1	1	6520	2
2	0	2	0	0	6521	2
2	0	2	0	0	6522	2
2	0	2	0	0	6523	2
2	0	2	0	0	6524	2
2	158	2	421	579	6525	1
2	0	2	23	23	6526	2
2	0	2	1	1	6527	2
2	0	2	0	0	6528	2
2	0	2	3	3	6529	2
2	0	2	0	0	6530	2
2	0	2	0	0	6531	2
2	0	2	0	0	6532	2
2	0	2	0	0	6533	2
2	0	2	0	0	6534	2
2	0	2	0	0	6535	2
2	0	2	0	0	6536	2
2	0	2	0	0	6537	2
2	0	2	0	0	6538	2
2	0	2	0	0	6539	2
2	4	2	0	4	6540	0
2	0	2	11	11	6541	2
2	0	2	1	1	6542	2
2	0	2	0	0	6543	2
2	2	2	0	2	6544	0
2	0	2	9	9	6545	2
2	0	2	0	0	6546	2
2	0	2	0	0	6547	2
2	0	2	0	0	6548	2
2	0	2	0	0	6549	2
2	0	2	0	0	6550	2
2	0	2	0	0	6551	2
2	0	2	0	0	6552	2
2	0	2	0	0	6553	2
2	0	2	0	0	6554	2
2	0	2	0	0	6555	2
2	0	2	0	0	6556	2
2	0	2	0	0	6557	2
2	0	2	2	2	6558	2
2	0	2	6	6	6559	2
2	0	2	0	0	6560	2
2	0	2	0	0	6561	2
2	1	2	1	2	6562	0
2	0	2	0	0	6563	2
2	0	2	0	0	6564	2
2	0	2	0	0	6565	2
2	0	2	0	0	6566	2
2	0	2	0	0	6567	2
2	0	2	0	0	6568	2
2	0	2	0	0	6569	2
2	0	2	0	0	6570	2
2	0	2	0	0	6571	2
2	0	2	0	0	6572	2
2	0	2	0	0	6573	2
2	0	2	0	0	6574	2
2	58	2	4	62	6575	0
2	0	2	43	43	6576	2
2	0	2	42	42	6577	2
2	0	2	0	0	6578	2
2	0	2	0	0	6579	2
2	0	2	0	0	6580	2
2	0	2	0	0	6581	2
2	0	2	0	0	6582	2
2	0	2	0	0	6583	2
2	0	2	0	0	6584	2
2	0	2	0	0	6585	2
2	0	2	0	0	6586	2
2	0	2	0	0	6587	2
2	0	2	0	0	6588	2
2	0	2	0	0	6589	2
2	0	2	0	0	6590	2
2	0	2	0	0	6591	2
2	0	2	0	0	6592	2
2	0	2	0	0	6593	2
2	0	2	0	0	6594	2
2	0	2	0	0	6595	2
2	0	2	0	0	6596	2
2	0	2	0	0	6597	2
2	0	2	0	0	6598	2
2	0	2	0	0	6599	2
2	0	2	0	0	6600	2
2	0	2	0	0	6601	2
2	0	2	0	0	6602	2
2	0	2	0	0	6603	2
2	0	2	0	0	6604	2
2	0	2	0	0	6605	2
2	0	2	0	0	6606	2
2	0	2	0	0	6607	2
2	0	2	0	0	6608	2
2	0	2	0	0	6609	2
2	0	2	0	0	6610	2
2	0	2	0	0	6611	2
2	0	2	0	0	6612	2
2	0	2	0	0	6613	2
2	0	2	0	0	6614	2
2	0	2	0	0	6615	2
2	0	2	0	0	6616	2
2	0	2	0	0	6617	2
2	0	2	0	0	6618	2
2	0	2	0	0	6619	2
2	1	2	0	1	6620	0
2	0	2	0	0	6621	2
2	0	2	0	0	6622	2
2	4	2	0	4	6623	0
2	0	2	148	148	6624	2
2	0	2	0	0	6625	2
2	0	2	0	0	6626	2
2	2	2	0	2	6627	1
2	0	2	32	32	6628	2
2	0	2	0	0	6629	2
2	0	2	0	0	6630	2
2	10	2	1114	1124	6631	0
2	0	2	0	0	6632	2
2	0	2	0	0	6633	2
2	0	2	0	0	6634	2
2	0	2	0	0	6635	2
2	0	2	0	0	6636	2
2	0	2	0	0	6637	2
2	0	2	0	0	6638	2
2	9	2	0	9	6639	0
2	0	2	100	100	6640	2
2	6	2	0	6	6641	0
2	0	2	31	31	6642	2
2	0	2	0	0	6643	2
2	0	2	0	0	6644	2
2	0	2	0	0	6645	2
2	0	2	0	0	6646	2
2	0	2	0	0	6647	2
2	0	2	0	0	6648	2
2	0	2	0	0	6649	2
2	0	2	0	0	6650	2
0	29	4	1388	1417	6651	0
0	0	4	1388	1388	6652	2
2	0	2	0	0	6653	2
2	0	2	0	0	6654	2
2	0	2	0	0	6655	2
2	0	2	0	0	6656	2
2	0	2	0	0	6657	2
2	0	2	0	0	6658	2
2	7	2	0	7	6659	0
2	1	2	0	1	6660	0
2	0	2	0	0	6661	2
2	0	2	0	0	6662	2
2	0	2	0	0	6663	2
2	0	2	0	0	6664	2
2	0	2	0	0	6665	2
2	0	2	0	0	6666	2
2	26	2	36	62	6667	1
2	0	2	3	3	6668	2
2	0	2	0	0	6669	2
2	15	2	1	16	6670	1
2	1	2	18	19	6671	1
2	0	2	0	0	6672	2
2	0	2	0	0	6673	2
2	0	2	2	2	6674	2
2	0	2	0	0	6675	2
2	0	2	0	0	6676	2
2	0	2	0	0	6677	2
2	0	2	0	0	6678	2
2	0	2	0	0	6679	2
2	0	2	0	0	6680	2
2	1	2	0	1	6681	0
2	0	2	13	13	6682	2
2	0	2	0	0	6683	2
2	0	2	0	0	6684	2
2	0	2	0	0	6685	2
2	0	2	4	4	6686	2
2	2	2	0	2	6687	0
2	0	2	0	0	6688	2
2	0	2	0	0	6689	2
2	0	2	0	0	6690	2
2	0	2	0	0	6691	2
2	0	2	0	0	6692	2
2	0	2	0	0	6693	2
2	13	2	1	14	6694	0
2	7	2	0	7	6695	0
2	0	2	72	72	6696	2
2	0	2	0	0	6697	2
2	0	2	0	0	6698	2
2	0	2	0	0	6699	2
2	0	2	0	0	6700	2
2	0	2	0	0	6701	2
2	0	2	0	0	6702	2
2	0	2	0	0	6703	2
2	0	2	2	2	6704	2
2	0	2	0	0	6705	2
2	0	2	0	0	6706	2
2	0	2	0	0	6707	2
2	0	2	0	0	6708	2
2	0	2	0	0	6709	2
2	0	2	0	0	6710	2
2	0	2	0	0	6711	2
2	0	2	0	0	6712	2
2	0	2	0	0	6713	2
2	0	2	0	0	6714	2
2	0	2	0	0	6715	2
2	0	2	0	0	6716	2
2	0	2	0	0	6717	2
2	0	2	0	0	6718	2
2	0	2	0	0	6719	2
2	0	2	0	0	6720	2
2	0	2	8	8	6721	2
2	0	2	0	0	6722	2
2	0	2	0	0	6723	2
2	0	2	0	0	6724	2
2	0	2	1	1	6725	2
2	0	2	0	0	6726	2
2	0	2	1	1	6727	2
2	0	2	0	0	6728	2
2	0	2	0	0	6729	2
2	0	2	0	0	6730	2
2	0	2	0	0	6731	2
2	0	2	0	0	6732	2
2	0	2	0	0	6733	2
2	0	2	0	0	6734	2
2	0	2	0	0	6735	2
2	0	2	0	0	6736	2
2	0	2	0	0	6737	2
2	1	2	1	2	6738	1
2	0	2	0	0	6739	2
2	0	2	0	0	6740	2
2	0	2	0	0	6741	2
2	0	2	0	0	6742	2
2	0	2	0	0	6743	2
2	0	2	0	0	6744	2
2	0	2	0	0	6745	2
2	0	2	0	0	6746	2
2	0	2	0	0	6747	2
2	0	2	0	0	6748	2
2	0	2	0	0	6749	2
2	0	2	0	0	6750	2
2	94	2	1	95	6751	0
2	42	2	1	43	6752	0
2	0	2	232	232	6753	2
2	95	2	1159	1254	6754	1
2	0	2	15	15	6755	2
2	0	2	0	0	6756	2
2	0	2	0	0	6757	2
2	0	2	0	0	6758	2
2	0	2	0	0	6759	2
2	0	2	0	0	6760	2
2	0	2	0	0	6761	2
2	0	2	0	0	6762	2
2	0	2	0	0	6763	2
2	0	2	0	0	6764	2
2	0	2	0	0	6765	2
2	0	2	0	0	6766	2
2	0	2	0	0	6767	2
2	0	2	0	0	6768	2
2	0	2	0	0	6769	2
2	0	4	0	0	6770	2
2	0	2	0	0	6771	2
2	0	2	0	0	6772	2
2	0	4	0	0	6773	2
2	0	2	0	0	6774	2
4	0	2	0	0	6775	2
2	0	2	0	0	6776	2
2	0	2	0	0	6777	2
2	0	2	0	0	6778	2
2	0	2	0	0	6779	2
2	0	2	0	0	6780	2
2	0	2	0	0	6781	2
2	1	2	0	1	6782	0
2	1	2	8	9	6783	1
2	0	2	0	0	6784	2
2	0	2	0	0	6785	2
2	0	2	0	0	6786	2
2	0	2	0	0	6787	2
2	0	2	0	0	6788	2
2	0	2	0	0	6789	2
2	0	2	0	0	6790	2
2	0	2	0	0	6791	2
2	0	2	0	0	6792	2
2	0	2	0	0	6793	2
2	11	2	0	11	6794	0
2	0	2	0	0	6795	2
2	0	2	0	0	6796	2
2	0	2	0	0	6797	2
2	0	2	0	0	6798	2
2	0	2	0	0	6799	2
2	0	2	0	0	6800	2
2	0	2	0	0	6801	2
2	4	2	1	5	6802	0
2	3	2	74	77	6803	1
2	0	2	13	13	6804	2
2	0	2	0	0	6805	2
2	6	2	5	11	6806	1
2	0	2	11	11	6807	2
2	2	2	1	3	6808	1
2	0	2	1	1	6809	2
2	2	2	394	396	6810	1
2	0	2	0	0	6811	2
2	0	2	0	0	6812	2
2	0	2	0	0	6813	2
2	0	2	0	0	6814	2
2	0	2	0	0	6815	2
2	0	2	9	9	6816	2
2	0	2	0	0	6817	2
2	0	2	0	0	6818	2
2	2	2	0	2	6819	1
2	0	2	1	1	6820	2
2	16	2	2	18	6821	0
2	0	2	1	1	6822	2
2	0	2	0	0	6823	2
2	0	2	0	0	6824	2
2	0	2	0	0	6825	2
2	0	2	0	0	6826	2
2	0	2	0	0	6827	2
2	0	2	0	0	6828	2
2	0	2	0	0	6829	2
2	0	2	5	5	6830	2
2	0	2	0	0	6831	2
2	0	2	0	0	6832	2
2	2	2	0	2	6833	1
2	0	2	0	0	6834	2
2	0	2	0	0	6835	2
2	0	2	0	0	6836	2
2	0	2	2	2	6837	2
2	0	2	0	0	6838	2
2	0	2	4	4	6839	2
2	0	2	0	0	6840	2
2	0	2	0	0	6841	2
2	0	2	0	0	6842	2
2	0	2	0	0	6843	2
2	0	2	0	0	6844	2
2	0	2	0	0	6845	2
2	0	2	0	0	6846	2
2	0	2	0	0	6847	2
2	0	2	0	0	6848	2
2	0	2	0	0	6849	2
2	0	2	0	0	6850	2
2	0	2	0	0	6851	2
2	0	2	0	0	6852	2
2	0	2	0	0	6853	2
2	0	2	0	0	6854	2
2	0	2	0	0	6855	2
2	0	2	0	0	6856	2
2	1	2	0	1	6857	0
2	0	2	13	13	6858	2
2	0	2	0	0	6859	2
2	0	2	0	0	6860	2
2	1	2	1	2	6861	1
2	0	2	3	3	6862	2
2	0	2	6	6	6863	2
2	0	2	0	0	6864	2
2	0	2	0	0	6865	2
2	0	2	0	0	6866	2
2	0	2	0	0	6867	2
2	0	2	0	0	6868	2
2	0	2	0	0	6869	2
2	0	2	0	0	6870	2
2	0	2	0	0	6871	2
2	0	2	0	0	6872	2
2	0	2	0	0	6873	2
2	0	2	0	0	6874	2
2	0	2	0	0	6875	2
2	0	2	0	0	6876	2
2	0	2	0	0	6877	2
2	0	2	0	0	6878	2
2	0	2	0	0	6879	2
4	30	2	4	34	6880	0
4	0	2	0	0	6881	2
2	0	2	0	0	6882	2
2	0	2	0	0	6883	2
2	0	2	0	0	6884	2
2	0	2	0	0	6885	2
2	0	2	0	0	6886	2
2	0	2	0	0	6887	2
2	0	2	0	0	6888	2
2	0	2	0	0	6889	2
2	0	2	0	0	6890	2
2	0	2	0	0	6891	2
2	0	2	0	0	6892	2
2	0	2	0	0	6893	2
2	149	2	0	149	6894	0
2	80	4	1074	1154	6895	1
2	0	2	9	9	6896	2
2	0	2	4	4	6897	2
2	56	4	17	73	6898	0
2	0	2	116	116	6899	2
2	0	2	0	0	6900	2
2	0	2	0	0	6901	2
2	0	2	0	0	6902	2
2	0	2	0	0	6903	2
2	0	2	0	0	6904	2
2	0	2	0	0	6905	2
2	0	2	0	0	6906	2
2	0	2	0	0	6907	2
2	0	2	0	0	6908	2
2	0	2	0	0	6909	2
2	0	2	0	0	6910	2
2	0	2	0	0	6911	2
2	0	2	0	0	6912	2
2	0	2	0	0	6913	2
2	8370	4	5	8375	6914	1
2	13	4	5	18	6915	0
0	32	2	0	32	6916	0
0	25	2	0	25	6917	0
2	0	2	0	0	6918	2
2	0	2	11	11	6919	2
2	0	2	0	0	6920	2
2	0	2	0	0	6921	2
2	1	2	1	2	6922	1
2	0	2	6	6	6923	2
2	971	2	0	971	6924	0
2	120	2	2788	2908	6925	1
2	0	2	40	40	6926	2
2	0	2	1	1	6927	2
2	81	2	4	85	6928	1
2	0	2	781	781	6929	2
2	0	2	0	0	6930	2
2	0	2	65	65	6931	2
2	0	2	0	0	6932	2
2	0	2	0	0	6933	2
2	0	2	2	2	6934	2
2	1	4	138	139	6935	1
2	0	2	0	0	6936	2
2	0	2	3	3	6937	2
2	0	2	0	0	6938	2
2	0	2	0	0	6939	2
2	0	2	0	0	6940	2
2	0	2	0	0	6941	2
2	0	2	0	0	6942	2
2	0	2	0	0	6943	2
2	0	2	0	0	6944	2
2	0	2	0	0	6945	2
2	0	2	0	0	6946	2
2	0	2	0	0	6947	2
4	27	2	3	30	6948	0
4	2	2	0	2	6949	0
0	0	2	0	0	6950	2
0	0	2	0	0	6951	2
0	0	2	0	0	6952	2
2	0	2	0	0	6953	2
2	0	2	2	2	6954	2
2	0	2	0	0	6955	2
2	0	2	0	0	6956	2
2	0	2	0	0	6957	2
2	0	2	0	0	6958	2
2	0	2	0	0	6959	2
2	0	2	0	0	6960	2
2	0	2	0	0	6961	2
2	0	2	0	0	6962	2
2	0	2	0	0	6963	2
2	0	2	0	0	6964	2
2	1	2	0	1	6965	0
2	0	2	32	32	6966	2
2	0	2	0	0	6967	2
2	0	2	0	0	6968	2
2	0	2	0	0	6969	2
2	0	2	2	2	6970	2
2	0	2	0	0	6971	2
2	0	2	0	0	6972	2
2	0	2	0	0	6973	2
2	0	2	1	1	6974	2
2	0	2	0	0	6975	2
2	0	2	5	5	6976	2
2	0	2	0	0	6977	2
2	0	2	0	0	6978	2
2	0	2	0	0	6979	2
2	0	2	0	0	6980	2
2	0	2	0	0	6981	2
2	0	2	0	0	6982	2
2	0	2	0	0	6983	2
2	0	2	0	0	6984	2
2	0	2	0	0	6985	2
2	0	2	0	0	6986	2
2	0	4	59	59	6987	2
2	0	2	0	0	6988	2
2	0	2	0	0	6989	2
2	0	2	0	0	6990	2
2	0	2	0	0	6991	2
2	0	2	0	0	6992	2
2	2	2	7	9	6993	1
2	0	2	0	0	6994	2
2	0	2	0	0	6995	2
2	0	2	0	0	6996	2
2	0	2	0	0	6997	2
2	0	2	0	0	6998	2
2	0	2	1	1	6999	2
2	0	2	0	0	7000	2
2	0	2	0	0	7001	2
2	0	2	0	0	7002	2
2	0	2	0	0	7003	2
2	0	2	0	0	7004	2
2	0	4	55	55	7005	2
2	0	2	0	0	7006	2
2	0	2	0	0	7007	2
2	0	4	0	0	7008	2
2	0	2	0	0	7009	2
2	0	2	0	0	7010	2
2	0	2	0	0	7011	2
2	0	2	0	0	7012	2
2	0	2	0	0	7013	2
2	0	2	1	1	7014	2
2	0	2	0	0	7015	2
2	0	2	0	0	7016	2
2	0	2	0	0	7017	2
2	0	2	0	0	7018	2
2	0	2	0	0	7019	2
2	0	2	0	0	7020	2
2	0	2	0	0	7021	2
2	0	2	0	0	7022	2
2	0	2	0	0	7023	2
2	0	2	0	0	7024	2
0	12	2	0	12	7025	0
0	144	2	0	144	7026	0
0	1	2	0	1	7027	0
2	0	2	0	0	7028	2
2	0	2	0	0	7029	2
2	0	2	0	0	7030	2
2	0	2	0	0	7031	2
2	0	2	0	0	7032	2
2	0	2	0	0	7033	2
2	0	2	0	0	7034	2
2	0	2	11	11	7035	2
2	0	2	0	0	7036	2
2	0	2	0	0	7037	2
2	0	2	0	0	7038	2
2	0	2	1	1	7039	2
2	0	2	1	1	7040	2
2	0	2	0	0	7041	2
2	0	2	0	0	7042	2
2	0	2	1	1	7043	2
2	0	2	0	0	7044	2
2	0	2	0	0	7045	2
2	0	2	0	0	7046	2
2	0	2	0	0	7047	2
2	0	2	2	2	7048	2
2	0	2	0	0	7049	2
2	0	2	0	0	7050	2
2	0	2	0	0	7051	2
2	0	2	0	0	7052	2
2	0	2	0	0	7053	2
2	0	2	0	0	7054	2
2	0	2	0	0	7055	2
2	0	2	0	0	7056	2
2	0	2	0	0	7057	2
2	0	2	2	2	7058	2
2	0	2	0	0	7059	2
2	0	2	0	0	7060	2
2	0	2	0	0	7061	2
2	0	2	0	0	7062	2
2	1	2	0	1	7063	0
2	0	2	2	2	7064	2
2	0	2	9	9	7065	2
2	0	2	0	0	7066	2
2	1	2	0	1	7067	1
2	0	2	0	0	7068	2
2	0	2	0	0	7069	2
2	0	2	0	0	7070	2
2	0	2	0	0	7071	2
2	0	2	0	0	7072	2
2	0	2	0	0	7073	2
2	0	2	0	0	7074	2
2	0	2	0	0	7075	2
2	0	2	0	0	7076	2
2	0	2	0	0	7077	2
2	0	2	0	0	7078	2
2	0	2	2	2	7079	2
2	0	2	0	0	7080	2
2	0	2	5	5	7081	2
2	0	2	0	0	7082	2
2	0	2	0	0	7083	2
2	0	2	0	0	7084	2
2	0	2	0	0	7085	2
2	0	2	0	0	7086	2
2	0	2	0	0	7087	2
0	0	2	0	0	7088	2
0	0	2	0	0	7089	2
2	0	2	0	0	7090	2
2	0	2	0	0	7091	2
2	0	2	0	0	7092	2
2	0	4	0	0	7093	2
2	0	2	0	0	7094	2
2	0	2	0	0	7095	2
2	0	4	0	0	7096	2
2	0	2	0	0	7097	2
2	0	2	0	0	7098	2
2	0	2	0	0	7099	2
2	0	2	0	0	7100	2
2	0	2	0	0	7101	2
2	1	2	0	1	7102	0
2	0	2	1	1	7103	2
2	0	2	0	0	7104	2
2	0	2	0	0	7105	2
2	0	2	0	0	7106	2
2	0	2	0	0	7107	2
2	0	2	0	0	7108	2
2	0	2	0	0	7109	2
2	0	2	0	0	7110	2
2	0	2	0	0	7111	2
2	0	2	0	0	7112	2
2	0	2	0	0	7113	2
2	0	2	0	0	7114	2
2	0	2	0	0	7115	2
2	0	2	0	0	7116	2
2	0	2	0	0	7117	2
2	0	2	0	0	7118	2
2	0	2	0	0	7119	2
2	0	2	0	0	7120	2
2	0	2	0	0	7121	2
2	0	2	0	0	7122	2
2	0	2	0	0	7123	2
2	0	2	1	1	7124	2
2	0	2	0	0	7125	2
2	0	2	10	10	7126	2
2	0	2	0	0	7127	2
2	0	2	0	0	7128	2
2	0	2	0	0	7129	2
2	0	2	1	1	7130	2
2	0	2	0	0	7131	2
2	0	2	0	0	7132	2
2	0	2	0	0	7133	2
2	0	2	0	0	7134	2
2	0	2	0	0	7135	2
2	0	2	0	0	7136	2
2	0	2	0	0	7137	2
2	0	2	0	0	7138	2
2	0	2	0	0	7139	2
2	0	2	0	0	7140	2
2	0	2	0	0	7141	2
2	0	2	0	0	7142	2
2	1	2	0	1	7143	0
2	7	2	10	17	7144	1
2	0	2	0	0	7145	2
2	0	2	0	0	7146	2
2	1	2	0	1	7147	0
2	0	2	1	1	7148	2
2	0	2	0	0	7149	2
2	0	2	2	2	7150	2
2	0	2	0	0	7151	2
2	0	2	0	0	7152	2
2	0	2	0	0	7153	2
2	0	2	0	0	7154	2
2	0	2	0	0	7155	2
2	0	2	3	3	7156	2
2	0	2	0	0	7157	2
2	0	2	0	0	7158	2
2	0	2	0	0	7159	2
2	0	2	6	6	7160	2
2	0	2	0	0	7161	2
2	0	2	0	0	7162	2
2	0	2	0	0	7163	2
2	0	2	0	0	7164	2
2	0	2	0	0	7165	2
2	0	2	0	0	7166	2
2	0	2	0	0	7167	2
2	0	2	0	0	7168	2
2	0	2	0	0	7169	2
2	0	2	0	0	7170	2
2	0	2	0	0	7171	2
2	0	2	0	0	7172	2
2	0	2	0	0	7173	2
2	0	2	0	0	7174	2
2	35	2	1	36	7175	0
2	42	2	413	455	7176	1
2	0	2	6	6	7177	2
2	0	2	0	0	7178	2
2	40	2	3	43	7179	1
2	0	2	160	160	7180	2
2	0	2	0	0	7181	2
2	0	2	0	0	7182	2
2	0	2	0	0	7183	2
2	0	2	0	0	7184	2
2	0	2	0	0	7185	2
2	0	2	0	0	7186	2
2	0	2	0	0	7187	2
2	0	2	0	0	7188	2
0	1901	2	1	1902	7189	0
0	2249	2	32	2281	7190	0
0	416	2	0	416	7191	0
2	2	2	0	2	7192	0
2	0	2	2	2	7193	2
2	0	2	0	0	7194	2
2	0	2	0	0	7195	2
2	0	2	0	0	7196	2
2	0	2	0	0	7197	2
2	1	2	0	1	7198	0
2	0	2	0	0	7199	2
2	0	2	0	0	7200	2
2	0	2	0	0	7201	2
2	0	2	0	0	7202	2
2	0	2	0	0	7203	2
2	0	2	0	0	7204	2
2	0	2	0	0	7205	2
2	0	2	0	0	7206	2
2	0	2	0	0	7207	2
2	0	2	0	0	7208	2
2	0	2	0	0	7209	2
2	0	2	0	0	7210	2
2	193	2	0	193	7211	0
2	3	2	402	405	7212	1
2	0	2	70	70	7213	2
2	0	2	0	0	7214	2
2	41	2	0	41	7215	1
2	0	2	52	52	7216	2
2	0	2	0	0	7217	2
2	0	2	0	0	7218	2
2	8	2	0	8	7219	1
2	0	2	16	16	7220	2
4	0	2	2	2	7221	2
2	93	2	2	95	7222	1
2	0	2	749	749	7223	2
2	1	4	3900	3901	7224	1
2	0	2	0	0	7225	2
2	0	2	0	0	7226	2
2	1	2	10	11	7227	1
2	0	2	0	0	7228	2
2	0	2	0	0	7229	2
2	0	2	0	0	7230	2
2	0	2	4	4	7231	2
2	0	2	0	0	7232	2
2	0	2	0	0	7233	2
2	0	2	0	0	7234	2
2	0	2	0	0	7235	2
2	112	2	0	112	7236	0
2	105	2	1062	1167	7237	1
2	0	2	116	116	7238	2
2	0	2	2	2	7239	2
2	0	2	0	0	7240	2
2	0	2	0	0	7241	2
2	0	4	88	88	7242	2
2	0	2	0	0	7243	2
2	0	2	0	0	7244	2
2	0	4	46	46	7245	2
2	0	2	0	0	7246	2
2	2	0	17	19	7247	1
2	0	2	0	0	7248	2
2	0	2	0	0	7249	2
2	0	0	1	1	7250	2
2	0	2	0	0	7251	2
2	0	2	0	0	7252	2
2	0	2	1	1	7253	2
2	0	2	0	0	7254	2
2	0	2	0	0	7255	2
2	0	2	0	0	7256	2
2	0	2	0	0	7257	2
2	0	2	0	0	7258	2
2	0	2	0	0	7259	2
2	0	2	0	0	7260	2
2	0	2	0	0	7261	2
2	0	2	0	0	7262	2
2	0	2	0	0	7263	2
2	0	2	0	0	7264	2
2	0	2	0	0	7265	2
2	0	2	0	0	7266	2
2	0	2	0	0	7267	2
2	2	4	740	742	7268	1
2	0	2	0	0	7269	2
2	0	2	0	0	7270	2
2	0	4	556	556	7271	2
2	0	2	8	8	7272	2
2	0	2	0	0	7273	2
2	0	2	2	2	7274	2
2	0	2	0	0	7275	2
2	0	2	0	0	7276	2
2	0	2	0	0	7277	2
2	0	2	0	0	7278	2
2	0	2	0	0	7279	2
2	0	2	0	0	7280	2
2	0	2	0	0	7281	2
2	0	2	0	0	7282	2
2	0	2	0	0	7283	2
2	0	2	0	0	7284	2
2	0	2	0	0	7285	2
2	0	2	0	0	7286	2
2	0	2	0	0	7287	2
2	0	2	0	0	7288	2
2	0	2	0	0	7289	2
2	3	2	0	3	7290	0
2	0	2	2	2	7291	2
2	0	2	0	0	7292	2
2	0	2	0	0	7293	2
2	0	2	0	0	7294	2
2	0	2	0	0	7295	2
2	0	2	1	1	7296	2
2	0	2	0	0	7297	2
2	0	2	0	0	7298	2
2	0	2	0	0	7299	2
2	0	2	0	0	7300	2
2	1	2	0	1	7301	0
2	0	2	0	0	7302	2
2	0	2	0	0	7303	2
2	0	2	0	0	7304	2
2	0	2	0	0	7305	2
2	0	2	0	0	7306	2
2	0	2	0	0	7307	2
2	0	2	62	62	7308	2
2	0	2	0	0	7309	2
2	0	2	0	0	7310	2
2	0	2	0	0	7311	2
2	0	2	1	1	7312	2
2	0	2	1	1	7313	2
2	0	2	0	0	7314	2
2	0	2	0	0	7315	2
2	0	2	0	0	7316	2
2	0	2	0	0	7317	2
2	0	2	1	1	7318	2
2	0	2	4	4	7319	2
2	0	2	0	0	7320	2
2	0	2	0	0	7321	2
2	0	2	0	0	7322	2
2	0	2	0	0	7323	2
2	0	2	0	0	7324	2
2	0	2	0	0	7325	2
2	0	2	0	0	7326	2
2	0	2	3	3	7327	2
2	0	2	0	0	7328	2
2	0	2	0	0	7329	2
2	0	2	0	0	7330	2
2	0	2	6	6	7331	2
2	0	2	0	0	7332	2
2	0	2	9	9	7333	2
2	0	2	0	0	7334	2
2	0	2	0	0	7335	2
0	1	2	3	4	7336	0
2	0	2	0	0	7337	2
2	0	2	0	0	7338	2
2	0	2	0	0	7339	2
2	0	2	0	0	7340	2
2	0	2	0	0	7341	2
2	0	2	0	0	7342	2
2	0	2	0	0	7343	2
2	0	2	0	0	7344	2
2	0	2	0	0	7345	2
2	0	4	1	1	7346	2
2	0	2	0	0	7347	2
2	0	2	0	0	7348	2
2	0	4	15	15	7349	2
2	0	2	0	0	7350	2
2	0	2	0	0	7351	2
2	7	2	0	7	7352	0
2	0	2	11	11	7353	2
2	0	2	0	0	7354	2
2	0	2	0	0	7355	2
2	0	2	0	0	7356	2
2	0	2	0	0	7357	2
2	0	2	0	0	7358	2
2	42	2	0	42	7359	0
2	11	2	224	235	7360	1
2	0	2	7	7	7361	2
2	0	2	0	0	7362	2
2	12	2	4	16	7363	1
2	0	2	43	43	7364	2
2	0	2	0	0	7365	2
2	0	2	0	0	7366	2
2	0	2	0	0	7367	2
2	0	2	0	0	7368	2
2	0	2	0	0	7369	2
2	0	2	0	0	7370	2
2	8	2	0	8	7371	0
2	0	2	32	32	7372	2
2	0	2	0	0	7373	2
2	0	2	0	0	7374	2
2	0	2	0	0	7375	2
2	0	2	2	2	7376	2
2	0	2	0	0	7377	2
2	0	2	0	0	7378	2
0	325	2	2	327	7379	0
0	4	2	1	5	7380	0
2	0	2	0	0	7381	2
2	0	2	0	0	7382	2
4	2965	2	8	2973	7383	0
2	0	2	0	0	7384	2
2	0	2	11	11	7385	2
2	0	2	0	0	7386	2
2	0	2	0	0	7387	2
2	0	2	0	0	7388	2
2	0	2	0	0	7389	2
2	0	2	0	0	7390	2
2	0	2	0	0	7391	2
2	0	2	0	0	7392	2
2	11	2	0	11	7393	0
2	5	2	47	52	7394	1
2	0	2	0	0	7395	2
2	0	2	0	0	7396	2
2	1	2	0	1	7397	1
2	0	2	3	3	7398	2
4	0	2	2	2	7399	2
2	19	4	65	84	7400	0
2	1981	4	326	2307	7401	1
2	0	2	0	0	7402	2
2	0	2	0	0	7403	2
2	0	2	0	0	7404	2
2	0	2	0	0	7405	2
2	0	2	0	0	7406	2
2	0	2	0	0	7407	2
2	0	2	0	0	7408	2
2	0	2	0	0	7409	2
2	0	2	0	0	7410	2
2	0	2	0	0	7411	2
2	0	2	0	0	7412	2
2	0	2	0	0	7413	2
2	2	2	0	2	7414	0
2	14	2	61	75	7415	1
2	0	2	4	4	7416	2
2	0	2	0	0	7417	2
2	1	2	0	1	7418	0
2	1	2	19	20	7419	1
2	0	2	0	0	7420	2
2	0	4	1	1	7421	2
2	0	2	0	0	7422	2
2	0	2	0	0	7423	2
2	0	4	1	1	7424	2
2	0	2	0	0	7425	2
2	0	2	0	0	7426	2
2	0	2	0	0	7427	2
2	0	2	0	0	7428	2
2	0	2	0	0	7429	2
2	0	2	0	0	7430	2
2	0	2	0	0	7431	2
2	0	2	0	0	7432	2
2	0	2	0	0	7433	2
2	0	2	0	0	7434	2
2	0	2	0	0	7435	2
2	0	2	0	0	7436	2
2	0	2	0	0	7437	2
2	0	2	0	0	7438	2
2	0	2	0	0	7439	2
2	0	2	0	0	7440	2
2	0	2	0	0	7441	2
2	0	2	0	0	7442	2
2	0	2	0	0	7443	2
2	0	2	0	0	7444	2
2	0	2	0	0	7445	2
2	0	2	0	0	7446	2
2	0	2	0	0	7447	2
2	0	2	0	0	7448	2
2	0	2	0	0	7449	2
2	0	2	0	0	7450	2
2	0	0	0	0	7451	2
2	0	2	0	0	7452	2
2	0	2	0	0	7453	2
2	0	0	0	0	7454	2
2	0	2	0	0	7455	2
2	0	2	0	0	7456	2
2	0	2	3	3	7457	2
2	0	2	0	0	7458	2
2	0	2	0	0	7459	2
2	0	2	0	0	7460	2
2	0	2	0	0	7461	2
0	1	2	0	1	7462	1
2	0	2	5	5	7463	2
2	0	2	0	0	7464	2
2	0	0	0	0	7465	2
2	0	2	0	0	7466	2
2	0	2	0	0	7467	2
2	0	2	0	0	7468	2
2	0	2	0	0	7469	2
2	0	2	0	0	7470	2
2	0	2	0	0	7471	2
2	0	2	0	0	7472	2
2	0	2	0	0	7473	2
2	0	0	0	0	7474	2
2	0	2	0	0	7475	2
2	1	4	17	18	7476	1
2	0	2	0	0	7477	2
2	0	2	0	0	7478	2
0	0	4	9	9	7479	2
2	0	2	13	13	7480	2
0	0	4	0	0	7481	2
2	0	2	0	0	7482	2
2	0	2	0	0	7483	2
2	0	2	0	0	7484	2
2	0	2	0	0	7485	2
2	0	2	0	0	7486	2
2	0	2	0	0	7487	2
2	0	2	0	0	7488	2
2	0	2	0	0	7489	2
2	0	2	0	0	7490	2
2	0	2	0	0	7491	2
2	0	2	0	0	7492	2
2	0	2	0	0	7493	2
2	0	2	0	0	7494	2
2	0	2	0	0	7495	2
2	0	2	0	0	7496	2
2	0	2	0	0	7497	2
2	0	2	0	0	7498	2
2	0	2	0	0	7499	2
2	0	2	0	0	7500	2
2	0	2	0	0	7501	2
2	0	2	0	0	7502	2
2	0	2	0	0	7503	2
2	0	2	0	0	7504	2
2	0	2	0	0	7505	2
2	0	2	0	0	7506	2
2	0	2	0	0	7507	2
2	0	2	0	0	7508	2
2	0	2	0	0	7509	2
2	0	2	0	0	7510	2
2	0	2	0	0	7511	2
2	0	2	0	0	7512	2
2	74	2	1	75	7513	0
2	0	2	0	0	7514	2
2	0	2	0	0	7515	2
2	0	2	0	0	7516	2
2	0	2	0	0	7517	2
2	0	2	0	0	7518	2
2	0	2	0	0	7519	2
2	28	0	7862	7890	7520	1
2	0	2	19	19	7521	2
2	0	2	1	1	7522	2
2	0	2	104	104	7523	2
4	3	2	31	34	7524	0
2	0	0	82	82	7525	2
2	0	2	0	0	7526	2
2	0	2	0	0	7527	2
0	0	4	39	39	7528	2
2	0	2	0	0	7529	2
2	0	2	0	0	7530	2
2	0	2	0	0	7531	2
2	0	2	0	0	7532	2
2	0	2	0	0	7533	2
2	0	2	0	0	7534	2
2	3	2	0	3	7535	0
2	0	2	24	24	7536	2
2	0	2	0	0	7537	2
2	0	2	0	0	7538	2
2	1	2	0	1	7539	0
2	0	2	0	0	7540	2
2	0	2	0	0	7541	2
2	0	2	0	0	7542	2
2	0	2	0	0	7543	2
2	0	2	24	24	7544	2
2	0	2	0	0	7545	2
2	0	2	0	0	7546	2
4	0	2	18	18	7547	2
4	0	4	99	99	7548	2
4	16	2	0	16	7549	0
2	0	2	0	0	7550	2
2	0	2	0	0	7551	2
2	0	2	0	0	7552	2
2	0	2	1	1	7553	2
2	0	2	0	0	7554	2
2	0	2	0	0	7555	2
2	0	2	0	0	7556	2
2	0	4	509	509	7557	2
2	0	2	0	0	7558	2
2	0	2	0	0	7559	2
4	0	2	0	0	7560	2
2	0	2	0	0	7561	2
2	0	2	0	0	7562	2
2	0	2	0	0	7563	2
2	0	2	0	0	7564	2
2	0	2	0	0	7565	2
2	0	2	0	0	7566	2
2	0	2	0	0	7567	2
2	0	2	0	0	7568	2
2	0	2	0	0	7569	2
2	0	2	0	0	7570	2
2	0	2	4	4	7571	2
2	0	2	0	0	7572	2
2	0	2	0	0	7573	2
2	0	2	1	1	7574	2
2	0	2	0	0	7575	2
2	0	2	0	0	7576	2
2	0	2	1	1	7577	2
2	0	2	0	0	7578	2
2	0	2	0	0	7579	2
2	0	2	0	0	7580	2
2	0	2	0	0	7581	2
2	0	2	0	0	7582	2
2	0	2	0	0	7583	2
2	0	2	0	0	7584	2
2	0	2	0	0	7585	2
2	0	0	0	0	7586	2
2	0	2	0	0	7587	2
2	0	2	0	0	7588	2
2	0	0	2	2	7589	2
0	0	2	0	0	7590	2
2	0	2	0	0	7591	2
2	0	2	0	0	7592	2
2	0	2	0	0	7593	2
2	0	2	0	0	7594	2
2	0	2	0	0	7595	2
2	0	2	0	0	7596	2
2	0	2	0	0	7597	2
2	1	4	1	2	7598	1
2	0	2	0	0	7599	2
2	0	2	0	0	7600	2
4	184	2	3	187	7601	0
2	0	2	0	0	7602	2
2	0	2	0	0	7603	2
2	0	2	0	0	7604	2
2	0	2	0	0	7605	2
2	0	2	0	0	7606	2
2	0	2	0	0	7607	2
2	0	2	0	0	7608	2
2	0	4	6	6	7609	2
2	0	2	0	0	7610	2
2	0	2	0	0	7611	2
2	0	4	3	3	7612	2
2	0	4	0	0	7613	2
2	0	2	0	0	7614	2
2	0	2	0	0	7615	2
2	0	4	0	0	7616	2
2	0	2	0	0	7617	2
2	0	2	0	0	7618	2
2	0	2	0	0	7619	2
2	0	2	0	0	7620	2
2	0	2	0	0	7621	2
2	0	2	0	0	7622	2
2	0	2	0	0	7623	2
2	0	2	0	0	7624	2
2	0	2	0	0	7625	2
2	6	4	171	177	7626	1
2	0	2	3	3	7627	2
2	0	2	0	0	7628	2
2	3	4	7	10	7629	1
2	0	2	14	14	7630	2
2	0	2	0	0	7631	2
2	0	4	6	6	7632	2
2	0	2	0	0	7633	2
2	0	2	0	0	7634	2
2	0	4	12	12	7635	2
2	0	2	0	0	7636	2
2	0	4	0	0	7637	2
2	0	2	0	0	7638	2
0	0	4	375	375	7639	2
0	0	4	375	375	7640	2
2	3	4	498	501	7641	0
2	0	2	0	0	7642	2
2	0	2	0	0	7643	2
2	0	2	36	36	7644	2
2	0	2	0	0	7645	2
2	0	2	0	0	7646	2
2	0	2	0	0	7647	2
2	0	2	0	0	7648	2
2	0	2	0	0	7649	2
2	0	2	0	0	7650	2
2	0	2	0	0	7651	2
2	0	2	0	0	7652	2
2	0	2	0	0	7653	2
2	0	2	0	0	7654	2
2	0	2	0	0	7655	2
2	0	2	0	0	7656	2
2	0	2	0	0	7657	2
2	0	4	0	0	7658	2
2	0	2	0	0	7659	2
2	0	2	0	0	7660	2
2	0	4	0	0	7661	2
2	0	2	0	0	7662	2
2	0	4	38	38	7663	2
2	0	2	0	0	7664	2
2	0	2	0	0	7665	2
2	0	4	2	2	7666	2
2	0	2	27	27	7667	2
2	1	2	0	1	7668	0
2	0	2	6	6	7669	2
2	0	2	0	0	7670	2
2	0	2	0	0	7671	2
2	0	2	0	0	7672	2
2	0	2	1	1	7673	2
2	0	2	0	0	7674	2
2	0	2	0	0	7675	2
2	0	2	0	0	7676	2
2	0	2	0	0	7677	2
2	0	2	0	0	7678	2
2	0	2	0	0	7679	2
2	0	2	0	0	7680	2
2	0	2	0	0	7681	2
2	0	2	0	0	7682	2
2	0	2	0	0	7683	2
2	0	2	0	0	7684	2
2	0	2	0	0	7685	2
2	0	2	0	0	7686	2
2	0	4	480	480	7687	2
2	0	2	0	0	7688	2
2	0	2	0	0	7689	2
0	496	2	7	503	7690	0
0	428	2	3	431	7691	0
2	0	2	1	1	7692	2
2	0	2	5	5	7693	2
2	1	2	0	1	7694	0
2	2	2	5	7	7695	1
2	0	2	0	0	7696	2
2	0	2	0	0	7697	2
2	0	2	0	0	7698	2
2	0	2	0	0	7699	2
2	0	2	0	0	7700	2
2	0	2	0	0	7701	2
2	0	2	0	0	7702	2
2	0	2	0	0	7703	2
2	0	2	0	0	7704	2
2	0	2	0	0	7705	2
2	0	2	0	0	7706	2
2	0	2	0	0	7707	2
2	0	2	0	0	7708	2
2	0	2	0	0	7709	2
2	0	2	0	0	7710	2
2	0	2	0	0	7711	2
2	0	2	0	0	7712	2
2	0	2	0	0	7713	2
2	0	2	0	0	7714	2
2	0	2	0	0	7715	2
2	0	2	0	0	7716	2
2	0	2	0	0	7717	2
2	0	2	0	0	7718	2
2	0	4	15	15	7719	2
2	0	2	0	0	7720	2
0	12	0	110	122	7721	1
0	5	0	146	151	7722	1
2	0	2	0	0	7723	2
2	0	2	0	0	7724	2
2	0	2	0	0	7725	2
2	0	2	0	0	7726	2
2	0	2	0	0	7727	2
2	0	2	0	0	7728	2
2	2	2	0	2	7729	0
2	0	2	0	0	7730	2
2	0	2	0	0	7731	2
2	0	2	0	0	7732	2
2	0	2	0	0	7733	2
2	0	2	0	0	7734	2
2	0	2	0	0	7735	2
2	0	4	406	406	7736	2
2	0	2	0	0	7737	2
2	0	2	0	0	7738	2
2	1	4	319	320	7739	1
2	0	2	3	3	7740	2
4	0	2	13	13	7741	2
2	0	2	0	0	7742	2
2	0	2	0	0	7743	2
2	0	2	0	0	7744	2
2	0	2	0	0	7745	2
2	0	2	0	0	7746	2
2	0	2	0	0	7747	2
2	0	2	0	0	7748	2
2	0	2	0	0	7749	2
2	0	2	0	0	7750	2
2	0	2	0	0	7751	2
2	0	2	0	0	7752	2
2	0	2	0	0	7753	2
2	3	2	0	3	7754	0
2	0	4	621	621	7755	2
2	0	2	3	3	7756	2
2	0	2	0	0	7757	2
2	0	4	233	233	7758	2
2	0	2	1	1	7759	2
2	1	2	0	1	7760	0
2	0	0	768	768	7761	2
2	0	2	0	0	7762	2
2	0	2	0	0	7763	2
2	0	0	322	322	7764	2
2	0	2	0	0	7765	2
2	0	2	0	0	7766	2
2	0	2	0	0	7767	2
2	0	2	0	0	7768	2
2	0	2	0	0	7769	2
2	0	2	0	0	7770	2
2	0	2	0	0	7771	2
2	0	2	0	0	7772	2
2	1	2	0	1	7773	1
2	0	2	0	0	7774	2
2	0	2	0	0	7775	2
2	0	2	0	0	7776	2
2	0	2	0	0	7777	2
2	1	2	474	475	7778	0
2	0	2	0	0	7779	2
2	0	2	0	0	7780	2
2	0	2	0	0	7781	2
2	0	2	0	0	7782	2
2	0	2	0	0	7783	2
2	0	2	0	0	7784	2
2	0	2	0	0	7785	2
2	0	4	0	0	7786	2
2	0	2	0	0	7787	2
2	0	2	0	0	7788	2
2	0	4	0	0	7789	2
2	0	2	0	0	7790	2
2	0	2	0	0	7791	2
2	0	2	0	0	7792	2
2	0	2	0	0	7793	2
2	0	2	0	0	7794	2
2	0	2	0	0	7795	2
2	0	2	0	0	7796	2
2	0	2	0	0	7797	2
2	0	2	0	0	7798	2
2	0	2	0	0	7799	2
2	0	2	0	0	7800	2
2	0	2	0	0	7801	2
2	0	2	0	0	7802	2
2	0	2	0	0	7803	2
2	0	2	0	0	7804	2
2	0	2	0	0	7805	2
2	0	2	0	0	7806	2
2	0	2	0	0	7807	2
2	0	2	0	0	7808	2
2	0	2	0	0	7809	2
2	0	2	0	0	7810	2
2	0	4	251	251	7811	2
2	0	2	0	0	7812	2
2	0	2	0	0	7813	2
4	3	2	0	3	7814	0
2	1	4	42	43	7815	1
4	0	2	0	0	7816	2
4	0	2	3	3	7817	2
0	0	4	0	0	7818	2
2	0	2	0	0	7819	2
2	0	2	0	0	7820	2
2	0	2	0	0	7821	2
2	0	2	0	0	7822	2
2	0	2	0	0	7823	2
2	0	2	0	0	7824	2
2	0	2	0	0	7825	2
2	0	2	0	0	7826	2
2	0	2	0	0	7827	2
2	0	2	0	0	7828	2
2	0	2	0	0	7829	2
2	0	2	0	0	7830	2
2	0	2	0	0	7831	2
2	0	2	0	0	7832	2
2	0	2	0	0	7833	2
2	0	2	0	0	7834	2
2	0	2	0	0	7835	2
2	0	2	0	0	7836	2
2	0	2	0	0	7837	2
2	0	2	0	0	7838	2
2	0	2	0	0	7839	2
2	0	2	0	0	7840	2
2	0	2	0	0	7841	2
2	0	2	0	0	7842	2
2	3	2	0	3	7843	0
2	3	4	62	65	7844	0
2	0	2	25	25	7845	2
2	21	2	0	21	7846	0
2	2	4	1608	1610	7847	1
2	0	2	0	0	7848	2
2	0	2	0	0	7849	2
2	0	2	0	0	7850	2
2	0	2	0	0	7851	2
2	0	2	0	0	7852	2
2	0	2	2	2	7853	2
2	0	2	0	0	7854	2
2	0	2	0	0	7855	2
2	0	2	0	0	7856	2
2	0	4	6	6	7857	2
2	0	2	0	0	7858	2
2	0	2	0	0	7859	2
2	0	4	0	0	7860	2
2	0	2	0	0	7861	2
2	0	2	0	0	7862	2
2	0	4	0	0	7863	2
2	0	2	0	0	7864	2
2	0	2	0	0	7865	2
2	0	4	0	0	7866	2
2	0	2	0	0	7867	2
2	0	2	0	0	7868	2
2	0	2	0	0	7869	2
2	0	2	0	0	7870	2
2	0	2	0	0	7871	2
2	0	2	0	0	7872	2
2	0	2	0	0	7873	2
2	0	2	0	0	7874	2
2	0	2	0	0	7875	2
2	0	2	0	0	7876	2
2	0	2	0	0	7877	2
2	0	2	0	0	7878	2
2	0	2	0	0	7879	2
2	0	4	7281	7281	7880	2
2	0	2	0	0	7881	2
2	0	2	0	0	7882	2
2	0	4	1558	1558	7883	2
2	0	4	1796	1796	7884	2
2	0	2	0	0	7885	2
4	0	2	9	9	7886	2
2	0	2	0	0	7887	2
2	0	2	0	0	7888	2
2	0	2	0	0	7889	2
2	0	2	0	0	7890	2
2	0	2	0	0	7891	2
2	0	2	0	0	7892	2
0	0	4	3	3	7893	2
2	199	2	8	207	7894	0
2	0	2	0	0	7895	2
2	0	2	0	0	7896	2
2	0	2	4	4	7897	2
2	0	2	0	0	7898	2
2	0	2	0	0	7899	2
2	2	2	0	2	7900	1
2	0	2	0	0	7901	2
2	0	0	225	225	7902	2
2	0	2	0	0	7903	2
2	0	2	0	0	7904	2
2	0	2	0	0	7905	2
2	0	2	0	0	7906	2
2	0	2	0	0	7907	2
2	0	2	0	0	7908	2
2	0	2	0	0	7909	2
2	0	2	0	0	7910	2
2	0	2	0	0	7911	2
2	0	2	0	0	7912	2
2	0	2	0	0	7913	2
2	0	2	0	0	7914	2
2	0	2	0	0	7915	2
2	0	2	0	0	7916	2
2	0	0	37	37	7917	2
2	0	2	0	0	7918	2
2	0	2	0	0	7919	2
2	0	2	0	0	7920	2
2	0	2	0	0	7921	2
2	0	2	0	0	7922	2
2	0	2	0	0	7923	2
2	0	2	0	0	7924	2
2	148	2	0	148	7925	0
2	0	2	0	0	7926	2
2	0	2	0	0	7927	2
2	0	2	0	0	7928	2
2	0	2	0	0	7929	2
2	0	2	0	0	7930	2
2	0	2	0	0	7931	2
0	0	4	0	0	7932	2
2	2	2	0	2	7933	0
2	0	2	0	0	7934	2
2	0	2	0	0	7935	2
2	0	2	0	0	7936	2
2	0	2	3	3	7937	2
2	0	2	0	0	7938	2
2	0	2	0	0	7939	2
2	0	0	1027	1027	7940	2
2	0	2	0	0	7941	2
2	0	2	0	0	7942	2
2	22	0	23	45	7943	1
2	9	2	145	154	7944	1
2	0	2	0	0	7945	2
2	0	2	0	0	7946	2
2	1	2	0	1	7947	1
4	263	2	0	263	7948	1
2	41	4	5153	5194	7949	1
2	0	2	26	26	7950	2
2	0	2	0	0	7951	2
2	36	4	4918	4954	7952	0
2	0	2	585	585	7953	2
2	1	2	0	1	7954	0
2	0	2	0	0	7955	2
2	0	2	0	0	7956	2
2	0	2	0	0	7957	2
2	0	2	0	0	7958	2
2	0	2	0	0	7959	2
2	0	2	0	0	7960	2
2	2	4	9736	9738	7961	1
2	0	2	0	0	7962	2
2	0	2	0	0	7963	2
2	0	4	1163	1163	7964	2
2	0	2	1	1	7965	2
4	929	2	0	929	7966	0
2	0	2	0	0	7967	2
2	0	2	0	0	7968	2
2	0	2	0	0	7969	2
2	0	2	0	0	7970	2
2	0	2	0	0	7971	2
2	0	2	0	0	7972	2
2	0	2	0	0	7973	2
2	0	2	1	1	7974	2
2	0	2	0	0	7975	2
2	0	2	0	0	7976	2
2	0	2	1	1	7977	2
2	0	2	0	0	7978	2
2	0	2	0	0	7979	2
2	1	4	0	1	7980	0
2	0	2	7	7	7981	2
2	0	4	53	53	7982	2
2	0	2	0	0	7983	2
2	0	2	0	0	7984	2
2	5	2	0	5	7985	0
2	0	2	4	4	7986	2
2	4	2	0	4	7987	0
2	31	2	17	48	7988	1
2	0	2	1	1	7989	2
2	0	2	0	0	7990	2
0	0	4	3	3	7991	2
2	0	2	0	0	7992	2
2	0	2	0	0	7993	2
2	0	2	0	0	7994	2
2	0	2	0	0	7995	2
2	0	2	0	0	7996	2
2	0	2	0	0	7997	2
2	0	2	0	0	7998	2
2	0	2	0	0	7999	2
2	0	2	0	0	8000	2
2	0	2	0	0	8001	2
2	0	2	0	0	8002	2
2	0	2	0	0	8003	2
2	0	2	0	0	8004	2
2	0	2	11	11	8005	2
2	0	2	0	0	8006	2
2	0	2	0	0	8007	2
2	0	2	0	0	8008	2
2	0	2	0	0	8009	2
2	0	2	0	0	8010	2
2	0	4	6	6	8011	2
2	0	2	0	0	8012	2
2	0	2	0	0	8013	2
2	0	4	1	1	8014	2
2	0	2	0	0	8015	2
2	0	2	0	0	8016	2
2	0	2	0	0	8017	2
2	0	2	0	0	8018	2
2	0	2	0	0	8019	2
2	0	2	0	0	8020	2
2	0	2	0	0	8021	2
2	2	2	225	227	8022	0
2	0	2	0	0	8023	2
2	0	4	19	19	8024	2
2	0	2	0	0	8025	2
2	0	2	0	0	8026	2
2	0	4	17	17	8027	2
2	0	2	0	0	8028	2
4	0	2	0	0	8029	2
2	0	2	0	0	8030	2
2	0	2	0	0	8031	2
2	0	2	0	0	8032	2
2	0	2	0	0	8033	2
2	0	2	0	0	8034	2
2	0	2	0	0	8035	2
2	0	2	0	0	8036	2
2	0	2	0	0	8037	2
2	0	2	0	0	8038	2
2	0	2	0	0	8039	2
2	0	2	0	0	8040	2
2	0	2	0	0	8041	2
2	0	2	0	0	8042	2
2	0	2	0	0	8043	2
2	0	2	0	0	8044	2
2	0	2	0	0	8045	2
2	0	2	0	0	8046	2
2	0	2	0	0	8047	2
4	1	4	74	75	8048	0
2	0	4	149	149	8049	2
2	2	2	4	6	8050	1
2	0	2	0	0	8051	2
2	0	2	0	0	8052	2
2	0	2	0	0	8053	2
0	103	2	0	103	8054	0
0	0	2	0	0	8055	2
2	0	2	1	1	8056	2
2	0	2	0	0	8057	2
2	0	2	0	0	8058	2
2	0	2	0	0	8059	2
2	0	2	0	0	8060	2
2	0	2	0	0	8061	2
2	0	4	35	35	8062	2
2	0	2	0	0	8063	2
2	0	2	0	0	8064	2
2	0	4	0	0	8065	2
2	0	2	0	0	8066	2
2	0	0	151	151	8067	2
2	0	2	0	0	8068	2
2	0	2	1	1	8069	2
2	0	2	0	0	8070	2
2	0	2	0	0	8071	2
2	0	2	0	0	8072	2
2	0	2	0	0	8073	2
0	2	2	0	2	8074	0
0	4	2	1	5	8075	0
0	0	2	0	0	8076	2
2	0	2	0	0	8077	2
2	0	4	642	642	8078	2
2	0	2	0	0	8079	2
2	0	2	0	0	8080	2
0	16	2	1	17	8081	0
0	0	2	0	0	8082	2
2	0	2	0	0	8083	2
2	0	4	10	10	8084	2
2	0	2	0	0	8085	2
2	0	2	0	0	8086	2
2	0	4	0	0	8087	2
2	0	2	0	0	8088	2
2	0	2	0	0	8089	2
2	0	2	0	0	8090	2
2	0	2	0	0	8091	2
2	0	2	0	0	8092	2
2	0	2	0	0	8093	2
2	0	2	0	0	8094	2
2	0	2	0	0	8095	2
2	0	2	0	0	8096	2
2	0	2	0	0	8097	2
2	0	2	0	0	8098	2
2	0	2	0	0	8099	2
2	0	2	0	0	8100	2
2	2	4	4	6	8101	0
0	0	2	27	27	8102	2
2	0	2	0	0	8103	2
2	0	2	0	0	8104	2
2	0	2	0	0	8105	2
2	0	2	0	0	8106	2
2	0	2	0	0	8107	2
2	0	2	0	0	8108	2
2	0	2	0	0	8109	2
2	0	2	0	0	8110	2
2	0	2	0	0	8111	2
2	0	2	0	0	8112	2
2	0	2	0	0	8113	2
2	0	2	0	0	8114	2
2	0	2	0	0	8115	2
2	0	2	0	0	8116	2
2	0	2	0	0	8117	2
2	0	2	0	0	8118	2
2	0	2	0	0	8119	2
2	0	2	0	0	8120	2
2	0	2	0	0	8121	2
2	0	2	0	0	8122	2
2	0	4	1	1	8123	2
2	0	2	5	5	8124	2
2	0	4	13	13	8125	2
2	0	2	0	0	8126	2
2	0	2	0	0	8127	2
4	0	2	1	1	8128	2
2	0	4	44	44	8129	2
2	0	2	0	0	8130	2
2	0	2	0	0	8131	2
2	0	2	1	1	8132	2
2	0	2	45	45	8133	2
2	0	2	0	0	8134	2
2	628	2	1	629	8135	0
2	10	2	1084	1094	8136	1
2	0	2	33	33	8137	2
2	0	2	2	2	8138	2
0	44	2	257	301	8139	0
0	90	2	0	90	8140	0
2	24	2	1	25	8141	0
2	0	2	0	0	8142	2
2	0	2	1	1	8143	2
2	0	2	0	0	8144	2
2	0	2	0	0	8145	2
2	0	2	0	0	8146	2
2	0	2	0	0	8147	2
2	0	2	0	0	8148	2
2	0	2	0	0	8149	2
2	0	2	0	0	8150	2
2	0	2	0	0	8151	2
2	0	2	0	0	8152	2
2	0	2	0	0	8153	2
2	0	2	0	0	8154	2
2	0	2	0	0	8155	2
0	0	4	2	2	8156	2
0	0	4	1	1	8157	2
0	0	4	2	2	8158	2
0	0	4	2	2	8159	2
0	0	4	2	2	8160	2
2	0	2	0	0	8161	2
2	0	4	0	0	8162	2
2	0	2	0	0	8163	2
2	0	2	0	0	8164	2
2	0	2	0	0	8165	2
2	0	2	0	0	8166	2
2	0	2	0	0	8167	2
2	0	2	0	0	8168	2
0	98	2	1	99	8169	0
0	160	2	1	161	8170	0
0	158	2	0	158	8171	0
2	0	2	0	0	8172	2
2	0	2	0	0	8173	2
2	0	2	0	0	8174	2
2	0	2	0	0	8175	2
2	0	2	0	0	8176	2
2	0	2	0	0	8177	2
2	0	2	0	0	8178	2
2	0	2	0	0	8179	2
2	0	2	0	0	8180	2
2	0	2	0	0	8181	2
2	0	2	0	0	8182	2
2	0	2	0	0	8183	2
2	0	4	472	472	8184	2
2	0	2	0	0	8185	2
2	0	2	0	0	8186	2
2	0	4	2	2	8187	2
2	0	2	0	0	8188	2
2	0	2	0	0	8189	2
2	0	4	0	0	8190	2
2	0	2	0	0	8191	2
2	0	2	0	0	8192	2
2	0	2	0	0	8193	2
2	0	2	0	0	8194	2
2	0	2	0	0	8195	2
2	0	2	0	0	8196	2
2	0	2	0	0	8197	2
0	20	4	5	25	8198	1
0	1	4	5	6	8199	0
2	1	2	0	1	8200	0
2	0	2	0	0	8201	2
2	0	2	0	0	8202	2
2	0	2	0	0	8203	2
2	0	2	0	0	8204	2
2	0	2	0	0	8205	2
2	0	2	0	0	8206	2
2	0	2	0	0	8207	2
2	2	2	5	7	8208	1
2	0	2	0	0	8209	2
2	0	2	0	0	8210	2
2	0	2	0	0	8211	2
2	0	2	0	0	8212	2
2	0	2	0	0	8213	2
2	0	2	0	0	8214	2
2	0	2	0	0	8215	2
2	0	2	0	0	8216	2
2	0	2	0	0	8217	2
2	0	2	0	0	8218	2
2	0	2	0	0	8219	2
2	0	2	0	0	8220	2
2	0	2	0	0	8221	2
2	0	2	0	0	8222	2
2	0	2	0	0	8223	2
2	0	2	0	0	8224	2
2	0	2	0	0	8225	2
2	0	2	0	0	8226	2
2	0	2	0	0	8227	2
2	0	2	0	0	8228	2
2	0	2	0	0	8229	2
2	0	2	0	0	8230	2
2	0	2	0	0	8231	2
2	0	2	0	0	8232	2
2	0	2	0	0	8233	2
2	0	2	0	0	8234	2
2	0	2	0	0	8235	2
2	0	2	0	0	8236	2
2	0	2	0	0	8237	2
2	0	2	0	0	8238	2
2	0	2	0	0	8239	2
2	0	2	0	0	8240	2
2	0	2	0	0	8241	2
2	0	2	0	0	8242	2
2	0	2	0	0	8243	2
2	0	2	0	0	8244	2
2	0	2	0	0	8245	2
2	0	2	0	0	8246	2
2	0	2	0	0	8247	2
2	0	2	0	0	8248	2
2	0	2	0	0	8249	2
2	0	2	0	0	8250	2
2	0	2	0	0	8251	2
2	0	2	0	0	8252	2
2	0	2	0	0	8253	2
2	0	2	0	0	8254	2
2	0	2	0	0	8255	2
4	65	4	14	79	8256	0
4	19	4	2	21	8257	0
4	3	4	1	4	8258	0
4	22	4	6	28	8259	0
2	0	2	0	0	8260	2
2	0	2	0	0	8261	2
2	0	2	0	0	8262	2
2	0	2	0	0	8263	2
2	0	2	0	0	8264	2
2	0	2	0	0	8265	2
2	0	2	0	0	8266	2
2	0	2	70	70	8267	2
2	0	2	0	0	8268	2
2	0	2	0	0	8269	2
2	0	2	189	189	8270	2
2	0	2	0	0	8271	2
2	0	2	0	0	8272	2
2	0	2	0	0	8273	2
2	0	2	0	0	8274	2
2	0	2	0	0	8275	2
2	0	2	0	0	8276	2
2	0	2	0	0	8277	2
2	0	2	0	0	8278	2
2	0	2	0	0	8279	2
2	0	2	0	0	8280	2
2	0	2	0	0	8281	2
2	0	2	0	0	8282	2
2	0	2	0	0	8283	2
2	0	2	0	0	8284	2
2	0	2	0	0	8285	2
2	0	2	0	0	8286	2
2	0	2	0	0	8287	2
2	0	2	0	0	8288	2
2	0	2	0	0	8289	2
2	0	2	0	0	8290	2
2	0	2	0	0	8291	2
2	0	2	0	0	8292	2
2	0	2	0	0	8293	2
2	0	4	0	0	8294	2
2	0	2	0	0	8295	2
2	0	2	0	0	8296	2
2	0	4	0	0	8297	2
2	0	2	0	0	8298	2
2	2	2	41	43	8299	1
2	0	2	1	1	8300	2
2	0	2	0	0	8301	2
2	1	2	1	2	8302	1
2	0	2	5	5	8303	2
4	1	4	7	8	8304	0
2	18	4	822	840	8305	0
2	0	2	0	0	8306	2
2	0	2	0	0	8307	2
2	0	2	0	0	8308	2
2	0	2	0	0	8309	2
2	0	2	0	0	8310	2
2	0	2	0	0	8311	2
2	1	2	0	1	8312	0
2	0	2	19	19	8313	2
2	0	2	0	0	8314	2
2	0	2	0	0	8315	2
2	0	2	0	0	8316	2
2	0	2	0	0	8317	2
0	0	4	1	1	8318	2
2	0	2	0	0	8319	2
2	0	2	0	0	8320	2
2	0	2	0	0	8321	2
2	0	2	0	0	8322	2
2	0	2	0	0	8323	2
2	0	2	0	0	8324	2
2	0	2	0	0	8325	2
2	0	2	0	0	8326	2
2	0	2	0	0	8327	2
2	0	2	0	0	8328	2
2	0	2	0	0	8329	2
2	0	2	0	0	8330	2
2	0	2	0	0	8331	2
2	0	2	11	11	8332	2
2	0	2	0	0	8333	2
2	0	2	0	0	8334	2
0	282	2	14	296	8335	0
0	199	2	1	200	8336	0
2	0	2	0	0	8337	2
2	0	2	23	23	8338	2
2	0	2	0	0	8339	2
2	0	2	2	2	8340	2
2	0	2	0	0	8341	2
2	0	2	0	0	8342	2
2	0	2	0	0	8343	2
2	0	2	0	0	8344	2
2	0	2	0	0	8345	2
2	0	4	622	622	8346	2
2	0	2	0	0	8347	2
2	0	2	0	0	8348	2
2	0	4	181	181	8349	2
2	0	2	0	0	8350	2
0	0	4	6	6	8351	2
2	0	2	0	0	8352	2
2	0	2	3	3	8353	2
2	0	2	0	0	8354	2
2	0	2	0	0	8355	2
2	0	2	0	0	8356	2
2	0	2	0	0	8357	2
2	0	2	0	0	8358	2
2	0	2	0	0	8359	2
2	0	2	0	0	8360	2
2	0	2	0	0	8361	2
2	0	2	0	0	8362	2
2	0	2	0	0	8363	2
2	0	2	0	0	8364	2
2	0	2	0	0	8365	2
2	0	2	0	0	8366	2
2	0	2	0	0	8367	2
2	0	2	1	1	8368	2
2	0	2	0	0	8369	2
2	0	2	0	0	8370	2
2	0	2	0	0	8371	2
2	0	2	0	0	8372	2
4	0	2	0	0	8373	2
2	0	2	0	0	8374	2
2	0	4	2	2	8375	2
2	0	2	0	0	8376	2
2	0	2	0	0	8377	2
2	0	4	0	0	8378	2
2	0	2	0	0	8379	2
2	0	2	0	0	8380	2
2	1	2	0	1	8381	0
2	0	2	2	2	8382	2
2	0	2	0	0	8383	2
2	0	2	0	0	8384	2
2	0	2	0	0	8385	2
2	0	2	2	2	8386	2
2	0	2	0	0	8387	2
2	0	2	0	0	8388	2
2	0	2	0	0	8389	2
2	0	2	0	0	8390	2
2	0	2	0	0	8391	2
2	0	2	0	0	8392	2
2	0	4	6	6	8393	2
2	0	2	0	0	8394	2
2	0	2	0	0	8395	2
2	0	4	0	0	8396	2
2	0	2	11	11	8397	2
4	61	2	3	64	8398	0
2	0	2	0	0	8399	2
2	0	2	0	0	8400	2
2	0	4	5	5	8401	2
2	0	2	0	0	8402	2
2	0	2	0	0	8403	2
2	0	4	102	102	8404	2
2	0	2	0	0	8405	2
2	0	4	1	1	8406	2
2	0	2	0	0	8407	2
2	0	2	0	0	8408	2
4	0	2	4	4	8409	2
4	0	2	4	4	8410	2
2	0	4	11	11	8411	2
2	0	2	0	0	8412	2
4	1	2	1	2	8413	1
4	4	2	1	5	8414	0
2	0	2	0	0	8415	2
2	0	2	0	0	8416	2
2	0	2	0	0	8417	2
2	0	2	0	0	8418	2
2	0	2	0	0	8419	2
2	0	2	0	0	8420	2
2	0	2	0	0	8421	2
2	0	2	5	5	8422	2
2	0	2	0	0	8423	2
2	0	2	0	0	8424	2
2	0	2	0	0	8425	2
2	0	2	0	0	8426	2
2	0	2	0	0	8427	2
2	0	2	0	0	8428	2
2	0	2	0	0	8429	2
2	0	2	0	0	8430	2
2	0	2	0	0	8431	2
2	0	2	0	0	8432	2
2	0	2	2	2	8433	2
2	0	2	0	0	8434	2
2	0	2	4	4	8435	2
2	0	2	0	0	8436	2
2	0	2	0	0	8437	2
2	0	2	0	0	8438	2
2	0	0	4	4	8439	2
2	0	2	0	0	8440	2
2	0	2	0	0	8441	2
2	0	0	2	2	8442	2
2	0	2	0	0	8443	2
2	0	2	0	0	8444	2
2	0	2	0	0	8445	2
2	0	2	0	0	8446	2
2	0	2	0	0	8447	2
2	0	2	1	1	8448	2
2	0	2	0	0	8449	2
2	0	2	0	0	8450	2
2	0	2	1	1	8451	2
2	0	2	0	0	8452	2
2	0	2	0	0	8453	2
2	0	2	0	0	8454	2
2	0	2	0	0	8455	2
2	0	2	0	0	8456	2
2	0	4	1	1	8457	2
2	0	2	0	0	8458	2
2	0	2	0	0	8459	2
2	0	4	0	0	8460	2
2	0	2	0	0	8461	2
2	0	2	0	0	8462	2
2	0	2	0	0	8463	2
2	0	2	0	0	8464	2
2	0	2	0	0	8465	2
2	0	2	0	0	8466	2
2	0	2	0	0	8467	2
2	0	2	0	0	8468	2
2	0	4	0	0	8469	2
2	0	2	0	0	8470	2
2	0	2	0	0	8471	2
2	0	4	0	0	8472	2
2	0	2	0	0	8473	2
2	0	2	0	0	8474	2
2	0	2	0	0	8475	2
2	0	2	0	0	8476	2
2	0	2	0	0	8477	2
2	0	2	0	0	8478	2
2	0	2	0	0	8479	2
0	0	4	38	38	8480	2
4	0	4	0	0	8481	2
2	0	2	0	0	8482	2
2	0	2	0	0	8483	2
2	0	2	1	1	8484	2
2	0	2	5	5	8485	2
2	0	2	0	0	8486	2
2	0	2	0	0	8487	2
2	0	2	0	0	8488	2
2	0	2	0	0	8489	2
2	0	2	0	0	8490	2
2	0	2	0	0	8491	2
2	0	2	0	0	8492	2
2	0	2	0	0	8493	2
4	0	4	0	0	8494	2
4	0	4	0	0	8495	2
2	0	2	0	0	8496	2
2	0	2	0	0	8497	2
2	1	2	0	1	8498	0
2	0	2	1	1	8499	2
2	0	2	0	0	8500	2
2	0	2	0	0	8501	2
2	1	2	0	1	8502	1
2	0	2	0	0	8503	2
2	12	2	0	12	8504	0
2	0	2	234	234	8505	2
2	0	2	0	0	8506	2
2	0	2	0	0	8507	2
2	0	2	0	0	8508	2
2	0	2	0	0	8509	2
2	0	2	0	0	8510	2
2	0	2	0	0	8511	2
2	0	2	0	0	8512	2
2	0	2	0	0	8513	2
2	12	2	2	14	8514	0
2	0	2	78	78	8515	2
2	58	2	0	58	8516	0
2	9	2	589	598	8517	1
2	0	2	5	5	8518	2
2	0	2	1	1	8519	2
2	0	2	0	0	8520	2
2	0	2	1	1	8521	2
2	0	2	0	0	8522	2
2	0	4	101	101	8523	2
2	0	2	0	0	8524	2
2	0	2	0	0	8525	2
2	0	4	62	62	8526	2
2	0	2	0	0	8527	2
4	0	0	17	17	8528	2
2	0	2	0	0	8529	2
2	0	2	0	0	8530	2
2	0	2	0	0	8531	2
2	0	2	0	0	8532	2
2	0	2	0	0	8533	2
2	0	2	0	0	8534	2
2	0	4	0	0	8535	2
4	31	2	0	31	8536	0
2	0	2	0	0	8537	2
2	0	2	0	0	8538	2
2	0	2	0	0	8539	2
2	0	2	0	0	8540	2
2	0	2	0	0	8541	2
2	0	2	0	0	8542	2
2	0	2	0	0	8543	2
2	0	2	0	0	8544	2
2	0	2	0	0	8545	2
2	0	2	0	0	8546	2
2	0	2	9	9	8547	2
2	0	2	0	0	8548	2
2	0	2	0	0	8549	2
2	0	4	5	5	8550	2
2	0	2	0	0	8551	2
2	0	4	12	12	8552	2
2	0	2	0	0	8553	2
2	0	2	0	0	8554	2
2	0	2	1	1	8555	2
2	0	2	0	0	8556	2
2	2	2	1	3	8557	0
2	0	2	4	4	8558	2
2	2	2	0	2	8559	0
2	3	2	10	13	8560	1
2	0	2	0	0	8561	2
2	0	2	0	0	8562	2
2	0	2	0	0	8563	2
2	0	2	0	0	8564	2
2	0	2	0	0	8565	2
2	0	2	0	0	8566	2
2	0	2	0	0	8567	2
2	0	2	0	0	8568	2
2	0	4	491	491	8569	2
2	0	2	0	0	8570	2
2	0	2	0	0	8571	2
2	0	4	35	35	8572	2
2	0	2	0	0	8573	2
2	0	2	0	0	8574	2
2	0	4	6	6	8575	2
2	0	2	0	0	8576	2
2	0	2	0	0	8577	2
2	0	4	3	3	8578	2
2	0	2	0	0	8579	2
2	0	4	17	17	8580	2
2	0	2	0	0	8581	2
2	0	2	0	0	8582	2
2	0	4	27	27	8583	2
2	4	2	0	4	8584	0
2	3	4	76	79	8585	1
2	0	2	0	0	8586	2
2	0	2	0	0	8587	2
2	0	2	0	0	8588	2
2	0	4	0	0	8589	2
2	0	2	0	0	8590	2
2	0	2	0	0	8591	2
2	0	4	0	0	8592	2
2	0	4	0	0	8593	2
2	0	2	0	0	8594	2
2	0	2	0	0	8595	2
2	0	4	1	1	8596	2
2	0	2	0	0	8597	2
2	0	2	0	0	8598	2
2	0	4	5	5	8599	2
2	0	2	1	1	8600	2
2	0	2	0	0	8601	2
2	0	2	0	0	8602	2
2	0	2	0	0	8603	2
2	2	4	0	2	8604	1
2	0	2	3	3	8605	2
4	0	4	11	11	8606	2
2	3	2	1	4	8607	0
2	0	2	8	8	8608	2
2	2	2	0	2	8609	0
2	11	2	32	43	8610	1
2	0	2	4	4	8611	2
2	0	2	0	0	8612	2
2	1	2	0	1	8613	0
2	0	2	0	0	8614	2
2	0	2	0	0	8615	2
2	0	2	0	0	8616	2
2	0	2	8	8	8617	2
2	0	2	0	0	8618	2
2	0	2	0	0	8619	2
2	0	2	0	0	8620	2
2	0	2	0	0	8621	2
2	0	2	0	0	8622	2
2	0	2	0	0	8623	2
2	0	2	0	0	8624	2
2	0	2	0	0	8625	2
2	0	2	0	0	8626	2
2	0	4	290	290	8627	2
2	0	2	0	0	8628	2
2	0	2	0	0	8629	2
2	0	4	267	267	8630	2
2	0	2	0	0	8631	2
2	0	4	1397	1397	8632	2
2	0	2	0	0	8633	2
2	0	2	0	0	8634	2
2	0	4	1262	1262	8635	2
2	3	2	1	4	8636	0
4	14	2	96	110	8637	1
2	0	2	0	0	8638	2
2	0	2	0	0	8639	2
2	0	2	0	0	8640	2
2	0	2	0	0	8641	2
2	0	2	0	0	8642	2
2	0	2	0	0	8643	2
2	0	2	0	0	8644	2
2	0	2	0	0	8645	2
2	0	2	0	0	8646	2
2	0	2	0	0	8647	2
2	0	2	0	0	8648	2
2	0	2	0	0	8649	2
2	0	2	0	0	8650	2
2	0	2	0	0	8651	2
2	0	2	0	0	8652	2
4	1	2	0	1	8653	0
4	1	4	18	19	8654	1
2	1	2	0	1	8655	0
2	0	2	0	0	8656	2
2	0	2	0	0	8657	2
2	0	2	0	0	8658	2
2	0	2	0	0	8659	2
2	0	2	0	0	8660	2
2	0	2	0	0	8661	2
2	0	2	0	0	8662	2
2	0	4	1	1	8663	2
2	0	2	0	0	8664	2
2	0	4	1	1	8665	2
2	0	2	0	0	8666	2
2	0	2	0	0	8667	2
2	0	2	0	0	8668	2
2	0	2	0	0	8669	2
4	0	4	129	129	8670	2
2	0	2	0	0	8671	2
2	0	2	0	0	8672	2
2	0	2	0	0	8673	2
2	0	2	2	2	8674	2
2	0	2	0	0	8675	2
2	0	2	0	0	8676	2
2	0	2	0	0	8677	2
2	0	2	0	0	8678	2
2	0	2	0	0	8679	2
2	0	2	0	0	8680	2
2	0	2	0	0	8681	2
2	0	2	0	0	8682	2
2	0	2	0	0	8683	2
2	0	2	0	0	8684	2
2	0	2	1	1	8685	2
2	0	2	0	0	8686	2
2	0	2	0	0	8687	2
2	0	2	0	0	8688	2
2	0	2	0	0	8689	2
2	0	2	0	0	8690	2
2	0	2	0	0	8691	2
2	0	2	0	0	8692	2
2	0	2	0	0	8693	2
2	0	2	2	2	8694	2
2	0	2	0	0	8695	2
2	0	2	0	0	8696	2
2	0	2	0	0	8697	2
2	0	2	0	0	8698	2
2	0	2	0	0	8699	2
2	0	2	0	0	8700	2
2	0	2	1	1	8701	2
2	0	2	0	0	8702	2
2	0	2	6	6	8703	2
2	0	2	0	0	8704	2
2	0	2	0	0	8705	2
2	0	2	0	0	8706	2
2	0	2	0	0	8707	2
2	0	2	0	0	8708	2
2	0	2	0	0	8709	2
2	0	2	0	0	8710	2
2	0	2	0	0	8711	2
2	0	2	0	0	8712	2
2	0	2	0	0	8713	2
2	0	2	0	0	8714	2
2	0	2	0	0	8715	2
2	0	2	0	0	8716	2
2	0	2	5	5	8717	2
2	0	0	171	171	8718	2
2	0	2	0	0	8719	2
2	0	2	0	0	8720	2
2	0	4	23	23	8721	2
2	0	2	2	2	8722	2
4	0	2	0	0	8723	2
4	15	2	3	18	8724	0
2	0	2	0	0	8725	2
2	0	2	0	0	8726	2
2	0	2	0	0	8727	2
2	0	2	0	0	8728	2
2	0	2	0	0	8729	2
2	0	2	0	0	8730	2
2	0	2	0	0	8731	2
2	0	4	1	1	8732	2
2	0	2	0	0	8733	2
2	0	2	0	0	8734	2
2	0	4	0	0	8735	2
2	0	2	0	0	8736	2
2	0	2	0	0	8737	2
2	0	2	0	0	8738	2
2	0	4	9	9	8739	2
2	0	2	0	0	8740	2
2	0	2	0	0	8741	2
2	0	4	16	16	8742	2
2	0	2	0	0	8743	2
2	0	2	0	0	8744	2
2	0	2	0	0	8745	2
2	0	2	0	0	8746	2
2	0	2	0	0	8747	2
2	0	2	0	0	8748	2
2	0	2	0	0	8749	2
2	0	2	0	0	8750	2
2	0	2	2	2	8751	2
2	0	2	0	0	8752	2
2	0	2	0	0	8753	2
2	0	2	3	3	8754	2
2	0	2	35	35	8755	2
2	0	2	0	0	8756	2
2	0	2	0	0	8757	2
2	0	2	0	0	8758	2
2	0	2	0	0	8759	2
2	0	2	0	0	8760	2
2	0	2	0	0	8761	2
2	0	2	0	0	8762	2
2	0	2	0	0	8763	2
2	0	2	0	0	8764	2
2	0	2	0	0	8765	2
2	0	2	0	0	8766	2
2	0	2	0	0	8767	2
2	0	2	0	0	8768	2
2	0	2	0	0	8769	2
2	0	2	0	0	8770	2
2	0	2	0	0	8771	2
2	0	2	0	0	8772	2
2	0	2	0	0	8773	2
2	0	2	0	0	8774	2
2	0	2	0	0	8775	2
2	0	2	0	0	8776	2
2	0	2	0	0	8777	2
2	0	2	0	0	8778	2
2	0	2	0	0	8779	2
2	0	2	0	0	8780	2
2	0	2	0	0	8781	2
2	0	2	0	0	8782	2
2	0	2	0	0	8783	2
2	0	2	0	0	8784	2
2	0	2	0	0	8785	2
2	0	2	0	0	8786	2
2	0	2	0	0	8787	2
2	0	2	0	0	8788	2
2	0	2	0	0	8789	2
2	0	2	2	2	8790	2
2	0	2	0	0	8791	2
2	0	2	0	0	8792	2
2	0	2	0	0	8793	2
2	0	2	0	0	8794	2
2	0	2	0	0	8795	2
2	0	2	0	0	8796	2
2	0	2	0	0	8797	2
2	0	2	0	0	8798	2
2	0	4	0	0	8799	2
2	0	2	0	0	8800	2
2	0	2	0	0	8801	2
2	0	4	0	0	8802	2
2	0	2	0	0	8803	2
2	2	4	36	38	8804	0
2	0	2	0	0	8805	2
2	0	2	0	0	8806	2
2	0	4	4	4	8807	2
2	0	2	0	0	8808	2
2	0	2	0	0	8809	2
2	0	2	0	0	8810	2
2	225	4	279	504	8811	1
2	0	2	0	0	8812	2
2	0	2	0	0	8813	2
2	0	2	0	0	8814	2
0	29	4	3490	3519	8815	1
0	1	4	0	1	8816	1
2	0	2	0	0	8817	2
2	0	2	0	0	8818	2
2	0	2	0	0	8819	2
2	0	2	0	0	8820	2
2	0	2	0	0	8821	2
2	0	2	0	0	8822	2
2	0	2	0	0	8823	2
2	0	2	0	0	8824	2
2	0	2	0	0	8825	2
2	0	2	0	0	8826	2
2	0	2	0	0	8827	2
2	0	2	0	0	8828	2
2	0	2	0	0	8829	2
2	0	2	2	2	8830	2
2	1	2	0	1	8831	0
2	0	2	0	0	8832	2
2	0	2	0	0	8833	2
2	0	2	0	0	8834	2
2	0	2	0	0	8835	2
2	0	2	0	0	8836	2
2	0	2	0	0	8837	2
2	0	2	0	0	8838	2
2	0	2	0	0	8839	2
2	0	2	0	0	8840	2
2	0	2	0	0	8841	2
2	0	2	0	0	8842	2
2	0	2	0	0	8843	2
2	0	2	0	0	8844	2
2	0	2	0	0	8845	2
2	0	2	0	0	8846	2
2	0	2	0	0	8847	2
2	0	2	0	0	8848	2
2	0	2	0	0	8849	2
2	0	2	0	0	8850	2
2	0	2	0	0	8851	2
2	0	2	0	0	8852	2
2	0	2	0	0	8853	2
2	0	2	0	0	8854	2
2	0	2	1	1	8855	2
2	0	2	0	0	8856	2
2	0	2	1	1	8857	2
2	0	2	0	0	8858	2
2	0	2	0	0	8859	2
2	0	2	0	0	8860	2
2	0	2	0	0	8861	2
2	0	2	0	0	8862	2
2	0	2	0	0	8863	2
2	0	2	0	0	8864	2
2	0	2	0	0	8865	2
2	0	2	0	0	8866	2
2	0	2	0	0	8867	2
2	0	2	0	0	8868	2
2	0	2	0	0	8869	2
2	0	2	0	0	8870	2
2	0	4	28	28	8871	2
2	0	2	0	0	8872	2
2	0	2	0	0	8873	2
2	0	4	5	5	8874	2
2	0	2	0	0	8875	2
2	0	4	91	91	8876	2
2	0	2	0	0	8877	2
2	0	2	0	0	8878	2
2	0	2	4	4	8879	2
2	1	4	232	233	8880	1
2	245	2	3	248	8881	0
2	0	2	0	0	8882	2
2	0	2	0	0	8883	2
2	0	2	0	0	8884	2
4	8093	2	12	8105	8885	0
2	0	2	0	0	8886	2
2	0	2	0	0	8887	2
2	0	2	0	0	8888	2
2	0	2	0	0	8889	2
2	0	2	0	0	8890	2
2	0	2	0	0	8891	2
2	0	2	0	0	8892	2
2	0	2	0	0	8893	2
2	0	2	0	0	8894	2
2	0	2	0	0	8895	2
2	0	2	1	1	8896	2
2	0	2	0	0	8897	2
2	0	2	0	0	8898	2
2	0	4	231	231	8899	2
2	0	2	0	0	8900	2
2	0	2	0	0	8901	2
2	0	4	33	33	8902	2
2	0	2	0	0	8903	2
4	1	4	80	81	8904	1
2	0	2	0	0	8905	2
2	0	4	0	0	8906	2
2	0	2	0	0	8907	2
2	0	2	0	0	8908	2
2	0	2	0	0	8909	2
2	0	2	0	0	8910	2
2	0	2	0	0	8911	2
2	0	2	0	0	8912	2
2	0	2	0	0	8913	2
2	0	2	0	0	8914	2
2	0	2	0	0	8915	2
2	0	2	0	0	8916	2
2	0	2	0	0	8917	2
2	0	2	0	0	8918	2
2	0	2	0	0	8919	2
2	0	2	0	0	8920	2
2	0	2	0	0	8921	2
2	0	2	0	0	8922	2
2	0	2	1	1	8923	2
2	0	2	0	0	8924	2
2	0	2	0	0	8925	2
2	0	2	0	0	8926	2
2	0	2	0	0	8927	2
2	0	4	32	32	8928	2
2	0	2	0	0	8929	2
2	0	2	0	0	8930	2
2	0	4	0	0	8931	2
2	0	2	2	2	8932	2
2	0	2	0	0	8933	2
2	0	4	2149	2149	8934	2
2	0	2	0	0	8935	2
2	0	2	0	0	8936	2
4	0	2	23	23	8937	2
2	1	2	0	1	8938	0
2	0	2	0	0	8939	2
2	0	2	0	0	8940	2
2	0	2	0	0	8941	2
2	0	2	0	0	8942	2
2	0	2	0	0	8943	2
2	0	2	0	0	8944	2
2	0	2	0	0	8945	2
2	1	4	11	12	8946	1
2	0	2	0	0	8947	2
2	0	2	0	0	8948	2
2	0	4	4	4	8949	2
2	0	2	45	45	8950	2
2	0	2	0	0	8951	2
2	0	2	0	0	8952	2
2	0	2	5	5	8953	2
4	0	2	21	21	8954	2
2	0	2	0	0	8955	2
2	0	2	0	0	8956	2
2	0	2	0	0	8957	2
2	0	2	0	0	8958	2
2	0	2	0	0	8959	2
2	0	2	0	0	8960	2
2	0	4	1366	1366	8961	2
2	0	2	0	0	8962	2
2	0	2	0	0	8963	2
2	0	2	0	0	8964	2
2	0	2	0	0	8965	2
2	0	2	0	0	8966	2
2	0	2	0	0	8967	2
2	0	2	0	0	8968	2
2	0	2	0	0	8969	2
2	0	2	0	0	8970	2
2	0	2	0	0	8971	2
2	0	2	0	0	8972	2
2	0	2	0	0	8973	2
2	0	2	0	0	8974	2
2	0	2	0	0	8975	2
2	0	2	0	0	8976	2
2	0	2	0	0	8977	2
2	0	2	0	0	8978	2
2	0	2	0	0	8979	2
2	0	2	0	0	8980	2
2	0	2	0	0	8981	2
2	0	2	0	0	8982	2
2	0	2	0	0	8983	2
2	0	2	0	0	8984	2
2	0	2	0	0	8985	2
2	0	2	0	0	8986	2
2	0	2	0	0	8987	2
2	0	2	0	0	8988	2
2	0	2	0	0	8989	2
2	0	2	0	0	8990	2
2	0	2	0	0	8991	2
2	0	2	0	0	8992	2
2	0	2	0	0	8993	2
2	0	2	0	0	8994	2
2	0	2	0	0	8995	2
2	0	2	0	0	8996	2
2	0	2	0	0	8997	2
2	0	2	0	0	8998	2
2	0	2	0	0	8999	2
2	0	2	0	0	9000	2
2	0	2	0	0	9001	2
2	0	2	0	0	9002	2
2	0	2	0	0	9003	2
2	1	4	1	2	9004	1
2	0	2	0	0	9005	2
2	0	4	35	35	9006	2
2	0	2	0	0	9007	2
2	0	2	1	1	9008	2
2	0	2	0	0	9009	2
2	0	2	0	0	9010	2
2	0	2	0	0	9011	2
2	0	2	0	0	9012	2
2	0	2	0	0	9013	2
2	0	2	0	0	9014	2
2	0	2	0	0	9015	2
2	0	2	0	0	9016	2
2	0	2	0	0	9017	2
2	0	2	0	0	9018	2
2	0	4	13	13	9019	2
2	0	2	0	0	9020	2
2	0	2	0	0	9021	2
2	0	4	6	6	9022	2
2	0	2	0	0	9023	2
2	0	2	0	0	9024	2
2	0	2	0	0	9025	2
2	0	2	0	0	9026	2
2	0	2	0	0	9027	2
2	0	2	0	0	9028	2
2	0	2	0	0	9029	2
2	0	2	0	0	9030	2
2	0	2	0	0	9031	2
2	0	4	9	9	9032	2
2	0	2	0	0	9033	2
2	0	2	0	0	9034	2
2	0	4	1	1	9035	2
2	0	2	0	0	9036	2
2	0	2	0	0	9037	2
2	0	2	0	0	9038	2
2	0	2	0	0	9039	2
2	0	2	0	0	9040	2
2	0	2	0	0	9041	2
2	0	4	0	0	9042	2
2	0	2	0	0	9043	2
2	0	2	0	0	9044	2
2	0	4	1	1	9045	2
2	0	2	1	1	9046	2
2	0	2	0	0	9047	2
2	0	2	0	0	9048	2
2	0	2	0	0	9049	2
2	0	2	0	0	9050	2
2	0	2	0	0	9051	2
2	0	2	0	0	9052	2
2	0	2	0	0	9053	2
2	0	2	0	0	9054	2
2	0	2	0	0	9055	2
2	0	2	0	0	9056	2
2	0	2	0	0	9057	2
2	0	2	0	0	9058	2
2	12	2	0	12	9059	0
2	0	4	151	151	9060	2
2	0	2	0	0	9061	2
2	0	2	0	0	9062	2
2	4	4	0	4	9063	0
2	0	2	26	26	9064	2
4	0	2	3	3	9065	2
2	251	2	0	251	9066	0
2	3	2	1085	1088	9067	1
2	0	2	21	21	9068	2
2	0	2	0	0	9069	2
2	19	2	0	19	9070	0
2	0	2	164	164	9071	2
2	0	2	0	0	9072	2
2	0	4	195	195	9073	2
2	0	2	0	0	9074	2
2	0	2	0	0	9075	2
2	0	4	13	13	9076	2
2	0	2	0	0	9077	2
2	0	2	0	0	9078	2
2	0	2	0	0	9079	2
2	0	2	0	0	9080	2
2	0	2	0	0	9081	2
2	0	2	0	0	9082	2
2	0	2	0	0	9083	2
2	0	2	0	0	9084	2
2	0	2	0	0	9085	2
2	0	2	0	0	9086	2
2	0	2	0	0	9087	2
2	0	2	0	0	9088	2
2	0	2	0	0	9089	2
2	0	2	0	0	9090	2
2	0	4	0	0	9091	2
2	0	2	0	0	9092	2
2	0	2	0	0	9093	2
2	0	4	0	0	9094	2
2	0	2	0	0	9095	2
0	0	4	0	0	9096	2
2	0	2	0	0	9097	2
2	0	2	0	0	9098	2
2	0	2	0	0	9099	2
2	2	2	0	2	9100	0
2	0	2	4	4	9101	2
2	0	2	0	0	9102	2
2	0	2	0	0	9103	2
2	0	2	1	1	9104	2
2	0	2	4	4	9105	2
2	0	2	0	0	9106	2
2	0	2	0	0	9107	2
2	0	2	0	0	9108	2
2	0	2	0	0	9109	2
2	0	2	0	0	9110	2
2	0	2	0	0	9111	2
2	0	2	0	0	9112	2
2	0	2	0	0	9113	2
2	0	2	0	0	9114	2
2	1	2	0	1	9115	0
2	0	4	27	27	9116	2
2	0	2	0	0	9117	2
2	0	2	0	0	9118	2
2	1	4	3	4	9119	1
2	0	2	3	3	9120	2
2	0	2	0	0	9121	2
2	0	2	0	0	9122	2
2	0	2	1	1	9123	2
2	0	2	0	0	9124	2
2	0	2	6	6	9125	2
2	0	2	0	0	9126	2
2	0	2	0	0	9127	2
2	0	2	0	0	9128	2
2	0	2	0	0	9129	2
2	0	2	0	0	9130	2
2	0	2	0	0	9131	2
2	0	2	0	0	9132	2
2	0	2	0	0	9133	2
2	0	4	778	778	9134	2
2	0	2	0	0	9135	2
2	0	2	0	0	9136	2
2	0	4	198	198	9137	2
2	0	2	0	0	9138	2
2	0	2	0	0	9139	2
2	0	2	0	0	9140	2
2	0	2	0	0	9141	2
2	0	2	0	0	9142	2
2	0	2	0	0	9143	2
2	0	2	0	0	9144	2
2	0	2	0	0	9145	2
2	0	2	0	0	9146	2
2	0	2	0	0	9147	2
2	0	2	0	0	9148	2
2	0	2	0	0	9149	2
2	0	2	0	0	9150	2
2	0	2	0	0	9151	2
2	0	2	1	1	9152	2
2	0	2	0	0	9153	2
2	0	2	0	0	9154	2
2	0	2	55	55	9155	2
2	0	2	0	0	9156	2
2	0	4	7	7	9157	2
2	0	2	0	0	9158	2
2	0	2	0	0	9159	2
2	0	4	661	661	9160	2
2	0	2	0	0	9161	2
2	0	2	0	0	9162	2
2	0	4	6	6	9163	2
2	0	2	0	0	9164	2
2	0	2	0	0	9165	2
2	0	2	0	0	9166	2
2	0	2	0	0	9167	2
2	0	2	0	0	9168	2
2	0	2	0	0	9169	2
2	0	2	0	0	9170	2
2	0	2	0	0	9171	2
2	0	4	1	1	9172	2
2	0	2	0	0	9173	2
2	0	2	0	0	9174	2
2	0	4	0	0	9175	2
2	0	2	0	0	9176	2
2	1	2	0	1	9177	0
2	0	2	0	0	9178	2
2	0	2	0	0	9179	2
2	0	2	0	0	9180	2
2	0	2	0	0	9181	2
2	0	2	0	0	9182	2
2	0	2	0	0	9183	2
2	0	2	0	0	9184	2
2	0	4	15	15	9185	2
2	0	2	0	0	9186	2
2	0	2	0	0	9187	2
2	0	4	4	4	9188	2
2	0	2	0	0	9189	2
2	0	2	3	3	9190	2
2	0	2	0	0	9191	2
2	0	2	0	0	9192	2
2	0	2	0	0	9193	2
2	0	2	0	0	9194	2
2	0	2	0	0	9195	2
2	0	2	0	0	9196	2
2	0	2	0	0	9197	2
2	0	2	0	0	9198	2
2	0	2	0	0	9199	2
2	0	2	0	0	9200	2
2	0	2	0	0	9201	2
2	0	2	0	0	9202	2
2	0	2	0	0	9203	2
2	0	2	0	0	9204	2
2	0	2	0	0	9205	2
2	0	2	0	0	9206	2
2	0	2	0	0	9207	2
2	0	2	0	0	9208	2
2	0	2	0	0	9209	2
2	0	2	0	0	9210	2
2	0	2	0	0	9211	2
2	0	2	0	0	9212	2
2	0	2	0	0	9213	2
2	0	2	0	0	9214	2
2	0	2	0	0	9215	2
2	0	2	0	0	9216	2
2	0	2	0	0	9217	2
2	0	2	0	0	9218	2
2	0	2	0	0	9219	2
2	0	4	291	291	9220	2
2	0	2	0	0	9221	2
2	0	2	0	0	9222	2
2	0	4	357	357	9223	2
2	0	2	0	0	9224	2
4	0	2	0	0	9225	2
2	0	2	0	0	9226	2
2	0	2	0	0	9227	2
2	0	2	0	0	9228	2
2	0	4	0	0	9229	2
2	0	2	0	0	9230	2
2	0	2	0	0	9231	2
2	0	2	0	0	9232	2
2	0	2	0	0	9233	2
2	0	2	0	0	9234	2
2	0	2	0	0	9235	2
2	0	2	0	0	9236	2
2	0	2	0	0	9237	2
2	0	2	0	0	9238	2
2	0	2	0	0	9239	2
2	0	2	0	0	9240	2
2	0	2	0	0	9241	2
2	0	2	0	0	9242	2
2	0	2	0	0	9243	2
2	0	2	0	0	9244	2
2	0	2	0	0	9245	2
2	0	2	0	0	9246	2
2	0	2	0	0	9247	2
2	0	2	0	0	9248	2
2	0	2	0	0	9249	2
2	0	2	0	0	9250	2
2	0	2	0	0	9251	2
2	0	2	0	0	9252	2
2	0	2	0	0	9253	2
2	0	2	0	0	9254	2
2	0	2	0	0	9255	2
2	0	2	0	0	9256	2
2	0	2	0	0	9257	2
2	0	2	0	0	9258	2
2	0	2	0	0	9259	2
2	0	2	0	0	9260	2
2	0	2	0	0	9261	2
2	0	2	0	0	9262	2
2	0	2	0	0	9263	2
0	7	4	6217	6224	9264	0
0	0	4	6217	6217	9265	2
2	0	2	0	0	9266	2
2	0	2	0	0	9267	2
2	0	2	0	0	9268	2
2	0	2	0	0	9269	2
2	0	2	0	0	9270	2
2	0	2	0	0	9271	2
2	0	2	0	0	9272	2
2	0	2	0	0	9273	2
0	0	2	0	0	9274	2
0	0	2	0	0	9275	2
4	0	4	0	0	9276	2
4	0	2	0	0	9277	2
4	0	2	0	0	9278	2
4	0	4	0	0	9279	2
2	0	2	0	0	9280	2
2	0	4	12	12	9281	2
2	0	2	0	0	9282	2
2	0	2	0	0	9283	2
2	0	4	0	0	9284	2
2	1	2	32	33	9285	1
4	0	2	10	10	9286	2
2	0	2	0	0	9287	2
2	0	2	0	0	9288	2
2	0	2	0	0	9289	2
2	0	2	0	0	9290	2
2	0	2	0	0	9291	2
2	0	2	0	0	9292	2
2	0	2	0	0	9293	2
2	0	2	0	0	9294	2
2	0	2	0	0	9295	2
2	0	2	0	0	9296	2
2	0	2	0	0	9297	2
2	0	2	0	0	9298	2
2	2	2	0	2	9299	0
2	0	2	0	0	9300	2
2	0	2	0	0	9301	2
2	0	2	0	0	9302	2
2	0	2	0	0	9303	2
2	0	2	0	0	9304	2
2	0	2	0	0	9305	2
2	0	2	0	0	9306	2
2	0	2	0	0	9307	2
2	0	2	0	0	9308	2
2	1	2	6	7	9309	1
2	0	2	0	0	9310	2
2	0	2	0	0	9311	2
2	0	2	0	0	9312	2
2	0	2	0	0	9313	2
2	0	2	0	0	9314	2
2	0	2	0	0	9315	2
2	0	2	0	0	9316	2
2	0	2	0	0	9317	2
2	1	0	147	148	9318	1
2	0	2	0	0	9319	2
2	0	2	0	0	9320	2
2	4	0	6	10	9321	1
2	0	2	5	5	9322	2
0	79	2	42	121	9323	0
2	0	2	0	0	9324	2
2	0	2	0	0	9325	2
2	0	2	0	0	9326	2
2	0	2	0	0	9327	2
2	0	2	0	0	9328	2
2	0	2	0	0	9329	2
2	0	2	0	0	9330	2
2	0	2	0	0	9331	2
2	0	2	0	0	9332	2
2	0	2	0	0	9333	2
2	0	2	0	0	9334	2
2	0	2	0	0	9335	2
2	18	2	0	18	9336	0
2	1	4	1770	1771	9337	1
2	1	2	0	1	9338	1
2	0	2	1	1	9339	2
2	9	4	813	822	9340	1
2	0	2	37	37	9341	2
2	0	2	0	0	9342	2
2	0	4	1	1	9343	2
2	0	2	0	0	9344	2
2	0	2	0	0	9345	2
2	0	4	0	0	9346	2
2	0	2	0	0	9347	2
2	0	2	0	0	9348	2
2	0	2	0	0	9349	2
2	0	2	0	0	9350	2
2	1	2	0	1	9351	0
2	1	2	8	9	9352	1
2	0	2	1	1	9353	2
2	0	2	0	0	9354	2
2	0	2	3	3	9355	2
0	58	4	3	61	9356	0
0	4	4	3	7	9357	0
2	0	2	1	1	9358	2
2	0	2	0	0	9359	2
2	0	2	0	0	9360	2
2	0	2	0	0	9361	2
2	0	2	0	0	9362	2
2	0	2	0	0	9363	2
2	0	2	0	0	9364	2
2	0	2	0	0	9365	2
2	0	4	0	0	9366	2
2	0	2	0	0	9367	2
2	0	2	0	0	9368	2
2	1	2	0	1	9369	0
2	0	2	0	0	9370	2
2	0	2	0	0	9371	2
2	0	2	0	0	9372	2
2	0	2	0	0	9373	2
2	0	2	0	0	9374	2
2	0	2	0	0	9375	2
2	2	4	242	244	9376	1
2	0	2	0	0	9377	2
2	0	2	0	0	9378	2
2	1	4	57	58	9379	0
2	0	2	7	7	9380	2
2	0	2	0	0	9381	2
2	0	2	0	0	9382	2
2	0	2	0	0	9383	2
2	0	2	0	0	9384	2
2	0	2	0	0	9385	2
2	0	2	1	1	9386	2
2	0	2	0	0	9387	2
2	0	2	0	0	9388	2
2	0	2	0	0	9389	2
2	0	2	0	0	9390	2
2	0	2	0	0	9391	2
2	0	2	0	0	9392	2
2	0	2	0	0	9393	2
2	0	2	0	0	9394	2
2	0	2	0	0	9395	2
2	0	2	0	0	9396	2
2	0	2	0	0	9397	2
2	0	2	0	0	9398	2
2	0	2	0	0	9399	2
2	0	4	1	1	9400	2
2	0	2	0	0	9401	2
2	0	2	0	0	9402	2
2	1	4	0	1	9403	1
2	0	2	0	0	9404	2
2	0	2	0	0	9405	2
4	0	2	0	0	9406	2
2	0	2	0	0	9407	2
2	0	2	0	0	9408	2
2	0	2	0	0	9409	2
2	0	2	0	0	9410	2
2	0	2	0	0	9411	2
2	0	2	0	0	9412	2
2	85	2	1	86	9413	0
2	26	4	1401	1427	9414	1
2	1	2	70	71	9415	1
2	0	2	0	0	9416	2
2	47	4	100	147	9417	0
2	0	2	268	268	9418	2
2	0	2	0	0	9419	2
2	0	2	0	0	9420	2
2	0	2	0	0	9421	2
2	0	2	1	1	9422	2
2	0	2	0	0	9423	2
2	0	2	0	0	9424	2
2	0	2	0	0	9425	2
2	0	2	7	7	9426	2
2	0	2	0	0	9427	2
2	0	2	0	0	9428	2
2	0	2	0	0	9429	2
2	0	2	0	0	9430	2
2	0	2	0	0	9431	2
2	0	4	217	217	9432	2
2	0	2	0	0	9433	2
2	0	2	0	0	9434	2
2	0	4	25	25	9435	2
2	0	2	0	0	9436	2
2	0	2	0	0	9437	2
2	0	2	0	0	9438	2
2	0	2	0	0	9439	2
2	0	2	0	0	9440	2
2	0	2	0	0	9441	2
2	0	2	0	0	9442	2
4	1	4	0	1	9443	1
4	0	4	0	0	9444	2
4	96	4	3	99	9445	1
4	21	4	0	21	9446	1
0	137	2	2	139	9447	0
4	17	2	4	21	9448	0
4	7	2	0	7	9449	0
4	639	4	9	648	9450	1
4	3	4	0	3	9451	1
4	0	4	60	60	9452	2
4	0	4	28	28	9453	2
0	2	2	0	2	9454	0
0	4	2	0	4	9455	0
0	0	2	0	0	9456	2
4	0	4	2	2	9457	2
4	0	4	0	0	9458	2
0	233	4	9	242	9459	0
0	135	4	2	137	9460	0
1	48132	4	628	48760	9461	0
4	3645	4	49	3694	9462	0
0	1	4	2	3	9463	1
0	0	4	0	0	9464	2
4	1	2	0	1	9465	1
4	0	2	0	0	9466	2
4	0	2	0	0	9467	2
4	7	4	1086	1093	9468	0
4	40	4	91	131	9469	0
4	22	4	232	254	9470	0
4	521	2	7	528	9471	0
4	149	2	0	149	9472	0
2	0	2	0	0	9473	2
2	0	2	0	0	9474	2
2	0	2	0	0	9475	2
2	0	2	0	0	9476	2
2	0	2	0	0	9477	2
2	0	2	0	0	9478	2
2	0	2	0	0	9479	2
2	0	4	7	7	9480	2
2	0	2	0	0	9481	2
2	0	2	0	0	9482	2
2	0	2	0	0	9483	2
2	0	2	0	0	9484	2
2	0	4	1	1	9485	2
2	0	2	0	0	9486	2
2	0	2	0	0	9487	2
2	0	2	0	0	9488	2
2	0	2	0	0	9489	2
2	0	2	0	0	9490	2
2	0	2	0	0	9491	2
2	0	2	0	0	9492	2
2	0	2	0	0	9493	2
2	0	4	0	0	9494	2
2	0	2	0	0	9495	2
2	0	2	0	0	9496	2
2	0	4	2	2	9497	2
2	0	2	0	0	9498	2
2	0	2	0	0	9499	2
2	0	2	0	0	9500	2
2	0	2	0	0	9501	2
2	0	2	0	0	9502	2
2	0	2	0	0	9503	2
2	0	2	0	0	9504	2
2	0	2	0	0	9505	2
2	0	4	2	2	9506	2
2	0	2	0	0	9507	2
2	0	2	0	0	9508	2
2	0	2	0	0	9509	2
2	0	2	0	0	9510	2
2	0	2	0	0	9511	2
2	0	2	0	0	9512	2
2	0	2	0	0	9513	2
2	0	2	0	0	9514	2
2	0	2	0	0	9515	2
2	0	2	0	0	9516	2
2	0	2	0	0	9517	2
2	0	2	0	0	9518	2
2	0	2	0	0	9519	2
2	0	2	0	0	9520	2
2	0	2	0	0	9521	2
2	0	2	0	0	9522	2
2	0	2	0	0	9523	2
2	0	2	0	0	9524	2
2	0	2	0	0	9525	2
2	0	2	0	0	9526	2
2	0	2	0	0	9527	2
2	0	2	0	0	9528	2
2	0	2	0	0	9529	2
2	0	2	0	0	9530	2
2	0	2	537	537	9531	2
2	0	2	0	0	9532	2
2	0	2	0	0	9533	2
2	0	2	0	0	9534	2
2	0	2	0	0	9535	2
2	0	2	0	0	9536	2
2	0	2	0	0	9537	2
2	0	2	0	0	9538	2
2	0	2	0	0	9539	2
2	0	2	0	0	9540	2
2	0	2	0	0	9541	2
2	0	2	0	0	9542	2
2	0	2	0	0	9543	2
2	0	2	0	0	9544	2
2	0	2	0	0	9545	2
2	0	4	0	0	9546	2
2	0	2	0	0	9547	2
2	0	4	0	0	9548	2
2	0	2	0	0	9549	2
2	0	2	0	0	9550	2
2	0	2	0	0	9551	2
2	0	2	0	0	9552	2
2	0	2	0	0	9553	2
2	0	2	1	1	9554	2
2	0	2	0	0	9555	2
2	0	2	0	0	9556	2
2	0	2	0	0	9557	2
2	0	4	0	0	9558	2
2	0	2	0	0	9559	2
2	0	2	0	0	9560	2
2	0	4	0	0	9561	2
2	0	2	0	0	9562	2
2	0	2	0	0	9563	2
2	0	4	3	3	9564	2
2	0	2	0	0	9565	2
2	0	2	0	0	9566	2
4	3	2	0	3	9567	0
2	2	4	7	9	9568	1
2	0	2	0	0	9569	2
2	7	4	287	294	9570	0
2	5	2	49	54	9571	0
2	0	2	0	0	9572	2
2	0	2	0	0	9573	2
2	0	2	0	0	9574	2
2	0	2	0	0	9575	2
2	0	2	0	0	9576	2
2	0	2	0	0	9577	2
2	0	2	0	0	9578	2
2	0	2	0	0	9579	2
2	0	2	0	0	9580	2
2	0	2	0	0	9581	2
2	0	2	0	0	9582	2
2	0	2	0	0	9583	2
4	5	2	0	5	9584	0
2	0	2	0	0	9585	2
2	0	2	0	0	9586	2
2	0	2	0	0	9587	2
2	0	2	0	0	9588	2
2	0	2	0	0	9589	2
2	0	2	0	0	9590	2
2	2	4	531	533	9591	0
2	0	2	12	12	9592	2
2	0	2	0	0	9593	2
2	0	0	1	1	9594	2
2	0	2	0	0	9595	2
2	0	2	0	0	9596	2
2	0	0	0	0	9597	2
2	0	2	0	0	9598	2
2	0	2	0	0	9599	2
2	0	4	6638	6638	9600	2
2	0	2	0	0	9601	2
2	0	2	0	0	9602	2
2	0	4	2086	2086	9603	2
2	0	2	0	0	9604	2
2	0	2	0	0	9605	2
2	0	2	0	0	9606	2
2	0	2	0	0	9607	2
2	0	2	0	0	9608	2
2	0	2	0	0	9609	2
2	0	2	0	0	9610	2
2	0	2	0	0	9611	2
2	0	2	0	0	9612	2
2	0	2	0	0	9613	2
2	0	2	0	0	9614	2
2	0	2	0	0	9615	2
2	0	2	0	0	9616	2
2	24	2	0	24	9617	0
2	0	0	136	136	9618	2
2	0	2	0	0	9619	2
2	0	2	0	0	9620	2
2	0	2	0	0	9621	2
2	0	2	0	0	9622	2
2	0	2	0	0	9623	2
2	0	2	0	0	9624	2
2	0	2	0	0	9625	2
2	0	2	0	0	9626	2
2	4	0	13	17	9627	0
2	0	2	22	22	9628	2
2	0	2	0	0	9629	2
2	0	2	0	0	9630	2
2	0	2	0	0	9631	2
2	0	2	0	0	9632	2
2	0	2	0	0	9633	2
2	0	2	0	0	9634	2
2	0	2	0	0	9635	2
2	3	2	8	11	9636	1
2	0	2	3	3	9637	2
2	1	2	24	25	9638	1
2	0	2	2	2	9639	2
2	0	2	0	0	9640	2
0	0	2	38	38	9641	2
2	120	2	0	120	9642	0
2	2	2	253	255	9643	1
2	0	2	0	0	9644	2
2	0	2	0	0	9645	2
2	0	2	0	0	9646	2
2	0	2	0	0	9647	2
2	0	2	0	0	9648	2
2	0	2	0	0	9649	2
2	0	2	0	0	9650	2
2	0	2	0	0	9651	2
2	0	2	0	0	9652	2
2	0	2	0	0	9653	2
2	0	2	0	0	9654	2
2	0	2	0	0	9655	2
2	0	2	0	0	9656	2
2	0	2	0	0	9657	2
2	0	2	0	0	9658	2
2	0	2	0	0	9659	2
2	0	2	5	5	9660	2
2	0	2	0	0	9661	2
4	1	4	0	1	9662	1
2	0	2	0	0	9663	2
2	0	2	0	0	9664	2
2	0	2	0	0	9665	2
2	0	2	0	0	9666	2
2	0	2	0	0	9667	2
2	0	2	0	0	9668	2
2	0	2	0	0	9669	2
2	0	2	0	0	9670	2
2	0	2	0	0	9671	2
2	0	2	0	0	9672	2
2	0	2	0	0	9673	2
2	0	2	0	0	9674	2
2	0	2	0	0	9675	2
2	0	4	0	0	9676	2
2	0	2	0	0	9677	2
2	0	2	0	0	9678	2
2	0	4	0	0	9679	2
2	0	2	0	0	9680	2
4	0	2	0	0	9681	2
0	6	4	0	6	9682	0
0	0	4	0	0	9683	2
2	0	2	0	0	9684	2
2	0	2	0	0	9685	2
2	0	2	0	0	9686	2
2	0	2	0	0	9687	2
2	0	2	0	0	9688	2
2	0	2	0	0	9689	2
2	0	2	0	0	9690	2
2	0	2	0	0	9691	2
2	0	2	0	0	9692	2
2	0	2	0	0	9693	2
2	0	2	0	0	9694	2
2	0	2	0	0	9695	2
2	0	2	0	0	9696	2
2	0	2	0	0	9697	2
2	0	2	0	0	9698	2
2	0	2	0	0	9699	2
2	0	2	0	0	9700	2
2	0	2	0	0	9701	2
2	0	2	0	0	9702	2
2	0	2	0	0	9703	2
2	0	2	0	0	9704	2
2	0	2	0	0	9705	2
2	0	2	0	0	9706	2
2	0	2	0	0	9707	2
2	0	2	0	0	9708	2
2	0	4	2	2	9709	2
2	0	2	0	0	9710	2
2	0	2	0	0	9711	2
2	0	4	0	0	9712	2
2	0	2	0	0	9713	2
2	6	2	0	6	9714	0
2	0	2	0	0	9715	2
2	0	2	0	0	9716	2
2	0	2	0	0	9717	2
2	0	2	0	0	9718	2
2	0	2	0	0	9719	2
2	0	2	0	0	9720	2
2	0	2	0	0	9721	2
0	0	0	18	18	9722	2
2	0	2	0	0	9723	2
2	0	2	0	0	9724	2
2	0	2	0	0	9725	2
2	0	2	0	0	9726	2
2	0	2	0	0	9727	2
2	0	2	0	0	9728	2
2	0	2	0	0	9729	2
2	0	2	0	0	9730	2
2	0	2	10	10	9731	2
2	0	2	58	58	9732	2
2	0	2	0	0	9733	2
2	0	2	0	0	9734	2
2	0	2	1	1	9735	2
2	0	4	2	2	9736	2
2	0	2	0	0	9737	2
2	0	2	0	0	9738	2
2	0	4	0	0	9739	2
2	0	2	0	0	9740	2
2	83	2	1	84	9741	0
2	21	2	1648	1669	9742	1
2	0	2	1	1	9743	2
2	0	2	1	1	9744	2
2	1	2	1	2	9745	0
2	0	2	33	33	9746	2
2	0	4	3	3	9747	2
2	0	2	0	0	9748	2
2	0	2	0	0	9749	2
0	342	2	0	342	9750	0
0	62	2	0	62	9751	0
0	0	4	33	33	9752	2
0	0	4	33	33	9753	2
2	0	4	471	471	9754	2
2	0	2	1	1	9755	2
2	0	2	0	0	9756	2
2	0	2	1	1	9757	2
2	0	2	0	0	9758	2
2	0	2	1	1	9759	2
2	0	2	0	0	9760	2
2	0	2	0	0	9761	2
0	3	4	2	5	9762	0
2	0	2	0	0	9763	2
2	0	2	0	0	9764	2
2	0	2	0	0	9765	2
2	0	2	0	0	9766	2
2	0	2	0	0	9767	2
2	0	2	0	0	9768	2
2	0	2	0	0	9769	2
2	0	2	0	0	9770	2
2	0	2	0	0	9771	2
2	0	2	0	0	9772	2
2	0	2	0	0	9773	2
2	0	2	0	0	9774	2
2	0	2	0	0	9775	2
2	0	2	3	3	9776	2
2	0	2	0	0	9777	2
2	0	2	0	0	9778	2
2	0	2	0	0	9779	2
2	0	2	0	0	9780	2
4	0	2	1	1	9781	2
2	2	2	0	2	9782	0
2	0	2	25	25	9783	2
2	0	2	0	0	9784	2
2	0	2	0	0	9785	2
2	2	2	29	31	9786	0
2	0	2	8	8	9787	2
2	0	2	0	0	9788	2
2	0	2	0	0	9789	2
2	0	2	0	0	9790	2
2	0	2	0	0	9791	2
2	0	2	0	0	9792	2
2	0	2	0	0	9793	2
2	3	2	0	3	9794	0
0	0	4	0	0	9795	2
0	0	4	0	0	9796	2
2	0	2	330	330	9797	2
2	0	2	1	1	9798	2
2	0	2	0	0	9799	2
2	8	4	21	29	9800	1
2	0	2	56	56	9801	2
2	11	2	0	11	9802	0
0	0	4	0	0	9803	2
2	2	0	856	858	9804	1
2	0	2	2	2	9805	2
2	0	2	0	0	9806	2
2	4	0	9	13	9807	0
2	0	2	52	52	9808	2
2	0	2	0	0	9809	2
2	0	2	0	0	9810	2
2	0	2	0	0	9811	2
2	0	2	0	0	9812	2
2	0	2	0	0	9813	2
2	0	2	0	0	9814	2
2	0	2	0	0	9815	2
2	0	2	0	0	9816	2
2	0	2	0	0	9817	2
2	0	2	0	0	9818	2
2	0	2	0	0	9819	2
2	0	2	0	0	9820	2
2	0	4	1	1	9821	2
2	0	2	0	0	9822	2
2	0	2	0	0	9823	2
2	1	2	7	8	9824	1
2	0	2	0	0	9825	2
2	0	2	0	0	9826	2
2	0	2	4	4	9827	2
2	0	2	0	0	9828	2
2	0	2	0	0	9829	2
2	0	4	171	171	9830	2
2	0	2	0	0	9831	2
2	0	2	0	0	9832	2
2	0	4	2	2	9833	2
2	0	2	0	0	9834	2
2	9	4	83	92	9835	1
2	0	2	0	0	9836	2
2	0	2	0	0	9837	2
2	0	2	0	0	9838	2
2	0	4	9	9	9839	2
2	0	2	0	0	9840	2
2	0	2	0	0	9841	2
4	0	2	0	0	9842	2
0	0	2	18	18	9843	2
0	6	2	18	24	9844	0
2	82	4	20	102	9845	0
2	0	4	51	51	9846	2
4	0	2	1	1	9847	2
4	6	2	2	8	9848	0
4	48	2	7	55	9849	0
4	42	2	4	46	9850	0
2	0	2	0	0	9851	2
2	0	2	0	0	9852	2
2	0	2	0	0	9853	2
2	0	2	0	0	9854	2
2	0	2	0	0	9855	2
2	0	2	0	0	9856	2
2	0	2	0	0	9857	2
2	0	2	0	0	9858	2
2	0	2	0	0	9859	2
2	0	2	0	0	9860	2
2	0	2	0	0	9861	2
2	0	2	0	0	9862	2
2	0	2	0	0	9863	2
2	0	2	0	0	9864	2
2	0	2	0	0	9865	2
2	0	2	0	0	9866	2
2	0	2	0	0	9867	2
2	0	2	0	0	9868	2
2	0	2	0	0	9869	2
2	0	2	0	0	9870	2
2	0	2	0	0	9871	2
2	0	2	0	0	9872	2
2	0	2	0	0	9873	2
2	0	2	0	0	9874	2
0	112	4	1068	1180	9875	0
2	0	2	0	0	9876	2
2	0	2	0	0	9877	2
2	0	2	0	0	9878	2
2	0	2	0	0	9879	2
2	0	2	0	0	9880	2
2	0	2	0	0	9881	2
2	0	2	0	0	9882	2
2	0	2	0	0	9883	2
2	0	2	0	0	9884	2
2	0	2	0	0	9885	2
2	0	2	0	0	9886	2
2	0	2	0	0	9887	2
0	0	4	1	1	9888	2
0	0	4	1	1	9889	2
2	0	2	0	0	9890	2
2	0	2	0	0	9891	2
2	0	2	0	0	9892	2
2	0	2	0	0	9893	2
2	0	2	0	0	9894	2
2	0	2	0	0	9895	2
2	10	2	0	10	9896	0
2	5	2	558	563	9897	1
2	0	2	12	12	9898	2
2	0	2	1	1	9899	2
2	7	2	24	31	9900	0
2	0	2	41	41	9901	2
2	0	2	0	0	9902	2
2	0	2	0	0	9903	2
2	0	2	0	0	9904	2
2	0	2	0	0	9905	2
2	0	2	0	0	9906	2
2	0	2	0	0	9907	2
2	1	2	0	1	9908	0
2	0	2	0	0	9909	2
2	0	2	0	0	9910	2
2	0	2	0	0	9911	2
2	0	2	1	1	9912	2
2	0	2	0	0	9913	2
2	0	2	0	0	9914	2
2	0	2	0	0	9915	2
2	0	2	0	0	9916	2
2	0	2	0	0	9917	2
2	0	0	0	0	9918	2
2	0	2	0	0	9919	2
2	0	2	0	0	9920	2
2	0	2	0	0	9921	2
2	0	2	7	7	9922	2
2	0	2	1	1	9923	2
2	0	2	0	0	9924	2
2	0	2	0	0	9925	2
2	0	2	3	3	9926	2
2	16	2	0	16	9927	0
2	0	2	56	56	9928	2
2	0	2	3	3	9929	2
2	0	2	0	0	9930	2
2	3	2	0	3	9931	0
2	0	2	36	36	9932	2
2	48	2	0	48	9933	0
2	18	2	623	641	9934	1
2	1	2	4	5	9935	1
2	0	2	0	0	9936	2
2	32	2	3	35	9937	0
2	0	2	43	43	9938	2
2	0	2	0	0	9939	2
2	0	4	9	9	9940	2
2	0	2	0	0	9941	2
2	0	2	0	0	9942	2
2	0	0	3	3	9943	2
2	0	2	0	0	9944	2
2	0	2	0	0	9945	2
2	0	2	0	0	9946	2
2	0	2	0	0	9947	2
2	0	2	0	0	9948	2
2	0	2	0	0	9949	2
2	0	2	0	0	9950	2
2	0	2	0	0	9951	2
2	0	2	0	0	9952	2
2	0	2	0	0	9953	2
2	0	2	0	0	9954	2
2	0	2	0	0	9955	2
2	0	2	0	0	9956	2
2	1	2	0	1	9957	1
2	5	2	1	6	9958	1
2	0	2	1	1	9959	2
2	0	2	0	0	9960	2
2	0	2	0	0	9961	2
2	0	2	0	0	9962	2
2	0	2	0	0	9963	2
2	0	2	0	0	9964	2
2	0	2	0	0	9965	2
2	0	2	2	2	9966	2
2	0	2	0	0	9967	2
2	6	2	1	7	9968	0
2	2	2	35	37	9969	1
2	0	2	20	20	9970	2
2	0	2	1	1	9971	2
2	0	2	6	6	9972	2
2	0	2	4	4	9973	2
2	0	2	0	0	9974	2
2	0	2	0	0	9975	2
2	0	2	0	0	9976	2
2	0	2	0	0	9977	2
2	0	2	0	0	9978	2
2	0	2	0	0	9979	2
2	0	2	0	0	9980	2
2	0	2	0	0	9981	2
2	0	2	0	0	9982	2
2	0	2	0	0	9983	2
2	0	2	0	0	9984	2
2	0	2	0	0	9985	2
2	12	2	1	13	9986	0
2	0	2	0	0	9987	2
2	0	2	0	0	9988	2
2	0	2	0	0	9989	2
2	0	2	0	0	9990	2
2	0	2	0	0	9991	2
2	0	2	0	0	9992	2
2	0	2	0	0	9993	2
2	0	2	0	0	9994	2
2	0	2	0	0	9995	2
2	0	2	0	0	9996	2
2	0	2	0	0	9997	2
2	0	2	0	0	9998	2
2	0	2	0	0	9999	2
2	0	2	0	0	10000	2
2	0	2	0	0	10001	2
2	0	2	0	0	10002	2
2	0	2	0	0	10003	2
2	0	2	0	0	10004	2
2	0	2	0	0	10005	2
2	0	2	0	0	10006	2
2	0	2	0	0	10007	2
2	0	2	0	0	10008	2
2	0	2	0	0	10009	2
2	0	2	0	0	10010	2
2	0	2	0	0	10011	2
2	0	2	0	0	10012	2
2	0	2	0	0	10013	2
2	0	2	0	0	10014	2
2	0	2	0	0	10015	2
2	0	2	0	0	10016	2
2	0	2	0	0	10017	2
2	0	2	0	0	10018	2
2	0	2	0	0	10019	2
2	0	2	0	0	10020	2
2	0	2	0	0	10021	2
2	0	2	0	0	10022	2
2	0	2	0	0	10023	2
2	0	2	0	0	10024	2
2	0	2	0	0	10025	2
2	0	2	0	0	10026	2
2	0	2	0	0	10027	2
2	0	2	0	0	10028	2
2	46	2	490	536	10029	1
2	0	2	2	2	10030	2
2	0	2	6	6	10031	2
2	12	2	17	29	10032	0
2	0	2	0	0	10033	2
2	0	2	0	0	10034	2
2	0	2	0	0	10035	2
2	915	2	1	916	10036	0
2	313	2	5265	5578	10037	1
2	1	2	63	64	10038	1
2	0	2	13	13	10039	2
0	28	2	185	213	10040	0
0	15	2	3	18	10041	0
2	165	2	44	209	10042	1
2	0	2	9	9	10043	2
2	0	2	0	0	10044	2
2	0	2	0	0	10045	2
2	0	2	0	0	10046	2
2	0	2	0	0	10047	2
2	0	2	0	0	10048	2
2	0	2	0	0	10049	2
2	3	2	0	3	10050	0
2	0	2	28	28	10051	2
2	0	2	1	1	10052	2
2	0	2	0	0	10053	2
2	2	2	0	2	10054	1
2	0	2	11	11	10055	2
2	0	2	0	0	10056	2
2	0	2	0	0	10057	2
2	0	2	0	0	10058	2
2	0	2	0	0	10059	2
2	0	2	0	0	10060	2
2	0	2	0	0	10061	2
4	7	4	0	7	10062	1
4	7	4	0	7	10063	1
2	0	2	0	0	10064	2
2	0	0	0	0	10065	2
2	0	2	0	0	10066	2
2	0	2	0	0	10067	2
2	0	0	0	0	10068	2
2	0	2	0	0	10069	2
2	0	2	0	0	10070	2
2	0	2	0	0	10071	2
2	0	2	0	0	10072	2
2	0	2	0	0	10073	2
2	0	2	0	0	10074	2
2	0	2	0	0	10075	2
2	0	2	0	0	10076	2
2	0	2	0	0	10077	2
2	0	2	0	0	10078	2
2	0	2	0	0	10079	2
2	0	2	0	0	10080	2
2	0	2	0	0	10081	2
2	0	2	0	0	10082	2
2	0	2	7	7	10083	2
2	0	2	0	0	10084	2
2	0	2	0	0	10085	2
2	0	2	1	1	10086	2
2	0	2	1	1	10087	2
4	8	2	0	8	10088	0
2	0	2	0	0	10089	2
2	0	2	0	0	10090	2
2	0	2	0	0	10091	2
2	0	2	0	0	10092	2
2	0	2	0	0	10093	2
2	0	2	0	0	10094	2
2	0	4	0	0	10095	2
2	0	2	0	0	10096	2
2	1	2	0	1	10097	1
2	0	2	0	0	10098	2
2	0	2	0	0	10099	2
2	0	2	3	3	10100	2
2	0	2	0	0	10101	2
2	0	2	0	0	10102	2
2	0	2	0	0	10103	2
2	0	2	0	0	10104	2
2	0	2	0	0	10105	2
2	0	2	0	0	10106	2
2	0	2	0	0	10107	2
2	0	2	0	0	10108	2
2	0	2	0	0	10109	2
2	0	2	0	0	10110	2
2	0	2	0	0	10111	2
2	0	4	219	219	10112	2
2	0	2	7	7	10113	2
2	0	2	0	0	10114	2
2	0	2	0	0	10115	2
2	0	2	0	0	10116	2
2	0	2	0	0	10117	2
2	0	2	0	0	10118	2
2	0	2	0	0	10119	2
2	0	2	0	0	10120	2
2	0	2	1	1	10121	2
2	0	2	0	0	10122	2
2	0	2	0	0	10123	2
4	0	2	1	1	10124	2
2	0	2	0	0	10125	2
2	0	2	0	0	10126	2
2	0	2	0	0	10127	2
2	0	2	0	0	10128	2
2	0	2	0	0	10129	2
2	0	2	0	0	10130	2
2	0	2	0	0	10131	2
2	0	2	0	0	10132	2
2	0	2	0	0	10133	2
2	0	2	114	114	10134	2
2	0	2	0	0	10135	2
2	0	2	0	0	10136	2
2	2	2	1	3	10137	0
2	0	2	1	1	10138	2
4	0	2	0	0	10139	2
2	0	2	0	0	10140	2
2	0	2	0	0	10141	2
2	0	2	0	0	10142	2
2	0	2	0	0	10143	2
2	0	2	0	0	10144	2
2	0	2	0	0	10145	2
2	0	2	0	0	10146	2
2	0	2	0	0	10147	2
2	0	2	0	0	10148	2
2	0	2	0	0	10149	2
2	0	2	0	0	10150	2
2	0	2	0	0	10151	2
2	0	2	0	0	10152	2
2	0	2	0	0	10153	2
2	0	2	0	0	10154	2
2	0	2	0	0	10155	2
2	0	2	0	0	10156	2
2	0	2	0	0	10157	2
2	0	2	0	0	10158	2
2	0	2	0	0	10159	2
2	1	2	6	7	10160	1
2	0	2	0	0	10161	2
2	0	2	0	0	10162	2
2	0	2	0	0	10163	2
2	0	2	3	3	10164	2
2	1	2	0	1	10165	1
2	0	2	0	0	10166	2
2	0	2	0	0	10167	2
2	2	2	2	4	10168	1
2	0	2	0	0	10169	2
2	0	2	0	0	10170	2
0	18	4	107	125	10171	1
2	0	2	0	0	10172	2
2	0	4	0	0	10173	2
2	0	2	0	0	10174	2
2	0	2	0	0	10175	2
2	0	4	0	0	10176	2
2	0	2	0	0	10177	2
2	0	2	0	0	10178	2
2	0	2	0	0	10179	2
2	0	2	0	0	10180	2
2	0	2	0	0	10181	2
2	0	2	0	0	10182	2
2	0	2	0	0	10183	2
2	0	2	0	0	10184	2
2	0	2	0	0	10185	2
2	0	2	0	0	10186	2
2	0	2	0	0	10187	2
2	0	2	0	0	10188	2
2	0	2	0	0	10189	2
2	0	2	0	0	10190	2
2	6	2	12	18	10191	1
2	0	2	0	0	10192	2
2	0	2	0	0	10193	2
2	1	2	0	1	10194	1
2	0	2	2	2	10195	2
2	0	2	0	0	10196	2
2	0	2	0	0	10197	2
2	0	2	0	0	10198	2
2	0	2	0	0	10199	2
2	0	2	0	0	10200	2
2	0	2	0	0	10201	2
2	0	2	0	0	10202	2
2	0	2	0	0	10203	2
2	0	2	0	0	10204	2
2	0	2	0	0	10205	2
2	0	2	0	0	10206	2
2	0	2	0	0	10207	2
2	0	2	0	0	10208	2
2	0	4	2	2	10209	2
2	0	2	0	0	10210	2
2	0	2	0	0	10211	2
2	0	4	5	5	10212	2
2	0	2	0	0	10213	2
2	0	2	0	0	10214	2
2	0	2	0	0	10215	2
2	0	2	0	0	10216	2
2	0	2	0	0	10217	2
2	0	2	0	0	10218	2
2	0	2	0	0	10219	2
2	0	2	0	0	10220	2
2	0	2	0	0	10221	2
2	0	2	0	0	10222	2
2	0	2	0	0	10223	2
2	0	2	0	0	10224	2
2	0	2	0	0	10225	2
2	0	2	0	0	10226	2
2	0	2	0	0	10227	2
2	0	2	0	0	10228	2
2	0	2	0	0	10229	2
2	0	2	0	0	10230	2
2	0	2	0	0	10231	2
2	0	2	0	0	10232	2
2	0	2	0	0	10233	2
2	0	2	0	0	10234	2
2	0	2	0	0	10235	2
2	0	2	0	0	10236	2
2	0	2	2	2	10237	2
2	0	2	0	0	10238	2
2	0	2	0	0	10239	2
2	0	2	0	0	10240	2
2	0	2	0	0	10241	2
2	0	2	0	0	10242	2
2	0	2	0	0	10243	2
2	0	2	0	0	10244	2
2	0	4	7	7	10245	2
2	0	2	0	0	10246	2
2	0	2	0	0	10247	2
2	0	4	0	0	10248	2
2	0	2	0	0	10249	2
2	0	2	0	0	10250	2
2	0	2	0	0	10251	2
2	0	2	0	0	10252	2
2	0	2	0	0	10253	2
2	0	2	0	0	10254	2
2	0	2	0	0	10255	2
0	18	4	69	87	10256	0
0	112	4	71	183	10257	0
2	5	2	0	5	10258	0
2	0	2	0	0	10259	2
2	0	2	0	0	10260	2
2	0	4	0	0	10261	2
2	0	2	0	0	10262	2
2	0	2	0	0	10263	2
2	0	4	0	0	10264	2
2	0	2	0	0	10265	2
2	0	2	0	0	10266	2
2	0	2	0	0	10267	2
2	0	2	0	0	10268	2
2	0	2	0	0	10269	2
2	2	0	37	39	10270	1
2	0	2	0	0	10271	2
2	0	2	0	0	10272	2
2	0	0	24	24	10273	2
2	0	2	1	1	10274	2
2	0	2	0	0	10275	2
2	0	2	0	0	10276	2
2	0	2	0	0	10277	2
2	0	2	0	0	10278	2
2	0	2	0	0	10279	2
2	0	2	0	0	10280	2
2	26	2	2	28	10281	0
2	106	4	3634	3740	10282	1
2	0	2	3	3	10283	2
2	0	2	0	0	10284	2
2	19	4	1415	1434	10285	1
2	0	2	20	20	10286	2
2	4	4	59	63	10287	1
2	1	2	2	3	10288	1
2	0	2	0	0	10289	2
2	0	2	0	0	10290	2
2	0	2	23	23	10291	2
2	2	4	5	7	10292	0
2	0	2	12	12	10293	2
2	0	2	13	13	10294	2
2	0	4	6605	6605	10295	2
2	0	2	0	0	10296	2
2	0	2	0	0	10297	2
2	0	2	0	0	10298	2
2	0	4	1	1	10299	2
2	0	2	0	0	10300	2
2	0	2	0	0	10301	2
4	0	2	0	0	10302	2
2	0	4	3161	3161	10303	2
2	0	2	8	8	10304	2
2	0	2	0	0	10305	2
2	0	2	0	0	10306	2
2	0	2	0	0	10307	2
2	0	2	0	0	10308	2
2	1	2	2	3	10309	1
2	0	2	0	0	10310	2
2	0	2	0	0	10311	2
4	0	2	12	12	10312	2
4	0	2	0	0	10313	2
2	0	2	0	0	10314	2
2	0	2	0	0	10315	2
2	0	2	0	0	10316	2
2	0	2	0	0	10317	2
2	0	2	0	0	10318	2
2	0	2	0	0	10319	2
2	0	2	0	0	10320	2
2	0	2	0	0	10321	2
2	0	2	0	0	10322	2
2	0	2	0	0	10323	2
2	0	2	0	0	10324	2
2	0	2	0	0	10325	2
2	23	2	0	23	10326	0
2	29	2	1339	1368	10327	1
2	0	2	0	0	10328	2
2	0	2	0	0	10329	2
2	3	2	0	3	10330	0
2	0	2	48	48	10331	2
2	0	2	0	0	10332	2
2	0	2	0	0	10333	2
2	0	2	0	0	10334	2
2	0	2	0	0	10335	2
2	0	2	0	0	10336	2
2	0	2	0	0	10337	2
2	0	2	0	0	10338	2
2	0	2	0	0	10339	2
2	0	2	0	0	10340	2
2	0	2	0	0	10341	2
2	0	2	0	0	10342	2
2	0	2	0	0	10343	2
2	0	2	0	0	10344	2
2	0	4	3	3	10345	2
2	0	2	0	0	10346	2
2	0	2	0	0	10347	2
2	0	4	0	0	10348	2
2	0	2	0	0	10349	2
2	0	2	0	0	10350	2
2	0	2	0	0	10351	2
2	0	2	0	0	10352	2
2	0	2	0	0	10353	2
2	0	2	0	0	10354	2
2	0	2	0	0	10355	2
2	0	2	0	0	10356	2
2	0	2	0	0	10357	2
2	0	2	0	0	10358	2
2	0	2	0	0	10359	2
2	0	2	0	0	10360	2
2	0	2	0	0	10361	2
2	0	2	0	0	10362	2
2	0	2	0	0	10363	2
2	0	2	0	0	10364	2
2	0	2	0	0	10365	2
2	0	2	0	0	10366	2
2	0	2	0	0	10367	2
2	0	4	2	2	10368	2
2	0	2	0	0	10369	2
2	0	2	1	1	10370	2
2	0	2	0	0	10371	2
2	0	2	0	0	10372	2
2	0	2	0	0	10373	2
2	0	2	0	0	10374	2
2	0	2	0	0	10375	2
2	0	2	0	0	10376	2
2	0	2	0	0	10377	2
2	0	2	0	0	10378	2
2	0	2	0	0	10379	2
2	0	2	0	0	10380	2
2	0	2	0	0	10381	2
2	0	2	0	0	10382	2
2	0	2	0	0	10383	2
2	0	2	0	0	10384	2
2	0	2	0	0	10385	2
2	0	2	0	0	10386	2
2	0	2	0	0	10387	2
2	0	2	0	0	10388	2
2	0	2	0	0	10389	2
2	0	2	0	0	10390	2
2	0	2	0	0	10391	2
2	0	2	0	0	10392	2
2	0	2	1	1	10393	2
2	0	2	0	0	10394	2
2	0	2	0	0	10395	2
0	0	2	0	0	10396	2
0	0	2	0	0	10397	2
2	0	2	0	0	10398	2
2	0	2	3648	3648	10399	2
2	0	2	0	0	10400	2
2	0	2	0	0	10401	2
2	0	2	0	0	10402	2
2	0	2	0	0	10403	2
2	0	2	0	0	10404	2
2	0	2	0	0	10405	2
2	0	2	0	0	10406	2
2	0	2	0	0	10407	2
2	0	2	0	0	10408	2
2	0	2	0	0	10409	2
2	0	2	0	0	10410	2
2	0	2	0	0	10411	2
2	0	2	0	0	10412	2
2	0	2	0	0	10413	2
2	0	2	0	0	10414	2
2	0	2	0	0	10415	2
2	0	2	0	0	10416	2
2	0	2	0	0	10417	2
2	0	2	0	0	10418	2
4	0	4	0	0	10419	2
2	0	2	0	0	10420	2
2	0	2	0	0	10421	2
2	0	2	0	0	10422	2
2	0	2	0	0	10423	2
2	0	2	0	0	10424	2
2	0	2	0	0	10425	2
2	0	4	6	6	10426	2
4	0	4	0	0	10427	2
2	0	2	3	3	10428	2
2	0	2	0	0	10429	2
2	1	4	7	8	10430	0
2	0	2	3	3	10431	2
2	0	2	0	0	10432	2
2	0	2	0	0	10433	2
2	0	2	0	0	10434	2
2	0	2	0	0	10435	2
2	0	2	0	0	10436	2
2	0	2	0	0	10437	2
2	0	2	0	0	10438	2
2	0	2	0	0	10439	2
2	0	2	0	0	10440	2
2	0	2	0	0	10441	2
2	0	2	0	0	10442	2
2	0	2	0	0	10443	2
2	0	2	0	0	10444	2
2	0	4	91	91	10445	2
2	0	2	0	0	10446	2
2	0	2	0	0	10447	2
2	0	4	26	26	10448	2
2	0	2	0	0	10449	2
2	0	2	0	0	10450	2
2	0	4	9	9	10451	2
2	0	2	0	0	10452	2
2	0	2	0	0	10453	2
2	0	4	0	0	10454	2
2	1	2	0	1	10455	1
2	0	2	0	0	10456	2
2	0	2	0	0	10457	2
2	0	2	0	0	10458	2
2	0	2	2	2	10459	2
2	0	2	0	0	10460	2
2	0	2	0	0	10461	2
2	0	2	0	0	10462	2
2	0	2	1	1	10463	2
2	0	4	131	131	10464	2
2	0	2	0	0	10465	2
2	0	2	0	0	10466	2
2	0	4	173	173	10467	2
2	0	2	0	0	10468	2
2	0	2	0	0	10469	2
2	0	4	19	19	10470	2
2	0	2	0	0	10471	2
2	0	2	0	0	10472	2
4	0	2	0	0	10473	2
4	0	2	0	0	10474	2
2	0	4	0	0	10475	2
2	0	2	2	2	10476	2
2	2	2	2	4	10477	1
2	0	2	0	0	10478	2
2	0	2	0	0	10479	2
2	0	2	2	2	10480	2
2	0	2	0	0	10481	2
4	0	4	75	75	10482	2
0	2	4	24	26	10483	1
2	0	2	0	0	10484	2
2	0	2	7	7	10485	2
2	0	2	0	0	10486	2
2	0	2	0	0	10487	2
2	0	2	0	0	10488	2
2	0	2	0	0	10489	2
2	0	2	0	0	10490	2
2	0	2	0	0	10491	2
2	0	2	0	0	10492	2
2	0	2	0	0	10493	2
2	0	2	0	0	10494	2
2	0	2	0	0	10495	2
0	0	4	6116	6116	10496	2
2	0	2	0	0	10497	2
0	13	2	0	13	10498	0
2	4	4	15	19	10499	0
2	0	2	0	0	10500	2
2	0	2	0	0	10501	2
2	0	2	0	0	10502	2
2	0	2	0	0	10503	2
2	0	2	0	0	10504	2
2	0	2	0	0	10505	2
2	0	2	0	0	10506	2
2	0	2	0	0	10507	2
2	0	4	39	39	10508	2
2	116	2	0	116	10509	0
2	8	2	14	22	10510	0
2	1	2	110	111	10511	1
2	16	2	1201	1217	10512	1
2	0	2	10	10	10513	2
2	1	2	1	2	10514	1
2	0	2	0	0	10515	2
2	0	2	3	3	10516	2
2	0	2	0	0	10517	2
2	0	2	0	0	10518	2
2	0	2	0	0	10519	2
2	0	2	0	0	10520	2
2	0	2	0	0	10521	2
2	0	2	0	0	10522	2
2	0	2	0	0	10523	2
2	0	2	0	0	10524	2
2	0	2	0	0	10525	2
2	0	2	0	0	10526	2
2	0	2	0	0	10527	2
2	0	2	0	0	10528	2
2	0	2	0	0	10529	2
2	0	2	0	0	10530	2
2	0	2	0	0	10531	2
2	0	2	0	0	10532	2
2	0	2	0	0	10533	2
2	0	2	0	0	10534	2
2	0	2	0	0	10535	2
2	0	2	0	0	10536	2
2	0	2	0	0	10537	2
2	0	2	0	0	10538	2
2	3	2	0	3	10539	1
2	0	2	0	0	10540	2
2	0	2	0	0	10541	2
2	0	2	3	3	10542	2
2	0	2	1	1	10543	2
4	1	2	439	440	10544	1
2	0	2	0	0	10545	2
2	0	2	0	0	10546	2
2	0	2	0	0	10547	2
2	0	2	0	0	10548	2
2	0	2	0	0	10549	2
2	0	2	0	0	10550	2
2	0	2	0	0	10551	2
2	0	2	0	0	10552	2
2	0	2	0	0	10553	2
2	1	2	2	3	10554	1
2	0	2	0	0	10555	2
2	0	2	0	0	10556	2
2	0	2	0	0	10557	2
2	0	2	0	0	10558	2
2	0	2	0	0	10559	2
2	0	2	0	0	10560	2
2	0	2	0	0	10561	2
2	0	2	0	0	10562	2
2	0	2	0	0	10563	2
2	0	2	0	0	10564	2
2	0	2	0	0	10565	2
2	0	2	0	0	10566	2
2	0	2	0	0	10567	2
2	5	4	150	155	10568	1
2	0	2	0	0	10569	2
2	0	2	0	0	10570	2
2	0	4	4	4	10571	2
2	0	2	0	0	10572	2
0	20	4	23	43	10573	0
2	0	2	0	0	10574	2
2	0	2	0	0	10575	2
2	0	2	0	0	10576	2
2	0	2	0	0	10577	2
2	0	2	0	0	10578	2
2	0	2	0	0	10579	2
2	0	2	0	0	10580	2
2	0	2	0	0	10581	2
2	0	2	0	0	10582	2
2	0	2	0	0	10583	2
2	0	2	0	0	10584	2
2	0	2	0	0	10585	2
2	0	2	0	0	10586	2
2	0	2	0	0	10587	2
2	0	2	0	0	10588	2
4	1	0	8196	8197	10589	1
4	0	0	1512	1512	10590	2
2	43	2	3	46	10591	0
2	0	2	0	0	10592	2
2	0	2	0	0	10593	2
2	0	2	0	0	10594	2
2	0	2	0	0	10595	2
2	0	2	0	0	10596	2
2	0	2	0	0	10597	2
2	0	2	0	0	10598	2
2	0	2	0	0	10599	2
2	0	2	0	0	10600	2
2	0	2	0	0	10601	2
2	0	2	0	0	10602	2
2	0	2	0	0	10603	2
2	0	2	0	0	10604	2
2	0	4	3	3	10605	2
2	0	2	1	1	10606	2
2	0	2	0	0	10607	2
2	0	2	0	0	10608	2
2	0	2	0	0	10609	2
2	0	2	0	0	10610	2
2	0	2	0	0	10611	2
2	0	2	0	0	10612	2
2	0	2	0	0	10613	2
2	0	4	1	1	10614	2
2	0	2	3	3	10615	2
2	1	2	0	1	10616	0
2	0	2	0	0	10617	2
2	1	2	0	1	10618	1
2	0	4	0	0	10619	2
2	0	4	50	50	10620	2
4	1	2	16	17	10621	1
4	10	2	1	11	10622	0
2	0	2	0	0	10623	2
2	0	2	0	0	10624	2
2	0	2	0	0	10625	2
2	0	2	0	0	10626	2
2	0	2	0	0	10627	2
2	0	2	0	0	10628	2
2	0	2	0	0	10629	2
2	0	2	0	0	10630	2
2	0	2	0	0	10631	2
2	0	2	0	0	10632	2
2	0	2	0	0	10633	2
2	0	2	0	0	10634	2
0	0	0	27	27	10635	2
0	0	0	27	27	10636	2
2	30	2	0	30	10637	0
2	13	2	1	14	10638	1
2	0	2	82	82	10639	2
2	3	2	188	191	10640	1
2	0	2	5	5	10641	2
2	0	2	1	1	10642	2
2	0	2	0	0	10643	2
2	0	2	9	9	10644	2
2	0	2	0	0	10645	2
2	0	2	0	0	10646	2
2	0	4	34	34	10647	2
2	0	2	1	1	10648	2
2	415	4	17131	17546	10649	1
2	0	2	16	16	10650	2
2	0	2	8	8	10651	2
2	45	4	3321	3366	10652	0
2	0	4	155	155	10653	2
2	0	2	0	0	10654	2
2	0	2	2	2	10655	2
2	0	2	0	0	10656	2
2	0	2	0	0	10657	2
2	0	2	0	0	10658	2
2	0	2	0	0	10659	2
2	0	2	0	0	10660	2
2	0	2	0	0	10661	2
2	0	2	0	0	10662	2
2	0	2	0	0	10663	2
2	0	2	0	0	10664	2
2	0	2	0	0	10665	2
2	0	2	0	0	10666	2
2	0	2	0	0	10667	2
2	0	2	0	0	10668	2
2	0	2	0	0	10669	2
2	0	2	0	0	10670	2
2	0	2	0	0	10671	2
2	1	2	0	1	10672	0
2	0	2	78	78	10673	2
2	0	2	0	0	10674	2
2	0	2	0	0	10675	2
2	0	2	0	0	10676	2
2	0	2	4	4	10677	2
2	0	2	0	0	10678	2
2	0	2	0	0	10679	2
2	0	2	3	3	10680	2
2	5	2	30	35	10681	1
2	0	2	0	0	10682	2
2	0	2	0	0	10683	2
2	0	2	0	0	10684	2
2	1	4	38	39	10685	1
2	0	2	0	0	10686	2
2	0	2	0	0	10687	2
2	0	4	38	38	10688	2
2	0	2	0	0	10689	2
0	0	4	2	2	10690	2
2	0	2	0	0	10691	2
2	3	2	20	23	10692	1
2	0	2	0	0	10693	2
2	0	2	0	0	10694	2
2	0	2	1	1	10695	2
2	0	2	1	1	10696	2
2	0	2	0	0	10697	2
2	1	2	0	1	10698	1
2	0	2	0	0	10699	2
2	0	2	0	0	10700	2
2	0	2	0	0	10701	2
2	0	2	0	0	10702	2
2	0	2	0	0	10703	2
2	0	2	0	0	10704	2
2	0	2	0	0	10705	2
2	0	2	0	0	10706	2
2	0	2	0	0	10707	2
2	0	2	0	0	10708	2
0	68	3	961	1029	10709	0
0	1	3	961	962	10710	0
2	0	2	0	0	10711	2
2	0	4	10	10	10712	2
2	0	2	0	0	10713	2
2	0	2	0	0	10714	2
2	1	4	0	1	10715	0
2	0	2	0	0	10716	2
2	0	2	0	0	10717	2
2	0	2	0	0	10718	2
2	0	2	0	0	10719	2
2	0	2	0	0	10720	2
2	0	2	0	0	10721	2
2	0	2	0	0	10722	2
2	15	2	3422	3437	10723	1
2	209	2	0	209	10724	0
2	0	2	8	8	10725	2
2	0	2	0	0	10726	2
2	29	4	3827	3856	10727	1
2	0	2	88	88	10728	2
2	0	2	0	0	10729	2
2	0	2	0	0	10730	2
2	0	2	0	0	10731	2
2	0	2	0	0	10732	2
2	1	2	0	1	10733	1
2	0	2	0	0	10734	2
2	0	2	0	0	10735	2
2	0	2	0	0	10736	2
2	0	2	0	0	10737	2
2	0	2	0	0	10738	2
2	0	2	0	0	10739	2
2	0	2	0	0	10740	2
2	3	2	0	3	10741	0
2	4	2	40	44	10742	1
2	0	2	6	6	10743	2
2	0	2	3	3	10744	2
2	0	2	0	0	10745	2
2	0	2	0	0	10746	2
2	0	2	0	0	10747	2
2	0	2	0	0	10748	2
2	0	2	0	0	10749	2
2	0	2	0	0	10750	2
2	0	2	0	0	10751	2
2	0	2	0	0	10752	2
2	0	2	0	0	10753	2
2	0	2	0	0	10754	2
2	0	2	0	0	10755	2
2	0	2	0	0	10756	2
2	0	2	0	0	10757	2
2	0	2	0	0	10758	2
2	0	2	0	0	10759	2
2	0	2	0	0	10760	2
2	0	2	0	0	10761	2
2	0	2	0	0	10762	2
2	0	2	0	0	10763	2
2	0	4	2	2	10764	2
2	0	2	0	0	10765	2
2	0	2	0	0	10766	2
2	0	4	0	0	10767	2
2	0	2	16	16	10768	2
4	1	2	9	10	10769	1
2	0	2	2	2	10770	2
2	0	2	2	2	10771	2
2	1	2	1	2	10772	0
2	0	2	0	0	10773	2
2	0	2	0	0	10774	2
2	0	2	0	0	10775	2
2	0	2	0	0	10776	2
2	0	2	0	0	10777	2
2	0	2	0	0	10778	2
2	0	2	0	0	10779	2
2	0	2	0	0	10780	2
2	0	2	0	0	10781	2
2	0	2	0	0	10782	2
2	0	2	0	0	10783	2
2	0	2	0	0	10784	2
2	0	4	95	95	10785	2
2	0	2	1	1	10786	2
2	0	2	0	0	10787	2
2	1	0	16	17	10788	1
2	0	2	4	4	10789	2
4	0	2	1	1	10790	2
2	1	2	1	2	10791	0
2	1	4	2148	2149	10792	1
2	0	2	0	0	10793	2
2	0	2	1	1	10794	2
4	0	2	1	1	10795	2
2	0	4	158	158	10796	2
2	43	2	1	44	10797	0
2	0	2	28	28	10798	2
2	0	2	0	0	10799	2
2	0	2	0	0	10800	2
2	0	2	0	0	10801	2
2	0	2	0	0	10802	2
2	0	2	0	0	10803	2
2	0	2	0	0	10804	2
2	0	2	0	0	10805	2
2	0	2	1	1	10806	2
2	0	0	243	243	10807	2
2	0	2	0	0	10808	2
2	0	0	321	321	10809	2
2	0	2	0	0	10810	2
2	0	2	0	0	10811	2
4	0	2	2	2	10812	2
2	0	2	0	0	10813	2
2	1948	2	2	1950	10814	0
2	182	2	1629	1811	10815	1
2	0	2	333	333	10816	2
2	0	2	1	1	10817	2
2	142	2	4	146	10818	0
2	0	2	644	644	10819	2
2	0	2	13	13	10820	2
2	0	2	0	0	10821	2
2	0	2	0	0	10822	2
2	0	2	1	1	10823	2
2	0	2	7	7	10824	2
2	0	2	0	0	10825	2
2	0	2	0	0	10826	2
2	0	2	0	0	10827	2
2	0	2	0	0	10828	2
2	0	2	0	0	10829	2
2	0	2	0	0	10830	2
2	0	2	0	0	10831	2
2	0	2	0	0	10832	2
2	0	2	0	0	10833	2
2	0	2	0	0	10834	2
2	0	2	0	0	10835	2
2	0	2	0	0	10836	2
2	0	2	0	0	10837	2
2	0	4	283	283	10838	2
2	0	2	0	0	10839	2
2	0	2	0	0	10840	2
2	0	4	493	493	10841	2
2	0	2	0	0	10842	2
2	0	2	0	0	10843	2
2	1	2	0	1	10844	0
2	3	4	1611	1614	10845	1
2	0	2	1	1	10846	2
2	0	2	0	0	10847	2
2	3	4	16	19	10848	0
2	0	2	7	7	10849	2
2	0	2	0	0	10850	2
2	0	2	0	0	10851	2
2	0	2	0	0	10852	2
2	0	2	0	0	10853	2
2	0	2	0	0	10854	2
2	0	2	0	0	10855	2
2	0	2	0	0	10856	2
2	0	2	3	3	10857	2
2	0	2	0	0	10858	2
2	0	2	0	0	10859	2
2	2	2	0	2	10860	0
2	0	2	16	16	10861	2
2	0	2	0	0	10862	2
2	0	2	0	0	10863	2
2	1	2	0	1	10864	1
2	0	2	8	8	10865	2
2	283	2	0	283	10866	0
2	0	2	0	0	10867	2
2	0	2	3	3	10868	2
2	0	2	0	0	10869	2
2	0	2	7	7	10870	2
2	0	2	0	0	10871	2
2	0	2	0	0	10872	2
2	48	2	2231	2279	10873	1
2	0	2	76	76	10874	2
2	0	2	0	0	10875	2
2	75	2	4672	4747	10876	0
2	0	2	455	455	10877	2
0	11	2	0	11	10878	0
0	43	2	7	50	10879	0
0	18	2	3	21	10880	0
2	0	2	0	0	10881	2
2	0	2	0	0	10882	2
2	0	2	0	0	10883	2
2	0	2	0	0	10884	2
2	0	2	0	0	10885	2
2	0	2	0	0	10886	2
4	2	4	3	5	10887	0
2	3	2	0	3	10888	0
2	0	2	7	7	10889	2
2	0	2	0	0	10890	2
2	129	2	1	130	10891	0
2	2	2	0	2	10892	0
2	0	2	2	2	10893	2
2	0	2	4	4	10894	2
2	0	2	0	0	10895	2
2	0	2	0	0	10896	2
2	0	2	12	12	10897	2
2	0	2	0	0	10898	2
2	0	2	0	0	10899	2
2	0	2	0	0	10900	2
2	0	2	0	0	10901	2
2	0	2	1081	1081	10902	2
2	0	2	0	0	10903	2
2	0	2	0	0	10904	2
2	0	2	0	0	10905	2
2	0	2	0	0	10906	2
2	0	2	0	0	10907	2
2	0	2	0	0	10908	2
2	0	2	0	0	10909	2
2	27	4	10418	10445	10910	1
2	0	2	5	5	10911	2
2	0	2	5	5	10912	2
4	1	2	7	8	10913	0
4	0	2	0	0	10914	2
0	1	4	3	4	10915	1
2	0	2	0	0	10916	2
2	0	2	0	0	10917	2
2	0	2	0	0	10918	2
2	6	4	580	586	10919	0
2	0	2	38	38	10920	2
2	7	2	0	7	10921	0
2	5	2	43	48	10922	1
2	0	2	1	1	10923	2
2	0	2	0	0	10924	2
2	6	2	0	6	10925	1
2	0	2	19	19	10926	2
0	4	4	1	5	10927	0
2	30	2	0	30	10928	0
2	28	2	89	117	10929	1
2	0	2	7	7	10930	2
2	0	2	0	0	10931	2
2	66	2	0	66	10932	1
2	0	2	69	69	10933	2
2	0	2	0	0	10934	2
2	0	2	0	0	10935	2
2	0	2	0	0	10936	2
2	0	2	0	0	10937	2
2	0	2	0	0	10938	2
2	0	2	0	0	10939	2
2	0	4	4	4	10940	2
2	0	2	0	0	10941	2
2	0	4	0	0	10942	2
2	0	2	0	0	10943	2
2	0	4	0	0	10944	2
2	0	2	0	0	10945	2
2	0	2	0	0	10946	2
2	0	2	0	0	10947	2
2	0	2	11	11	10948	2
2	0	2	0	0	10949	2
2	0	2	0	0	10950	2
2	0	2	0	0	10951	2
2	0	2	1	1	10952	2
2	0	2	0	0	10953	2
2	0	2	1	1	10954	2
2	0	2	0	0	10955	2
2	0	2	0	0	10956	2
2	0	2	0	0	10957	2
2	0	2	0	0	10958	2
2	0	2	0	0	10959	2
2	0	2	0	0	10960	2
2	0	2	0	0	10961	2
2	0	2	0	0	10962	2
2	0	2	0	0	10963	2
2	0	2	0	0	10964	2
0	3	4	1	4	10965	0
0	2	4	0	2	10966	1
2	0	2	0	0	10967	2
2	0	4	20	20	10968	2
2	0	2	0	0	10969	2
2	0	2	0	0	10970	2
2	0	4	15	15	10971	2
2	0	2	0	0	10972	2
2	0	2	0	0	10973	2
2	0	2	0	0	10974	2
2	0	2	0	0	10975	2
2	0	2	0	0	10976	2
2	0	2	267	267	10977	2
2	0	2	0	0	10978	2
2	0	2	0	0	10979	2
2	0	2	0	0	10980	2
2	0	2	0	0	10981	2
2	0	2	0	0	10982	2
2	0	2	0	0	10983	2
2	0	2	0	0	10984	2
2	0	2	0	0	10985	2
2	0	2	0	0	10986	2
2	0	2	0	0	10987	2
2	0	2	0	0	10988	2
2	0	2	0	0	10989	2
2	0	2	0	0	10990	2
2	0	2	0	0	10991	2
2	0	2	0	0	10992	2
2	4	2	0	4	10993	1
2	0	2	0	0	10994	2
2	0	2	0	0	10995	2
2	1	2	0	1	10996	1
2	0	2	1	1	10997	2
2	0	4	44	44	10998	2
2	0	2	0	0	10999	2
2	0	2	0	0	11000	2
4	1	2	4	5	11001	0
4	0	2	4	4	11002	2
2	0	4	10	10	11003	2
2	1	2	4	5	11004	1
2	0	2	0	0	11005	2
2	0	4	83	83	11006	2
2	0	2	0	0	11007	2
2	0	2	0	0	11008	2
2	0	4	1	1	11009	2
2	0	2	0	0	11010	2
2	0	2	0	0	11011	2
2	0	4	2	2	11012	2
2	0	2	0	0	11013	2
2	0	2	0	0	11014	2
2	0	4	21	21	11015	2
2	0	2	0	0	11016	2
0	0	3	32	32	11017	2
0	0	3	32	32	11018	2
2	0	2	0	0	11019	2
2	0	2	0	0	11020	2
2	0	2	0	0	11021	2
2	0	2	0	0	11022	2
2	0	2	0	0	11023	2
2	0	2	0	0	11024	2
2	0	2	0	0	11025	2
2	0	2	0	0	11026	2
2	0	4	4	4	11027	2
2	0	2	0	0	11028	2
2	0	2	0	0	11029	2
2	0	4	0	0	11030	2
2	0	2	0	0	11031	2
2	0	2	0	0	11032	2
2	0	4	136	136	11033	2
2	0	2	0	0	11034	2
2	0	2	0	0	11035	2
2	0	4	8	8	11036	2
2	0	2	0	0	11037	2
4	844	2	2	846	11038	0
2	0	4	965	965	11039	2
2	0	2	0	0	11040	2
2	0	2	0	0	11041	2
2	0	4	322	322	11042	2
2	0	2	2	2	11043	2
4	0	4	4	4	11044	2
2	1	2	0	1	11045	0
2	0	2	0	0	11046	2
2	0	2	0	0	11047	2
2	0	2	0	0	11048	2
2	0	2	0	0	11049	2
2	0	2	1	1	11050	2
2	8	2	0	8	11051	0
2	8	2	224	232	11052	1
2	0	2	1	1	11053	2
2	0	2	0	0	11054	2
2	7	2	0	7	11055	1
2	0	2	34	34	11056	2
2	0	2	0	0	11057	2
2	1	2	0	1	11058	1
2	0	2	0	0	11059	2
2	0	2	0	0	11060	2
2	0	2	0	0	11061	2
2	0	2	1	1	11062	2
2	0	2	0	0	11063	2
2	0	2	13	13	11064	2
2	0	2	0	0	11065	2
2	0	2	0	0	11066	2
2	0	2	0	0	11067	2
2	0	2	0	0	11068	2
2	0	2	0	0	11069	2
2	0	2	0	0	11070	2
2	0	2	0	0	11071	2
2	2	2	1	3	11072	1
2	0	2	0	0	11073	2
2	0	2	0	0	11074	2
2	0	2	0	0	11075	2
2	0	2	2	2	11076	2
2	3	2	60	63	11077	0
2	0	2	0	0	11078	2
2	0	2	1	1	11079	2
2	0	2	0	0	11080	2
2	0	2	0	0	11081	2
2	0	2	11	11	11082	2
2	0	2	0	0	11083	2
4	1169	2	1	1170	11084	0
4	5837	2	11	5848	11085	0
2	2	2	0	2	11086	0
2	1	2	6	7	11087	1
2	0	2	0	0	11088	2
2	0	2	0	0	11089	2
2	0	2	0	0	11090	2
2	0	2	0	0	11091	2
2	0	2	0	0	11092	2
2	0	2	0	0	11093	2
4	303	4	676	979	11094	0
0	0	4	0	0	11095	2
2	0	2	0	0	11096	2
2	0	4	27	27	11097	2
2	0	2	0	0	11098	2
2	0	2	0	0	11099	2
2	0	4	3	3	11100	2
2	0	2	0	0	11101	2
2	0	2	0	0	11102	2
2	0	2	0	0	11103	2
2	0	2	0	0	11104	2
2	0	2	0	0	11105	2
2	0	2	0	0	11106	2
2	0	2	0	0	11107	2
2	0	2	0	0	11108	2
2	0	4	2	2	11109	2
2	0	2	0	0	11110	2
2	0	2	0	0	11111	2
2	0	4	1	1	11112	2
2	0	2	1	1	11113	2
2	9	2	0	9	11114	0
2	27	4	2126	2153	11115	1
2	0	2	3	3	11116	2
2	0	2	0	0	11117	2
2	12	4	817	829	11118	0
2	0	2	96	96	11119	2
2	0	2	0	0	11120	2
2	0	2	0	0	11121	2
2	0	2	0	0	11122	2
2	0	2	0	0	11123	2
2	0	2	0	0	11124	2
2	0	2	0	0	11125	2
2	0	2	0	0	11126	2
2	0	2	0	0	11127	2
2	0	2	0	0	11128	2
2	0	2	0	0	11129	2
2	0	2	0	0	11130	2
2	0	2	0	0	11131	2
2	0	4	783	783	11132	2
2	0	2	0	0	11133	2
2	0	2	0	0	11134	2
2	0	4	8	8	11135	2
2	0	2	1	1	11136	2
2	0	2	0	0	11137	2
2	0	4	6	6	11138	2
2	0	2	0	0	11139	2
2	0	2	0	0	11140	2
2	1	2	0	1	11141	0
2	0	2	0	0	11142	2
2	0	2	0	0	11143	2
2	0	2	0	0	11144	2
2	0	2	0	0	11145	2
2	0	2	0	0	11146	2
2	0	2	0	0	11147	2
2	0	2	0	0	11148	2
2	0	2	0	0	11149	2
2	0	2	0	0	11150	2
2	0	2	0	0	11151	2
2	0	2	0	0	11152	2
2	0	2	0	0	11153	2
2	1	2	36	37	11154	1
2	0	2	1	1	11155	2
2	0	2	0	0	11156	2
2	0	2	0	0	11157	2
2	0	2	1	1	11158	2
2	0	2	0	0	11159	2
2	0	2	0	0	11160	2
2	0	2	0	0	11161	2
2	0	2	0	0	11162	2
2	0	2	0	0	11163	2
2	0	2	0	0	11164	2
2	0	2	0	0	11165	2
2	0	2	0	0	11166	2
2	0	2	0	0	11167	2
2	0	2	0	0	11168	2
2	0	2	0	0	11169	2
2	0	2	0	0	11170	2
2	0	2	0	0	11171	2
2	0	2	0	0	11172	2
2	0	4	2	2	11173	2
2	0	2	0	0	11174	2
2	0	2	0	0	11175	2
2	0	4	14	14	11176	2
2	0	2	0	0	11177	2
2	0	2	0	0	11178	2
2	0	2	0	0	11179	2
2	0	2	0	0	11180	2
4	0	2	0	0	11181	2
4	17	2	2	19	11182	0
2	0	4	2	2	11183	2
2	0	2	0	0	11184	2
2	0	2	0	0	11185	2
2	0	2	1	1	11186	2
2	0	2	0	0	11187	2
2	0	2	1	1	11188	2
2	0	2	0	0	11189	2
2	0	2	0	0	11190	2
2	1	2	0	1	11191	0
2	3	2	11	14	11192	1
2	0	2	0	0	11193	2
2	0	2	0	0	11194	2
2	0	2	0	0	11195	2
2	0	2	0	0	11196	2
2	0	2	0	0	11197	2
2	0	2	0	0	11198	2
2	0	2	0	0	11199	2
2	0	2	0	0	11200	2
2	0	2	0	0	11201	2
2	0	2	0	0	11202	2
2	12	2	0	12	11203	0
2	46	2	354	400	11204	1
2	0	2	0	0	11205	2
2	0	2	0	0	11206	2
2	8	2	1	9	11207	0
2	0	2	21	21	11208	2
2	0	2	0	0	11209	2
2	0	2	0	0	11210	2
2	0	2	0	0	11211	2
2	0	2	0	0	11212	2
2	0	2	0	0	11213	2
2	0	2	0	0	11214	2
2	1	2	0	1	11215	0
2	0	2	1	1	11216	2
2	0	2	0	0	11217	2
2	0	2	0	0	11218	2
2	0	2	0	0	11219	2
2	0	2	1	1	11220	2
2	4	2	0	4	11221	0
2	5	4	324	329	11222	1
2	0	2	1	1	11223	2
2	0	2	0	0	11224	2
2	1	4	3	4	11225	0
2	0	2	5	5	11226	2
2	5	2	0	5	11227	0
2	0	2	0	0	11228	2
2	0	2	0	0	11229	2
2	0	2	0	0	11230	2
2	0	2	0	0	11231	2
2	0	2	0	0	11232	2
2	0	2	0	0	11233	2
2	0	2	0	0	11234	2
2	0	4	17	17	11235	2
2	0	2	0	0	11236	2
2	0	2	0	0	11237	2
2	0	4	33	33	11238	2
2	0	2	0	0	11239	2
4	0	2	0	0	11240	2
2	3	4	39	42	11241	1
2	0	2	2	2	11242	2
2	1	2	0	1	11243	1
4	0	2	5	5	11244	2
4	0	2	0	0	11245	2
2	2	4	11	13	11246	0
2	0	2	3	3	11247	2
4	0	2	3	3	11248	2
2	0	2	0	0	11249	2
2	0	2	0	0	11250	2
2	0	2	0	0	11251	2
2	0	2	0	0	11252	2
2	0	2	0	0	11253	2
2	0	2	0	0	11254	2
2	0	2	0	0	11255	2
2	0	4	4	4	11256	2
2	0	2	0	0	11257	2
2	0	2	0	0	11258	2
2	0	4	0	0	11259	2
2	0	2	0	0	11260	2
2	0	2	0	0	11261	2
2	0	2	0	0	11262	2
2	0	2	1	1	11263	2
2	0	2	0	0	11264	2
2	0	2	0	0	11265	2
2	0	2	0	0	11266	2
2	0	2	0	0	11267	2
2	0	2	0	0	11268	2
2	0	2	110	110	11269	2
2	0	2	0	0	11270	2
2	0	2	0	0	11271	2
2	0	2	0	0	11272	2
2	0	2	0	0	11273	2
2	0	2	0	0	11274	2
2	0	2	0	0	11275	2
2	0	2	0	0	11276	2
2	0	2	0	0	11277	2
2	0	2	0	0	11278	2
2	0	2	0	0	11279	2
2	0	2	0	0	11280	2
2	0	2	0	0	11281	2
2	0	2	0	0	11282	2
2	0	2	5	5	11283	2
2	0	2	3	3	11284	2
2	0	2	38	38	11285	2
2	0	2	0	0	11286	2
2	0	2	0	0	11287	2
2	0	2	0	0	11288	2
2	0	2	0	0	11289	2
2	0	2	0	0	11290	2
2	0	2	0	0	11291	2
2	0	2	0	0	11292	2
2	0	2	0	0	11293	2
2	0	2	0	0	11294	2
2	0	2	0	0	11295	2
2	0	2	0	0	11296	2
2	0	2	0	0	11297	2
2	0	2	0	0	11298	2
2	0	4	3	3	11299	2
2	0	2	0	0	11300	2
2	0	2	0	0	11301	2
2	0	4	5	5	11302	2
2	0	2	0	0	11303	2
2	0	2	0	0	11304	2
2	0	2	0	0	11305	2
2	5	2	0	5	11306	0
2	0	2	140	140	11307	2
2	0	2	3	3	11308	2
2	0	2	0	0	11309	2
2	1	2	13	14	11310	1
2	0	2	2	2	11311	2
2	0	2	0	0	11312	2
2	0	2	0	0	11313	2
2	0	2	0	0	11314	2
2	0	2	0	0	11315	2
2	0	2	0	0	11316	2
2	0	2	0	0	11317	2
2	0	2	0	0	11318	2
2	0	2	0	0	11319	2
2	0	2	0	0	11320	2
2	0	2	0	0	11321	2
2	0	2	0	0	11322	2
2	0	2	0	0	11323	2
2	0	2	0	0	11324	2
2	0	2	0	0	11325	2
2	0	2	0	0	11326	2
2	0	2	0	0	11327	2
2	0	2	0	0	11328	2
2	0	2	1	1	11329	2
2	0	2	0	0	11330	2
2	0	4	276	276	11331	2
2	0	2	0	0	11332	2
2	0	2	0	0	11333	2
2	0	4	138	138	11334	2
2	0	2	0	0	11335	2
2	0	2	0	0	11336	2
2	0	4	1	1	11337	2
2	0	2	0	0	11338	2
2	0	2	0	0	11339	2
2	0	4	0	0	11340	2
2	0	2	0	0	11341	2
2	0	2	5	5	11342	2
2	0	2	0	0	11343	2
2	0	2	1	1	11344	2
2	0	2	0	0	11345	2
2	0	2	0	0	11346	2
2	0	2	0	0	11347	2
2	0	2	0	0	11348	2
2	1	2	0	1	11349	0
2	0	2	5	5	11350	2
2	0	2	0	0	11351	2
2	0	2	0	0	11352	2
2	0	2	0	0	11353	2
2	0	2	3	3	11354	2
2	0	2	0	0	11355	2
2	0	2	0	0	11356	2
2	0	2	0	0	11357	2
2	0	2	0	0	11358	2
2	0	2	0	0	11359	2
2	0	2	0	0	11360	2
2	2	2	0	2	11361	0
2	0	2	2	2	11362	2
2	0	2	0	0	11363	2
2	0	2	0	0	11364	2
2	0	2	0	0	11365	2
2	0	2	2	2	11366	2
2	0	2	0	0	11367	2
2	0	2	0	0	11368	2
2	0	2	0	0	11369	2
2	0	2	0	0	11370	2
2	0	2	0	0	11371	2
2	0	2	0	0	11372	2
2	0	2	0	0	11373	2
2	0	2	1	1	11374	2
2	0	2	0	0	11375	2
2	0	2	0	0	11376	2
2	0	2	0	0	11377	2
2	0	2	2	2	11378	2
2	0	2	0	0	11379	2
2	0	2	0	0	11380	2
2	0	2	0	0	11381	2
2	0	2	0	0	11382	2
2	0	2	0	0	11383	2
2	0	2	0	0	11384	2
2	0	2	0	0	11385	2
2	0	2	0	0	11386	2
2	0	2	0	0	11387	2
2	0	2	0	0	11388	2
2	0	2	0	0	11389	2
2	0	2	0	0	11390	2
2	1	2	0	1	11391	0
2	0	2	8	8	11392	2
2	0	2	0	0	11393	2
2	0	2	0	0	11394	2
2	0	2	0	0	11395	2
2	0	2	4	4	11396	2
2	0	2	0	0	11397	2
2	0	2	0	0	11398	2
2	0	2	0	0	11399	2
2	0	2	0	0	11400	2
2	0	2	0	0	11401	2
2	0	2	0	0	11402	2
2	0	2	2	2	11403	2
2	0	2	0	0	11404	2
2	0	2	0	0	11405	2
2	0	2	0	0	11406	2
2	0	2	0	0	11407	2
4	154	2	2	156	11408	0
4	3	2	0	3	11409	0
2	0	2	0	0	11410	2
2	0	2	0	0	11411	2
2	0	2	0	0	11412	2
2	0	2	5	5	11413	2
2	0	2	0	0	11414	2
2	0	2	0	0	11415	2
2	0	2	0	0	11416	2
2	0	2	0	0	11417	2
2	0	2	0	0	11418	2
2	0	2	0	0	11419	2
2	0	2	0	0	11420	2
2	0	2	0	0	11421	2
2	47	2	0	47	11422	0
2	0	2	0	0	11423	2
2	0	2	0	0	11424	2
2	0	2	0	0	11425	2
2	0	2	0	0	11426	2
2	0	2	0	0	11427	2
2	0	2	0	0	11428	2
2	94	2	0	94	11429	0
2	4	4	362	366	11430	1
2	0	2	2	2	11431	2
2	0	2	1	1	11432	2
2	9	4	24	33	11433	0
2	16	2	31	47	11434	1
2	0	2	9	9	11435	2
2	0	2	0	0	11436	2
2	23	2	0	23	11437	1
2	0	2	0	0	11438	2
2	0	2	0	0	11439	2
2	0	2	0	0	11440	2
2	0	2	0	0	11441	2
2	0	2	0	0	11442	2
2	0	2	0	0	11443	2
2	0	2	0	0	11444	2
2	0	2	0	0	11445	2
2	0	2	0	0	11446	2
2	0	2	0	0	11447	2
2	0	2	0	0	11448	2
2	0	2	0	0	11449	2
4	5	4	239	244	11450	1
2	0	2	0	0	11451	2
2	0	2	0	0	11452	2
2	0	2	0	0	11453	2
2	0	2	0	0	11454	2
2	1	2	0	1	11455	1
2	0	2	0	0	11456	2
2	0	2	0	0	11457	2
2	0	2	0	0	11458	2
2	0	2	0	0	11459	2
2	0	2	0	0	11460	2
2	0	2	0	0	11461	2
2	0	2	0	0	11462	2
2	0	2	0	0	11463	2
2	0	2	0	0	11464	2
2	0	2	1	1	11465	2
2	4	2	0	4	11466	0
2	7	2	220	227	11467	1
2	0	2	0	0	11468	2
2	0	2	0	0	11469	2
2	3	2	0	3	11470	0
2	0	2	17	17	11471	2
2	0	2	0	0	11472	2
2	0	2	0	0	11473	2
2	0	2	0	0	11474	2
4	0	4	1783	1783	11475	2
2	0	2	0	0	11476	2
2	1	2	0	1	11477	1
2	0	2	0	0	11478	2
2	0	2	0	0	11479	2
2	0	2	0	0	11480	2
2	0	2	0	0	11481	2
2	0	2	0	0	11482	2
2	0	2	0	0	11483	2
2	0	2	0	0	11484	2
2	0	2	0	0	11485	2
2	0	2	0	0	11486	2
2	0	2	0	0	11487	2
2	0	2	0	0	11488	2
2	0	2	0	0	11489	2
2	0	2	0	0	11490	2
2	0	2	0	0	11491	2
2	0	2	0	0	11492	2
2	0	2	0	0	11493	2
2	0	2	0	0	11494	2
2	0	2	0	0	11495	2
2	0	2	0	0	11496	2
2	0	2	0	0	11497	2
2	0	2	0	0	11498	2
2	0	2	48	48	11499	2
2	0	2	0	0	11500	2
2	0	2	0	0	11501	2
2	0	2	0	0	11502	2
2	0	2	0	0	11503	2
2	0	2	0	0	11504	2
2	0	2	0	0	11505	2
2	4	2	0	4	11506	0
2	0	2	1	1	11507	2
2	0	2	0	0	11508	2
2	0	2	0	0	11509	2
2	3	2	0	3	11510	1
2	0	2	8	8	11511	2
2	3	2	0	3	11512	0
2	0	2	25	25	11513	2
2	0	2	2	2	11514	2
2	0	2	0	0	11515	2
2	0	2	0	0	11516	2
2	12	2	2	14	11517	1
2	0	2	0	0	11518	2
2	0	2	0	0	11519	2
2	0	2	0	0	11520	2
2	0	2	0	0	11521	2
2	0	4	11	11	11522	2
2	0	2	0	0	11523	2
2	0	2	0	0	11524	2
2	0	4	1	1	11525	2
2	0	2	2	2	11526	2
2	0	2	0	0	11527	2
2	0	2	0	0	11528	2
2	0	2	0	0	11529	2
2	0	2	0	0	11530	2
2	0	2	0	0	11531	2
2	0	2	0	0	11532	2
2	0	2	0	0	11533	2
2	0	2	1	1	11534	2
2	0	2	0	0	11535	2
2	0	2	0	0	11536	2
2	0	2	0	0	11537	2
2	0	2	0	0	11538	2
2	0	2	0	0	11539	2
2	0	2	6	6	11540	2
2	0	2	0	0	11541	2
2	0	2	0	0	11542	2
2	0	2	0	0	11543	2
2	0	2	0	0	11544	2
2	0	2	0	0	11545	2
2	0	2	4	4	11546	2
2	0	2	0	0	11547	2
2	0	2	2	2	11548	2
2	0	2	0	0	11549	2
2	0	2	0	0	11550	2
2	0	2	0	0	11551	2
2	0	2	1	1	11552	2
2	0	2	0	0	11553	2
2	0	2	0	0	11554	2
2	0	2	0	0	11555	2
2	0	2	0	0	11556	2
2	0	2	0	0	11557	2
2	0	2	0	0	11558	2
2	0	2	0	0	11559	2
2	0	2	0	0	11560	2
2	0	2	0	0	11561	2
2	0	2	0	0	11562	2
2	0	2	0	0	11563	2
2	0	2	1	1	11564	2
2	0	2	0	0	11565	2
2	0	2	0	0	11566	2
2	0	2	0	0	11567	2
2	0	2	0	0	11568	2
2	0	2	0	0	11569	2
2	0	2	0	0	11570	2
2	0	2	0	0	11571	2
2	0	2	0	0	11572	2
2	0	2	0	0	11573	2
2	0	2	0	0	11574	2
2	0	2	1	1	11575	2
2	0	2	0	0	11576	2
2	0	2	0	0	11577	2
2	0	2	0	0	11578	2
2	0	2	0	0	11579	2
2	148	2	0	148	11580	0
2	0	2	12	12	11581	2
2	0	2	0	0	11582	2
2	0	2	0	0	11583	2
2	0	2	0	0	11584	2
2	0	2	0	0	11585	2
2	0	2	0	0	11586	2
2	0	2	0	0	11587	2
2	0	2	0	0	11588	2
2	0	2	0	0	11589	2
2	0	2	0	0	11590	2
2	2	2	0	2	11591	0
2	0	2	15	15	11592	2
2	0	2	0	0	11593	2
2	0	2	0	0	11594	2
2	2	2	0	2	11595	0
2	0	2	0	0	11596	2
2	0	2	5	5	11597	2
2	0	2	0	0	11598	2
2	0	2	0	0	11599	2
2	0	2	0	0	11600	2
2	0	4	1	1	11601	2
2	0	2	0	0	11602	2
2	0	4	6	6	11603	2
2	0	2	1	1	11604	2
2	0	2	0	0	11605	2
2	0	2	0	0	11606	2
2	0	2	0	0	11607	2
2	0	2	0	0	11608	2
2	0	2	0	0	11609	2
2	0	2	0	0	11610	2
2	0	2	1	1	11611	2
2	0	2	0	0	11612	2
2	0	2	25	25	11613	2
2	0	2	3	3	11614	2
2	0	2	0	0	11615	2
2	0	2	0	0	11616	2
2	0	2	0	0	11617	2
2	0	2	0	0	11618	2
2	8	2	1	9	11619	0
2	0	2	0	0	11620	2
2	0	2	0	0	11621	2
2	0	2	0	0	11622	2
2	0	2	0	0	11623	2
2	0	2	0	0	11624	2
2	0	2	0	0	11625	2
2	0	2	0	0	11626	2
2	0	2	0	0	11627	2
2	0	2	0	0	11628	2
2	0	2	0	0	11629	2
2	0	2	0	0	11630	2
2	0	2	0	0	11631	2
2	0	2	0	0	11632	2
2	0	2	0	0	11633	2
2	0	2	0	0	11634	2
2	0	2	0	0	11635	2
2	0	2	0	0	11636	2
2	0	2	0	0	11637	2
2	0	2	0	0	11638	2
2	0	2	0	0	11639	2
2	0	2	0	0	11640	2
2	0	2	0	0	11641	2
2	0	2	0	0	11642	2
2	0	2	0	0	11643	2
2	0	2	0	0	11644	2
2	0	2	0	0	11645	2
2	0	2	0	0	11646	2
2	0	2	0	0	11647	2
2	0	4	273	273	11648	2
2	0	2	0	0	11649	2
2	0	2	0	0	11650	2
2	0	4	63	63	11651	2
2	0	2	8	8	11652	2
2	0	2	4	4	11653	2
2	0	2	0	0	11654	2
2	0	2	5	5	11655	2
4	1	2	1	2	11656	0
2	0	2	0	0	11657	2
2	2	2	12	14	11658	1
2	0	2	0	0	11659	2
2	0	2	0	0	11660	2
2	2	2	0	2	11661	1
2	0	2	0	0	11662	2
2	0	2	0	0	11663	2
2	0	2	3	3	11664	2
2	0	2	0	0	11665	2
2	0	2	0	0	11666	2
2	0	2	6	6	11667	2
2	0	2	2	2	11668	2
2	11	2	6	17	11669	1
2	0	2	16	16	11670	2
2	5	2	0	5	11671	0
2	23	2	177	200	11672	1
2	0	2	4	4	11673	2
2	0	2	0	0	11674	2
2	0	2	0	0	11675	2
2	0	2	0	0	11676	2
2	0	2	0	0	11677	2
2	0	2	0	0	11678	2
2	0	2	0	0	11679	2
2	0	2	0	0	11680	2
2	0	2	0	0	11681	2
2	0	2	0	0	11682	2
2	0	2	0	0	11683	2
2	0	2	0	0	11684	2
2	0	2	0	0	11685	2
2	0	2	0	0	11686	2
2	0	2	0	0	11687	2
2	0	2	0	0	11688	2
2	0	2	0	0	11689	2
2	0	2	0	0	11690	2
2	0	2	0	0	11691	2
0	0	4	0	0	11692	2
2	0	2	0	0	11693	2
2	0	2	0	0	11694	2
2	0	2	0	0	11695	2
2	0	2	0	0	11696	2
2	0	2	0	0	11697	2
2	0	2	0	0	11698	2
2	0	2	0	0	11699	2
2	0	4	75	75	11700	2
2	0	2	0	0	11701	2
2	0	2	0	0	11702	2
2	0	4	33	33	11703	2
2	0	2	0	0	11704	2
2	45	2	1	46	11705	0
2	116	2	306	422	11706	1
2	0	2	50	50	11707	2
2	0	2	1	1	11708	2
2	21	2	0	21	11709	1
2	0	2	124	124	11710	2
2	0	2	0	0	11711	2
2	0	2	0	0	11712	2
2	0	2	0	0	11713	2
2	0	2	0	0	11714	2
2	0	2	0	0	11715	2
2	0	2	0	0	11716	2
2	13	2	0	13	11717	0
2	15	2	51	66	11718	1
2	0	2	0	0	11719	2
2	0	2	0	0	11720	2
2	11	2	25	36	11721	0
2	0	2	8	8	11722	2
2	1	2	0	1	11723	0
2	4	2	16	20	11724	1
2	0	2	0	0	11725	2
2	0	2	0	0	11726	2
2	2	2	1	3	11727	1
2	0	2	1	1	11728	2
2	0	2	0	0	11729	2
2	0	2	0	0	11730	2
2	0	2	0	0	11731	2
2	0	2	0	0	11732	2
2	0	2	0	0	11733	2
2	0	2	0	0	11734	2
2	0	2	0	0	11735	2
2	0	4	28	28	11736	2
2	0	2	0	0	11737	2
2	0	2	0	0	11738	2
2	0	4	3	3	11739	2
2	0	2	0	0	11740	2
2	0	2	0	0	11741	2
2	0	2	0	0	11742	2
2	0	2	2	2	11743	2
2	0	2	0	0	11744	2
2	0	2	0	0	11745	2
2	0	2	0	0	11746	2
2	0	2	0	0	11747	2
2	0	4	2198	2198	11748	2
2	0	2	0	0	11749	2
2	0	2	0	0	11750	2
2	0	2	0	0	11751	2
2	0	2	0	0	11752	2
2	0	4	658	658	11753	2
2	1	2	0	1	11754	0
2	0	2	0	0	11755	2
2	0	2	0	0	11756	2
2	0	2	0	0	11757	2
2	0	2	0	0	11758	2
2	0	2	0	0	11759	2
2	0	2	0	0	11760	2
2	0	2	0	0	11761	2
2	0	2	0	0	11762	2
2	0	2	0	0	11763	2
2	0	2	0	0	11764	2
2	0	2	0	0	11765	2
2	0	2	0	0	11766	2
2	0	2	0	0	11767	2
2	0	2	0	0	11768	2
2	0	2	0	0	11769	2
2	0	2	1	1	11770	2
2	0	2	0	0	11771	2
2	0	2	0	0	11772	2
2	0	2	0	0	11773	2
2	0	2	5	5	11774	2
2	65	2	0	65	11775	0
2	31	2	811	842	11776	1
2	0	2	10	10	11777	2
2	0	2	2	2	11778	2
2	15	2	5	20	11779	0
2	0	2	138	138	11780	2
2	0	2	0	0	11781	2
2	0	2	0	0	11782	2
2	0	2	0	0	11783	2
2	1	4	307	308	11784	1
2	0	2	1	1	11785	2
2	0	2	0	0	11786	2
2	1	4	87	88	11787	0
2	0	4	163	163	11788	2
4	8	2	0	8	11789	0
0	0	2	1	1	11790	2
2	0	2	0	0	11791	2
2	2	2	0	2	11792	0
2	0	2	0	0	11793	2
2	0	4	2	2	11794	2
2	0	2	0	0	11795	2
2	0	2	0	0	11796	2
0	1	2	0	1	11797	1
0	4	2	0	4	11798	0
2	0	4	0	0	11799	2
2	0	2	0	0	11800	2
2	142	4	1019	1161	11801	1
2	0	2	0	0	11802	2
2	0	2	0	0	11803	2
2	9	4	708	717	11804	1
2	0	2	1	1	11805	2
2	0	4	1	1	11806	2
2	0	2	0	0	11807	2
2	0	2	0	0	11808	2
2	0	4	0	0	11809	2
2	0	2	0	0	11810	2
2	0	2	0	0	11811	2
2	0	2	0	0	11812	2
2	0	2	0	0	11813	2
2	0	2	0	0	11814	2
2	0	2	0	0	11815	2
2	0	2	0	0	11816	2
0	0	4	403	403	11817	2
2	0	2	0	0	11818	2
2	0	2	0	0	11819	2
2	0	2	0	0	11820	2
2	0	2	0	0	11821	2
2	0	2	0	0	11822	2
2	0	2	0	0	11823	2
2	0	2	0	0	11824	2
2	0	4	1	1	11825	2
2	3	2	6112	6115	11826	1
2	6	2	0	6	11827	0
2	3	2	60	63	11828	1
2	34	2	0	34	11829	0
2	24	2	936	960	11830	1
2	0	2	5	5	11831	2
2	0	2	0	0	11832	2
2	23	2	6	29	11833	1
2	0	2	89	89	11834	2
2	0	2	0	0	11835	2
2	0	2	0	0	11836	2
2	0	2	0	0	11837	2
2	0	2	0	0	11838	2
2	0	2	0	0	11839	2
2	0	4	259	259	11840	2
2	0	2	0	0	11841	2
2	0	2	0	0	11842	2
2	0	2	0	0	11843	2
2	0	2	5	5	11844	2
2	0	2	0	0	11845	2
2	0	2	0	0	11846	2
4	0	4	10	10	11847	2
2	339	2	110	449	11848	1
2	3	2	1209	1212	11849	1
2	20	2	0	20	11850	0
2	80	2	306	386	11851	1
2	0	2	7	7	11852	2
2	0	2	0	0	11853	2
2	37	2	3	40	11854	1
2	0	2	99	99	11855	2
2	670	2	14	684	11856	0
2	1654	2	5207	6861	11857	1
2	4	2	271	275	11858	1
2	0	2	14	14	11859	2
2	4	2	0	4	11860	0
2	10	2	143	153	11861	1
2	0	2	0	0	11862	2
2	0	2	0	0	11863	2
2	1	2	0	1	11864	0
2	0	2	19	19	11865	2
2	2	2	0	2	11866	0
2	0	2	0	0	11867	2
2	0	2	0	0	11868	2
2	0	2	0	0	11869	2
2	0	2	0	0	11870	2
2	0	2	0	0	11871	2
2	0	2	0	0	11872	2
2	0	2	48	48	11873	2
2	0	2	1	1	11874	2
2	0	2	0	0	11875	2
2	3	2	1	4	11876	1
2	0	2	0	0	11877	2
2	7	2	1420	1427	11878	1
2	15	4	862	877	11879	0
2	0	2	73	73	11880	2
2	0	2	0	0	11881	2
2	0	2	207	207	11882	2
2	0	2	0	0	11883	2
2	0	2	0	0	11884	2
2	0	2	61	61	11885	2
2	0	2	0	0	11886	2
2	0	2	0	0	11887	2
2	0	2	0	0	11888	2
2	0	2	0	0	11889	2
2	1	2	0	1	11890	0
2	2	2	1	3	11891	1
2	0	2	0	0	11892	2
2	0	2	0	0	11893	2
2	0	2	0	0	11894	2
2	0	2	0	0	11895	2
2	0	2	0	0	11896	2
2	0	2	0	0	11897	2
2	0	2	0	0	11898	2
4	12694	2	207	12901	11899	1
4	60	2	61	121	11900	1
2	0	2	0	0	11901	2
2	0	2	0	0	11902	2
2	11	2	0	11	11903	0
2	2	2	236	238	11904	1
2	0	2	11	11	11905	2
2	0	2	0	0	11906	2
2	2	2	0	2	11907	1
2	0	2	4	4	11908	2
2	0	2	0	0	11909	2
2	0	2	0	0	11910	2
2	0	2	0	0	11911	2
2	0	2	0	0	11912	2
2	0	2	0	0	11913	2
2	0	2	0	0	11914	2
2	0	2	0	0	11915	2
2	0	2	4	4	11916	2
2	0	2	0	0	11917	2
2	0	2	0	0	11918	2
2	0	2	1	1	11919	2
2	0	2	3	3	11920	2
2	1	2	0	1	11921	0
2	1	2	6	7	11922	1
2	0	2	0	0	11923	2
2	0	2	0	0	11924	2
2	1	2	0	1	11925	1
2	0	2	0	0	11926	2
2	0	2	0	0	11927	2
2	0	2	2	2	11928	2
2	0	2	65	65	11929	2
2	13	2	0	13	11930	0
2	2	2	1119	1121	11931	1
2	0	2	0	0	11932	2
2	0	2	2	2	11933	2
2	6	2	0	6	11934	0
2	0	2	20	20	11935	2
2	1	2	0	1	11936	0
2	1	2	315	316	11937	1
2	0	2	0	0	11938	2
2	0	2	0	0	11939	2
2	0	2	271	271	11940	2
2	0	2	0	0	11941	2
2	0	2	0	0	11942	2
2	0	2	0	0	11943	2
2	0	2	0	0	11944	2
2	2	2	0	2	11945	0
2	3	2	15	18	11946	1
2	0	2	0	0	11947	2
2	0	2	0	0	11948	2
2	0	2	0	0	11949	2
2	0	2	1	1	11950	2
2	0	2	0	0	11951	2
2	0	2	0	0	11952	2
2	0	2	0	0	11953	2
2	0	2	0	0	11954	2
2	0	2	0	0	11955	2
2	0	2	0	0	11956	2
2	22	2	0	22	11957	0
2	13	2	0	13	11958	0
2	0	2	55	55	11959	2
2	0	2	0	0	11960	2
2	0	2	0	0	11961	2
2	0	2	0	0	11962	2
2	0	2	0	0	11963	2
2	0	2	0	0	11964	2
2	0	2	0	0	11965	2
2	69	2	1	70	11966	0
2	0	2	32	32	11967	2
2	0	2	2	2	11968	2
2	25	2	686	711	11969	1
2	0	2	3	3	11970	2
2	0	2	0	0	11971	2
2	7	2	9	16	11972	1
2	0	2	42	42	11973	2
2	0	2	0	0	11974	2
2	0	2	2	2	11975	2
2	0	2	0	0	11976	2
2	0	2	0	0	11977	2
2	0	2	0	0	11978	2
2	0	2	0	0	11979	2
2	0	2	0	0	11980	2
2	1	2	4	5	11981	1
2	0	2	0	0	11982	2
2	0	2	0	0	11983	2
2	0	2	0	0	11984	2
2	0	2	4	4	11985	2
2	0	2	0	0	11986	2
2	0	2	0	0	11987	2
2	0	2	0	0	11988	2
2	0	2	0	0	11989	2
2	0	2	0	0	11990	2
2	0	2	0	0	11991	2
2	0	2	0	0	11992	2
2	0	2	4	4	11993	2
2	0	2	0	0	11994	2
2	0	2	0	0	11995	2
2	0	2	0	0	11996	2
2	0	2	0	0	11997	2
2	0	2	0	0	11998	2
2	1	2	0	1	11999	1
2	0	2	0	0	12000	2
2	0	2	0	0	12001	2
2	0	2	0	0	12002	2
2	0	2	0	0	12003	2
2	40	2	0	40	12004	0
2	1	2	139	140	12005	1
2	0	2	3	3	12006	2
2	0	2	0	0	12007	2
2	10	2	0	10	12008	0
2	0	2	54	54	12009	2
2	22	2	1	23	12010	0
2	0	2	14	14	12011	2
2	0	2	0	0	12012	2
2	8	2	0	8	12013	0
2	21	2	81	102	12014	1
2	0	2	1	1	12015	2
2	0	2	0	0	12016	2
2	2	2	1	3	12017	0
2	0	2	12	12	12018	2
2	0	2	0	0	12019	2
2	0	2	0	0	12020	2
2	0	2	0	0	12021	2
2	0	2	0	0	12022	2
2	0	2	0	0	12023	2
2	0	2	0	0	12024	2
2	0	2	0	0	12025	2
2	0	2	12	12	12026	2
2	0	2	0	0	12027	2
2	0	2	0	0	12028	2
2	0	2	0	0	12029	2
2	0	2	0	0	12030	2
2	0	2	0	0	12031	2
2	0	2	0	0	12032	2
2	0	2	0	0	12033	2
2	0	2	248	248	12034	2
2	56	2	0	56	12035	0
2	5	2	288	293	12036	1
2	0	2	1	1	12037	2
2	0	2	0	0	12038	2
0	1162	2	21	1183	12039	0
0	989	2	0	989	12040	0
2	6	2	0	6	12041	0
2	0	2	85	85	12042	2
2	128	2	1	129	12043	0
2	131	0	6503	6634	12044	1
2	0	2	8	8	12045	2
2	0	2	3	3	12046	2
2	75	0	624	699	12047	0
2	0	2	229	229	12048	2
2	0	2	0	0	12049	2
2	0	2	0	0	12050	2
2	0	2	0	0	12051	2
2	0	2	0	0	12052	2
2	0	2	0	0	12053	2
2	0	2	0	0	12054	2
2	0	2	0	0	12055	2
2	0	0	2008	2008	12056	2
2	0	2	0	0	12057	2
2	0	2	0	0	12058	2
2	0	0	1336	1336	12059	2
2	0	2	0	0	12060	2
2	26	2	0	26	12061	0
2	7	2	177	184	12062	1
2	0	2	2	2	12063	2
2	0	2	0	0	12064	2
2	0	2	0	0	12065	2
2	0	2	1	1	12066	2
2	0	2	0	0	12067	2
2	0	2	0	0	12068	2
2	0	2	0	0	12069	2
2	0	2	0	0	12070	2
2	1	2	1	2	12071	1
2	0	2	21	21	12072	2
2	276	2	0	276	12073	0
2	0	2	0	0	12074	2
2	0	2	0	0	12075	2
2	0	2	0	0	12076	2
2	0	2	0	0	12077	2
2	0	2	0	0	12078	2
2	0	2	0	0	12079	2
2	0	2	92	92	12080	2
2	0	2	0	0	12081	2
2	0	2	1239	1239	12082	2
2	17	2	0	17	12083	0
2	0	2	20	20	12084	2
2	355	2	0	355	12085	0
2	101	4	2600	2701	12086	1
2	0	2	4	4	12087	2
2	0	2	1	1	12088	2
2	22	4	69	91	12089	0
2	0	2	234	234	12090	2
2	0	2	0	0	12091	2
2	0	2	0	0	12092	2
0	0	4	81	81	12093	2
2	0	2	1510	1510	12094	2
2	0	2	0	0	12095	2
2	0	2	0	0	12096	2
2	0	2	423	423	12097	2
2	0	2	0	0	12098	2
4	0	2	0	0	12099	2
2	0	2	19	19	12100	2
2	0	2	0	0	12101	2
2	0	2	0	0	12102	2
2	0	2	0	0	12103	2
2	0	2	0	0	12104	2
2	40	2	3	43	12105	0
2	3	2	3058	3061	12106	1
2	47	2	0	47	12107	0
2	0	2	354	354	12108	2
2	11	2	0	11	12109	0
2	0	2	0	0	12110	2
2	0	2	0	0	12111	2
2	9	2	2670	2679	12112	0
2	57	2	0	57	12113	0
2	1	2	298	299	12114	1
2	141	2	2	143	12115	0
2	9	2	1468	1477	12116	1
2	0	2	109	109	12117	2
2	0	2	2	2	12118	2
2	45	2	3	48	12119	0
2	0	2	208	208	12120	2
2	58	4	2252	2310	12121	1
2	1	2	21	22	12122	1
2	0	2	0	0	12123	2
2	1643	2	504	2147	12124	1
2	967	4	753	1720	12125	0
2	15	2	504	519	12126	0
2	42	4	753	795	12127	1
2	0	0	1	1	12128	2
2	0	2	91	91	12129	2
2	3	2	0	3	12130	0
2	2	2	28	30	12131	1
2	0	2	0	0	12132	2
2	0	2	0	0	12133	2
2	1	2	0	1	12134	0
2	0	2	3	3	12135	2
2	397	2	3	400	12136	0
2	32	2	4603	4635	12137	1
2	1	2	159	160	12138	1
2	0	2	0	0	12139	2
2	84	2	13346	13430	12140	0
2	1	2	609	610	12141	1
2	0	2	0	0	12142	2
2	0	4	2	2	12143	2
2	0	2	0	0	12144	2
2	0	2	0	0	12145	2
2	0	4	0	0	12146	2
2	0	2	0	0	12147	2
2	0	2	0	0	12148	2
2	0	2	0	0	12149	2
2	0	2	0	0	12150	2
2	9	2	0	9	12151	0
2	0	2	40	40	12152	2
2	0	2	0	0	12153	2
2	0	2	0	0	12154	2
2	0	2	0	0	12155	2
2	0	2	3	3	12156	2
2	59	2	0	59	12157	0
2	16	2	337	353	12158	1
2	0	2	31	31	12159	2
2	0	2	2	2	12160	2
2	51	2	3	54	12161	0
2	0	2	184	184	12162	2
2	0	2	0	0	12163	2
4	0	4	4543	4543	12164	2
4	0	4	4543	4543	12165	2
2	0	2	0	0	12166	2
2	0	2	0	0	12167	2
2	0	4	1057	1057	12168	2
2	0	2	0	0	12169	2
2	0	2	0	0	12170	2
2	1426	4	590	2016	12171	0
2	29	4	590	619	12172	1
2	1	2	0	1	12173	1
2	0	2	0	0	12174	2
2	0	2	0	0	12175	2
2	0	2	0	0	12176	2
2	0	2	0	0	12177	2
2	0	2	0	0	12178	2
2	0	2	0	0	12179	2
2	2	2	0	2	12180	0
2	0	2	13	13	12181	2
2	0	2	0	0	12182	2
2	0	2	0	0	12183	2
2	0	2	0	0	12184	2
2	0	2	0	0	12185	2
2	0	2	698	698	12186	2
2	2	2	0	2	12187	0
2	0	2	23	23	12188	2
2	236	2	5	241	12189	0
2	0	2	43	43	12190	2
2	0	2	1	1	12191	2
2	0	2	0	0	12192	2
2	1	2	0	1	12193	1
2	0	2	0	0	12194	2
2	0	2	0	0	12195	2
2	0	2	0	0	12196	2
2	0	2	1	1	12197	2
2	41	2	1	42	12198	0
2	31	2	462	493	12199	1
2	0	2	11	11	12200	2
2	0	2	0	0	12201	2
2	42	2	4	46	12202	0
2	0	2	140	140	12203	2
2	0	2	0	0	12204	2
2	1	2	4	5	12205	1
2	0	2	0	0	12206	2
2	0	2	0	0	12207	2
2	0	2	0	0	12208	2
2	0	2	0	0	12209	2
2	0	2	0	0	12210	2
2	0	2	0	0	12211	2
2	0	2	0	0	12212	2
2	0	2	0	0	12213	2
2	0	2	0	0	12214	2
2	5	2	0	5	12215	0
2	0	2	0	0	12216	2
2	0	2	0	0	12217	2
2	3	2	0	3	12218	0
2	1	2	9	10	12219	1
2	0	2	1	1	12220	2
2	0	2	0	0	12221	2
2	1	2	2	3	12222	1
2	0	2	23	23	12223	2
2	1	2	0	1	12224	0
2	0	2	39	39	12225	2
2	0	2	0	0	12226	2
2	0	2	0	0	12227	2
2	1	2	1	2	12228	1
2	0	2	2	2	12229	2
2	1	2	0	1	12230	0
2	0	2	10	10	12231	2
2	0	2	0	0	12232	2
2	0	2	0	0	12233	2
2	0	2	0	0	12234	2
2	0	2	2	2	12235	2
2	50	2	0	50	12236	0
2	0	2	404	404	12237	2
2	251	2	5229	5480	12238	1
2	2	2	0	2	12239	0
2	1	2	609	610	12240	1
2	0	2	0	0	12241	2
2	0	2	0	0	12242	2
2	0	2	159	159	12243	2
2	0	4	71	71	12244	2
2	27	2	0	27	12245	0
2	8	0	3427	3435	12246	1
2	0	2	2	2	12247	2
2	0	2	0	0	12248	2
2	11	0	5176	5187	12249	0
2	0	2	72	72	12250	2
2	0	2	0	0	12251	2
2	0	2	0	0	12252	2
2	0	2	0	0	12253	2
2	0	2	0	0	12254	2
2	0	2	0	0	12255	2
2	0	2	0	0	12256	2
2	0	2	0	0	12257	2
2	0	2	10	10	12258	2
2	0	2	0	0	12259	2
2	0	2	0	0	12260	2
2	0	2	0	0	12261	2
2	0	2	1	1	12262	2
2	0	2	0	0	12263	2
2	0	2	1	1	12264	2
2	0	2	0	0	12265	2
2	0	2	0	0	12266	2
2	0	2	0	0	12267	2
2	0	2	0	0	12268	2
2	0	2	0	0	12269	2
2	10	2	1	11	12270	1
2	0	2	0	0	12271	2
2	0	2	0	0	12272	2
2	0	2	0	0	12273	2
2	0	2	0	0	12274	2
2	28	2	1	29	12275	0
2	60	4	2512	2572	12276	1
2	0	2	21	21	12277	2
2	0	2	0	0	12278	2
2	28	4	429	457	12279	1
2	0	2	132	132	12280	2
2	2	2	0	2	12281	0
2	1	2	45	46	12282	1
2	0	2	0	0	12283	2
2	0	2	0	0	12284	2
2	1	2	0	1	12285	0
2	0	2	5	5	12286	2
2	0	2	0	0	12287	2
2	0	2	0	0	12288	2
2	0	2	0	0	12289	2
2	21	2	0	21	12290	0
2	2	2	90	92	12291	1
2	0	2	1	1	12292	2
2	0	2	0	0	12293	2
2	3	2	5	8	12294	0
2	0	2	25	25	12295	2
2	0	2	0	0	12296	2
2	0	2	5	5	12297	2
2	0	2	0	0	12298	2
2	0	2	0	0	12299	2
2	0	2	0	0	12300	2
2	0	2	1	1	12301	2
2	6	2	0	6	12302	0
2	0	2	0	0	12303	2
2	0	2	0	0	12304	2
2	0	2	0	0	12305	2
2	0	2	0	0	12306	2
2	0	2	0	0	12307	2
2	0	2	0	0	12308	2
2	2	2	0	2	12309	0
2	0	2	3	3	12310	2
2	0	2	0	0	12311	2
2	0	2	0	0	12312	2
2	1	2	0	1	12313	1
2	0	2	4	4	12314	2
2	0	2	0	0	12315	2
2	0	2	0	0	12316	2
2	0	2	0	0	12317	2
2	0	2	0	0	12318	2
2	0	2	0	0	12319	2
2	0	2	6	6	12320	2
2	0	2	0	0	12321	2
2	0	2	0	0	12322	2
2	0	2	0	0	12323	2
2	82	2	7	89	12324	0
2	0	2	300	300	12325	2
2	0	2	0	0	12326	2
2	0	2	0	0	12327	2
2	0	2	0	0	12328	2
2	0	2	0	0	12329	2
2	0	2	0	0	12330	2
2	0	2	0	0	12331	2
2	3	2	0	3	12332	0
2	3	2	14	17	12333	1
2	0	2	1	1	12334	2
2	0	2	0	0	12335	2
2	2	2	0	2	12336	1
2	0	2	10	10	12337	2
2	0	2	0	0	12338	2
2	0	2	0	0	12339	2
2	0	2	0	0	12340	2
2	0	2	0	0	12341	2
2	0	2	0	0	12342	2
2	0	2	0	0	12343	2
2	0	2	0	0	12344	2
2	0	2	0	0	12345	2
2	0	2	0	0	12346	2
2	0	2	0	0	12347	2
2	0	2	34	34	12348	2
2	0	2	0	0	12349	2
2	0	2	0	0	12350	2
2	0	2	8	8	12351	2
2	0	2	0	0	12352	2
2	27	2	0	27	12353	0
4	14107	2	34	14141	12354	0
4	1791	2	8	1799	12355	0
2	0	2	1	1	12356	2
2	0	2	0	0	12357	2
2	2	2	0	2	12358	0
2	17	2	85	102	12359	1
2	0	2	1	1	12360	2
2	0	2	1	1	12361	2
2	5	2	0	5	12362	0
2	0	2	9	9	12363	2
2	31	2	0	31	12364	0
2	41	2	0	41	12365	0
2	3	2	1824	1827	12366	1
2	0	2	4	4	12367	2
2	0	2	3	3	12368	2
2	2	2	4	6	12369	1
2	0	2	47	47	12370	2
2	0	2	0	0	12371	2
2	0	2	17	17	12372	2
2	0	2	0	0	12373	2
2	0	2	0	0	12374	2
2	1	2	0	1	12375	0
2	0	2	4	4	12376	2
2	94	2	0	94	12377	0
2	113	2	1616	1729	12378	1
2	0	2	17	17	12379	2
2	0	2	1	1	12380	2
2	147	2	324	471	12381	0
2	0	2	326	326	12382	2
2	0	2	0	0	12383	2
2	11	2	10	21	12384	1
2	0	2	0	0	12385	2
2	0	2	0	0	12386	2
2	6	2	0	6	12387	0
2	0	2	5	5	12388	2
2	0	2	0	0	12389	2
2	0	0	0	0	12390	2
2	0	2	0	0	12391	2
2	0	2	0	0	12392	2
2	0	0	0	0	12393	2
2	0	2	0	0	12394	2
2	29	2	582	611	12395	1
2	1	2	12	13	12396	1
2	0	2	1	1	12397	2
2	15	2	49	64	12398	0
2	2	2	3	5	12399	0
2	0	2	0	0	12400	2
2	0	2	0	0	12401	2
2	0	2	0	0	12402	2
2	0	2	0	0	12403	2
2	0	2	0	0	12404	2
2	0	2	0	0	12405	2
2	0	2	0	0	12406	2
2	0	2	0	0	12407	2
2	0	2	1043	1043	12408	2
2	7	2	1	8	12409	0
2	0	2	47	47	12410	2
2	12	2	0	12	12411	0
2	5	2	150	155	12412	1
2	0	2	9	9	12413	2
2	0	2	0	0	12414	2
2	2	2	261	263	12415	0
2	0	2	10	10	12416	2
2	2	2	0	2	12417	0
2	0	2	12	12	12418	2
2	0	2	0	0	12419	2
2	0	2	0	0	12420	2
2	0	2	0	0	12421	2
2	0	2	3	3	12422	2
2	0	2	0	0	12423	2
2	0	2	0	0	12424	2
2	0	2	0	0	12425	2
2	0	2	0	0	12426	2
2	0	2	0	0	12427	2
2	0	2	0	0	12428	2
2	2	2	0	2	12429	0
2	2	4	24	26	12430	1
2	0	2	2	2	12431	2
2	0	2	0	0	12432	2
2	0	4	1	1	12433	2
2	0	2	3	3	12434	2
2	0	2	0	0	12435	2
2	0	2	0	0	12436	2
2	0	2	0	0	12437	2
2	0	2	0	0	12438	2
2	0	2	0	0	12439	2
2	0	2	0	0	12440	2
2	0	2	0	0	12441	2
2	0	2	0	0	12442	2
2	0	2	0	0	12443	2
2	0	2	0	0	12444	2
2	0	2	0	0	12445	2
2	8	2	0	8	12446	0
2	2	2	74	76	12447	1
2	0	2	6	6	12448	2
2	0	2	1	1	12449	2
2	11	2	1	12	12450	0
2	0	2	24	24	12451	2
2	0	2	0	0	12452	2
2	0	2	1	1	12453	2
2	0	2	0	0	12454	2
2	0	2	0	0	12455	2
2	0	2	0	0	12456	2
2	0	2	0	0	12457	2
2	0	2	0	0	12458	2
2	0	2	4	4	12459	2
2	0	2	0	0	12460	2
2	0	2	0	0	12461	2
2	0	2	0	0	12462	2
2	0	2	0	0	12463	2
2	0	2	0	0	12464	2
2	0	2	0	0	12465	2
2	0	2	0	0	12466	2
2	0	2	0	0	12467	2
2	0	2	0	0	12468	2
2	0	2	0	0	12469	2
2	0	2	0	0	12470	2
2	0	2	0	0	12471	2
2	0	2	0	0	12472	2
2	0	2	0	0	12473	2
2	0	2	0	0	12474	2
2	0	2	0	0	12475	2
2	0	2	0	0	12476	2
2	0	2	0	0	12477	2
2	0	2	0	0	12478	2
2	0	2	0	0	12479	2
2	0	2	0	0	12480	2
2	0	2	0	0	12481	2
2	0	2	0	0	12482	2
2	0	2	0	0	12483	2
2	0	2	0	0	12484	2
2	0	2	0	0	12485	2
2	0	2	0	0	12486	2
2	0	2	0	0	12487	2
2	0	2	0	0	12488	2
2	0	4	1	1	12489	2
2	0	2	0	0	12490	2
2	0	2	0	0	12491	2
2	0	4	1	1	12492	2
2	0	2	0	0	12493	2
2	0	2	0	0	12494	2
2	0	2	0	0	12495	2
2	0	2	0	0	12496	2
2	0	2	0	0	12497	2
2	0	2	0	0	12498	2
2	0	2	0	0	12499	2
2	0	2	0	0	12500	2
2	1	2	196	197	12501	1
2	0	2	1	1	12502	2
2	0	2	0	0	12503	2
2	0	2	0	0	12504	2
2	0	2	7	7	12505	2
2	2	2	0	2	12506	0
2	1	2	0	1	12507	0
2	0	2	1	1	12508	2
2	2	2	12	14	12509	1
2	0	2	0	0	12510	2
2	0	2	0	0	12511	2
2	0	2	0	0	12512	2
2	0	2	0	0	12513	2
2	0	2	0	0	12514	2
2	0	2	0	0	12515	2
2	0	2	0	0	12516	2
2	0	2	0	0	12517	2
2	0	2	0	0	12518	2
2	0	2	0	0	12519	2
2	0	2	0	0	12520	2
2	0	2	0	0	12521	2
2	0	2	0	0	12522	2
2	0	2	0	0	12523	2
4	4144	4	2	4146	12524	0
2	0	2	0	0	12525	2
2	0	2	0	0	12526	2
2	0	2	0	0	12527	2
2	0	2	0	0	12528	2
2	0	2	0	0	12529	2
2	0	2	0	0	12530	2
2	0	2	0	0	12531	2
2	0	0	1	1	12532	2
2	0	2	0	0	12533	2
2	0	2	0	0	12534	2
2	0	4	0	0	12535	2
2	0	2	0	0	12536	2
4	0	2	0	0	12537	2
2	0	2	0	0	12538	2
2	3	4	256	259	12539	1
2	0	2	0	0	12540	2
2	0	2	0	0	12541	2
2	0	4	112	112	12542	2
2	0	2	0	0	12543	2
2	0	2	0	0	12544	2
2	0	2	1	1	12545	2
2	0	2	8	8	12546	2
2	0	2	34	34	12547	2
2	0	2	0	0	12548	2
2	0	2	0	0	12549	2
2	6	2	0	6	12550	0
2	0	2	41	41	12551	2
2	0	2	2	2	12552	2
2	0	2	0	0	12553	2
2	0	2	0	0	12554	2
2	0	2	26	26	12555	2
2	0	2	0	0	12556	2
2	0	0	4004	4004	12557	2
2	0	2	0	0	12558	2
2	0	2	0	0	12559	2
2	0	0	900	900	12560	2
2	0	2	0	0	12561	2
2	0	2	0	0	12562	2
2	0	2	0	0	12563	2
2	0	2	0	0	12564	2
2	0	2	0	0	12565	2
2	0	4	20	20	12566	2
2	0	2	0	0	12567	2
2	0	2	0	0	12568	2
2	0	4	1	1	12569	2
2	0	2	1	1	12570	2
2	0	2	0	0	12571	2
2	0	2	0	0	12572	2
2	0	2	0	0	12573	2
2	0	2	0	0	12574	2
2	0	2	0	0	12575	2
2	0	2	0	0	12576	2
2	0	2	0	0	12577	2
2	0	4	0	0	12578	2
2	0	2	0	0	12579	2
2	0	4	0	0	12580	2
2	0	2	0	0	12581	2
2	0	2	0	0	12582	2
2	0	2	0	0	12583	2
2	0	2	0	0	12584	2
2	0	2	0	0	12585	2
2	0	2	0	0	12586	2
2	0	2	0	0	12587	2
2	0	2	0	0	12588	2
2	97	2	0	97	12589	0
2	10	2	1362	1372	12590	1
2	0	2	8	8	12591	2
2	0	2	6	6	12592	2
2	9	2	18	27	12593	1
2	0	2	135	135	12594	2
2	0	2	0	0	12595	2
2	0	2	7	7	12596	2
2	0	2	0	0	12597	2
2	0	2	0	0	12598	2
2	0	2	0	0	12599	2
2	0	2	0	0	12600	2
2	0	2	0	0	12601	2
2	0	2	0	0	12602	2
2	0	2	0	0	12603	2
2	0	2	0	0	12604	2
2	0	2	0	0	12605	2
2	0	2	0	0	12606	2
2	1	2	1	2	12607	0
2	0	2	3	3	12608	2
2	0	2	1	1	12609	2
2	3	2	0	3	12610	0
2	3	4	28	31	12611	0
2	0	2	6	6	12612	2
2	0	2	0	0	12613	2
2	3	4	3	6	12614	0
2	0	2	4	4	12615	2
0	0	4	382	382	12616	2
0	0	4	382	382	12617	2
2	0	2	0	0	12618	2
2	4	2	0	4	12619	0
2	5	2	133	138	12620	1
2	0	2	2	2	12621	2
2	0	2	0	0	12622	2
2	4	2	0	4	12623	0
2	0	2	0	0	12624	2
2	0	2	1	1	12625	2
2	0	2	0	0	12626	2
2	0	2	0	0	12627	2
2	0	2	0	0	12628	2
2	0	2	0	0	12629	2
4	0	2	0	0	12630	2
2	22	2	0	22	12631	0
2	23	2	216	239	12632	1
2	0	2	1	1	12633	2
2	0	2	0	0	12634	2
2	8	2	0	8	12635	0
2	0	2	42	42	12636	2
2	1	2	0	1	12637	0
2	0	2	0	0	12638	2
2	0	2	0	0	12639	2
2	0	2	0	0	12640	2
2	0	2	0	0	12641	2
2	0	2	0	0	12642	2
2	0	2	0	0	12643	2
2	0	2	19	19	12644	2
2	0	2	0	0	12645	2
2	0	2	0	0	12646	2
2	1	2	0	1	12647	0
2	0	2	0	0	12648	2
4	3806	2	19	3825	12649	0
4	144	2	0	144	12650	0
2	0	2	0	0	12651	2
2	0	2	1	1	12652	2
2	0	2	1	1	12653	2
2	0	2	0	0	12654	2
2	1	2	0	1	12655	0
2	14	2	0	14	12656	0
2	2	2	11	13	12657	1
2	0	2	9	9	12658	2
2	0	2	0	0	12659	2
2	5	2	0	5	12660	0
2	89	2	1	90	12661	0
2	41	4	1488	1529	12662	1
2	0	2	14	14	12663	2
2	0	2	0	0	12664	2
2	21	4	109	130	12665	0
2	0	2	150	150	12666	2
2	306	2	5	311	12667	0
2	169	2	9741	9910	12668	1
2	0	2	101	101	12669	2
2	0	2	1	1	12670	2
2	233	2	24	257	12671	0
2	0	2	1341	1341	12672	2
2	7	2	0	7	12673	0
2	0	4	158	158	12674	2
2	0	2	0	0	12675	2
2	0	2	0	0	12676	2
2	2	4	117	119	12677	0
2	0	2	8	8	12678	2
2	0	2	0	0	12679	2
2	0	2	0	0	12680	2
2	0	2	0	0	12681	2
2	0	2	0	0	12682	2
2	0	2	0	0	12683	2
2	0	2	0	0	12684	2
2	198	2	0	198	12685	0
2	0	2	0	0	12686	2
2	0	2	0	0	12687	2
2	2	2	0	2	12688	0
2	0	2	0	0	12689	2
2	0	4	0	0	12690	2
2	0	2	0	0	12691	2
2	0	2	0	0	12692	2
2	0	4	0	0	12693	2
2	0	2	0	0	12694	2
2	61	2	0	61	12695	0
2	35	2	153	188	12696	1
2	0	2	6	6	12697	2
2	0	2	0	0	12698	2
2	15	2	1	16	12699	0
2	0	2	127	127	12700	2
2	0	4	1044	1044	12701	2
2	0	2	0	0	12702	2
2	0	2	0	0	12703	2
2	0	4	197	197	12704	2
2	0	2	2	2	12705	2
2	0	2	0	0	12706	2
2	0	2	0	0	12707	2
2	0	2	0	0	12708	2
2	0	2	0	0	12709	2
2	0	2	2	2	12710	2
2	0	2	0	0	12711	2
2	0	2	0	0	12712	2
2	0	2	0	0	12713	2
2	0	2	0	0	12714	2
2	0	2	0	0	12715	2
2	0	2	0	0	12716	2
2	0	2	1	1	12717	2
2	0	2	0	0	12718	2
2	0	2	0	0	12719	2
2	0	2	0	0	12720	2
2	0	2	0	0	12721	2
2	0	2	0	0	12722	2
2	0	2	0	0	12723	2
2	1	2	0	1	12724	0
2	8	2	25	33	12725	1
2	0	2	0	0	12726	2
2	0	2	0	0	12727	2
2	0	2	1	1	12728	2
2	0	2	0	0	12729	2
4	7	4	5	12	12730	0
2	69	2	2	71	12731	0
2	7	2	0	7	12732	0
2	13	2	365	378	12733	1
2	0	2	8	8	12734	2
2	0	2	0	0	12735	2
2	9	2	0	9	12736	0
2	0	2	25	25	12737	2
2	0	2	0	0	12738	2
2	0	2	0	0	12739	2
2	0	2	0	0	12740	2
2	0	2	0	0	12741	2
2	0	2	0	0	12742	2
2	0	2	0	0	12743	2
2	0	2	0	0	12744	2
2	0	2	20	20	12745	2
2	0	2	0	0	12746	2
2	0	2	0	0	12747	2
2	0	2	0	0	12748	2
2	0	2	0	0	12749	2
2	1	2	0	1	12750	0
2	0	2	2	2	12751	2
2	0	2	0	0	12752	2
2	0	2	0	0	12753	2
2	0	2	0	0	12754	2
2	0	2	0	0	12755	2
2	1	2	0	1	12756	0
2	0	2	2	2	12757	2
2	0	2	0	0	12758	2
2	0	2	0	0	12759	2
2	0	2	0	0	12760	2
2	0	2	1	1	12761	2
2	0	2	3	3	12762	2
2	0	2	1	1	12763	2
2	0	2	0	0	12764	2
2	0	2	1	1	12765	2
2	0	2	0	0	12766	2
2	0	2	0	0	12767	2
2	0	2	6	6	12768	2
2	0	2	60	60	12769	2
2	0	2	6	6	12770	2
2	4	2	2124	2128	12771	1
2	0	2	0	0	12772	2
2	0	2	0	0	12773	2
2	77	2	0	77	12774	1
2	0	2	280	280	12775	2
2	75	2	0	75	12776	0
2	5	4	5304	5309	12777	1
2	0	2	26	26	12778	2
2	0	2	0	0	12779	2
2	40	4	2336	2376	12780	0
2	0	2	223	223	12781	2
2	0	2	0	0	12782	2
2	19	2	1	20	12783	0
2	0	2	4	4	12784	2
2	0	2	0	0	12785	2
2	0	2	0	0	12786	2
2	2	2	0	2	12787	0
2	3	2	12	15	12788	1
2	0	2	2	2	12789	2
2	0	2	1	1	12790	2
2	4	2	0	4	12791	0
4	0	2	0	0	12792	2
4	0	2	0	0	12793	2
2	8	2	0	8	12794	0
2	36	2	139	175	12795	1
2	0	2	6	6	12796	2
2	0	2	0	0	12797	2
2	9	2	4256	4265	12798	0
2	0	2	40	40	12799	2
2	0	2	0	0	12800	2
2	0	2	8	8	12801	2
2	0	2	0	0	12802	2
2	0	2	0	0	12803	2
2	1	2	0	1	12804	0
2	0	2	0	0	12805	2
4	0	2	1	1	12806	2
2	6	2	0	6	12807	0
2	3	2	525	528	12808	1
2	0	2	0	0	12809	2
2	0	2	0	0	12810	2
2	4	2	1	5	12811	0
2	0	2	23	23	12812	2
2	9	2	1	10	12813	0
2	0	2	0	0	12814	2
2	0	2	0	0	12815	2
2	0	2	0	0	12816	2
2	0	2	0	0	12817	2
2	0	2	0	0	12818	2
2	0	2	0	0	12819	2
2	30	2	0	30	12820	0
2	9	2	1515	1524	12821	1
2	0	2	8	8	12822	2
2	0	2	0	0	12823	2
2	33	2	0	33	12824	0
2	0	2	330	330	12825	2
2	0	2	0	0	12826	2
2	0	2	0	0	12827	2
2	0	2	0	0	12828	2
2	0	2	0	0	12829	2
2	0	2	0	0	12830	2
2	0	2	0	0	12831	2
2	0	2	0	0	12832	2
2	0	2	4	4	12833	2
2	0	2	0	0	12834	2
2	0	2	0	0	12835	2
2	0	2	0	0	12836	2
2	0	2	2	2	12837	2
2	80	2	0	80	12838	0
2	15	4	206	221	12839	1
2	0	2	8	8	12840	2
2	0	2	0	0	12841	2
2	42	4	10	52	12842	0
2	0	2	142	142	12843	2
2	0	2	0	0	12844	2
2	0	2	5	5	12845	2
2	0	2	0	0	12846	2
2	0	2	0	0	12847	2
2	0	2	0	0	12848	2
2	0	2	1	1	12849	2
2	4	2	15	19	12850	0
2	41	2	1	42	12851	0
2	0	2	749	749	12852	2
2	3628	2	7	3635	12853	0
2	650	2	13895	14545	12854	1
2	1	2	1648	1649	12855	1
2	0	2	7	7	12856	2
2	331	2	88	419	12857	1
2	0	2	0	0	12858	2
2	0	2	0	0	12859	2
2	0	2	0	0	12860	2
2	0	2	0	0	12861	2
2	0	2	0	0	12862	2
2	0	2	0	0	12863	2
2	0	2	0	0	12864	2
2	0	2	0	0	12865	2
2	0	2	0	0	12866	2
2	0	2	0	0	12867	2
2	0	2	0	0	12868	2
2	0	2	0	0	12869	2
2	0	2	0	0	12870	2
2	0	2	0	0	12871	2
2	0	2	0	0	12872	2
2	0	2	0	0	12873	2
2	0	2	2	2	12874	2
2	0	2	0	0	12875	2
2	0	2	0	0	12876	2
2	0	2	0	0	12877	2
2	0	2	0	0	12878	2
2	0	2	0	0	12879	2
2	0	2	0	0	12880	2
2	0	2	0	0	12881	2
2	0	2	0	0	12882	2
2	0	2	0	0	12883	2
2	0	2	0	0	12884	2
2	0	2	0	0	12885	2
2	0	2	0	0	12886	2
2	0	2	0	0	12887	2
2	0	2	0	0	12888	2
2	0	2	0	0	12889	2
2	0	2	0	0	12890	2
2	0	2	0	0	12891	2
2	1	2	0	1	12892	0
2	9	2	40	49	12893	1
2	0	2	0	0	12894	2
2	0	2	0	0	12895	2
2	1	2	1	2	12896	1
2	0	2	0	0	12897	2
2	0	2	0	0	12898	2
2	0	2	0	0	12899	2
2	0	2	0	0	12900	2
2	0	2	0	0	12901	2
2	0	2	0	0	12902	2
2	0	2	0	0	12903	2
2	0	2	0	0	12904	2
2	0	2	0	0	12905	2
2	0	2	0	0	12906	2
2	0	2	0	0	12907	2
2	0	2	0	0	12908	2
2	0	2	0	0	12909	2
2	0	2	0	0	12910	2
2	0	2	0	0	12911	2
2	0	2	0	0	12912	2
2	18	2	0	18	12913	0
2	0	2	0	0	12914	2
2	0	4	0	0	12915	2
2	0	2	0	0	12916	2
2	0	2	0	0	12917	2
2	0	4	0	0	12918	2
2	0	2	0	0	12919	2
2	30	4	97	127	12920	1
2	0	2	3	3	12921	2
2	0	2	0	0	12922	2
2	17	4	3035	3052	12923	1
2	0	2	39	39	12924	2
2	2	2	0	2	12925	0
2	0	2	34	34	12926	2
2	0	2	0	0	12927	2
2	0	2	0	0	12928	2
2	0	2	0	0	12929	2
2	0	2	0	0	12930	2
2	0	2	0	0	12931	2
2	0	2	0	0	12932	2
2	0	2	0	0	12933	2
2	0	2	0	0	12934	2
2	0	2	0	0	12935	2
2	0	2	0	0	12936	2
2	0	2	0	0	12937	2
2	0	2	0	0	12938	2
2	0	2	0	0	12939	2
2	0	4	2	2	12940	2
2	0	2	0	0	12941	2
2	0	2	0	0	12942	2
2	0	4	0	0	12943	2
2	0	2	0	0	12944	2
2	0	2	0	0	12945	2
2	0	2	0	0	12946	2
2	0	2	0	0	12947	2
2	0	2	0	0	12948	2
2	0	2	0	0	12949	2
2	0	2	0	0	12950	2
2	0	4	0	0	12951	2
2	0	2	0	0	12952	2
2	0	2	0	0	12953	2
2	0	4	0	0	12954	2
2	0	2	0	0	12955	2
2	0	2	0	0	12956	2
2	0	2	0	0	12957	2
2	0	2	0	0	12958	2
2	0	2	0	0	12959	2
2	0	2	0	0	12960	2
2	0	2	0	0	12961	2
2	0	2	0	0	12962	2
2	0	2	0	0	12963	2
2	9	2	0	9	12964	0
2	0	2	0	0	12965	2
2	0	2	0	0	12966	2
2	0	2	0	0	12967	2
2	0	2	0	0	12968	2
2	0	2	0	0	12969	2
2	0	2	0	0	12970	2
2	0	2	0	0	12971	2
2	0	2	0	0	12972	2
2	0	2	0	0	12973	2
2	0	2	0	0	12974	2
2	0	2	0	0	12975	2
2	0	2	0	0	12976	2
2	0	2	0	0	12977	2
2	0	2	0	0	12978	2
2	0	4	0	0	12979	2
2	0	2	0	0	12980	2
2	0	2	0	0	12981	2
2	0	4	0	0	12982	2
2	0	2	0	0	12983	2
2	0	2	0	0	12984	2
2	0	4	1	1	12985	2
2	0	2	0	0	12986	2
2	0	2	0	0	12987	2
2	0	4	0	0	12988	2
2	0	2	0	0	12989	2
2	0	2	0	0	12990	2
2	0	4	0	0	12991	2
2	0	2	0	0	12992	2
2	0	2	0	0	12993	2
2	0	4	1	1	12994	2
2	0	2	0	0	12995	2
2	0	2	0	0	12996	2
2	0	2	0	0	12997	2
2	0	2	0	0	12998	2
2	0	2	0	0	12999	2
2	0	2	0	0	13000	2
2	0	2	0	0	13001	2
2	0	2	0	0	13002	2
2	0	2	0	0	13003	2
2	0	2	0	0	13004	2
2	0	2	0	0	13005	2
2	0	2	0	0	13006	2
2	0	2	0	0	13007	2
2	0	2	0	0	13008	2
2	0	2	0	0	13009	2
2	0	2	0	0	13010	2
2	0	2	0	0	13011	2
2	0	2	0	0	13012	2
2	0	2	0	0	13013	2
2	0	2	0	0	13014	2
2	0	4	0	0	13015	2
2	0	2	0	0	13016	2
2	0	2	0	0	13017	2
2	0	4	0	0	13018	2
2	0	2	0	0	13019	2
2	0	2	0	0	13020	2
2	0	2	0	0	13021	2
2	0	2	0	0	13022	2
2	0	2	0	0	13023	2
2	0	2	0	0	13024	2
2	0	2	0	0	13025	2
2	0	2	0	0	13026	2
2	0	2	2	2	13027	2
2	0	2	0	0	13028	2
2	0	2	0	0	13029	2
2	0	2	0	0	13030	2
2	0	2	0	0	13031	2
2	0	2	0	0	13032	2
2	0	2	0	0	13033	2
2	0	2	0	0	13034	2
2	0	2	0	0	13035	2
2	0	2	0	0	13036	2
2	0	2	0	0	13037	2
2	0	2	0	0	13038	2
2	0	2	30	30	13039	2
2	0	2	1	1	13040	2
2	0	2	0	0	13041	2
2	1	2	1	2	13042	0
2	0	2	7	7	13043	2
2	0	2	0	0	13044	2
2	0	2	0	0	13045	2
2	0	2	0	0	13046	2
2	0	2	0	0	13047	2
2	0	2	0	0	13048	2
2	0	2	0	0	13049	2
2	0	2	0	0	13050	2
2	0	2	0	0	13051	2
2	0	2	0	0	13052	2
2	0	2	0	0	13053	2
2	0	2	0	0	13054	2
2	0	2	0	0	13055	2
2	0	2	0	0	13056	2
2	0	2	0	0	13057	2
2	0	2	0	0	13058	2
2	0	2	0	0	13059	2
2	0	2	0	0	13060	2
2	0	2	0	0	13061	2
2	0	2	0	0	13062	2
2	0	2	0	0	13063	2
2	0	2	0	0	13064	2
2	0	2	0	0	13065	2
2	0	2	0	0	13066	2
2	0	2	0	0	13067	2
2	13	2	0	13	13068	0
2	0	2	40	40	13069	2
2	0	2	4	4	13070	2
2	0	2	0	0	13071	2
2	3	2	1	4	13072	1
2	0	2	22	22	13073	2
2	0	2	0	0	13074	2
2	0	2	0	0	13075	2
2	0	2	0	0	13076	2
2	0	2	0	0	13077	2
2	0	2	0	0	13078	2
2	0	2	0	0	13079	2
2	0	2	0	0	13080	2
2	0	2	22	22	13081	2
2	0	2	0	0	13082	2
2	0	2	0	0	13083	2
2	0	2	1	1	13084	2
2	0	2	0	0	13085	2
2	0	2	0	0	13086	2
2	0	2	0	0	13087	2
2	0	2	0	0	13088	2
2	0	2	0	0	13089	2
2	0	2	0	0	13090	2
2	0	2	0	0	13091	2
2	0	2	0	0	13092	2
2	0	2	0	0	13093	2
2	0	2	0	0	13094	2
2	0	2	0	0	13095	2
2	0	2	0	0	13096	2
2	0	2	0	0	13097	2
2	4	2	0	4	13098	0
2	2	2	362	364	13099	1
2	1	2	0	1	13100	1
2	0	2	0	0	13101	2
2	0	2	1	1	13102	2
2	0	2	3	3	13103	2
2	0	2	166	166	13104	2
2	0	2	0	0	13105	2
2	0	2	0	0	13106	2
2	2	2	0	2	13107	0
2	0	2	13	13	13108	2
2	0	2	0	0	13109	2
2	0	2	0	0	13110	2
2	0	2	0	0	13111	2
2	0	2	0	0	13112	2
2	0	2	0	0	13113	2
2	0	2	0	0	13114	2
2	0	2	119	119	13115	2
2	0	2	2	2	13116	2
2	0	2	0	0	13117	2
2	0	2	1	1	13118	2
2	0	2	0	0	13119	2
2	0	2	0	0	13120	2
2	0	2	0	0	13121	2
2	0	2	0	0	13122	2
2	107	2	1	108	13123	0
2	15	2	1515	1530	13124	1
2	0	2	30	30	13125	2
2	0	2	4	4	13126	2
2	36	2	17	53	13127	0
2	0	2	287	287	13128	2
2	0	2	0	0	13129	2
2	0	2	0	0	13130	2
2	0	2	0	0	13131	2
0	1182	2	22	1204	13132	0
0	523	2	1	524	13133	0
2	0	2	0	0	13134	2
2	0	2	0	0	13135	2
2	0	2	0	0	13136	2
2	0	2	0	0	13137	2
2	0	2	0	0	13138	2
2	0	2	0	0	13139	2
2	5	2	189	194	13140	1
2	0	2	5	5	13141	2
2	0	2	1	1	13142	2
2	1	2	775	776	13143	1
2	12805	2	668	13473	13144	0
2	2	2	71	73	13145	1
2	7	2	775	782	13146	1
2	0	2	72	72	13147	2
2	0	2	1	1	13148	2
0	2327	2	13895	16222	13149	0
0	658	2	88	746	13150	0
2	0	2	0	0	13151	2
2	1	2	2	3	13152	1
2	0	2	0	0	13153	2
2	0	2	0	0	13154	2
2	0	2	0	0	13155	2
2	0	2	2	2	13156	2
2	43	2	0	43	13157	0
2	0	2	9	9	13158	2
2	0	2	1	1	13159	2
2	20	2	1	21	13160	0
2	0	2	73	73	13161	2
2	0	2	0	0	13162	2
2	3	2	0	3	13163	0
2	0	2	0	0	13164	2
2	0	2	0	0	13165	2
2	1	2	0	1	13166	0
2	0	2	0	0	13167	2
2	0	2	0	0	13168	2
2	0	2	0	0	13169	2
2	0	2	0	0	13170	2
2	0	2	0	0	13171	2
2	0	2	0	0	13172	2
2	0	0	1436	1436	13173	2
2	0	2	3	3	13174	2
2	0	2	0	0	13175	2
2	1	0	4335	4336	13176	0
2	0	2	2	2	13177	2
2	822	2	9	831	13178	0
2	1	2	56	57	13179	1
2	0	2	5	5	13180	2
2	54	2	0	54	13181	0
2	47	2	691	738	13182	1
2	0	2	16	16	13183	2
2	0	2	0	0	13184	2
2	32	2	24	56	13185	1
2	0	2	125	125	13186	2
2	0	2	0	0	13187	2
2	8	2	0	8	13188	0
2	0	2	135	135	13189	2
2	0	2	0	0	13190	2
2	0	2	7	7	13191	2
2	0	2	233	233	13192	2
2	36	2	0	36	13193	0
2	48	2	94	142	13194	1
2	0	2	9	9	13195	2
2	0	2	0	0	13196	2
2	29	2	0	29	13197	0
2	0	2	83	83	13198	2
2	0	2	0	0	13199	2
2	1	2	0	1	13200	0
2	0	2	0	0	13201	2
2	0	2	0	0	13202	2
2	0	2	0	0	13203	2
4	0	2	0	0	13204	2
4	0	2	0	0	13205	2
2	0	2	0	0	13206	2
2	0	2	1	1	13207	2
2	0	0	8	8	13208	2
2	0	2	0	0	13209	2
2	0	2	0	0	13210	2
2	0	0	2	2	13211	2
2	0	2	0	0	13212	2
2	0	2	0	0	13213	2
2	0	2	0	0	13214	2
2	0	4	10	10	13215	2
2	0	2	0	0	13216	2
2	0	2	0	0	13217	2
2	0	4	4	4	13218	2
2	0	2	1	1	13219	2
2	0	4	2	2	13220	2
2	0	2	0	0	13221	2
2	0	2	0	0	13222	2
2	0	4	2	2	13223	2
2	0	2	0	0	13224	2
2	37	2	1	38	13225	0
2	4	2	110	114	13226	1
2	0	2	32	32	13227	2
2	0	2	0	0	13228	2
2	34	2	6	40	13229	1
2	0	2	150	150	13230	2
2	0	2	0	0	13231	2
2	1	2	0	1	13232	1
2	0	2	0	0	13233	2
2	0	2	0	0	13234	2
2	0	2	0	0	13235	2
2	0	2	0	0	13236	2
2	48	2	0	48	13237	0
2	15	2	238	253	13238	1
2	0	2	1	1	13239	2
2	0	2	0	0	13240	2
2	15	2	0	15	13241	1
2	0	2	139	139	13242	2
2	0	2	0	0	13243	2
2	0	2	0	0	13244	2
2	0	2	0	0	13245	2
2	0	2	0	0	13246	2
2	0	2	0	0	13247	2
2	0	2	0	0	13248	2
2	0	2	0	0	13249	2
2	0	2	0	0	13250	2
2	0	2	0	0	13251	2
2	0	2	0	0	13252	2
2	0	2	0	0	13253	2
2	0	2	0	0	13254	2
2	1	2	0	1	13255	0
2	1	2	1	2	13256	1
2	0	2	5	5	13257	2
2	1	2	0	1	13258	0
2	2	2	21	23	13259	1
2	0	2	0	0	13260	2
2	0	2	0	0	13261	2
2	0	2	0	0	13262	2
2	0	4	0	0	13263	2
2	0	2	0	0	13264	2
2	0	2	0	0	13265	2
2	0	4	0	0	13266	2
2	0	2	0	0	13267	2
2	101	2	1	102	13268	0
2	0	2	0	0	13269	2
2	0	2	0	0	13270	2
2	0	2	0	0	13271	2
2	0	2	0	0	13272	2
2	0	2	0	0	13273	2
2	0	2	0	0	13274	2
2	8	2	1601	1609	13275	1
2	0	2	1	1	13276	2
2	0	2	0	0	13277	2
2	3	2	38	41	13278	0
2	0	2	0	0	13279	2
4	0	2	7	7	13280	2
2	0	2	0	0	13281	2
2	0	2	0	0	13282	2
2	0	2	0	0	13283	2
2	0	2	0	0	13284	2
2	0	2	0	0	13285	2
2	0	2	0	0	13286	2
2	0	2	0	0	13287	2
2	0	2	0	0	13288	2
2	0	2	0	0	13289	2
2	0	2	2	2	13290	2
2	0	2	0	0	13291	2
2	0	2	0	0	13292	2
2	0	2	0	0	13293	2
2	0	2	0	0	13294	2
2	0	2	0	0	13295	2
2	0	2	5	5	13296	2
2	0	2	0	0	13297	2
2	0	2	0	0	13298	2
2	0	2	0	0	13299	2
2	0	2	0	0	13300	2
2	2	4	2614	2616	13301	1
2	0	2	0	0	13302	2
2	0	2	0	0	13303	2
2	0	4	262	262	13304	2
2	0	2	3	3	13305	2
4	2	2	0	2	13306	0
2	0	2	1	1	13307	2
2	0	2	0	0	13308	2
2	0	2	0	0	13309	2
2	0	2	6	6	13310	2
2	0	2	0	0	13311	2
2	0	2	0	0	13312	2
0	0	0	1	1	13313	2
2	0	2	0	0	13314	2
2	0	2	0	0	13315	2
2	0	2	0	0	13316	2
2	0	2	0	0	13317	2
2	0	2	0	0	13318	2
2	0	2	1	1	13319	2
2	0	2	0	0	13320	2
2	0	2	0	0	13321	2
2	0	2	0	0	13322	2
2	0	2	0	0	13323	2
2	0	2	0	0	13324	2
2	0	2	0	0	13325	2
2	0	2	0	0	13326	2
2	0	2	0	0	13327	2
2	0	2	0	0	13328	2
2	0	2	0	0	13329	2
2	0	2	0	0	13330	2
2	0	2	0	0	13331	2
2	0	2	0	0	13332	2
2	0	2	0	0	13333	2
2	0	2	0	0	13334	2
2	0	2	0	0	13335	2
2	0	2	0	0	13336	2
2	9	2	0	9	13337	0
2	0	0	2156	2156	13338	2
2	0	2	0	0	13339	2
2	0	2	0	0	13340	2
2	0	0	831	831	13341	2
2	0	2	0	0	13342	2
2	0	2	0	0	13343	2
2	0	2	0	0	13344	2
2	0	2	0	0	13345	2
2	0	2	0	0	13346	2
2	0	2	0	0	13347	2
2	0	2	0	0	13348	2
2	0	2	0	0	13349	2
2	0	2	0	0	13350	2
2	0	2	0	0	13351	2
2	0	2	0	0	13352	2
2	0	2	0	0	13353	2
2	0	2	0	0	13354	2
2	0	2	19	19	13355	2
2	0	2	0	0	13356	2
2	0	2	0	0	13357	2
2	0	2	0	0	13358	2
2	0	2	0	0	13359	2
2	0	2	0	0	13360	2
2	0	2	0	0	13361	2
2	0	2	0	0	13362	2
2	0	2	0	0	13363	2
2	0	2	0	0	13364	2
2	0	2	0	0	13365	2
2	0	2	1	1	13366	2
2	0	2	0	0	13367	2
2	0	2	0	0	13368	2
2	0	4	7	7	13369	2
2	0	2	0	0	13370	2
2	0	2	0	0	13371	2
2	0	4	0	0	13372	2
2	0	2	0	0	13373	2
2	0	2	0	0	13374	2
2	0	4	0	0	13375	2
2	0	2	0	0	13376	2
2	3	4	1167	1170	13377	0
2	0	2	0	0	13378	2
2	0	2	0	0	13379	2
2	0	4	741	741	13380	2
2	0	2	2	2	13381	2
4	216	2	1	217	13382	0
2	1	2	0	1	13383	1
2	0	2	0	0	13384	2
2	0	2	0	0	13385	2
2	0	2	8	8	13386	2
2	0	2	0	0	13387	2
2	0	2	0	0	13388	2
2	0	2	0	0	13389	2
2	3	4	137	140	13390	1
2	0	2	0	0	13391	2
2	0	2	0	0	13392	2
2	0	4	24	24	13393	2
2	0	2	0	0	13394	2
2	0	2	0	0	13395	2
2	0	2	0	0	13396	2
2	0	2	0	0	13397	2
2	0	2	0	0	13398	2
2	0	2	0	0	13399	2
2	0	2	0	0	13400	2
0	409	4	4081	4490	13401	1
2	0	2	0	0	13402	2
2	0	2	0	0	13403	2
2	0	2	0	0	13404	2
2	0	2	0	0	13405	2
2	0	2	0	0	13406	2
2	0	2	0	0	13407	2
2	0	2	0	0	13408	2
2	0	2	0	0	13409	2
2	0	2	0	0	13410	2
2	0	4	11	11	13411	2
2	0	2	0	0	13412	2
2	0	2	0	0	13413	2
2	0	4	2	2	13414	2
2	0	2	0	0	13415	2
2	0	2	0	0	13416	2
2	0	2	0	0	13417	2
2	0	2	0	0	13418	2
2	0	2	0	0	13419	2
2	0	2	0	0	13420	2
2	0	2	0	0	13421	2
2	0	2	0	0	13422	2
2	0	2	0	0	13423	2
2	0	2	0	0	13424	2
2	0	2	0	0	13425	2
2	0	2	0	0	13426	2
2	0	2	0	0	13427	2
2	0	2	0	0	13428	2
2	0	2	0	0	13429	2
2	0	2	0	0	13430	2
2	0	2	0	0	13431	2
2	0	2	0	0	13432	2
2	0	2	0	0	13433	2
2	0	2	0	0	13434	2
2	0	2	0	0	13435	2
2	0	2	1	1	13436	2
2	0	2	0	0	13437	2
2	0	2	0	0	13438	2
2	0	2	0	0	13439	2
2	0	2	0	0	13440	2
2	0	2	0	0	13441	2
2	0	2	0	0	13442	2
2	0	2	0	0	13443	2
2	0	2	7	7	13444	2
2	5	2	0	5	13445	0
2	20	4	2071	2091	13446	1
2	0	2	0	0	13447	2
2	0	2	0	0	13448	2
0	26	2	8	34	13449	0
0	42	2	0	42	13450	0
2	2	4	331	333	13451	1
2	0	2	5	5	13452	2
2	0	2	0	0	13453	2
2	0	2	0	0	13454	2
2	0	2	0	0	13455	2
2	0	2	0	0	13456	2
2	0	2	0	0	13457	2
2	0	2	0	0	13458	2
2	0	2	0	0	13459	2
2	0	2	0	0	13460	2
2	0	2	0	0	13461	2
2	0	2	0	0	13462	2
2	0	2	0	0	13463	2
2	0	2	0	0	13464	2
2	0	2	1	1	13465	2
2	0	2	0	0	13466	2
2	0	2	4	4	13467	2
2	0	2	0	0	13468	2
2	0	2	0	0	13469	2
2	0	2	0	0	13470	2
2	0	2	0	0	13471	2
2	0	2	0	0	13472	2
2	0	2	0	0	13473	2
2	0	2	0	0	13474	2
2	0	2	0	0	13475	2
2	64	2	0	64	13476	0
2	0	2	0	0	13477	2
2	0	2	0	0	13478	2
2	0	2	0	0	13479	2
2	0	2	0	0	13480	2
2	0	2	0	0	13481	2
2	0	2	0	0	13482	2
2	0	2	31	31	13483	2
2	0	2	0	0	13484	2
2	1	2	0	1	13485	0
2	0	2	39	39	13486	2
2	0	2	0	0	13487	2
2	0	2	0	0	13488	2
2	0	2	0	0	13489	2
2	0	2	2	2	13490	2
2	0	2	0	0	13491	2
2	0	2	0	0	13492	2
2	0	2	0	0	13493	2
2	0	2	0	0	13494	2
2	0	2	0	0	13495	2
2	0	2	0	0	13496	2
2	72	4	1	73	13497	0
2	0	2	407	407	13498	2
2	25	2	0	25	13499	0
2	0	2	396	396	13500	2
2	1	2	0	1	13501	0
2	0	2	1	1	13502	2
2	0	2	0	0	13503	2
2	0	2	0	0	13504	2
2	0	2	0	0	13505	2
2	0	2	0	0	13506	2
2	0	2	0	0	13507	2
2	0	2	0	0	13508	2
2	0	2	0	0	13509	2
2	0	2	0	0	13510	2
2	0	2	0	0	13511	2
2	0	2	0	0	13512	2
2	0	2	0	0	13513	2
2	0	2	0	0	13514	2
2	0	2	0	0	13515	2
2	0	2	0	0	13516	2
2	0	2	0	0	13517	2
2	0	2	0	0	13518	2
2	1	2	0	1	13519	0
2	2	2	49	51	13520	1
2	0	2	0	0	13521	2
2	0	2	0	0	13522	2
2	4	2	0	4	13523	1
2	0	2	6	6	13524	2
2	0	2	72	72	13525	2
2	1	2	0	1	13526	0
2	0	2	8	8	13527	2
2	0	2	0	0	13528	2
2	0	2	0	0	13529	2
2	0	2	0	0	13530	2
2	0	2	0	0	13531	2
2	0	2	0	0	13532	2
2	0	2	0	0	13533	2
2	0	2	0	0	13534	2
2	0	2	0	0	13535	2
2	0	2	0	0	13536	2
2	0	2	0	0	13537	2
2	0	2	0	0	13538	2
2	0	2	0	0	13539	2
2	0	2	0	0	13540	2
2	0	2	0	0	13541	2
2	0	2	0	0	13542	2
2	0	2	0	0	13543	2
2	0	2	0	0	13544	2
2	0	2	0	0	13545	2
2	0	2	0	0	13546	2
2	0	2	0	0	13547	2
2	0	2	0	0	13548	2
2	0	0	0	0	13549	2
2	0	2	0	0	13550	2
2	0	2	0	0	13551	2
2	0	0	0	0	13552	2
2	0	2	0	0	13553	2
2	0	2	0	0	13554	2
2	0	2	2	2	13555	2
2	0	2	0	0	13556	2
2	0	2	4	4	13557	2
2	0	2	0	0	13558	2
2	0	2	0	0	13559	2
0	56	0	31	87	13560	0
2	0	2	0	0	13561	2
2	0	2	0	0	13562	2
2	0	2	0	0	13563	2
2	0	2	0	0	13564	2
2	0	2	0	0	13565	2
2	0	2	0	0	13566	2
2	0	2	0	0	13567	2
2	0	2	0	0	13568	2
2	0	2	0	0	13569	2
2	0	2	0	0	13570	2
2	0	2	0	0	13571	2
2	0	2	0	0	13572	2
2	0	2	1	1	13573	2
2	0	2	0	0	13574	2
2	0	2	0	0	13575	2
2	0	2	0	0	13576	2
2	0	2	0	0	13577	2
2	0	2	0	0	13578	2
2	0	2	0	0	13579	2
2	0	2	0	0	13580	2
2	0	4	18	18	13581	2
2	0	2	0	0	13582	2
2	0	2	0	0	13583	2
2	0	4	4	4	13584	2
2	0	2	0	0	13585	2
2	372	2	3	375	13586	0
2	0	2	0	0	13587	2
2	0	2	0	0	13588	2
2	3	2	0	3	13589	0
2	0	2	0	0	13590	2
2	0	2	0	0	13591	2
2	0	2	0	0	13592	2
2	0	2	0	0	13593	2
2	0	2	0	0	13594	2
2	0	2	0	0	13595	2
2	0	2	0	0	13596	2
2	0	2	0	0	13597	2
2	0	2	0	0	13598	2
2	0	2	0	0	13599	2
2	0	2	0	0	13600	2
2	0	2	0	0	13601	2
2	0	2	0	0	13602	2
2	0	2	0	0	13603	2
0	0	4	2	2	13604	2
2	31	4	10741	10772	13605	1
2	0	2	0	0	13606	2
2	0	2	0	0	13607	2
2	7	4	1475	1482	13608	0
2	0	2	913	913	13609	2
0	432	4	10043	10475	13610	0
2	0	2	0	0	13611	2
2	0	2	0	0	13612	2
2	0	2	0	0	13613	2
4	8	4	2	10	13614	1
2	1	2	0	1	13615	0
2	0	2	33	33	13616	2
2	0	2	0	0	13617	2
2	0	2	0	0	13618	2
2	1	2	0	1	13619	1
2	0	2	3	3	13620	2
2	0	2	0	0	13621	2
2	0	4	0	0	13622	2
2	0	2	0	0	13623	2
2	0	2	0	0	13624	2
2	0	4	0	0	13625	2
2	0	2	0	0	13626	2
2	0	2	0	0	13627	2
2	0	2	0	0	13628	2
2	0	2	0	0	13629	2
2	0	2	0	0	13630	2
2	0	2	0	0	13631	2
2	0	2	0	0	13632	2
2	0	2	0	0	13633	2
2	0	2	0	0	13634	2
2	0	2	0	0	13635	2
2	0	2	0	0	13636	2
2	0	2	0	0	13637	2
2	0	2	0	0	13638	2
2	0	0	155	155	13639	2
2	0	2	0	0	13640	2
2	0	2	0	0	13641	2
2	0	4	120	120	13642	2
2	0	2	2	2	13643	2
4	959	2	3	962	13644	0
2	0	2	0	0	13645	2
2	4	2	0	4	13646	1
2	0	2	0	0	13647	2
2	0	2	0	0	13648	2
2	0	2	1038	1038	13649	2
2	0	2	2	2	13650	2
2	0	2	0	0	13651	2
2	0	2	0	0	13652	2
2	0	4	725	725	13653	2
2	0	2	0	0	13654	2
2	0	2	0	0	13655	2
2	0	4	508	508	13656	2
2	0	2	0	0	13657	2
4	15	2	0	15	13658	0
2	0	2	0	0	13659	2
2	0	2	0	0	13660	2
2	0	2	0	0	13661	2
2	0	2	0	0	13662	2
2	0	2	0	0	13663	2
2	0	2	0	0	13664	2
2	0	2	0	0	13665	2
2	0	2	0	0	13666	2
2	0	2	0	0	13667	2
2	0	2	0	0	13668	2
2	0	2	1	1	13669	2
2	0	2	590	590	13670	2
2	0	2	0	0	13671	2
2	0	2	0	0	13672	2
2	0	2	0	0	13673	2
2	0	2	0	0	13674	2
2	0	2	0	0	13675	2
2	0	2	0	0	13676	2
2	0	2	0	0	13677	2
2	0	2	0	0	13678	2
2	0	2	0	0	13679	2
2	0	2	0	0	13680	2
2	0	2	0	0	13681	2
2	0	2	0	0	13682	2
4	0	2	0	0	13683	2
4	0	2	0	0	13684	2
2	1240	2	4	1244	13685	0
2	0	2	0	0	13686	2
2	0	2	0	0	13687	2
2	0	2	0	0	13688	2
2	0	2	0	0	13689	2
2	0	2	0	0	13690	2
2	0	2	0	0	13691	2
2	0	2	0	0	13692	2
2	0	2	0	0	13693	2
2	0	2	0	0	13694	2
2	0	2	0	0	13695	2
2	0	2	0	0	13696	2
2	0	2	0	0	13697	2
2	47	2	6	53	13698	0
2	0	2	399	399	13699	2
2	0	2	9	9	13700	2
2	0	2	0	0	13701	2
2	29	4	6	35	13702	0
2	0	2	191	191	13703	2
2	0	2	0	0	13704	2
2	0	2	0	0	13705	2
2	0	2	0	0	13706	2
2	0	2	0	0	13707	2
2	0	2	0	0	13708	2
2	0	2	0	0	13709	2
2	25	2	2	27	13710	0
2	21	4	679	700	13711	0
2	1	2	11	12	13712	1
2	0	2	1	1	13713	2
2	26	4	55	81	13714	0
2	0	2	36	36	13715	2
2	0	2	0	0	13716	2
2	0	4	7	7	13717	2
2	0	2	0	0	13718	2
2	0	2	0	0	13719	2
2	0	4	0	0	13720	2
2	0	2	0	0	13721	2
2	0	2	0	0	13722	2
2	0	2	0	0	13723	2
2	0	2	0	0	13724	2
2	0	2	0	0	13725	2
2	0	2	0	0	13726	2
2	0	2	0	0	13727	2
2	0	2	0	0	13728	2
2	0	2	0	0	13729	2
2	0	2	0	0	13730	2
2	0	2	0	0	13731	2
4	0	2	1	1	13732	2
4	0	2	1	1	13733	2
4	0	2	1	1	13734	2
2	0	2	1	1	13735	2
2	0	2	0	0	13736	2
4	0	2	0	0	13737	2
2	0	2	0	0	13738	2
2	0	0	1	1	13739	2
2	0	2	0	0	13740	2
2	0	2	0	0	13741	2
2	0	0	0	0	13742	2
4	1	4	474	475	13743	0
2	1	2	24	25	13744	0
2	0	2	1	1	13745	2
2	0	2	0	0	13746	2
2	0	2	0	0	13747	2
2	0	2	0	0	13748	2
2	0	2	0	0	13749	2
2	0	2	0	0	13750	2
2	0	2	0	0	13751	2
2	0	2	0	0	13752	2
2	0	2	0	0	13753	2
2	0	2	0	0	13754	2
2	0	2	0	0	13755	2
2	0	2	0	0	13756	2
2	0	2	0	0	13757	2
2	0	2	0	0	13758	2
2	0	4	407	407	13759	2
2	0	2	0	0	13760	2
2	0	2	0	0	13761	2
2	0	4	220	220	13762	2
2	0	2	0	0	13763	2
4	1	2	0	1	13764	0
0	0	4	1	1	13765	2
0	0	4	1	1	13766	2
2	12	2	1	13	13767	0
2	15	2	3465	3480	13768	1
2	21	2	352	373	13769	1
2	0	2	9	9	13770	2
2	0	2	1	1	13771	2
2	15	2	4	19	13772	0
2	0	2	20	20	13773	2
2	422	2	7183	7605	13774	1
2	1	2	151	152	13775	1
2	0	2	31	31	13776	2
2	196	2	34	230	13777	0
2	0	2	22	22	13778	2
2	2	2	0	2	13779	0
2	0	2	0	0	13780	2
2	0	2	0	0	13781	2
2	0	2	0	0	13782	2
2	0	2	0	0	13783	2
2	0	2	0	0	13784	2
2	0	2	0	0	13785	2
2	0	2	0	0	13786	2
2	0	2	0	0	13787	2
2	0	2	0	0	13788	2
2	0	2	0	0	13789	2
2	0	2	0	0	13790	2
2	0	2	0	0	13791	2
2	50	2	3	53	13792	0
2	53	4	6265	6318	13793	1
2	0	2	18	18	13794	2
2	0	2	3	3	13795	2
2	37	4	1007	1044	13796	1
2	0	2	170	170	13797	2
2	2	2	0	2	13798	0
2	2	2	32	34	13799	1
2	0	2	0	0	13800	2
2	0	2	0	0	13801	2
2	1	2	0	1	13802	1
2	0	2	7	7	13803	2
2	0	2	0	0	13804	2
2	0	2	0	0	13805	2
2	0	2	0	0	13806	2
2	0	2	0	0	13807	2
2	0	2	0	0	13808	2
2	0	2	0	0	13809	2
2	0	2	0	0	13810	2
2	0	2	0	0	13811	2
2	0	2	0	0	13812	2
2	0	2	0	0	13813	2
2	0	2	0	0	13814	2
2	0	2	0	0	13815	2
2	0	2	0	0	13816	2
2	0	4	217	217	13817	2
2	0	2	0	0	13818	2
2	0	2	0	0	13819	2
2	0	4	0	0	13820	2
2	0	2	0	0	13821	2
2	0	2	0	0	13822	2
2	0	4	5	5	13823	2
2	0	2	0	0	13824	2
2	0	2	0	0	13825	2
2	0	4	0	0	13826	2
2	0	2	0	0	13827	2
4	12	2	0	12	13828	0
2	0	2	0	0	13829	2
2	0	4	1	1	13830	2
2	0	2	0	0	13831	2
2	0	2	0	0	13832	2
2	0	2	0	0	13833	2
2	3	2	0	3	13834	0
2	3	2	52	55	13835	1
2	0	2	0	0	13836	2
2	0	2	0	0	13837	2
2	0	2	0	0	13838	2
2	0	2	5	5	13839	2
2	0	2	0	0	13840	2
2	0	2	0	0	13841	2
2	1	2	0	1	13842	1
2	0	2	0	0	13843	2
2	0	2	0	0	13844	2
2	0	2	0	0	13845	2
2	0	2	0	0	13846	2
2	0	4	1688	1688	13847	2
2	0	2	0	0	13848	2
2	0	2	0	0	13849	2
2	0	2	815	815	13850	2
2	0	2	3	3	13851	2
4	12	4	1	13	13852	1
4	0	4	0	0	13853	2
2	12	2	0	12	13854	0
2	65	2	500	565	13855	1
2	0	2	7	7	13856	2
2	0	2	0	0	13857	2
2	0	2	0	0	13858	2
2	0	2	0	0	13859	2
2	0	2	0	0	13860	2
2	0	2	0	0	13861	2
2	0	2	0	0	13862	2
2	0	2	0	0	13863	2
2	19	2	14	33	13864	1
2	0	2	59	59	13865	2
2	0	2	0	0	13866	2
2	0	2	1	1	13867	2
2	0	2	0	0	13868	2
2	0	2	0	0	13869	2
2	0	2	0	0	13870	2
2	0	2	10	10	13871	2
2	18	4	1124	1142	13872	1
2	0	2	1	1	13873	2
2	0	2	0	0	13874	2
2	1	4	343	344	13875	1
2	0	2	0	0	13876	2
2	0	2	0	0	13877	2
2	0	2	0	0	13878	2
2	0	2	0	0	13879	2
2	0	2	0	0	13880	2
2	0	2	0	0	13881	2
2	0	2	0	0	13882	2
2	0	2	0	0	13883	2
2	0	4	71	71	13884	2
2	0	2	0	0	13885	2
2	0	2	0	0	13886	2
2	0	4	0	0	13887	2
2	0	2	0	0	13888	2
0	1	4	31	32	13889	1
2	0	2	0	0	13890	2
2	0	2	0	0	13891	2
2	0	2	0	0	13892	2
2	0	2	0	0	13893	2
2	0	2	0	0	13894	2
2	0	2	0	0	13895	2
2	0	2	0	0	13896	2
2	0	2	4	4	13897	2
2	0	2	0	0	13898	2
2	0	2	0	0	13899	2
2	0	2	1	1	13900	2
2	0	2	0	0	13901	2
4	129	2	0	129	13902	0
4	30	2	1	31	13903	0
2	0	2	0	0	13904	2
2	0	2	0	0	13905	2
2	0	2	0	0	13906	2
2	0	2	0	0	13907	2
2	0	2	0	0	13908	2
2	0	2	0	0	13909	2
2	0	4	54	54	13910	2
2	2	2	0	2	13911	0
2	0	2	1	1	13912	2
2	0	2	0	0	13913	2
2	0	2	0	0	13914	2
2	0	2	0	0	13915	2
2	0	2	1	1	13916	2
2	0	2	0	0	13917	2
2	0	2	0	0	13918	2
2	0	2	0	0	13919	2
2	0	2	0	0	13920	2
2	0	2	0	0	13921	2
2	0	2	0	0	13922	2
2	0	2	0	0	13923	2
2	0	2	0	0	13924	2
2	0	2	1	1	13925	2
2	0	2	0	0	13926	2
2	0	2	0	0	13927	2
2	0	2	0	0	13928	2
2	0	2	0	0	13929	2
2	0	2	0	0	13930	2
2	0	2	0	0	13931	2
2	0	2	0	0	13932	2
2	0	2	0	0	13933	2
2	0	2	1	1	13934	2
2	0	2	0	0	13935	2
2	0	4	1	1	13936	2
4	2300	4	60	2360	13937	1
4	927	4	15	942	13938	1
2	161	2	6402	6563	13939	1
2	0	2	267	267	13940	2
2	0	2	6402	6402	13941	2
2	0	2	267	267	13942	2
4	0	4	36	36	13943	2
4	0	4	2	2	13944	2
0	2699	2	11	2710	13945	0
0	5230	2	500	5730	13946	0
0	4565	2	14	4579	13947	0
4	1	4	0	1	13948	1
4	0	4	0	0	13949	2
0	0	4	5	5	13950	2
0	0	4	5	5	13951	2
2	0	2	0	0	13952	2
2	0	2	0	0	13953	2
2	0	2	0	0	13954	2
2	0	2	0	0	13955	2
2	0	2	1	1	13956	2
2	0	2	0	0	13957	2
4	0	4	1	1	13958	2
4	0	4	0	0	13959	2
0	480	4	2776	3256	13960	0
2	0	2	0	0	13961	2
2	0	2	0	0	13962	2
2	0	2	0	0	13963	2
2	0	2	0	0	13964	2
2	0	2	0	0	13965	2
2	0	2	0	0	13966	2
2	0	2	0	0	13967	2
2	0	4	42	42	13968	2
2	0	2	0	0	13969	2
2	0	2	0	0	13970	2
2	0	2	0	0	13971	2
2	0	2	0	0	13972	2
2	0	2	0	0	13973	2
2	0	2	1	1	13974	2
2	0	2	0	0	13975	2
2	0	2	0	0	13976	2
2	0	2	0	0	13977	2
2	0	2	0	0	13978	2
2	0	2	0	0	13979	2
2	0	2	0	0	13980	2
2	0	2	0	0	13981	2
2	0	2	0	0	13982	2
0	0	4	0	0	13983	2
2	28	2	2	30	13984	0
2	2	2	163	165	13985	1
2	0	2	15	15	13986	2
2	0	2	0	0	13987	2
2	13	2	7	20	13988	1
2	0	2	39	39	13989	2
2	4	2	0	4	13990	0
2	0	2	0	0	13991	2
2	0	2	0	0	13992	2
2	0	2	0	0	13993	2
2	0	2	0	0	13994	2
2	0	2	0	0	13995	2
2	0	2	0	0	13996	2
2	1	4	1186	1187	13997	1
2	0	2	4	4	13998	2
2	0	2	0	0	13999	2
2	4	4	117	121	14000	0
2	0	2	7	7	14001	2
2	0	2	0	0	14002	2
2	0	4	57	57	14003	2
2	0	2	0	0	14004	2
2	0	2	0	0	14005	2
2	0	4	11	11	14006	2
2	0	2	0	0	14007	2
2	0	2	0	0	14008	2
2	0	2	0	0	14009	2
2	0	2	0	0	14010	2
2	0	2	0	0	14011	2
2	0	2	0	0	14012	2
2	0	2	0	0	14013	2
2	0	2	0	0	14014	2
2	0	2	51	51	14015	2
2	0	2	0	0	14016	2
2	0	2	0	0	14017	2
2	0	2	24	24	14018	2
2	0	2	0	0	14019	2
2	0	2	0	0	14020	2
2	0	2	0	0	14021	2
2	0	2	0	0	14022	2
2	0	2	0	0	14023	2
2	0	2	0	0	14024	2
2	0	2	0	0	14025	2
2	0	2	0	0	14026	2
2	0	2	0	0	14027	2
2	0	2	0	0	14028	2
2	0	2	0	0	14029	2
2	0	2	0	0	14030	2
2	0	2	0	0	14031	2
2	0	2	0	0	14032	2
2	0	2	0	0	14033	2
2	0	2	0	0	14034	2
2	0	2	0	0	14035	2
2	0	2	0	0	14036	2
2	0	2	0	0	14037	2
2	0	2	0	0	14038	2
0	0	4	91	91	14039	2
0	0	4	4	4	14040	2
2	39	2	0	39	14041	0
2	31	2	102	133	14042	1
2	0	2	4	4	14043	2
2	0	2	0	0	14044	2
2	4	2	0	4	14045	0
2	0	2	47	47	14046	2
2	0	2	0	0	14047	2
2	0	2	0	0	14048	2
2	0	2	0	0	14049	2
2	0	2	0	0	14050	2
2	0	2	0	0	14051	2
2	0	2	0	0	14052	2
2	0	2	0	0	14053	2
2	0	2	4	4	14054	2
2	0	2	0	0	14055	2
2	0	2	0	0	14056	2
2	0	2	0	0	14057	2
2	0	2	1	1	14058	2
2	6	2	0	6	14059	0
2	12	4	2821	2833	14060	1
2	0	2	3	3	14061	2
2	0	2	1	1	14062	2
2	4	4	82	86	14063	0
2	0	2	10	10	14064	2
2	0	2	0	0	14065	2
2	9	4	120	129	14066	1
2	0	2	0	0	14067	2
2	0	2	0	0	14068	2
2	0	4	1	1	14069	2
2	0	2	1	1	14070	2
2	0	2	0	0	14071	2
2	0	2	0	0	14072	2
2	0	2	0	0	14073	2
2	0	2	0	0	14074	2
2	0	2	0	0	14075	2
2	0	2	0	0	14076	2
2	0	2	1	1	14077	2
2	0	2	0	0	14078	2
2	0	2	0	0	14079	2
2	0	2	0	0	14080	2
2	0	2	0	0	14081	2
2	0	4	39	39	14082	2
2	0	2	0	0	14083	2
2	22	2	0	22	14084	0
2	7	4	18	25	14085	1
2	0	2	0	0	14086	2
2	20	4	1490	1510	14087	1
2	0	2	0	0	14088	2
2	0	2	0	0	14089	2
2	3	4	694	697	14090	0
2	0	2	22	22	14091	2
2	0	2	0	0	14092	2
2	1	2	0	1	14093	1
2	0	2	0	0	14094	2
2	0	2	0	0	14095	2
2	0	2	0	0	14096	2
2	0	2	0	0	14097	2
2	0	2	0	0	14098	2
2	0	2	0	0	14099	2
2	0	2	0	0	14100	2
2	0	2	0	0	14101	2
2	0	2	0	0	14102	2
2	0	2	0	0	14103	2
2	0	2	0	0	14104	2
2	0	0	2	2	14105	2
2	0	2	0	0	14106	2
2	0	2	0	0	14107	2
2	0	0	5	5	14108	2
2	0	2	0	0	14109	2
2	4	4	3178	3182	14110	1
2	0	2	7	7	14111	2
2	0	2	0	0	14112	2
2	4	4	574	578	14113	0
2	0	2	35	35	14114	2
0	22	4	2	24	14115	0
2	2	2	0	2	14116	0
2	0	2	0	0	14117	2
2	0	2	33	33	14118	2
2	0	2	0	0	14119	2
2	0	2	0	0	14120	2
2	1	2	0	1	14121	1
2	0	2	0	0	14122	2
2	0	4	27	27	14123	2
2	0	2	1	1	14124	2
2	0	2	0	0	14125	2
2	0	2	0	0	14126	2
2	0	2	0	0	14127	2
2	0	0	31	31	14128	2
0	4	2	0	4	14129	0
4	0	2	16	16	14130	2
4	3	2	0	3	14131	0
4	3	2	0	3	14132	0
4	0	2	144	144	14133	2
4	0	2	6	6	14134	2
0	3	2	0	3	14135	0
4	3001	2	3	3004	14136	0
4	13	2	0	13	14137	0
4	0	2	0	0	14138	2
4	1	4	18	19	14139	1
4	0	4	1	1	14140	2
4	275	2	262	537	14141	0
4	202	4	995	1197	14142	1
4	0	2	1294	1294	14143	2
4	0	4	8	8	14144	2
4	1	4	6	7	14145	0
2	1	2	0	1	14146	0
2	1	2	0	1	14147	0
2	0	2	0	0	14148	2
0	31	2	2	33	14149	0
4	0	2	0	0	14150	2
4	0	2	0	0	14151	2
4	7618	2	1201	8819	14152	0
4	2182	2	14	2196	14153	0
4	7	4	450	457	14154	1
4	1	4	13	14	14155	1
0	395	2	6	401	14156	0
0	121	2	4	125	14157	0
4	105	2	0	105	14158	0
4	0	4	3	3	14159	2
4	0	2	0	0	14160	2
4	0	2	11	11	14161	2
4	0	2	0	0	14162	2
4	0	4	2	2	14163	2
4	0	4	0	0	14164	2
4	24	2	0	24	14165	0
4	4	2	0	4	14166	0
4	371	4	7	378	14167	0
4	1	0	0	1	14168	1
4	87	4	75	162	14169	0
4	2	4	1449	1451	14170	1
4	133	2	1	134	14171	0
4	425	4	201	626	14172	1
4	90	4	3	93	14173	1
4	4344	2	1601	5945	14174	0
4	2141	2	38	2179	14175	0
4	40	2	5	45	14176	0
4	2	2	0	2	14177	0
4	0	4	2	2	14178	2
4	3	4	63	66	14179	1
4	0	4	7	7	14180	2
4	54	1	481264	481318	14181	0
4	1	4	5	6	14182	0
4	0	4	11975	11975	14183	2
4	0	4	1693	1693	14184	2
4	13	4	62	75	14185	1
4	0	4	31	31	14186	2
4	3	4	2386	2389	14187	1
0	170	2	2	172	14188	0
0	180	2	0	180	14189	1
0	61	2	1	62	14190	0
4	11	4	2	13	14191	0
0	13	4	900	913	14192	0
2	0	2	0	0	14193	2
2	0	4	0	0	14194	2
2	0	2	0	0	14195	2
2	0	2	0	0	14196	2
2	0	4	0	0	14197	2
2	0	2	0	0	14198	2
2	0	2	0	0	14199	2
2	0	4	29	29	14200	2
2	0	2	0	0	14201	2
2	0	2	0	0	14202	2
2	0	4	401	401	14203	2
2	0	4	19	19	14204	2
2	1	2	114	115	14205	1
4	0	2	0	0	14206	2
2	0	2	0	0	14207	2
2	0	4	0	0	14208	2
2	0	2	0	0	14209	2
2	0	2	0	0	14210	2
2	0	4	1	1	14211	2
2	0	2	0	0	14212	2
2	0	2	0	0	14213	2
2	0	2	0	0	14214	2
2	0	2	0	0	14215	2
2	0	2	0	0	14216	2
2	0	2	0	0	14217	2
2	0	2	0	0	14218	2
2	0	2	0	0	14219	2
2	0	2	0	0	14220	2
2	0	2	1	1	14221	2
2	0	2	0	0	14222	2
2	0	2	0	0	14223	2
2	0	2	0	0	14224	2
2	0	2	0	0	14225	2
2	1	2	0	1	14226	1
2	0	2	0	0	14227	2
2	0	2	0	0	14228	2
2	0	2	0	0	14229	2
2	0	2	0	0	14230	2
4	2	4	1031	1033	14231	0
4	1	4	26	27	14232	0
2	0	2	0	0	14233	2
2	0	2	0	0	14234	2
2	0	2	0	0	14235	2
2	0	2	0	0	14236	2
2	0	2	0	0	14237	2
2	0	2	0	0	14238	2
2	0	2	0	0	14239	2
2	1	4	887	888	14240	0
2	0	2	0	0	14241	2
2	0	2	0	0	14242	2
2	0	4	226	226	14243	2
2	0	2	5	5	14244	2
2	20	2	0	20	14245	0
2	13	2	176	189	14246	1
2	0	2	2	2	14247	2
2	0	2	0	0	14248	2
2	12	2	2	14	14249	0
2	3	2	32	35	14250	1
2	0	2	0	0	14251	2
2	0	2	0	0	14252	2
2	0	2	0	0	14253	2
2	0	2	0	0	14254	2
2	0	2	0	0	14255	2
2	0	2	0	0	14256	2
2	0	2	0	0	14257	2
2	0	2	1	1	14258	2
2	0	2	0	0	14259	2
2	0	2	0	0	14260	2
2	0	2	1	1	14261	2
2	0	2	0	0	14262	2
0	0	0	2371	2371	14263	2
2	1	2	43	44	14264	1
2	0	2	0	0	14265	2
2	1	4	13511	13512	14266	1
2	0	2	0	0	14267	2
2	0	2	0	0	14268	2
2	0	4	2165	2165	14269	2
2	1	2	43	44	14270	1
2	0	2	0	0	14271	2
2	0	4	15	15	14272	2
2	0	2	0	0	14273	2
2	0	2	0	0	14274	2
2	0	2	0	0	14275	2
2	0	2	0	0	14276	2
2	4	2	13	17	14277	1
2	0	2	0	0	14278	2
2	0	2	0	0	14279	2
2	0	2	0	0	14280	2
2	0	2	0	0	14281	2
2	0	2	0	0	14282	2
2	0	2	0	0	14283	2
2	0	2	0	0	14284	2
2	0	2	0	0	14285	2
2	0	2	0	0	14286	2
2	0	2	0	0	14287	2
2	0	2	0	0	14288	2
2	0	2	3	3	14289	2
2	0	2	0	0	14290	2
2	0	2	0	0	14291	2
2	0	2	0	0	14292	2
2	0	2	0	0	14293	2
2	0	2	0	0	14294	2
2	0	2	1	1	14295	2
2	0	2	0	0	14296	2
2	0	2	0	0	14297	2
2	0	2	0	0	14298	2
2	0	2	0	0	14299	2
2	0	2	0	0	14300	2
2	0	2	0	0	14301	2
2	0	2	0	0	14302	2
2	0	2	0	0	14303	2
2	0	2	0	0	14304	2
2	0	2	0	0	14305	2
2	16	2	5185	5201	14306	1
2	63	2	3	66	14307	0
2	0	2	289	289	14308	2
2	0	2	0	0	14309	2
2	0	2	0	0	14310	2
2	0	2	0	0	14311	2
2	0	2	0	0	14312	2
2	0	2	0	0	14313	2
2	0	2	0	0	14314	2
2	0	2	0	0	14315	2
2	0	2	0	0	14316	2
2	0	2	0	0	14317	2
2	5	2	0	5	14318	0
2	10	2	27	37	14319	1
2	0	2	1	1	14320	2
2	0	2	0	0	14321	2
2	1	2	0	1	14322	1
2	0	2	1	1	14323	2
2	1	2	0	1	14324	0
2	90	2	27	117	14325	1
2	0	2	0	0	14326	2
2	0	2	0	0	14327	2
2	0	2	0	0	14328	2
2	0	2	0	0	14329	2
2	6	2	0	6	14330	0
2	0	2	20	20	14331	2
2	1	2	0	1	14332	0
2	0	2	0	0	14333	2
2	0	2	0	0	14334	2
2	0	2	0	0	14335	2
2	0	2	0	0	14336	2
2	0	2	0	0	14337	2
2	0	2	0	0	14338	2
2	0	2	1	1	14339	2
2	0	2	0	0	14340	2
2	0	2	0	0	14341	2
2	0	2	0	0	14342	2
2	0	2	0	0	14343	2
2	0	2	0	0	14344	2
2	0	2	0	0	14345	2
2	0	2	0	0	14346	2
2	0	2	0	0	14347	2
2	0	2	0	0	14348	2
2	0	2	0	0	14349	2
2	0	2	0	0	14350	2
2	0	2	0	0	14351	2
2	0	2	0	0	14352	2
2	0	2	0	0	14353	2
2	2	2	27	29	14354	1
2	0	2	1	1	14355	2
2	0	2	0	0	14356	2
2	0	2	1	1	14357	2
2	0	2	4	4	14358	2
2	0	2	0	0	14359	2
2	1	2	0	1	14360	0
2	2	2	4	6	14361	1
2	0	2	0	0	14362	2
2	0	2	0	0	14363	2
2	1	2	1	2	14364	1
2	0	2	1	1	14365	2
2	0	2	0	0	14366	2
2	0	2	0	0	14367	2
2	0	2	0	0	14368	2
2	0	2	0	0	14369	2
2	0	2	0	0	14370	2
2	0	2	0	0	14371	2
2	0	2	0	0	14372	2
2	0	2	0	0	14373	2
2	0	2	135	135	14374	2
2	16	2	166	182	14375	0
2	0	2	0	0	14376	2
2	0	2	15	15	14377	2
2	0	2	0	0	14378	2
2	0	2	2	2	14379	2
2	0	2	0	0	14380	2
2	0	2	0	0	14381	2
2	0	2	1	1	14382	2
2	0	2	0	0	14383	2
2	489	2	7	496	14384	0
2	2	2	112	114	14385	1
2	0	2	4	4	14386	2
2	0	2	0	0	14387	2
2	1	2	3	4	14388	1
2	0	2	0	0	14389	2
2	0	2	0	0	14390	2
2	0	2	0	0	14391	2
2	0	2	0	0	14392	2
2	34	2	1	35	14393	0
2	293	2	1059	1352	14394	1
2	0	2	9	9	14395	2
2	0	2	0	0	14396	2
2	100	2	4	104	14397	0
2	0	2	223	223	14398	2
2	1	2	0	1	14399	0
2	57	2	36	93	14400	1
2	0	2	1	1	14401	2
2	0	2	0	0	14402	2
2	3	2	0	3	14403	1
2	0	2	10	10	14404	2
2	0	2	0	0	14405	2
2	0	2	2	2	14406	2
2	0	2	0	0	14407	2
2	0	2	0	0	14408	2
2	0	2	0	0	14409	2
2	0	2	0	0	14410	2
2	0	2	0	0	14411	2
2	0	2	1	1	14412	2
2	0	2	0	0	14413	2
2	0	2	0	0	14414	2
2	1	2	0	1	14415	1
2	0	2	0	0	14416	2
2	0	2	0	0	14417	2
2	0	2	0	0	14418	2
2	0	2	0	0	14419	2
2	0	2	0	0	14420	2
2	0	2	0	0	14421	2
2	0	2	0	0	14422	2
2	0	2	0	0	14423	2
2	6	2	32	38	14424	1
2	0	2	0	0	14425	2
2	0	2	0	0	14426	2
2	3	2	1	4	14427	1
2	0	2	2	2	14428	2
2	0	2	0	0	14429	2
2	0	2	0	0	14430	2
2	0	2	0	0	14431	2
2	0	2	0	0	14432	2
2	0	2	0	0	14433	2
2	0	2	0	0	14434	2
2	0	2	0	0	14435	2
2	0	2	0	0	14436	2
2	0	2	0	0	14437	2
2	0	2	0	0	14438	2
2	0	2	0	0	14439	2
2	0	2	0	0	14440	2
2	2	2	0	2	14441	0
2	26	2	36	62	14442	1
2	0	2	0	0	14443	2
2	0	2	0	0	14444	2
2	8	2	1	9	14445	0
2	0	2	10	10	14446	2
0	9	2	0	9	14447	0
0	6	2	0	6	14448	1
0	2	2	0	2	14449	0
2	0	2	0	0	14450	2
2	0	2	0	0	14451	2
2	0	2	0	0	14452	2
2	0	2	0	0	14453	2
2	0	2	0	0	14454	2
2	0	2	0	0	14455	2
2	0	2	0	0	14456	2
2	0	2	0	0	14457	2
2	0	2	0	0	14458	2
2	0	2	0	0	14459	2
2	0	2	0	0	14460	2
2	0	2	0	0	14461	2
4	0	4	0	0	14462	2
4	0	4	0	0	14463	2
2	113	2	1	114	14464	0
2	223	2	789	1012	14465	1
2	0	2	55	55	14466	2
2	0	2	1	1	14467	2
2	52	2	24	76	14468	0
2	0	2	261	261	14469	2
2	0	2	1	1	14470	2
2	0	2	0	0	14471	2
2	0	2	0	0	14472	2
2	0	4	0	0	14473	2
2	0	2	0	0	14474	2
2	0	2	0	0	14475	2
2	2	2	0	2	14476	0
2	0	2	0	0	14477	2
2	0	2	0	0	14478	2
2	0	4	0	0	14479	2
2	0	2	0	0	14480	2
2	0	2	0	0	14481	2
2	0	2	2	2	14482	2
2	0	2	0	0	14483	2
2	0	2	0	0	14484	2
2	2	2	68	70	14485	0
2	0	2	0	0	14486	2
2	0	2	0	0	14487	2
2	0	2	0	0	14488	2
2	0	2	0	0	14489	2
2	0	2	0	0	14490	2
2	0	2	0	0	14491	2
2	0	2	0	0	14492	2
2	0	2	0	0	14493	2
2	122	2	0	122	14494	0
2	134	4	15270	15404	14495	1
2	0	2	100	100	14496	2
2	0	2	0	0	14497	2
2	41	4	724	765	14498	1
2	0	2	373	373	14499	2
2	0	2	0	0	14500	2
2	0	2	1	1	14501	2
2	0	2	0	0	14502	2
2	0	2	0	0	14503	2
2	0	2	0	0	14504	2
2	117	2	0	117	14505	0
2	0	2	19	19	14506	2
2	0	2	4	4	14507	2
2	0	2	0	0	14508	2
2	0	2	0	0	14509	2
2	0	2	0	0	14510	2
2	0	2	0	0	14511	2
2	0	2	0	0	14512	2
2	0	2	0	0	14513	2
2	0	2	0	0	14514	2
2	0	2	0	0	14515	2
2	0	2	0	0	14516	2
2	0	2	0	0	14517	2
2	0	2	0	0	14518	2
2	0	2	0	0	14519	2
2	0	2	0	0	14520	2
2	0	2	0	0	14521	2
2	0	2	0	0	14522	2
2	0	2	0	0	14523	2
2	0	2	0	0	14524	2
2	0	2	0	0	14525	2
2	0	2	0	0	14526	2
2	0	2	0	0	14527	2
2	0	2	0	0	14528	2
2	0	2	0	0	14529	2
2	0	2	0	0	14530	2
2	0	2	0	0	14531	2
2	0	2	0	0	14532	2
2	0	2	0	0	14533	2
2	0	2	0	0	14534	2
2	0	2	0	0	14535	2
2	0	2	1	1	14536	2
2	0	2	0	0	14537	2
2	0	2	0	0	14538	2
2	0	2	0	0	14539	2
2	0	2	0	0	14540	2
2	0	2	0	0	14541	2
2	0	2	50	50	14542	2
2	0	2	0	0	14543	2
2	0	2	0	0	14544	2
2	1	2	15	16	14545	0
2	0	2	6	6	14546	2
2	3	2	0	3	14547	0
2	0	2	35	35	14548	2
2	0	2	9	9	14549	2
2	0	2	0	0	14550	2
2	3	2	1	4	14551	0
2	0	2	12	12	14552	2
2	3	2	0	3	14553	0
2	0	4	3	3	14554	2
2	0	2	2	2	14555	2
2	0	2	0	0	14556	2
2	3	4	0	3	14557	0
2	8	2	0	8	14558	0
2	5	2	16	21	14559	1
2	0	2	0	0	14560	2
2	0	2	0	0	14561	2
2	6	2	11	17	14562	1
2	0	2	40	40	14563	2
2	0	2	0	0	14564	2
2	0	2	0	0	14565	2
2	0	2	0	0	14566	2
2	1	2	0	1	14567	0
2	0	4	6	6	14568	2
2	0	2	0	0	14569	2
2	0	2	0	0	14570	2
2	0	4	0	0	14571	2
2	0	2	0	0	14572	2
2	0	2	0	0	14573	2
2	0	2	1	1	14574	2
2	0	2	0	0	14575	2
2	0	2	0	0	14576	2
2	0	2	1	1	14577	2
2	0	2	0	0	14578	2
2	0	2	0	0	14579	2
2	0	2	10	10	14580	2
2	0	2	0	0	14581	2
2	0	2	0	0	14582	2
2	0	2	0	0	14583	2
2	0	2	0	0	14584	2
4	0	2	0	0	14585	2
2	8	2	1	9	14586	0
2	0	2	114	114	14587	2
2	0	2	1	1	14588	2
2	0	2	0	0	14589	2
2	3	2	0	3	14590	0
2	0	2	19	19	14591	2
2	0	2	0	0	14592	2
2	0	2	0	0	14593	2
2	0	2	0	0	14594	2
2	0	2	0	0	14595	2
2	0	2	0	0	14596	2
2	0	2	0	0	14597	2
2	70	2	0	70	14598	0
2	5	2	110	115	14599	0
4	261	2	3	264	14600	0
2	775	2	11	786	14601	0
2	0	2	0	0	14602	2
2	0	2	0	0	14603	2
2	0	2	0	0	14604	2
2	0	2	0	0	14605	2
2	0	2	0	0	14606	2
2	0	2	0	0	14607	2
2	0	2	0	0	14608	2
2	0	2	0	0	14609	2
2	0	2	0	0	14610	2
2	0	2	0	0	14611	2
2	0	2	0	0	14612	2
2	0	2	0	0	14613	2
2	0	2	0	0	14614	2
2	0	2	0	0	14615	2
2	0	2	0	0	14616	2
2	0	2	0	0	14617	2
2	0	2	0	0	14618	2
2	0	4	2	2	14619	2
2	0	2	0	0	14620	2
2	0	2	0	0	14621	2
2	0	4	0	0	14622	2
2	0	2	0	0	14623	2
2	457	4	6013	6470	14624	1
2	2	2	322	324	14625	1
2	0	2	22	22	14626	2
2	364	4	299	663	14627	1
2	0	2	1615	1615	14628	2
2	0	2	0	0	14629	2
2	0	2	0	0	14630	2
2	0	2	0	0	14631	2
2	0	2	0	0	14632	2
2	0	2	0	0	14633	2
2	0	2	0	0	14634	2
2	0	2	0	0	14635	2
2	0	2	0	0	14636	2
2	0	2	1	1	14637	2
2	0	2	0	0	14638	2
2	0	2	0	0	14639	2
2	0	2	81	81	14640	2
2	4	2	0	4	14641	0
2	0	2	11	11	14642	2
2	0	2	0	0	14643	2
2	0	2	0	0	14644	2
2	2	2	0	2	14645	1
2	0	2	2	2	14646	2
2	0	2	0	0	14647	2
2	0	2	0	0	14648	2
2	0	2	0	0	14649	2
2	0	2	0	0	14650	2
2	0	2	0	0	14651	2
2	0	2	0	0	14652	2
2	1	2	0	1	14653	0
2	0	2	11	11	14654	2
2	0	2	0	0	14655	2
2	0	2	0	0	14656	2
2	0	2	0	0	14657	2
2	0	2	2	2	14658	2
2	2	2	0	2	14659	0
2	1	2	0	1	14660	1
2	0	2	35	35	14661	2
2	10	2	68	78	14662	1
2	0	2	1	1	14663	2
2	0	2	0	0	14664	2
2	0	2	0	0	14665	2
2	0	2	0	0	14666	2
2	0	2	0	0	14667	2
2	0	2	0	0	14668	2
2	0	2	0	0	14669	2
2	0	2	0	0	14670	2
2	0	2	0	0	14671	2
2	0	2	0	0	14672	2
2	0	2	0	0	14673	2
2	0	2	0	0	14674	2
2	0	2	0	0	14675	2
2	0	2	0	0	14676	2
2	0	2	0	0	14677	2
2	0	4	1	1	14678	2
2	0	2	0	0	14679	2
2	0	2	0	0	14680	2
2	0	4	0	0	14681	2
2	0	2	0	0	14682	2
0	0	4	0	0	14683	2
0	0	4	0	0	14684	2
2	17	2	0	17	14685	0
2	0	2	17	17	14686	2
2	0	2	11	11	14687	2
2	0	2	0	0	14688	2
2	1	2	0	1	14689	1
2	0	2	18	18	14690	2
2	2	2	0	2	14691	0
2	0	2	68	68	14692	2
2	0	2	0	0	14693	2
2	0	2	0	0	14694	2
2	2	2	0	2	14695	0
2	0	2	15	15	14696	2
2	1	2	0	1	14697	0
2	0	2	1	1	14698	2
2	0	2	0	0	14699	2
2	0	2	0	0	14700	2
2	1	2	0	1	14701	1
2	0	2	0	0	14702	2
2	0	2	0	0	14703	2
2	0	2	0	0	14704	2
2	0	2	0	0	14705	2
2	0	2	0	0	14706	2
2	0	2	0	0	14707	2
2	0	2	0	0	14708	2
2	0	2	0	0	14709	2
2	0	2	0	0	14710	2
2	0	2	1	1	14711	2
2	0	2	58	58	14712	2
2	0	2	0	0	14713	2
2	0	2	1	1	14714	2
2	0	2	0	0	14715	2
2	0	2	0	0	14716	2
2	0	2	1	1	14717	2
2	0	2	0	0	14718	2
2	2	2	0	2	14719	0
2	2	4	5	7	14720	1
2	0	2	0	0	14721	2
2	0	2	0	0	14722	2
2	0	4	27	27	14723	2
2	0	2	1	1	14724	2
4	0	4	0	0	14725	2
4	0	4	0	0	14726	2
2	0	4	12	12	14727	2
2	0	2	0	0	14728	2
2	0	2	0	0	14729	2
2	0	0	0	0	14730	2
2	0	2	0	0	14731	2
2	0	2	0	0	14732	2
2	0	2	0	0	14733	2
2	0	2	0	0	14734	2
2	0	2	0	0	14735	2
2	0	2	0	0	14736	2
2	683	2	4	687	14737	0
2	0	2	0	0	14738	2
2	0	2	0	0	14739	2
2	0	2	0	0	14740	2
2	0	2	0	0	14741	2
2	11	2	0	11	14742	0
2	11	4	5105	5116	14743	0
2	0	2	1	1	14744	2
2	0	2	0	0	14745	2
2	5	4	2025	2030	14746	0
2	0	2	19	19	14747	2
2	0	2	0	0	14748	2
2	0	2	0	0	14749	2
2	313	2	5947	6260	14750	1
2	0	2	197	197	14751	2
2	0	2	4	4	14752	2
2	174	2	73	247	14753	0
2	0	2	685	685	14754	2
2	0	2	0	0	14755	2
2	1	4	6	7	14756	1
2	0	2	0	0	14757	2
2	0	2	0	0	14758	2
2	1	4	0	1	14759	0
2	0	2	1	1	14760	2
2	0	2	0	0	14761	2
2	0	2	0	0	14762	2
2	0	2	0	0	14763	2
2	0	2	0	0	14764	2
2	0	2	0	0	14765	2
2	0	2	0	0	14766	2
2	0	2	0	0	14767	2
2	0	2	0	0	14768	2
2	0	2	1	1	14769	2
2	4	2	0	4	14770	0
2	0	2	8	8	14771	2
2	0	2	0	0	14772	2
2	0	2	0	0	14773	2
2	2	2	0	2	14774	0
2	0	2	9	9	14775	2
2	0	2	0	0	14776	2
2	0	2	0	0	14777	2
2	0	2	0	0	14778	2
2	0	2	0	0	14779	2
2	0	2	7	7	14780	2
2	0	2	0	0	14781	2
2	0	2	0	0	14782	2
2	0	2	0	0	14783	2
2	0	2	1	1	14784	2
2	7	2	0	7	14785	0
2	2	4	1152	1154	14786	1
2	0	2	0	0	14787	2
2	0	2	0	0	14788	2
2	1	4	204	205	14789	0
2	0	2	17	17	14790	2
2	240	2	0	240	14791	0
2	185	2	5682	5867	14792	1
2	0	2	61	61	14793	2
2	0	2	0	0	14794	2
2	81	2	9	90	14795	0
2	0	2	646	646	14796	2
2	0	2	0	0	14797	2
2	0	2	0	0	14798	2
2	0	2	0	0	14799	2
2	0	2	0	0	14800	2
2	0	2	0	0	14801	2
2	0	2	0	0	14802	2
4	9093	4	5	9098	14803	0
2	3	4	8	11	14804	1
2	69	4	8	77	14805	1
2	14	2	0	14	14806	0
2	15	2	1	16	14807	0
2	0	2	29	29	14808	2
2	6	2	136	142	14809	1
2	0	2	2	2	14810	2
2	0	2	0	0	14811	2
2	0	2	0	0	14812	2
2	0	2	0	0	14813	2
2	0	2	0	0	14814	2
2	0	2	0	0	14815	2
2	0	2	0	0	14816	2
2	0	2	0	0	14817	2
2	0	2	0	0	14818	2
2	0	2	0	0	14819	2
2	0	2	0	0	14820	2
2	0	2	0	0	14821	2
2	0	2	0	0	14822	2
2	0	2	0	0	14823	2
2	0	2	0	0	14824	2
2	1	2	4	5	14825	1
2	0	2	0	0	14826	2
2	0	2	0	0	14827	2
2	0	2	0	0	14828	2
2	0	2	0	0	14829	2
2	14	2	0	14	14830	0
2	18	2	735	753	14831	1
2	0	2	3	3	14832	2
2	0	2	0	0	14833	2
2	2	2	0	2	14834	0
2	0	2	34	34	14835	2
2	1	2	0	1	14836	0
2	1	2	348	349	14837	1
2	0	2	2	2	14838	2
2	0	2	0	0	14839	2
2	0	2	0	0	14840	2
2	0	2	10	10	14841	2
2	0	2	0	0	14842	2
2	0	2	2	2	14843	2
2	0	2	0	0	14844	2
2	0	2	0	0	14845	2
2	0	2	0	0	14846	2
2	0	2	0	0	14847	2
2	0	2	0	0	14848	2
2	0	2	0	0	14849	2
2	0	2	0	0	14850	2
2	0	2	0	0	14851	2
2	0	2	0	0	14852	2
2	0	2	0	0	14853	2
2	0	2	0	0	14854	2
2	0	2	0	0	14855	2
2	0	2	0	0	14856	2
2	0	2	0	0	14857	2
2	0	2	0	0	14858	2
2	0	2	0	0	14859	2
2	0	2	0	0	14860	2
2	0	2	0	0	14861	2
2	0	2	0	0	14862	2
2	0	2	0	0	14863	2
0	2	2	0	2	14864	1
0	2	2	0	2	14865	0
2	0	2	0	0	14866	2
2	0	2	1	1	14867	2
2	0	2	0	0	14868	2
2	0	2	0	0	14869	2
2	0	2	0	0	14870	2
2	0	2	0	0	14871	2
2	0	2	0	0	14872	2
2	0	2	0	0	14873	2
2	7	2	1	8	14874	0
2	47	2	182	229	14875	1
2	0	2	5	5	14876	2
2	0	2	0	0	14877	2
2	15	2	10	25	14878	1
2	0	2	0	0	14879	2
4	600	2	182	782	14880	0
4	500	2	10	510	14881	0
2	1	2	0	1	14882	1
2	0	2	0	0	14883	2
2	0	2	0	0	14884	2
2	0	2	0	0	14885	2
2	1	2	3	4	14886	1
2	0	2	0	0	14887	2
2	0	2	0	0	14888	2
2	0	2	0	0	14889	2
2	0	2	0	0	14890	2
2	7	2	0	7	14891	0
2	0	2	77	77	14892	2
2	0	2	2	2	14893	2
2	0	2	0	0	14894	2
2	4	2	0	4	14895	1
2	0	2	25	25	14896	2
2	0	2	0	0	14897	2
2	0	2	1	1	14898	2
2	0	2	0	0	14899	2
2	0	2	0	0	14900	2
2	0	2	0	0	14901	2
2	0	2	0	0	14902	2
2	0	2	0	0	14903	2
2	0	2	0	0	14904	2
2	0	2	0	0	14905	2
2	0	2	0	0	14906	2
2	0	2	0	0	14907	2
2	0	2	0	0	14908	2
2	0	2	738	738	14909	2
2	63	2	0	63	14910	0
2	0	2	162	162	14911	2
2	0	2	0	0	14912	2
2	0	2	0	0	14913	2
2	0	2	0	0	14914	2
2	0	2	1	1	14915	2
2	0	2	0	0	14916	2
2	0	2	0	0	14917	2
2	0	2	0	0	14918	2
2	0	2	0	0	14919	2
2	0	2	0	0	14920	2
2	0	2	0	0	14921	2
2	0	2	1	1	14922	2
2	0	2	0	0	14923	2
2	0	2	0	0	14924	2
2	1	2	0	1	14925	1
2	0	2	0	0	14926	2
2	0	2	0	0	14927	2
2	1	2	86	87	14928	1
2	0	2	0	0	14929	2
2	0	2	0	0	14930	2
2	4	2	0	4	14931	1
2	0	2	1	1	14932	2
2	4	2	0	4	14933	0
2	2	2	11	13	14934	1
2	0	2	1	1	14935	2
2	0	2	0	0	14936	2
2	1	2	19	20	14937	1
2	0	2	6	6	14938	2
2	0	2	1	1	14939	2
2	1	2	0	1	14940	1
2	0	2	7	7	14941	2
2	0	2	0	0	14942	2
2	0	2	0	0	14943	2
0	0	2	0	0	14944	2
0	0	2	0	0	14945	2
2	0	2	0	0	14946	2
2	0	2	0	0	14947	2
2	13	2	3	16	14948	1
2	0	2	0	0	14949	2
2	0	2	0	0	14950	2
2	3	2	0	3	14951	1
2	0	2	5	5	14952	2
2	0	2	0	0	14953	2
2	0	2	0	0	14954	2
2	0	2	0	0	14955	2
2	0	2	0	0	14956	2
2	0	2	0	0	14957	2
2	0	2	0	0	14958	2
2	3	2	0	3	14959	0
2	1	2	12	13	14960	1
2	0	2	0	0	14961	2
2	0	2	0	0	14962	2
2	0	2	0	0	14963	2
2	0	2	1	1	14964	2
2	0	2	0	0	14965	2
2	1	2	5	6	14966	1
2	0	2	0	0	14967	2
2	0	2	0	0	14968	2
2	0	2	0	0	14969	2
2	0	2	0	0	14970	2
2	0	2	0	0	14971	2
2	0	2	0	0	14972	2
2	0	2	0	0	14973	2
2	1	2	0	1	14974	0
2	0	2	0	0	14975	2
2	0	2	0	0	14976	2
2	2	2	0	2	14977	0
2	1	2	66	67	14978	1
2	0	2	0	0	14979	2
2	0	2	0	0	14980	2
2	0	2	0	0	14981	2
2	0	2	3	3	14982	2
4	15	2	8	23	14983	1
2	0	2	0	0	14984	2
2	0	2	0	0	14985	2
2	0	2	0	0	14986	2
2	46	2	0	46	14987	0
2	0	2	0	0	14988	2
2	0	2	0	0	14989	2
2	0	2	0	0	14990	2
2	0	2	0	0	14991	2
2	0	2	0	0	14992	2
2	0	2	0	0	14993	2
2	17	4	2503	2520	14994	1
2	0	2	1	1	14995	2
2	0	2	0	0	14996	2
2	5	4	60	65	14997	0
2	0	2	76	76	14998	2
2	5	2	1	6	14999	0
2	3	2	0	3	15000	0
2	0	2	40	40	15001	2
2	4	2	109	113	15002	1
2	0	2	0	0	15003	2
2	0	2	0	0	15004	2
2	0	2	0	0	15005	2
2	0	4	1	1	15006	2
2	0	2	0	0	15007	2
2	0	2	0	0	15008	2
2	0	4	1	1	15009	2
2	0	2	0	0	15010	2
2	0	2	0	0	15011	2
2	0	2	1	1	15012	2
2	0	2	0	0	15013	2
2	0	2	0	0	15014	2
2	0	2	1	1	15015	2
2	0	2	0	0	15016	2
2	0	2	0	0	15017	2
2	0	2	0	0	15018	2
2	0	2	0	0	15019	2
2	0	2	0	0	15020	2
2	0	2	0	0	15021	2
2	0	2	0	0	15022	2
2	0	2	0	0	15023	2
2	0	2	0	0	15024	2
2	0	2	0	0	15025	2
2	1	2	0	1	15026	0
2	3	2	10	13	15027	1
2	0	2	0	0	15028	2
2	0	2	0	0	15029	2
2	2	2	2	4	15030	1
2	0	2	5	5	15031	2
2	14	2	0	14	15032	0
2	125	4	2225	2350	15033	0
2	0	2	12	12	15034	2
2	0	2	0	0	15035	2
2	13	4	258	271	15036	0
2	0	2	6	6	15037	2
2	0	2	0	0	15038	2
2	0	2	0	0	15039	2
2	0	2	0	0	15040	2
2	0	2	0	0	15041	2
2	0	2	0	0	15042	2
2	0	2	0	0	15043	2
2	0	2	0	0	15044	2
2	0	2	0	0	15045	2
2	0	2	0	0	15046	2
2	0	2	0	0	15047	2
2	0	2	0	0	15048	2
2	0	2	0	0	15049	2
2	0	2	0	0	15050	2
2	0	2	0	0	15051	2
2	0	2	0	0	15052	2
2	0	2	0	0	15053	2
2	0	2	0	0	15054	2
2	0	2	0	0	15055	2
2	0	2	0	0	15056	2
2	0	2	0	0	15057	2
2	0	2	0	0	15058	2
2	0	2	0	0	15059	2
2	0	2	0	0	15060	2
2	0	2	0	0	15061	2
2	0	2	0	0	15062	2
2	0	2	0	0	15063	2
2	0	2	0	0	15064	2
2	0	2	0	0	15065	2
2	0	2	0	0	15066	2
2	0	2	0	0	15067	2
2	0	2	0	0	15068	2
2	0	2	0	0	15069	2
2	0	2	0	0	15070	2
2	0	2	0	0	15071	2
2	0	2	0	0	15072	2
2	0	2	0	0	15073	2
2	0	2	0	0	15074	2
2	0	2	0	0	15075	2
2	0	2	0	0	15076	2
2	0	2	0	0	15077	2
2	0	2	0	0	15078	2
2	0	2	0	0	15079	2
2	0	2	0	0	15080	2
2	0	2	0	0	15081	2
2	0	2	0	0	15082	2
2	0	2	5	5	15083	2
2	0	2	0	0	15084	2
2	0	2	0	0	15085	2
2	0	2	0	0	15086	2
2	0	2	0	0	15087	2
2	6	2	0	6	15088	0
2	2	2	9	11	15089	1
2	0	2	0	0	15090	2
2	0	2	0	0	15091	2
2	1	2	0	1	15092	0
2	0	2	6	6	15093	2
2	0	2	0	0	15094	2
2	0	2	0	0	15095	2
2	0	2	0	0	15096	2
2	0	2	0	0	15097	2
2	0	2	0	0	15098	2
2	0	2	0	0	15099	2
2	0	2	0	0	15100	2
2	0	2	0	0	15101	2
2	0	2	0	0	15102	2
2	0	2	0	0	15103	2
2	0	2	0	0	15104	2
2	0	2	0	0	15105	2
2	0	2	0	0	15106	2
2	0	2	0	0	15107	2
2	0	2	0	0	15108	2
2	0	2	0	0	15109	2
2	0	2	0	0	15110	2
2	0	2	0	0	15111	2
2	0	2	0	0	15112	2
2	0	2	0	0	15113	2
2	0	2	0	0	15114	2
2	0	2	0	0	15115	2
2	0	2	0	0	15116	2
2	0	2	0	0	15117	2
2	1	2	21	22	15118	1
2	0	2	1	1	15119	2
2	0	2	0	0	15120	2
2	0	2	0	0	15121	2
2	0	2	0	0	15122	2
2	0	2	0	0	15123	2
2	0	2	0	0	15124	2
2	0	2	0	0	15125	2
2	0	2	0	0	15126	2
2	0	2	0	0	15127	2
2	0	2	0	0	15128	2
2	0	2	0	0	15129	2
2	0	2	0	0	15130	2
2	0	2	0	0	15131	2
2	0	2	0	0	15132	2
2	0	2	0	0	15133	2
2	0	2	0	0	15134	2
2	0	2	0	0	15135	2
2	0	2	0	0	15136	2
2	0	2	0	0	15137	2
2	0	2	0	0	15138	2
2	0	2	0	0	15139	2
2	0	2	0	0	15140	2
2	0	2	0	0	15141	2
2	0	2	0	0	15142	2
2	0	2	0	0	15143	2
2	0	2	0	0	15144	2
2	0	2	0	0	15145	2
2	0	2	0	0	15146	2
2	5	2	32	37	15147	1
2	0	2	0	0	15148	2
2	0	2	0	0	15149	2
2	0	2	0	0	15150	2
2	0	2	5	5	15151	2
2	0	2	0	0	15152	2
2	0	2	0	0	15153	2
2	0	2	0	0	15154	2
2	0	2	0	0	15155	2
2	0	2	0	0	15156	2
2	0	2	0	0	15157	2
2	0	2	0	0	15158	2
2	0	2	0	0	15159	2
2	0	2	0	0	15160	2
2	0	2	0	0	15161	2
2	0	2	0	0	15162	2
2	0	2	0	0	15163	2
2	0	2	0	0	15164	2
2	0	2	0	0	15165	2
2	0	2	0	0	15166	2
2	0	2	0	0	15167	2
2	0	2	0	0	15168	2
2	0	2	0	0	15169	2
2	0	2	0	0	15170	2
2	0	2	0	0	15171	2
2	0	2	0	0	15172	2
2	0	2	0	0	15173	2
2	0	2	0	0	15174	2
2	0	2	0	0	15175	2
2	0	2	0	0	15176	2
2	0	2	0	0	15177	2
2	0	2	0	0	15178	2
2	0	2	0	0	15179	2
2	0	2	0	0	15180	2
2	0	2	0	0	15181	2
2	0	2	0	0	15182	2
2	0	2	0	0	15183	2
2	0	2	0	0	15184	2
2	0	2	0	0	15185	2
2	0	2	0	0	15186	2
2	0	2	0	0	15187	2
2	5	2	0	5	15188	0
2	3	2	49	52	15189	1
2	0	2	0	0	15190	2
2	0	2	0	0	15191	2
2	1	2	0	1	15192	1
2	0	2	5	5	15193	2
2	81	2	0	81	15194	0
2	3	2	1009	1012	15195	1
2	0	2	2	2	15196	2
2	0	2	0	0	15197	2
2	2	2	23	25	15198	0
2	0	2	28	28	15199	2
2	0	2	0	0	15200	2
2	0	2	0	0	15201	2
2	0	2	0	0	15202	2
2	0	2	0	0	15203	2
2	0	2	0	0	15204	2
2	0	2	0	0	15205	2
2	0	2	0	0	15206	2
2	0	2	0	0	15207	2
2	0	2	0	0	15208	2
2	0	2	0	0	15209	2
2	0	2	0	0	15210	2
2	0	2	0	0	15211	2
2	0	2	0	0	15212	2
2	0	2	0	0	15213	2
2	0	2	0	0	15214	2
2	0	2	0	0	15215	2
2	0	2	0	0	15216	2
2	0	2	0	0	15217	2
2	0	2	0	0	15218	2
2	0	2	0	0	15219	2
2	0	2	0	0	15220	2
2	0	2	0	0	15221	2
2	0	2	0	0	15222	2
2	0	2	0	0	15223	2
2	0	2	0	0	15224	2
2	0	2	0	0	15225	2
2	0	2	0	0	15226	2
2	0	2	0	0	15227	2
2	0	2	0	0	15228	2
2	0	2	0	0	15229	2
2	0	2	0	0	15230	2
2	0	4	0	0	15231	2
2	0	2	0	0	15232	2
2	0	2	0	0	15233	2
2	0	4	9	9	15234	2
2	0	2	0	0	15235	2
2	0	2	0	0	15236	2
2	0	2	0	0	15237	2
2	0	2	0	0	15238	2
2	0	2	0	0	15239	2
2	0	2	0	0	15240	2
2	0	2	0	0	15241	2
2	0	2	0	0	15242	2
2	0	2	0	0	15243	2
2	0	2	0	0	15244	2
2	0	2	0	0	15245	2
2	0	2	0	0	15246	2
2	0	2	0	0	15247	2
2	4	2	0	4	15248	0
2	0	2	0	0	15249	2
2	0	2	0	0	15250	2
2	0	2	0	0	15251	2
2	0	2	0	0	15252	2
2	0	2	0	0	15253	2
2	0	2	0	0	15254	2
2	0	2	0	0	15255	2
2	0	2	0	0	15256	2
2	0	2	0	0	15257	2
2	0	2	0	0	15258	2
2	0	2	0	0	15259	2
2	0	2	0	0	15260	2
2	0	2	0	0	15261	2
2	0	2	2	2	15262	2
2	0	2	0	0	15263	2
2	0	2	0	0	15264	2
2	0	2	0	0	15265	2
2	0	2	0	0	15266	2
2	9	2	111	120	15267	1
2	0	2	2	2	15268	2
2	0	2	0	0	15269	2
2	9	2	3	12	15270	0
2	0	2	0	0	15271	2
2	0	2	0	0	15272	2
2	0	2	0	0	15273	2
2	0	2	0	0	15274	2
2	0	2	0	0	15275	2
2	0	2	0	0	15276	2
2	0	2	0	0	15277	2
2	0	2	0	0	15278	2
2	0	2	0	0	15279	2
2	0	2	0	0	15280	2
2	0	2	0	0	15281	2
2	0	2	0	0	15282	2
2	0	2	0	0	15283	2
2	0	2	0	0	15284	2
2	0	2	0	0	15285	2
2	0	2	0	0	15286	2
2	0	2	0	0	15287	2
2	0	2	0	0	15288	2
2	0	2	0	0	15289	2
2	0	2	0	0	15290	2
2	0	2	0	0	15291	2
2	0	2	0	0	15292	2
2	0	2	0	0	15293	2
2	0	2	0	0	15294	2
2	0	2	0	0	15295	2
2	0	2	0	0	15296	2
2	0	2	0	0	15297	2
2	0	2	0	0	15298	2
2	0	2	0	0	15299	2
2	0	2	0	0	15300	2
2	0	2	0	0	15301	2
2	1	2	0	1	15302	0
2	0	2	68	68	15303	2
2	0	2	0	0	15304	2
2	0	2	0	0	15305	2
2	0	2	0	0	15306	2
2	0	2	4	4	15307	2
2	0	2	0	0	15308	2
2	0	2	0	0	15309	2
2	0	2	0	0	15310	2
2	0	2	0	0	15311	2
2	0	2	0	0	15312	2
2	0	2	2	2	15313	2
2	0	2	0	0	15314	2
2	0	2	0	0	15315	2
2	0	2	0	0	15316	2
2	0	2	0	0	15317	2
2	0	2	0	0	15318	2
2	0	2	0	0	15319	2
2	0	2	0	0	15320	2
2	0	2	0	0	15321	2
2	1	2	0	1	15322	0
2	0	2	40	40	15323	2
2	0	2	0	0	15324	2
2	0	2	0	0	15325	2
2	0	2	0	0	15326	2
2	0	2	0	0	15327	2
2	0	2	0	0	15328	2
2	0	2	21	21	15329	2
2	0	2	0	0	15330	2
2	0	2	0	0	15331	2
2	0	2	1	1	15332	2
2	0	2	0	0	15333	2
2	0	2	0	0	15334	2
2	0	2	0	0	15335	2
2	0	2	0	0	15336	2
2	0	2	0	0	15337	2
2	0	2	1	1	15338	2
2	0	2	0	0	15339	2
2	0	2	0	0	15340	2
2	0	2	0	0	15341	2
2	0	2	0	0	15342	2
2	0	2	0	0	15343	2
2	0	2	0	0	15344	2
2	0	2	0	0	15345	2
2	2	2	0	2	15346	0
2	0	2	0	0	15347	2
2	0	2	0	0	15348	2
2	0	2	0	0	15349	2
2	0	2	0	0	15350	2
2	0	2	1	1	15351	2
2	0	2	0	0	15352	2
2	0	2	0	0	15353	2
2	0	2	0	0	15354	2
2	0	2	0	0	15355	2
2	0	2	0	0	15356	2
2	0	2	0	0	15357	2
2	0	2	0	0	15358	2
2	0	2	0	0	15359	2
2	0	2	0	0	15360	2
2	0	2	0	0	15361	2
2	0	2	0	0	15362	2
2	0	2	0	0	15363	2
2	0	2	0	0	15364	2
2	0	2	0	0	15365	2
2	0	2	0	0	15366	2
2	0	2	0	0	15367	2
2	0	2	0	0	15368	2
2	0	2	0	0	15369	2
2	0	2	0	0	15370	2
2	0	2	0	0	15371	2
2	0	2	0	0	15372	2
2	0	2	0	0	15373	2
2	0	2	0	0	15374	2
2	0	2	0	0	15375	2
2	0	2	0	0	15376	2
2	0	2	0	0	15377	2
2	0	2	0	0	15378	2
2	0	2	0	0	15379	2
2	0	2	0	0	15380	2
2	0	2	0	0	15381	2
2	0	2	0	0	15382	2
2	0	2	0	0	15383	2
2	0	2	0	0	15384	2
2	0	2	0	0	15385	2
2	0	2	0	0	15386	2
2	0	2	0	0	15387	2
2	1	2	0	1	15388	1
2	0	2	3	3	15389	2
2	1	2	0	1	15390	0
2	0	2	2	2	15391	2
2	0	2	0	0	15392	2
2	0	2	0	0	15393	2
2	0	2	0	0	15394	2
2	0	2	0	0	15395	2
2	0	2	0	0	15396	2
2	0	2	0	0	15397	2
2	0	2	0	0	15398	2
2	0	2	0	0	15399	2
2	0	2	0	0	15400	2
2	0	2	0	0	15401	2
2	0	2	0	0	15402	2
2	0	2	1	1	15403	2
2	0	2	0	0	15404	2
2	0	2	0	0	15405	2
2	0	2	0	0	15406	2
2	0	2	0	0	15407	2
2	0	2	0	0	15408	2
2	0	2	0	0	15409	2
2	0	2	0	0	15410	2
2	0	2	0	0	15411	2
2	0	2	0	0	15412	2
2	0	2	0	0	15413	2
2	0	2	0	0	15414	2
2	0	2	0	0	15415	2
2	0	2	0	0	15416	2
2	0	2	0	0	15417	2
2	0	2	0	0	15418	2
2	0	2	0	0	15419	2
2	0	0	0	0	15420	2
2	0	2	0	0	15421	2
2	0	0	0	0	15422	2
2	0	2	0	0	15423	2
2	0	2	0	0	15424	2
2	0	2	0	0	15425	2
2	0	2	0	0	15426	2
2	0	2	0	0	15427	2
2	0	2	0	0	15428	2
2	0	2	0	0	15429	2
2	0	2	0	0	15430	2
2	0	2	0	0	15431	2
2	0	2	0	0	15432	2
2	0	2	0	0	15433	2
2	0	2	0	0	15434	2
2	0	2	0	0	15435	2
2	0	2	0	0	15436	2
2	0	2	0	0	15437	2
2	0	2	0	0	15438	2
2	0	2	0	0	15439	2
2	0	2	0	0	15440	2
2	0	2	0	0	15441	2
2	0	2	0	0	15442	2
2	0	2	0	0	15443	2
2	0	2	0	0	15444	2
2	0	2	0	0	15445	2
2	0	2	0	0	15446	2
2	0	2	0	0	15447	2
2	0	2	0	0	15448	2
2	0	2	0	0	15449	2
2	0	2	0	0	15450	2
2	0	2	0	0	15451	2
2	0	2	0	0	15452	2
2	0	2	0	0	15453	2
2	0	2	0	0	15454	2
2	0	2	0	0	15455	2
2	0	2	0	0	15456	2
2	0	2	0	0	15457	2
2	0	2	0	0	15458	2
2	0	2	0	0	15459	2
2	0	2	0	0	15460	2
2	0	2	0	0	15461	2
2	0	2	0	0	15462	2
2	0	2	0	0	15463	2
2	0	2	0	0	15464	2
2	0	2	0	0	15465	2
2	0	2	0	0	15466	2
2	0	2	117	117	15467	2
2	0	2	0	0	15468	2
2	0	2	0	0	15469	2
2	0	2	0	0	15470	2
2	0	2	0	0	15471	2
2	0	2	0	0	15472	2
2	0	2	0	0	15473	2
2	0	2	0	0	15474	2
2	0	2	4	4	15475	2
2	0	2	0	0	15476	2
2	0	2	0	0	15477	2
2	0	2	0	0	15478	2
2	0	2	0	0	15479	2
2	0	2	0	0	15480	2
2	0	2	0	0	15481	2
2	0	2	0	0	15482	2
2	0	2	0	0	15483	2
2	0	2	0	0	15484	2
2	0	2	0	0	15485	2
2	6	2	0	6	15486	0
2	1	2	34	35	15487	1
2	0	2	1	1	15488	2
2	0	2	0	0	15489	2
2	1	2	0	1	15490	1
2	0	2	13	13	15491	2
2	0	2	1	1	15492	2
2	0	2	0	0	15493	2
2	0	2	0	0	15494	2
2	0	2	0	0	15495	2
2	0	2	0	0	15496	2
2	0	2	0	0	15497	2
2	0	2	0	0	15498	2
2	0	2	0	0	15499	2
2	0	2	0	0	15500	2
2	0	2	0	0	15501	2
2	0	2	0	0	15502	2
2	65	2	0	65	15503	0
2	0	2	215	215	15504	2
2	0	2	0	0	15505	2
2	0	2	3	3	15506	2
2	0	2	0	0	15507	2
2	0	2	0	0	15508	2
2	0	2	0	0	15509	2
2	0	2	0	0	15510	2
2	0	2	0	0	15511	2
2	0	2	0	0	15512	2
2	0	2	0	0	15513	2
2	0	2	0	0	15514	2
2	0	2	0	0	15515	2
2	0	2	0	0	15516	2
2	0	2	0	0	15517	2
2	0	2	0	0	15518	2
2	0	2	0	0	15519	2
2	0	2	0	0	15520	2
2	0	2	0	0	15521	2
2	0	2	0	0	15522	2
2	0	2	0	0	15523	2
2	0	2	0	0	15524	2
2	0	2	0	0	15525	2
2	0	2	0	0	15526	2
2	0	2	0	0	15527	2
2	0	2	0	0	15528	2
2	0	2	0	0	15529	2
2	0	2	0	0	15530	2
2	0	2	0	0	15531	2
2	0	2	0	0	15532	2
2	0	2	0	0	15533	2
2	0	2	0	0	15534	2
2	0	2	0	0	15535	2
2	0	2	0	0	15536	2
2	0	2	0	0	15537	2
2	0	2	0	0	15538	2
2	0	2	0	0	15539	2
2	0	2	0	0	15540	2
2	0	2	0	0	15541	2
2	0	2	0	0	15542	2
2	0	2	0	0	15543	2
2	0	2	0	0	15544	2
2	0	2	0	0	15545	2
2	0	2	0	0	15546	2
2	0	2	0	0	15547	2
2	0	2	0	0	15548	2
2	0	2	0	0	15549	2
2	0	2	0	0	15550	2
2	0	2	0	0	15551	2
2	0	2	0	0	15552	2
2	0	2	0	0	15553	2
2	0	2	0	0	15554	2
2	0	2	0	0	15555	2
2	0	2	0	0	15556	2
2	0	2	0	0	15557	2
2	0	2	0	0	15558	2
2	0	2	0	0	15559	2
2	0	2	1	1	15560	2
2	0	2	0	0	15561	2
2	0	2	0	0	15562	2
2	0	2	0	0	15563	2
2	0	2	0	0	15564	2
2	0	2	0	0	15565	2
2	0	2	0	0	15566	2
2	0	2	0	0	15567	2
2	0	2	0	0	15568	2
2	0	2	0	0	15569	2
2	0	2	0	0	15570	2
2	0	2	1	1	15571	2
2	0	2	0	0	15572	2
2	0	2	0	0	15573	2
2	5	2	0	5	15574	0
2	1	2	20	21	15575	1
2	0	2	2	2	15576	2
2	0	2	0	0	15577	2
2	1	2	0	1	15578	0
2	0	2	13	13	15579	2
2	0	2	0	0	15580	2
2	0	2	0	0	15581	2
2	0	2	0	0	15582	2
2	0	2	0	0	15583	2
2	0	2	0	0	15584	2
2	0	2	0	0	15585	2
2	3	2	1	4	15586	0
2	3	2	40	43	15587	1
2	0	2	1	1	15588	2
2	0	2	0	0	15589	2
2	0	2	0	0	15590	2
2	0	2	4	4	15591	2
2	0	2	0	0	15592	2
2	0	2	0	0	15593	2
2	0	2	0	0	15594	2
2	0	2	0	0	15595	2
2	0	2	0	0	15596	2
2	0	2	0	0	15597	2
2	0	2	0	0	15598	2
2	0	2	0	0	15599	2
2	0	2	0	0	15600	2
2	0	2	0	0	15601	2
2	0	2	0	0	15602	2
2	0	2	0	0	15603	2
2	0	2	0	0	15604	2
2	0	2	1	1	15605	2
2	0	2	0	0	15606	2
2	0	2	0	0	15607	2
2	0	2	0	0	15608	2
2	0	2	0	0	15609	2
2	0	2	0	0	15610	2
2	0	2	0	0	15611	2
2	0	2	0	0	15612	2
2	0	2	0	0	15613	2
2	0	2	0	0	15614	2
2	0	2	0	0	15615	2
2	0	2	0	0	15616	2
2	0	2	0	0	15617	2
2	0	2	0	0	15618	2
2	0	2	0	0	15619	2
2	0	2	0	0	15620	2
2	0	2	0	0	15621	2
2	0	2	0	0	15622	2
2	0	2	0	0	15623	2
2	0	2	0	0	15624	2
2	0	2	0	0	15625	2
2	0	2	0	0	15626	2
2	0	2	0	0	15627	2
2	0	2	0	0	15628	2
2	0	2	0	0	15629	2
2	0	2	0	0	15630	2
2	0	2	0	0	15631	2
2	0	2	0	0	15632	2
2	0	2	0	0	15633	2
2	2	2	0	2	15634	0
2	0	2	8	8	15635	2
2	0	2	3	3	15636	2
2	0	2	0	0	15637	2
2	10	2	0	10	15638	0
2	0	2	9	9	15639	2
2	0	2	0	0	15640	2
2	0	2	0	0	15641	2
2	0	2	0	0	15642	2
2	0	2	0	0	15643	2
2	0	2	0	0	15644	2
2	0	2	0	0	15645	2
2	0	2	0	0	15646	2
2	0	2	0	0	15647	2
2	0	2	0	0	15648	2
2	0	2	0	0	15649	2
2	0	2	0	0	15650	2
2	0	2	0	0	15651	2
2	0	2	0	0	15652	2
2	0	2	0	0	15653	2
2	0	2	0	0	15654	2
2	0	2	0	0	15655	2
2	0	2	0	0	15656	2
2	0	2	0	0	15657	2
2	0	2	0	0	15658	2
2	0	2	0	0	15659	2
2	0	2	0	0	15660	2
2	0	2	0	0	15661	2
2	0	2	0	0	15662	2
2	0	2	0	0	15663	2
2	0	2	0	0	15664	2
2	0	2	0	0	15665	2
2	0	2	0	0	15666	2
2	0	2	0	0	15667	2
2	0	2	0	0	15668	2
2	0	2	0	0	15669	2
2	0	2	0	0	15670	2
2	0	2	0	0	15671	2
2	0	2	0	0	15672	2
2	0	2	0	0	15673	2
2	0	2	0	0	15674	2
2	0	2	0	0	15675	2
2	0	2	0	0	15676	2
2	0	2	0	0	15677	2
2	0	2	0	0	15678	2
2	0	2	0	0	15679	2
2	0	2	0	0	15680	2
2	0	2	0	0	15681	2
2	0	2	0	0	15682	2
2	0	2	0	0	15683	2
2	0	2	0	0	15684	2
2	0	2	0	0	15685	2
2	0	2	0	0	15686	2
2	0	2	0	0	15687	2
2	0	2	0	0	15688	2
2	0	2	0	0	15689	2
2	0	2	0	0	15690	2
2	0	2	0	0	15691	2
2	0	2	0	0	15692	2
2	0	2	0	0	15693	2
2	0	2	0	0	15694	2
2	0	2	0	0	15695	2
2	0	2	0	0	15696	2
2	0	2	0	0	15697	2
2	0	2	0	0	15698	2
2	0	2	0	0	15699	2
2	0	2	0	0	15700	2
2	0	2	0	0	15701	2
2	0	2	0	0	15702	2
2	0	2	0	0	15703	2
2	0	2	0	0	15704	2
2	0	2	0	0	15705	2
2	0	2	0	0	15706	2
2	0	2	0	0	15707	2
2	0	2	2	2	15708	2
2	0	2	0	0	15709	2
2	0	2	0	0	15710	2
2	0	2	0	0	15711	2
2	0	2	1	1	15712	2
2	0	2	0	0	15713	2
2	0	2	0	0	15714	2
2	0	2	0	0	15715	2
2	0	2	0	0	15716	2
2	0	2	0	0	15717	2
2	0	2	0	0	15718	2
2	0	2	0	0	15719	2
2	0	2	0	0	15720	2
2	0	2	0	0	15721	2
2	0	2	0	0	15722	2
2	0	2	0	0	15723	2
2	0	2	0	0	15724	2
2	0	2	0	0	15725	2
2	0	2	0	0	15726	2
2	0	2	0	0	15727	2
2	0	2	0	0	15728	2
2	0	2	0	0	15729	2
2	0	2	0	0	15730	2
2	0	2	0	0	15731	2
2	0	2	0	0	15732	2
2	0	2	0	0	15733	2
2	0	2	0	0	15734	2
2	0	2	0	0	15735	2
2	0	2	0	0	15736	2
2	0	2	0	0	15737	2
2	0	2	0	0	15738	2
2	0	2	0	0	15739	2
2	0	2	0	0	15740	2
2	0	2	0	0	15741	2
2	0	2	0	0	15742	2
2	0	2	0	0	15743	2
2	0	2	0	0	15744	2
2	0	2	0	0	15745	2
2	0	2	0	0	15746	2
2	0	2	0	0	15747	2
2	0	2	0	0	15748	2
2	0	2	0	0	15749	2
2	0	2	0	0	15750	2
2	0	2	0	0	15751	2
2	0	2	0	0	15752	2
2	0	2	0	0	15753	2
2	0	2	0	0	15754	2
2	0	2	0	0	15755	2
2	0	2	0	0	15756	2
2	0	2	0	0	15757	2
2	0	2	0	0	15758	2
2	0	2	0	0	15759	2
2	0	2	0	0	15760	2
2	0	2	0	0	15761	2
2	0	2	0	0	15762	2
2	0	2	0	0	15763	2
2	0	2	0	0	15764	2
2	0	2	0	0	15765	2
2	0	2	0	0	15766	2
2	0	2	0	0	15767	2
2	0	2	0	0	15768	2
2	0	2	0	0	15769	2
2	0	2	0	0	15770	2
2	0	2	0	0	15771	2
2	0	2	0	0	15772	2
2	0	2	0	0	15773	2
2	0	2	0	0	15774	2
2	0	2	0	0	15775	2
2	0	2	0	0	15776	2
2	0	2	0	0	15777	2
2	0	2	0	0	15778	2
2	0	2	0	0	15779	2
2	0	2	0	0	15780	2
2	0	2	0	0	15781	2
2	0	2	0	0	15782	2
2	0	2	0	0	15783	2
2	0	2	0	0	15784	2
2	0	2	0	0	15785	2
2	0	2	2	2	15786	2
2	0	2	0	0	15787	2
2	0	2	0	0	15788	2
2	0	2	0	0	15789	2
2	0	2	0	0	15790	2
2	0	2	0	0	15791	2
2	0	2	0	0	15792	2
2	0	2	0	0	15793	2
2	0	2	0	0	15794	2
2	0	2	0	0	15795	2
2	0	2	0	0	15796	2
2	0	2	0	0	15797	2
2	0	2	5	5	15798	2
2	0	2	0	0	15799	2
2	0	2	0	0	15800	2
2	0	2	0	0	15801	2
2	0	2	0	0	15802	2
2	314	2	0	314	15803	0
2	0	2	0	0	15804	2
2	0	2	0	0	15805	2
2	0	2	0	0	15806	2
2	0	2	0	0	15807	2
2	0	2	0	0	15808	2
2	0	2	0	0	15809	2
2	0	2	0	0	15810	2
2	0	2	0	0	15811	2
2	0	2	0	0	15812	2
2	0	2	0	0	15813	2
2	0	2	0	0	15814	2
2	0	2	0	0	15815	2
2	0	2	0	0	15816	2
2	1	2	0	1	15817	0
2	0	2	0	0	15818	2
2	0	2	0	0	15819	2
2	0	2	0	0	15820	2
2	0	2	0	0	15821	2
2	0	2	0	0	15822	2
2	0	2	0	0	15823	2
2	0	2	0	0	15824	2
2	0	2	0	0	15825	2
2	0	2	0	0	15826	2
2	0	2	0	0	15827	2
2	0	2	0	0	15828	2
2	1	2	0	1	15829	0
2	0	2	15	15	15830	2
2	0	2	0	0	15831	2
2	0	2	0	0	15832	2
2	0	2	0	0	15833	2
2	0	2	0	0	15834	2
2	0	2	0	0	15835	2
2	0	2	0	0	15836	2
2	0	2	0	0	15837	2
2	0	2	0	0	15838	2
2	0	2	0	0	15839	2
2	0	2	0	0	15840	2
2	0	2	0	0	15841	2
2	0	2	16	16	15842	2
2	0	2	0	0	15843	2
2	0	2	0	0	15844	2
2	0	2	0	0	15845	2
2	0	2	0	0	15846	2
2	0	2	0	0	15847	2
2	0	2	0	0	15848	2
2	0	2	0	0	15849	2
2	0	2	0	0	15850	2
2	0	2	0	0	15851	2
2	0	2	0	0	15852	2
2	0	2	0	0	15853	2
2	0	2	0	0	15854	2
2	0	2	0	0	15855	2
2	0	2	0	0	15856	2
2	0	2	0	0	15857	2
2	0	2	0	0	15858	2
2	0	2	0	0	15859	2
2	0	2	0	0	15860	2
2	0	2	0	0	15861	2
2	0	2	0	0	15862	2
2	0	2	0	0	15863	2
2	0	2	0	0	15864	2
2	0	2	0	0	15865	2
2	0	2	0	0	15866	2
2	0	2	0	0	15867	2
2	0	2	60	60	15868	2
2	0	2	0	0	15869	2
2	0	2	0	0	15870	2
2	0	2	0	0	15871	2
2	0	2	0	0	15872	2
2	0	2	0	0	15873	2
2	1	2	0	1	15874	0
2	0	2	1	1	15875	2
2	0	2	0	0	15876	2
2	0	2	25	25	15877	2
2	0	2	0	0	15878	2
2	0	2	0	0	15879	2
2	0	2	55	55	15880	2
2	0	2	0	0	15881	2
2	0	2	0	0	15882	2
2	0	2	0	0	15883	2
2	0	2	0	0	15884	2
2	0	2	0	0	15885	2
2	0	2	0	0	15886	2
2	0	2	0	0	15887	2
2	0	2	0	0	15888	2
2	0	2	1	1	15889	2
2	0	2	0	0	15890	2
2	0	2	0	0	15891	2
2	0	2	0	0	15892	2
2	0	2	0	0	15893	2
2	0	2	0	0	15894	2
2	0	2	6	6	15895	2
2	0	2	0	0	15896	2
2	0	2	0	0	15897	2
2	0	2	0	0	15898	2
2	0	2	2	2	15899	2
2	0	2	0	0	15900	2
2	0	2	0	0	15901	2
2	0	2	0	0	15902	2
2	0	2	0	0	15903	2
2	0	2	0	0	15904	2
2	0	2	0	0	15905	2
2	0	2	0	0	15906	2
2	0	2	0	0	15907	2
2	0	2	0	0	15908	2
2	0	2	0	0	15909	2
2	0	2	0	0	15910	2
2	0	2	0	0	15911	2
2	0	2	0	0	15912	2
2	0	2	0	0	15913	2
2	0	2	0	0	15914	2
2	0	2	0	0	15915	2
2	0	2	0	0	15916	2
2	0	2	0	0	15917	2
2	0	2	0	0	15918	2
2	0	2	0	0	15919	2
2	0	2	0	0	15920	2
2	0	2	0	0	15921	2
2	0	2	0	0	15922	2
2	0	2	11	11	15923	2
2	0	2	0	0	15924	2
2	0	2	0	0	15925	2
2	0	2	0	0	15926	2
2	0	2	0	0	15927	2
2	0	2	0	0	15928	2
2	0	2	0	0	15929	2
2	0	2	0	0	15930	2
2	0	2	0	0	15931	2
2	0	2	0	0	15932	2
2	0	2	0	0	15933	2
2	0	2	0	0	15934	2
2	0	2	0	0	15935	2
2	0	2	0	0	15936	2
2	0	2	0	0	15937	2
2	0	2	0	0	15938	2
2	0	2	0	0	15939	2
2	0	2	0	0	15940	2
2	0	2	0	0	15941	2
2	0	2	0	0	15942	2
2	0	2	0	0	15943	2
2	0	2	0	0	15944	2
2	1	2	4	5	15945	1
2	0	2	0	0	15946	2
2	0	2	0	0	15947	2
2	0	2	0	0	15948	2
2	0	2	3	3	15949	2
2	0	2	0	0	15950	2
2	3	2	1	4	15951	1
2	0	2	0	0	15952	2
2	0	2	0	0	15953	2
2	0	2	0	0	15954	2
2	0	2	0	0	15955	2
2	0	2	0	0	15956	2
2	0	2	0	0	15957	2
2	0	2	0	0	15958	2
2	0	2	0	0	15959	2
2	0	2	0	0	15960	2
2	0	2	3	3	15961	2
2	2	2	0	2	15962	0
2	1	2	12	13	15963	1
2	0	2	0	0	15964	2
2	0	2	0	0	15965	2
2	1	2	0	1	15966	0
2	0	2	5	5	15967	2
2	0	2	0	0	15968	2
2	0	2	0	0	15969	2
2	0	2	0	0	15970	2
2	0	2	0	0	15971	2
2	0	2	0	0	15972	2
2	0	2	0	0	15973	2
2	0	2	0	0	15974	2
2	0	2	0	0	15975	2
2	0	2	0	0	15976	2
2	0	2	0	0	15977	2
2	0	2	0	0	15978	2
2	0	2	0	0	15979	2
2	0	2	0	0	15980	2
2	0	2	1	1	15981	2
2	0	2	0	0	15982	2
2	0	2	0	0	15983	2
2	0	2	0	0	15984	2
2	0	2	0	0	15985	2
2	0	2	0	0	15986	2
2	0	2	0	0	15987	2
2	0	2	0	0	15988	2
2	0	2	0	0	15989	2
2	0	2	0	0	15990	2
2	0	2	0	0	15991	2
2	0	2	0	0	15992	2
2	0	2	0	0	15993	2
2	0	2	0	0	15994	2
2	0	2	0	0	15995	2
2	0	2	0	0	15996	2
2	0	2	0	0	15997	2
2	0	2	0	0	15998	2
2	0	2	0	0	15999	2
2	0	2	0	0	16000	2
2	0	2	0	0	16001	2
2	0	2	0	0	16002	2
2	0	2	0	0	16003	2
2	0	2	0	0	16004	2
2	0	2	0	0	16005	2
2	0	2	0	0	16006	2
2	0	2	0	0	16007	2
2	0	2	0	0	16008	2
2	0	2	63	63	16009	2
2	0	2	0	0	16010	2
2	0	2	0	0	16011	2
2	2	2	1	3	16012	0
2	0	2	40	40	16013	2
2	17	2	0	17	16014	0
2	0	2	150	150	16015	2
2	0	2	2	2	16016	2
2	0	2	0	0	16017	2
2	0	2	0	0	16018	2
2	0	2	2	2	16019	2
2	0	2	0	0	16020	2
2	0	2	2	2	16021	2
2	0	2	0	0	16022	2
2	0	2	0	0	16023	2
2	0	2	0	0	16024	2
2	0	2	0	0	16025	2
2	0	2	0	0	16026	2
2	0	2	0	0	16027	2
2	0	2	0	0	16028	2
2	0	2	0	0	16029	2
2	0	2	0	0	16030	2
2	0	2	0	0	16031	2
2	4	2	0	4	16032	0
2	1	2	54	55	16033	1
2	0	2	0	0	16034	2
2	0	2	0	0	16035	2
2	2	2	0	2	16036	0
2	0	2	10	10	16037	2
2	0	2	0	0	16038	2
2	0	2	0	0	16039	2
2	0	2	0	0	16040	2
2	0	2	0	0	16041	2
2	0	2	0	0	16042	2
2	0	2	0	0	16043	2
2	0	2	0	0	16044	2
2	0	2	0	0	16045	2
2	0	2	0	0	16046	2
2	0	2	0	0	16047	2
2	0	2	0	0	16048	2
2	0	2	0	0	16049	2
2	0	2	0	0	16050	2
2	0	2	0	0	16051	2
2	0	2	0	0	16052	2
2	0	2	0	0	16053	2
2	0	2	0	0	16054	2
2	0	2	0	0	16055	2
2	0	2	0	0	16056	2
2	0	2	0	0	16057	2
2	0	2	0	0	16058	2
2	0	2	0	0	16059	2
2	0	2	0	0	16060	2
2	0	2	0	0	16061	2
2	0	2	0	0	16062	2
2	0	2	0	0	16063	2
2	0	2	0	0	16064	2
2	0	2	0	0	16065	2
2	0	2	0	0	16066	2
2	0	2	0	0	16067	2
2	0	2	0	0	16068	2
2	0	2	0	0	16069	2
2	0	2	0	0	16070	2
2	0	2	0	0	16071	2
2	0	2	0	0	16072	2
2	0	2	0	0	16073	2
2	0	2	0	0	16074	2
2	0	2	0	0	16075	2
2	0	2	0	0	16076	2
2	0	2	0	0	16077	2
2	0	2	0	0	16078	2
2	0	2	0	0	16079	2
2	0	2	0	0	16080	2
2	0	2	0	0	16081	2
2	0	2	0	0	16082	2
2	0	2	0	0	16083	2
2	0	2	0	0	16084	2
2	0	2	0	0	16085	2
2	0	2	0	0	16086	2
2	0	2	0	0	16087	2
2	0	2	0	0	16088	2
2	0	2	0	0	16089	2
2	0	2	0	0	16090	2
2	0	2	0	0	16091	2
2	0	2	0	0	16092	2
2	0	2	0	0	16093	2
2	0	2	0	0	16094	2
2	0	2	0	0	16095	2
2	0	2	0	0	16096	2
2	0	2	0	0	16097	2
2	0	2	0	0	16098	2
2	0	2	0	0	16099	2
2	0	2	0	0	16100	2
2	0	2	0	0	16101	2
2	0	2	0	0	16102	2
2	0	2	0	0	16103	2
2	0	2	0	0	16104	2
2	0	2	0	0	16105	2
2	0	2	0	0	16106	2
2	0	2	0	0	16107	2
2	0	2	0	0	16108	2
2	0	2	0	0	16109	2
2	0	2	0	0	16110	2
2	0	2	0	0	16111	2
2	0	2	0	0	16112	2
2	0	2	0	0	16113	2
2	0	2	0	0	16114	2
2	0	2	0	0	16115	2
2	0	2	0	0	16116	2
2	0	2	0	0	16117	2
2	0	2	0	0	16118	2
2	0	2	0	0	16119	2
2	0	2	0	0	16120	2
2	0	2	0	0	16121	2
2	0	2	0	0	16122	2
2	0	2	0	0	16123	2
2	0	2	0	0	16124	2
2	0	2	0	0	16125	2
2	0	2	0	0	16126	2
2	0	2	0	0	16127	2
2	0	2	0	0	16128	2
2	0	2	0	0	16129	2
2	0	2	0	0	16130	2
2	0	2	1	1	16131	2
2	0	2	0	0	16132	2
2	0	2	0	0	16133	2
2	0	2	0	0	16134	2
2	0	2	0	0	16135	2
2	0	2	0	0	16136	2
2	0	2	0	0	16137	2
2	0	2	0	0	16138	2
2	0	2	0	0	16139	2
2	0	2	0	0	16140	2
2	0	2	0	0	16141	2
2	1	2	0	1	16142	0
2	0	2	0	0	16143	2
2	0	2	0	0	16144	2
2	0	2	0	0	16145	2
2	0	2	0	0	16146	2
2	0	2	0	0	16147	2
2	0	2	0	0	16148	2
2	0	2	0	0	16149	2
2	0	2	0	0	16150	2
2	0	2	0	0	16151	2
2	0	2	0	0	16152	2
2	0	2	1	1	16153	2
2	0	2	0	0	16154	2
2	0	2	0	0	16155	2
2	0	2	0	0	16156	2
2	0	2	0	0	16157	2
2	0	2	0	0	16158	2
2	0	2	0	0	16159	2
2	0	2	0	0	16160	2
2	0	2	0	0	16161	2
2	0	2	0	0	16162	2
2	0	2	0	0	16163	2
2	0	2	0	0	16164	2
2	0	2	0	0	16165	2
2	0	2	0	0	16166	2
2	0	2	0	0	16167	2
2	0	2	0	0	16168	2
2	0	2	0	0	16169	2
2	0	2	0	0	16170	2
2	0	2	0	0	16171	2
2	0	2	0	0	16172	2
2	0	2	0	0	16173	2
2	0	2	0	0	16174	2
2	0	2	0	0	16175	2
2	0	2	0	0	16176	2
2	0	2	0	0	16177	2
2	0	2	0	0	16178	2
2	0	2	0	0	16179	2
2	0	2	0	0	16180	2
2	0	2	0	0	16181	2
2	0	2	0	0	16182	2
2	0	2	0	0	16183	2
2	0	2	0	0	16184	2
2	0	2	0	0	16185	2
2	0	2	0	0	16186	2
2	0	2	0	0	16187	2
2	0	2	0	0	16188	2
2	0	2	0	0	16189	2
2	0	0	5	5	16190	2
2	0	2	1	1	16191	2
2	0	2	0	0	16192	2
2	0	2	0	0	16193	2
2	0	2	0	0	16194	2
2	0	2	0	0	16195	2
2	0	2	0	0	16196	2
2	0	2	0	0	16197	2
2	0	2	0	0	16198	2
2	0	0	24	24	16199	2
2	0	2	0	0	16200	2
2	0	2	0	0	16201	2
2	0	2	0	0	16202	2
2	0	2	0	0	16203	2
2	0	2	0	0	16204	2
2	0	2	0	0	16205	2
2	0	2	0	0	16206	2
2	0	2	0	0	16207	2
2	0	2	0	0	16208	2
2	0	2	0	0	16209	2
2	0	2	0	0	16210	2
2	0	2	0	0	16211	2
2	0	2	0	0	16212	2
2	0	2	0	0	16213	2
2	0	2	0	0	16214	2
2	0	2	0	0	16215	2
2	0	2	0	0	16216	2
2	0	2	0	0	16217	2
2	0	2	0	0	16218	2
2	0	2	0	0	16219	2
2	0	2	0	0	16220	2
2	0	2	0	0	16221	2
2	0	2	0	0	16222	2
2	0	2	0	0	16223	2
2	0	2	0	0	16224	2
2	0	2	0	0	16225	2
2	16	2	1	17	16226	0
2	2	2	319	321	16227	1
2	0	2	6	6	16228	2
2	0	2	0	0	16229	2
2	4	2	3	7	16230	1
2	0	2	48	48	16231	2
2	0	2	0	0	16232	2
2	0	2	0	0	16233	2
2	0	2	0	0	16234	2
2	0	2	0	0	16235	2
2	0	2	0	0	16236	2
2	0	2	0	0	16237	2
2	0	2	0	0	16238	2
2	0	2	0	0	16239	2
2	0	2	0	0	16240	2
2	0	2	0	0	16241	2
2	0	2	0	0	16242	2
2	0	2	0	0	16243	2
2	0	2	0	0	16244	2
2	0	2	0	0	16245	2
2	0	2	0	0	16246	2
2	0	2	0	0	16247	2
2	0	2	0	0	16248	2
2	0	2	0	0	16249	2
2	0	2	0	0	16250	2
2	0	2	0	0	16251	2
2	0	2	0	0	16252	2
2	0	2	0	0	16253	2
2	0	2	0	0	16254	2
2	0	2	0	0	16255	2
2	0	2	0	0	16256	2
2	0	2	0	0	16257	2
2	0	2	0	0	16258	2
2	0	2	0	0	16259	2
2	0	2	1	1	16260	2
2	0	2	0	0	16261	2
2	0	2	0	0	16262	2
2	0	2	0	0	16263	2
2	0	2	0	0	16264	2
2	0	2	0	0	16265	2
2	0	2	0	0	16266	2
2	0	2	0	0	16267	2
2	0	2	0	0	16268	2
2	0	2	0	0	16269	2
2	0	2	0	0	16270	2
2	0	2	0	0	16271	2
2	0	2	0	0	16272	2
2	0	2	0	0	16273	2
2	0	2	0	0	16274	2
2	0	2	0	0	16275	2
2	0	2	0	0	16276	2
2	0	2	0	0	16277	2
2	0	2	0	0	16278	2
2	0	2	0	0	16279	2
2	0	2	0	0	16280	2
2	0	2	0	0	16281	2
2	0	2	0	0	16282	2
2	0	2	0	0	16283	2
2	0	2	0	0	16284	2
2	0	2	0	0	16285	2
2	0	2	0	0	16286	2
2	0	2	0	0	16287	2
2	0	2	0	0	16288	2
2	0	2	0	0	16289	2
2	0	2	0	0	16290	2
2	0	2	0	0	16291	2
2	0	2	0	0	16292	2
2	0	2	0	0	16293	2
2	0	2	0	0	16294	2
2	0	2	0	0	16295	2
2	0	2	0	0	16296	2
2	0	2	0	0	16297	2
2	0	2	0	0	16298	2
2	0	2	0	0	16299	2
2	0	2	1	1	16300	2
2	0	2	0	0	16301	2
2	0	2	0	0	16302	2
2	0	2	0	0	16303	2
2	0	2	0	0	16304	2
2	0	2	0	0	16305	2
2	0	2	0	0	16306	2
2	0	2	0	0	16307	2
2	0	2	0	0	16308	2
2	0	2	0	0	16309	2
2	0	2	0	0	16310	2
2	0	2	0	0	16311	2
2	0	2	0	0	16312	2
2	0	2	0	0	16313	2
2	0	2	0	0	16314	2
2	0	2	0	0	16315	2
2	0	2	0	0	16316	2
2	1	2	0	1	16317	1
2	0	2	1	1	16318	2
2	0	2	0	0	16319	2
2	0	2	0	0	16320	2
2	0	2	0	0	16321	2
2	0	2	0	0	16322	2
2	0	2	0	0	16323	2
2	0	2	0	0	16324	2
2	0	2	0	0	16325	2
2	0	2	0	0	16326	2
2	0	2	0	0	16327	2
2	0	2	0	0	16328	2
2	24	2	0	24	16329	0
2	5	2	12	17	16330	0
2	0	2	20	20	16331	2
2	1	2	326	327	16332	1
2	1	2	1	2	16333	1
2	0	2	2	2	16334	2
2	0	2	0	0	16335	2
2	0	2	0	0	16336	2
2	0	2	0	0	16337	2
2	0	2	0	0	16338	2
2	0	2	0	0	16339	2
2	0	2	0	0	16340	2
2	0	2	0	0	16341	2
2	2	2	3	5	16342	1
2	0	2	0	0	16343	2
2	0	2	0	0	16344	2
2	4	2	0	4	16345	1
2	0	2	7	7	16346	2
2	30	2	0	30	16347	0
2	8	2	332	340	16348	1
2	0	2	3	3	16349	2
2	0	2	0	0	16350	2
2	1	4	122	123	16351	1
2	0	2	77	77	16352	2
2	0	2	0	0	16353	2
2	0	2	0	0	16354	2
2	0	2	0	0	16355	2
2	0	2	0	0	16356	2
2	0	2	1	1	16357	2
2	0	2	0	0	16358	2
2	0	2	0	0	16359	2
2	0	2	0	0	16360	2
2	0	2	0	0	16361	2
2	0	2	0	0	16362	2
2	0	2	0	0	16363	2
2	0	2	0	0	16364	2
2	0	2	0	0	16365	2
2	0	2	0	0	16366	2
2	0	2	0	0	16367	2
2	0	2	0	0	16368	2
2	0	2	0	0	16369	2
2	0	2	0	0	16370	2
2	0	2	0	0	16371	2
2	0	2	0	0	16372	2
2	0	2	0	0	16373	2
2	0	2	0	0	16374	2
2	0	2	0	0	16375	2
2	0	2	0	0	16376	2
2	0	2	0	0	16377	2
2	0	2	0	0	16378	2
2	0	2	0	0	16379	2
2	0	2	0	0	16380	2
2	0	2	0	0	16381	2
2	0	2	0	0	16382	2
2	0	2	0	0	16383	2
2	0	2	0	0	16384	2
2	0	2	0	0	16385	2
2	0	2	0	0	16386	2
2	0	2	0	0	16387	2
2	0	2	0	0	16388	2
2	0	2	0	0	16389	2
2	0	2	0	0	16390	2
2	0	2	0	0	16391	2
2	0	2	0	0	16392	2
2	0	2	0	0	16393	2
2	0	2	0	0	16394	2
2	0	2	0	0	16395	2
2	0	2	0	0	16396	2
2	0	2	0	0	16397	2
2	0	2	0	0	16398	2
2	0	2	0	0	16399	2
2	0	2	0	0	16400	2
2	0	2	0	0	16401	2
2	0	2	0	0	16402	2
2	0	2	0	0	16403	2
2	0	2	0	0	16404	2
2	0	2	0	0	16405	2
2	32	2	0	32	16406	0
2	0	2	0	0	16407	2
2	0	2	0	0	16408	2
2	1	2	0	1	16409	0
2	0	2	4	4	16410	2
2	0	2	1	1	16411	2
2	0	2	0	0	16412	2
2	1	2	0	1	16413	0
2	0	2	9	9	16414	2
2	0	2	0	0	16415	2
2	0	2	0	0	16416	2
2	0	2	0	0	16417	2
2	0	2	0	0	16418	2
2	0	2	0	0	16419	2
2	0	2	0	0	16420	2
2	0	2	0	0	16421	2
2	0	2	0	0	16422	2
2	0	2	0	0	16423	2
2	0	2	0	0	16424	2
2	0	2	0	0	16425	2
2	0	2	0	0	16426	2
2	0	2	0	0	16427	2
2	0	2	0	0	16428	2
2	0	2	0	0	16429	2
2	0	2	0	0	16430	2
2	0	2	0	0	16431	2
2	0	2	0	0	16432	2
2	0	2	0	0	16433	2
2	0	2	0	0	16434	2
2	0	2	0	0	16435	2
2	0	2	0	0	16436	2
2	0	2	0	0	16437	2
2	0	2	0	0	16438	2
2	0	2	0	0	16439	2
2	0	2	0	0	16440	2
2	0	2	0	0	16441	2
2	0	2	0	0	16442	2
2	0	2	0	0	16443	2
2	0	2	0	0	16444	2
2	0	2	0	0	16445	2
2	0	2	0	0	16446	2
2	0	2	0	0	16447	2
2	0	2	0	0	16448	2
2	0	2	0	0	16449	2
2	1	2	0	1	16450	1
2	0	2	0	0	16451	2
2	0	2	0	0	16452	2
2	1	2	0	1	16453	1
2	0	2	0	0	16454	2
2	0	2	0	0	16455	2
2	0	2	0	0	16456	2
2	0	2	0	0	16457	2
2	0	2	0	0	16458	2
2	0	2	0	0	16459	2
2	0	2	0	0	16460	2
2	0	2	0	0	16461	2
2	0	2	0	0	16462	2
2	0	2	0	0	16463	2
2	0	2	0	0	16464	2
2	0	2	0	0	16465	2
2	0	2	0	0	16466	2
2	0	2	1	1	16467	2
2	0	2	0	0	16468	2
2	0	2	0	0	16469	2
2	0	2	0	0	16470	2
2	0	2	0	0	16471	2
2	0	2	0	0	16472	2
2	0	2	0	0	16473	2
2	0	2	0	0	16474	2
2	0	2	0	0	16475	2
2	0	2	0	0	16476	2
2	0	2	0	0	16477	2
2	0	2	0	0	16478	2
2	0	2	0	0	16479	2
2	0	2	0	0	16480	2
2	0	2	0	0	16481	2
2	0	2	0	0	16482	2
2	0	2	0	0	16483	2
2	0	2	0	0	16484	2
2	0	2	0	0	16485	2
2	0	2	0	0	16486	2
2	0	2	0	0	16487	2
2	0	2	0	0	16488	2
2	0	2	0	0	16489	2
2	0	2	0	0	16490	2
2	0	2	0	0	16491	2
2	0	2	9	9	16492	2
2	0	2	0	0	16493	2
2	0	2	0	0	16494	2
2	0	2	0	0	16495	2
2	0	2	0	0	16496	2
2	0	2	0	0	16497	2
2	0	2	0	0	16498	2
2	0	2	0	0	16499	2
2	0	2	0	0	16500	2
2	0	2	0	0	16501	2
2	0	2	0	0	16502	2
2	0	2	0	0	16503	2
2	0	2	0	0	16504	2
2	0	2	0	0	16505	2
2	46	2	2	48	16506	0
2	2	2	52	54	16507	1
2	0	2	4	4	16508	2
2	2	2	0	2	16509	0
2	0	2	46	46	16510	2
2	0	2	0	0	16511	2
2	0	2	0	0	16512	2
2	0	2	0	0	16513	2
2	0	2	2	2	16514	2
2	0	2	0	0	16515	2
2	0	2	0	0	16516	2
2	0	2	0	0	16517	2
2	0	2	0	0	16518	2
2	0	2	0	0	16519	2
2	0	2	0	0	16520	2
2	0	2	0	0	16521	2
2	0	2	0	0	16522	2
2	0	2	0	0	16523	2
2	0	2	0	0	16524	2
2	0	2	0	0	16525	2
2	0	2	0	0	16526	2
2	0	2	0	0	16527	2
2	0	2	0	0	16528	2
2	0	2	0	0	16529	2
2	0	2	0	0	16530	2
2	0	2	0	0	16531	2
2	0	2	0	0	16532	2
2	0	2	0	0	16533	2
2	0	2	0	0	16534	2
2	0	2	0	0	16535	2
2	0	2	0	0	16536	2
2	0	2	0	0	16537	2
2	0	2	0	0	16538	2
2	0	2	0	0	16539	2
2	0	2	0	0	16540	2
2	0	2	0	0	16541	2
2	0	2	0	0	16542	2
2	0	2	0	0	16543	2
2	0	2	0	0	16544	2
2	0	2	0	0	16545	2
2	0	2	0	0	16546	2
2	0	2	0	0	16547	2
2	0	2	0	0	16548	2
2	0	2	0	0	16549	2
2	0	2	0	0	16550	2
2	0	2	0	0	16551	2
2	0	2	0	0	16552	2
2	0	2	0	0	16553	2
2	0	2	0	0	16554	2
2	0	2	0	0	16555	2
2	0	2	0	0	16556	2
2	1	2	0	1	16557	1
2	0	2	0	0	16558	2
2	0	2	0	0	16559	2
2	0	2	0	0	16560	2
2	0	2	0	0	16561	2
2	1	2	1	2	16562	1
2	0	2	0	0	16563	2
2	0	2	0	0	16564	2
2	0	2	0	0	16565	2
2	0	2	0	0	16566	2
2	0	2	0	0	16567	2
2	0	2	0	0	16568	2
2	0	2	0	0	16569	2
2	0	2	0	0	16570	2
2	0	2	0	0	16571	2
2	0	2	0	0	16572	2
2	0	2	0	0	16573	2
2	0	2	0	0	16574	2
2	0	2	0	0	16575	2
2	0	2	0	0	16576	2
2	0	2	0	0	16577	2
2	0	2	0	0	16578	2
2	0	2	0	0	16579	2
2	0	2	0	0	16580	2
2	0	2	0	0	16581	2
2	1	2	0	1	16582	0
2	0	2	0	0	16583	2
2	0	2	0	0	16584	2
2	0	2	0	0	16585	2
2	0	2	0	0	16586	2
2	0	2	0	0	16587	2
2	0	2	0	0	16588	2
2	0	2	3	3	16589	2
2	0	2	0	0	16590	2
2	0	2	0	0	16591	2
2	0	2	0	0	16592	2
2	0	2	0	0	16593	2
2	0	2	0	0	16594	2
2	0	2	0	0	16595	2
2	0	2	0	0	16596	2
2	0	2	129	129	16597	2
2	0	2	0	0	16598	2
2	0	2	4	4	16599	2
2	0	2	0	0	16600	2
2	0	2	0	0	16601	2
2	0	2	0	0	16602	2
2	0	2	0	0	16603	2
2	0	2	0	0	16604	2
2	0	2	0	0	16605	2
2	8	2	0	8	16606	0
2	1	2	5	6	16607	1
2	0	2	1	1	16608	2
2	0	2	0	0	16609	2
2	0	2	157	157	16610	2
2	0	2	4	4	16611	2
2	0	2	0	0	16612	2
2	0	2	0	0	16613	2
2	0	2	0	0	16614	2
2	0	2	0	0	16615	2
2	0	2	0	0	16616	2
2	0	2	0	0	16617	2
2	0	2	0	0	16618	2
2	0	2	0	0	16619	2
2	0	2	0	0	16620	2
2	0	2	0	0	16621	2
2	0	2	0	0	16622	2
2	1	2	0	1	16623	0
2	3	2	36	39	16624	1
2	0	2	0	0	16625	2
2	0	2	0	0	16626	2
2	0	2	0	0	16627	2
2	0	2	1	1	16628	2
2	0	2	0	0	16629	2
2	0	2	0	0	16630	2
2	0	2	0	0	16631	2
2	0	2	0	0	16632	2
2	0	2	0	0	16633	2
2	0	2	0	0	16634	2
2	0	2	0	0	16635	2
2	0	2	15	15	16636	2
2	0	2	0	0	16637	2
2	0	2	0	0	16638	2
2	0	2	1	1	16639	2
2	0	2	0	0	16640	2
2	0	2	0	0	16641	2
2	0	2	0	0	16642	2
2	0	2	0	0	16643	2
2	0	2	0	0	16644	2
2	0	2	0	0	16645	2
2	0	2	0	0	16646	2
2	0	2	0	0	16647	2
2	0	2	0	0	16648	2
2	0	2	0	0	16649	2
2	0	2	0	0	16650	2
2	0	2	30	30	16651	2
2	0	2	1	1	16652	2
2	0	2	0	0	16653	2
2	0	2	2	2	16654	2
2	1	2	0	1	16655	0
2	0	2	0	0	16656	2
2	0	2	0	0	16657	2
2	0	2	0	0	16658	2
2	0	2	0	0	16659	2
2	0	2	0	0	16660	2
2	0	2	0	0	16661	2
2	0	2	14	14	16662	2
2	0	2	4	4	16663	2
2	0	2	0	0	16664	2
2	0	2	0	0	16665	2
2	0	2	0	0	16666	2
2	0	2	5	5	16667	2
2	0	2	0	0	16668	2
2	0	2	0	0	16669	2
2	0	2	0	0	16670	2
2	0	2	2	2	16671	2
2	2	2	0	2	16672	0
2	0	2	1	1	16673	2
2	0	2	0	0	16674	2
2	0	2	0	0	16675	2
2	0	2	0	0	16676	2
2	0	2	1	1	16677	2
2	0	2	0	0	16678	2
2	0	2	0	0	16679	2
2	0	2	0	0	16680	2
2	0	2	0	0	16681	2
2	0	2	0	0	16682	2
2	0	2	0	0	16683	2
2	0	2	0	0	16684	2
2	0	2	0	0	16685	2
2	0	2	0	0	16686	2
2	0	2	0	0	16687	2
2	0	2	0	0	16688	2
2	0	2	0	0	16689	2
2	11	2	0	11	16690	0
2	0	2	124	124	16691	2
2	0	2	1	1	16692	2
2	0	2	1	1	16693	2
2	5	2	0	5	16694	0
2	0	2	19	19	16695	2
2	0	2	0	0	16696	2
2	0	2	0	0	16697	2
2	0	2	0	0	16698	2
2	0	2	0	0	16699	2
2	0	2	0	0	16700	2
2	0	2	0	0	16701	2
2	0	2	0	0	16702	2
2	0	2	0	0	16703	2
2	0	2	0	0	16704	2
2	0	2	0	0	16705	2
2	0	2	0	0	16706	2
2	0	2	0	0	16707	2
2	0	2	0	0	16708	2
2	0	2	0	0	16709	2
2	0	2	0	0	16710	2
2	0	2	0	0	16711	2
2	0	2	0	0	16712	2
2	0	2	0	0	16713	2
2	0	2	0	0	16714	2
2	0	2	0	0	16715	2
2	0	2	0	0	16716	2
2	0	2	1	1	16717	2
2	0	2	0	0	16718	2
2	0	2	0	0	16719	2
2	0	2	0	0	16720	2
2	0	2	0	0	16721	2
2	0	2	0	0	16722	2
2	0	0	84	84	16723	2
2	0	2	0	0	16724	2
2	0	2	0	0	16725	2
2	0	0	17	17	16726	2
2	0	2	0	0	16727	2
2	0	2	0	0	16728	2
2	0	2	0	0	16729	2
2	0	2	0	0	16730	2
2	0	2	0	0	16731	2
2	0	2	0	0	16732	2
2	0	2	0	0	16733	2
2	0	2	0	0	16734	2
2	0	2	0	0	16735	2
2	0	2	0	0	16736	2
2	0	2	0	0	16737	2
2	0	2	0	0	16738	2
2	0	2	0	0	16739	2
2	0	2	0	0	16740	2
2	1	2	2	3	16741	1
2	0	2	0	0	16742	2
2	0	2	0	0	16743	2
2	2	2	0	2	16744	0
2	0	2	5	5	16745	2
2	0	2	0	0	16746	2
2	0	2	0	0	16747	2
2	0	2	0	0	16748	2
2	0	2	0	0	16749	2
2	0	2	0	0	16750	2
2	0	2	0	0	16751	2
2	0	2	0	0	16752	2
2	0	2	0	0	16753	2
2	0	2	0	0	16754	2
2	0	2	0	0	16755	2
2	0	2	0	0	16756	2
2	0	2	0	0	16757	2
2	0	2	0	0	16758	2
2	0	2	0	0	16759	2
2	0	2	0	0	16760	2
2	0	2	0	0	16761	2
2	0	2	0	0	16762	2
2	0	2	0	0	16763	2
2	0	2	0	0	16764	2
2	0	2	0	0	16765	2
2	0	2	0	0	16766	2
2	0	2	0	0	16767	2
2	0	2	0	0	16768	2
2	0	2	0	0	16769	2
2	0	2	0	0	16770	2
2	0	2	0	0	16771	2
2	0	2	0	0	16772	2
2	0	2	0	0	16773	2
2	0	2	0	0	16774	2
2	1	4	0	1	16775	1
2	0	2	5	5	16776	2
2	11	2	0	11	16777	0
2	0	2	26	26	16778	2
2	0	2	0	0	16779	2
2	0	2	0	0	16780	2
2	0	2	0	0	16781	2
2	0	2	3	3	16782	2
2	0	2	1	1	16783	2
2	0	2	0	0	16784	2
2	0	2	1	1	16785	2
2	0	2	0	0	16786	2
2	0	2	0	0	16787	2
2	0	2	0	0	16788	2
2	0	2	0	0	16789	2
2	0	2	0	0	16790	2
2	0	2	0	0	16791	2
2	0	2	0	0	16792	2
2	0	2	0	0	16793	2
2	0	2	0	0	16794	2
2	0	2	0	0	16795	2
2	0	2	0	0	16796	2
2	0	2	0	0	16797	2
2	0	2	0	0	16798	2
2	0	2	0	0	16799	2
2	0	2	0	0	16800	2
2	0	2	0	0	16801	2
2	0	2	0	0	16802	2
2	0	2	0	0	16803	2
2	0	2	0	0	16804	2
2	0	2	0	0	16805	2
2	0	2	0	0	16806	2
2	0	2	0	0	16807	2
2	0	2	0	0	16808	2
2	0	2	0	0	16809	2
2	0	2	0	0	16810	2
2	0	2	0	0	16811	2
2	0	2	0	0	16812	2
2	0	2	0	0	16813	2
2	0	2	0	0	16814	2
2	0	2	0	0	16815	2
2	0	2	0	0	16816	2
2	0	2	0	0	16817	2
2	0	2	0	0	16818	2
2	0	2	0	0	16819	2
2	0	2	0	0	16820	2
2	0	2	0	0	16821	2
2	0	2	0	0	16822	2
2	0	2	0	0	16823	2
2	0	2	0	0	16824	2
2	0	2	0	0	16825	2
2	0	2	0	0	16826	2
2	0	2	0	0	16827	2
2	0	2	0	0	16828	2
2	0	2	0	0	16829	2
2	0	2	0	0	16830	2
2	0	2	0	0	16831	2
2	0	2	0	0	16832	2
2	0	2	0	0	16833	2
2	0	2	0	0	16834	2
2	0	2	0	0	16835	2
2	0	2	0	0	16836	2
2	0	2	0	0	16837	2
2	0	2	0	0	16838	2
2	0	2	0	0	16839	2
2	0	2	0	0	16840	2
2	0	2	0	0	16841	2
2	0	2	0	0	16842	2
2	0	2	0	0	16843	2
2	0	2	0	0	16844	2
2	0	2	0	0	16845	2
2	0	2	0	0	16846	2
2	0	2	0	0	16847	2
2	0	2	0	0	16848	2
2	0	2	0	0	16849	2
2	0	2	0	0	16850	2
2	0	2	0	0	16851	2
2	0	2	0	0	16852	2
2	0	2	0	0	16853	2
2	0	2	0	0	16854	2
2	0	2	0	0	16855	2
2	0	2	0	0	16856	2
2	0	2	0	0	16857	2
2	0	2	0	0	16858	2
2	0	2	0	0	16859	2
2	0	2	0	0	16860	2
2	0	2	0	0	16861	2
2	0	2	0	0	16862	2
2	0	2	0	0	16863	2
2	0	2	0	0	16864	2
2	0	2	0	0	16865	2
2	0	2	0	0	16866	2
2	0	2	0	0	16867	2
2	0	2	0	0	16868	2
2	0	2	0	0	16869	2
2	0	2	0	0	16870	2
2	0	2	0	0	16871	2
2	0	2	0	0	16872	2
2	0	2	0	0	16873	2
2	6	2	0	6	16874	0
2	1	2	100	101	16875	1
2	0	2	0	0	16876	2
2	0	2	0	0	16877	2
2	0	2	0	0	16878	2
2	0	2	0	0	16879	2
2	0	2	0	0	16880	2
2	0	2	0	0	16881	2
2	0	2	0	0	16882	2
2	0	2	0	0	16883	2
2	0	2	0	0	16884	2
2	0	2	0	0	16885	2
2	0	2	0	0	16886	2
2	0	2	0	0	16887	2
2	31	2	4069	4100	16888	0
2	0	2	0	0	16889	2
2	0	2	0	0	16890	2
2	0	2	0	0	16891	2
2	0	2	0	0	16892	2
2	0	2	0	0	16893	2
2	0	2	0	0	16894	2
2	0	2	0	0	16895	2
2	0	2	0	0	16896	2
2	0	2	0	0	16897	2
2	0	2	0	0	16898	2
2	0	2	0	0	16899	2
2	0	2	0	0	16900	2
2	0	2	0	0	16901	2
2	0	2	0	0	16902	2
2	0	2	0	0	16903	2
2	0	2	0	0	16904	2
2	0	2	0	0	16905	2
2	0	2	0	0	16906	2
2	0	2	0	0	16907	2
2	0	2	0	0	16908	2
2	0	2	0	0	16909	2
2	0	2	0	0	16910	2
2	0	2	0	0	16911	2
2	0	2	0	0	16912	2
2	0	2	0	0	16913	2
2	0	2	0	0	16914	2
2	0	2	0	0	16915	2
2	0	2	0	0	16916	2
2	0	2	0	0	16917	2
2	0	2	0	0	16918	2
2	0	2	0	0	16919	2
2	0	2	0	0	16920	2
2	0	2	0	0	16921	2
2	1	2	5	6	16922	1
2	0	2	0	0	16923	2
2	0	2	0	0	16924	2
2	3	2	3	6	16925	0
2	0	2	2	2	16926	2
2	0	2	0	0	16927	2
2	0	2	0	0	16928	2
2	0	2	0	0	16929	2
2	0	2	0	0	16930	2
2	0	2	0	0	16931	2
2	0	2	0	0	16932	2
2	0	2	0	0	16933	2
2	0	2	0	0	16934	2
2	0	2	0	0	16935	2
2	0	2	0	0	16936	2
2	0	2	0	0	16937	2
2	0	2	0	0	16938	2
2	0	2	0	0	16939	2
2	0	2	0	0	16940	2
2	3	2	0	3	16941	0
2	0	2	0	0	16942	2
2	0	2	0	0	16943	2
2	0	2	0	0	16944	2
2	0	2	0	0	16945	2
2	0	2	0	0	16946	2
2	0	2	0	0	16947	2
2	0	2	32	32	16948	2
2	0	2	3	3	16949	2
2	0	2	0	0	16950	2
2	1	2	0	1	16951	1
2	0	2	12	12	16952	2
2	0	2	0	0	16953	2
2	0	2	0	0	16954	2
2	0	2	0	0	16955	2
2	0	2	0	0	16956	2
4	957	2	326	1283	16957	0
4	405	2	12	417	16958	0
2	0	2	0	0	16959	2
2	0	2	0	0	16960	2
2	0	2	0	0	16961	2
2	0	2	0	0	16962	2
2	0	2	0	0	16963	2
2	0	2	0	0	16964	2
2	0	2	0	0	16965	2
2	0	2	0	0	16966	2
2	0	2	0	0	16967	2
2	0	2	0	0	16968	2
2	0	2	0	0	16969	2
2	0	2	0	0	16970	2
2	0	2	0	0	16971	2
2	0	2	3	3	16972	2
2	0	2	0	0	16973	2
2	0	2	0	0	16974	2
2	0	2	0	0	16975	2
2	0	2	68	68	16976	2
2	0	2	0	0	16977	2
2	0	2	0	0	16978	2
2	0	2	0	0	16979	2
2	0	2	0	0	16980	2
2	0	2	0	0	16981	2
2	0	2	0	0	16982	2
2	0	2	0	0	16983	2
2	0	2	0	0	16984	2
2	0	2	0	0	16985	2
2	0	2	0	0	16986	2
2	0	2	0	0	16987	2
2	0	2	0	0	16988	2
2	0	2	0	0	16989	2
2	0	2	0	0	16990	2
2	0	2	0	0	16991	2
2	0	2	0	0	16992	2
2	0	2	0	0	16993	2
2	0	2	0	0	16994	2
2	0	2	0	0	16995	2
2	0	2	4	4	16996	2
2	0	2	0	0	16997	2
2	0	2	0	0	16998	2
2	0	2	0	0	16999	2
2	0	2	0	0	17000	2
2	0	2	0	0	17001	2
2	0	2	7	7	17002	2
2	0	2	0	0	17003	2
2	0	2	0	0	17004	2
2	0	2	0	0	17005	2
2	0	2	1	1	17006	2
2	0	2	0	0	17007	2
2	0	2	3	3	17008	2
2	0	2	0	0	17009	2
2	0	2	0	0	17010	2
2	0	2	0	0	17011	2
2	0	2	0	0	17012	2
2	0	2	0	0	17013	2
2	0	2	0	0	17014	2
2	0	2	0	0	17015	2
2	0	2	0	0	17016	2
2	0	2	0	0	17017	2
2	0	2	0	0	17018	2
2	0	2	5	5	17019	2
2	0	2	0	0	17020	2
2	0	2	0	0	17021	2
2	0	2	2	2	17022	2
2	0	2	0	0	17023	2
2	0	2	0	0	17024	2
2	0	2	0	0	17025	2
2	0	2	0	0	17026	2
2	0	2	0	0	17027	2
2	0	2	0	0	17028	2
2	0	2	0	0	17029	2
2	0	2	0	0	17030	2
2	0	2	0	0	17031	2
2	0	2	0	0	17032	2
2	0	2	0	0	17033	2
2	0	2	0	0	17034	2
2	0	2	0	0	17035	2
2	0	2	0	0	17036	2
2	0	2	0	0	17037	2
2	0	2	0	0	17038	2
2	0	2	0	0	17039	2
2	0	2	0	0	17040	2
2	0	2	0	0	17041	2
2	0	2	0	0	17042	2
2	0	2	0	0	17043	2
2	0	2	0	0	17044	2
2	0	2	0	0	17045	2
2	0	2	0	0	17046	2
2	0	2	0	0	17047	2
2	0	2	0	0	17048	2
2	0	2	0	0	17049	2
2	0	2	0	0	17050	2
2	0	2	0	0	17051	2
2	0	2	0	0	17052	2
2	0	2	0	0	17053	2
2	0	2	0	0	17054	2
2	0	2	0	0	17055	2
2	0	2	0	0	17056	2
2	0	2	0	0	17057	2
2	0	2	0	0	17058	2
2	0	2	0	0	17059	2
2	0	2	0	0	17060	2
2	0	2	0	0	17061	2
2	0	2	0	0	17062	2
2	0	2	0	0	17063	2
2	0	2	0	0	17064	2
2	0	2	0	0	17065	2
2	0	2	0	0	17066	2
2	0	2	0	0	17067	2
2	0	2	0	0	17068	2
2	0	2	0	0	17069	2
2	0	2	0	0	17070	2
2	0	2	0	0	17071	2
2	0	2	0	0	17072	2
2	0	2	0	0	17073	2
2	0	2	0	0	17074	2
2	0	2	0	0	17075	2
2	0	2	0	0	17076	2
2	0	2	0	0	17077	2
2	0	2	0	0	17078	2
2	0	2	0	0	17079	2
2	0	2	0	0	17080	2
2	0	2	0	0	17081	2
2	0	2	0	0	17082	2
2	0	2	0	0	17083	2
2	0	2	0	0	17084	2
2	0	2	0	0	17085	2
2	0	2	0	0	17086	2
2	0	2	0	0	17087	2
2	0	2	0	0	17088	2
2	0	2	0	0	17089	2
2	0	2	0	0	17090	2
2	0	2	0	0	17091	2
2	0	2	0	0	17092	2
2	0	2	0	0	17093	2
2	0	2	0	0	17094	2
2	0	2	0	0	17095	2
2	0	4	0	0	17096	2
2	0	2	0	0	17097	2
2	0	2	0	0	17098	2
2	0	2	0	0	17099	2
2	0	2	0	0	17100	2
2	0	2	0	0	17101	2
2	0	2	0	0	17102	2
2	0	2	0	0	17103	2
2	0	2	0	0	17104	2
2	0	2	0	0	17105	2
2	0	2	0	0	17106	2
2	0	2	0	0	17107	2
2	0	2	0	0	17108	2
2	0	2	0	0	17109	2
2	0	2	0	0	17110	2
2	0	2	0	0	17111	2
2	0	2	0	0	17112	2
2	0	2	0	0	17113	2
2	0	2	0	0	17114	2
2	0	2	0	0	17115	2
2	0	2	0	0	17116	2
2	0	2	0	0	17117	2
2	0	2	0	0	17118	2
2	0	2	0	0	17119	2
2	0	2	0	0	17120	2
2	0	2	0	0	17121	2
2	0	2	0	0	17122	2
2	0	2	0	0	17123	2
2	0	2	0	0	17124	2
2	0	2	0	0	17125	2
2	0	2	0	0	17126	2
2	0	2	0	0	17127	2
2	0	2	0	0	17128	2
2	0	2	0	0	17129	2
2	0	2	0	0	17130	2
2	0	2	0	0	17131	2
2	0	2	0	0	17132	2
2	0	2	0	0	17133	2
2	0	2	0	0	17134	2
2	0	2	0	0	17135	2
2	0	2	0	0	17136	2
2	0	2	0	0	17137	2
2	0	2	0	0	17138	2
2	0	2	0	0	17139	2
2	0	2	0	0	17140	2
2	0	2	0	0	17141	2
2	0	2	1	1	17142	2
2	0	2	0	0	17143	2
2	0	2	0	0	17144	2
2	1	2	1	2	17145	1
2	0	2	0	0	17146	2
2	3	2	2	5	17147	0
2	35	2	16	51	17148	1
2	0	2	1	1	17149	2
2	1	2	0	1	17150	1
2	0	2	0	0	17151	2
2	0	2	0	0	17152	2
2	0	2	0	0	17153	2
2	0	2	0	0	17154	2
2	0	2	0	0	17155	2
2	0	2	0	0	17156	2
2	0	2	0	0	17157	2
2	0	2	0	0	17158	2
2	0	2	0	0	17159	2
2	0	2	0	0	17160	2
2	0	2	0	0	17161	2
2	0	2	0	0	17162	2
2	6	2	2	8	17163	1
2	0	2	53	53	17164	2
2	0	2	0	0	17165	2
2	0	2	0	0	17166	2
2	0	2	0	0	17167	2
2	0	2	0	0	17168	2
2	0	2	0	0	17169	2
2	0	2	0	0	17170	2
2	0	2	0	0	17171	2
2	0	2	0	0	17172	2
2	0	2	0	0	17173	2
2	0	2	0	0	17174	2
2	0	2	0	0	17175	2
2	0	2	0	0	17176	2
2	0	2	0	0	17177	2
2	0	2	0	0	17178	2
2	0	2	0	0	17179	2
2	0	2	0	0	17180	2
2	0	2	0	0	17181	2
2	0	2	0	0	17182	2
2	0	2	0	0	17183	2
2	0	2	0	0	17184	2
2	0	2	0	0	17185	2
2	0	2	0	0	17186	2
2	0	2	0	0	17187	2
2	0	2	0	0	17188	2
2	0	2	0	0	17189	2
2	0	2	0	0	17190	2
2	0	2	0	0	17191	2
2	0	2	0	0	17192	2
2	0	2	0	0	17193	2
2	0	2	0	0	17194	2
2	0	2	0	0	17195	2
2	0	2	0	0	17196	2
2	0	2	0	0	17197	2
2	0	2	0	0	17198	2
2	0	2	0	0	17199	2
2	0	2	0	0	17200	2
2	0	2	0	0	17201	2
2	0	2	0	0	17202	2
2	0	2	0	0	17203	2
2	0	2	0	0	17204	2
2	0	2	0	0	17205	2
2	0	2	0	0	17206	2
2	0	2	0	0	17207	2
2	0	2	1	1	17208	2
2	0	2	0	0	17209	2
2	0	2	0	0	17210	2
2	0	2	0	0	17211	2
2	0	2	0	0	17212	2
2	0	2	0	0	17213	2
2	0	2	0	0	17214	2
2	0	2	0	0	17215	2
2	0	2	0	0	17216	2
2	0	2	0	0	17217	2
2	0	2	0	0	17218	2
2	52	2	0	52	17219	0
2	12	2	289	301	17220	1
2	0	2	0	0	17221	2
2	0	2	0	0	17222	2
2	0	2	0	0	17223	2
2	0	2	0	0	17224	2
2	0	2	0	0	17225	2
2	0	2	0	0	17226	2
2	0	2	0	0	17227	2
2	0	2	0	0	17228	2
2	0	2	0	0	17229	2
2	0	2	0	0	17230	2
2	0	2	0	0	17231	2
2	0	2	0	0	17232	2
2	0	2	0	0	17233	2
2	0	2	0	0	17234	2
2	0	2	0	0	17235	2
2	0	2	0	0	17236	2
2	0	2	0	0	17237	2
2	0	2	0	0	17238	2
2	0	2	0	0	17239	2
2	0	2	0	0	17240	2
2	0	2	0	0	17241	2
2	0	2	0	0	17242	2
2	0	2	0	0	17243	2
2	0	2	0	0	17244	2
2	0	2	0	0	17245	2
2	0	2	0	0	17246	2
2	0	2	0	0	17247	2
2	0	2	12	12	17248	2
2	0	2	0	0	17249	2
2	0	2	0	0	17250	2
2	0	2	0	0	17251	2
2	0	2	1	1	17252	2
2	0	2	0	0	17253	2
2	0	2	0	0	17254	2
2	9	2	0	9	17255	1
2	0	2	69	69	17256	2
2	0	2	0	0	17257	2
2	0	2	0	0	17258	2
2	0	2	0	0	17259	2
2	0	2	0	0	17260	2
2	0	2	0	0	17261	2
2	0	2	0	0	17262	2
2	0	2	0	0	17263	2
2	0	2	0	0	17264	2
2	0	2	0	0	17265	2
2	0	2	0	0	17266	2
2	0	2	0	0	17267	2
2	0	2	0	0	17268	2
2	5	2	0	5	17269	0
2	0	2	16	16	17270	2
2	0	2	0	0	17271	2
2	0	2	0	0	17272	2
2	0	2	0	0	17273	2
2	0	2	5	5	17274	2
2	0	2	0	0	17275	2
2	0	2	0	0	17276	2
2	0	2	0	0	17277	2
2	0	2	0	0	17278	2
2	0	2	0	0	17279	2
2	0	2	0	0	17280	2
2	0	2	0	0	17281	2
2	0	2	0	0	17282	2
2	0	2	0	0	17283	2
2	0	2	0	0	17284	2
2	0	2	0	0	17285	2
2	0	2	0	0	17286	2
2	0	2	0	0	17287	2
2	0	2	0	0	17288	2
2	0	2	0	0	17289	2
2	0	2	0	0	17290	2
2	0	2	0	0	17291	2
2	0	2	0	0	17292	2
2	0	2	0	0	17293	2
2	0	2	0	0	17294	2
2	0	2	0	0	17295	2
2	0	2	0	0	17296	2
2	0	2	0	0	17297	2
2	0	2	0	0	17298	2
2	0	2	0	0	17299	2
2	0	2	0	0	17300	2
2	0	2	0	0	17301	2
2	0	2	0	0	17302	2
2	0	2	0	0	17303	2
2	0	2	0	0	17304	2
2	0	2	0	0	17305	2
2	0	2	0	0	17306	2
2	0	2	0	0	17307	2
2	0	2	0	0	17308	2
2	0	2	0	0	17309	2
2	0	2	0	0	17310	2
2	0	2	0	0	17311	2
2	0	2	0	0	17312	2
2	0	2	0	0	17313	2
2	0	2	0	0	17314	2
2	0	2	0	0	17315	2
2	0	2	0	0	17316	2
2	0	2	0	0	17317	2
2	0	2	0	0	17318	2
2	0	2	0	0	17319	2
2	0	2	0	0	17320	2
2	0	2	0	0	17321	2
2	0	2	0	0	17322	2
2	0	2	0	0	17323	2
2	0	2	0	0	17324	2
2	0	2	0	0	17325	2
2	0	2	0	0	17326	2
2	0	2	0	0	17327	2
2	0	2	0	0	17328	2
2	0	2	0	0	17329	2
2	0	2	0	0	17330	2
2	0	2	0	0	17331	2
2	0	2	0	0	17332	2
2	0	2	0	0	17333	2
2	0	2	0	0	17334	2
2	0	2	0	0	17335	2
2	0	2	0	0	17336	2
2	0	2	0	0	17337	2
2	0	2	0	0	17338	2
2	0	2	0	0	17339	2
2	0	2	0	0	17340	2
2	0	2	0	0	17341	2
2	0	2	0	0	17342	2
2	0	2	0	0	17343	2
2	0	2	0	0	17344	2
2	0	2	0	0	17345	2
2	0	2	0	0	17346	2
2	0	2	0	0	17347	2
2	0	2	0	0	17348	2
2	0	2	0	0	17349	2
2	0	2	0	0	17350	2
2	0	2	0	0	17351	2
2	0	2	0	0	17352	2
2	0	2	0	0	17353	2
2	0	2	0	0	17354	2
2	0	2	0	0	17355	2
2	0	2	0	0	17356	2
2	0	2	0	0	17357	2
2	0	2	0	0	17358	2
2	0	2	0	0	17359	2
2	0	2	0	0	17360	2
2	0	2	0	0	17361	2
2	0	2	0	0	17362	2
2	0	2	0	0	17363	2
2	0	2	0	0	17364	2
2	0	2	0	0	17365	2
2	0	2	0	0	17366	2
2	0	2	0	0	17367	2
2	0	2	0	0	17368	2
2	0	2	0	0	17369	2
2	0	2	0	0	17370	2
2	0	2	0	0	17371	2
2	0	2	0	0	17372	2
2	0	2	0	0	17373	2
2	0	2	0	0	17374	2
2	0	2	0	0	17375	2
2	0	2	0	0	17376	2
2	0	2	0	0	17377	2
2	0	2	0	0	17378	2
2	0	2	0	0	17379	2
2	0	2	0	0	17380	2
2	0	2	0	0	17381	2
2	0	2	0	0	17382	2
2	0	2	0	0	17383	2
2	0	2	0	0	17384	2
2	0	2	0	0	17385	2
2	0	2	0	0	17386	2
2	0	2	0	0	17387	2
2	0	2	0	0	17388	2
2	0	2	0	0	17389	2
2	0	2	0	0	17390	2
2	0	2	0	0	17391	2
2	0	2	0	0	17392	2
2	0	2	0	0	17393	2
2	0	2	0	0	17394	2
2	0	2	0	0	17395	2
2	0	2	0	0	17396	2
2	0	2	0	0	17397	2
2	0	2	0	0	17398	2
2	0	2	0	0	17399	2
2	0	2	0	0	17400	2
2	0	2	0	0	17401	2
2	0	2	0	0	17402	2
2	0	2	0	0	17403	2
2	0	2	0	0	17404	2
2	0	2	0	0	17405	2
2	0	2	0	0	17406	2
2	0	2	0	0	17407	2
2	0	2	0	0	17408	2
2	0	2	0	0	17409	2
2	0	2	0	0	17410	2
2	0	2	0	0	17411	2
2	0	2	0	0	17412	2
2	0	2	0	0	17413	2
2	0	2	0	0	17414	2
2	0	2	0	0	17415	2
2	0	2	0	0	17416	2
2	0	2	0	0	17417	2
2	0	2	0	0	17418	2
2	0	2	0	0	17419	2
2	0	2	0	0	17420	2
2	0	2	0	0	17421	2
2	0	2	0	0	17422	2
2	0	2	0	0	17423	2
2	0	2	0	0	17424	2
2	0	2	0	0	17425	2
2	0	2	0	0	17426	2
2	0	2	0	0	17427	2
2	0	2	0	0	17428	2
2	0	2	0	0	17429	2
2	0	2	0	0	17430	2
2	0	2	0	0	17431	2
2	0	2	0	0	17432	2
2	0	2	0	0	17433	2
2	0	2	0	0	17434	2
2	0	2	0	0	17435	2
2	0	2	0	0	17436	2
2	0	2	0	0	17437	2
2	0	2	0	0	17438	2
2	0	2	0	0	17439	2
2	0	2	0	0	17440	2
2	0	2	0	0	17441	2
2	0	2	0	0	17442	2
2	0	2	0	0	17443	2
2	0	2	0	0	17444	2
2	0	2	0	0	17445	2
2	0	2	0	0	17446	2
2	0	2	0	0	17447	2
2	0	2	0	0	17448	2
2	0	2	0	0	17449	2
2	0	2	0	0	17450	2
2	0	2	0	0	17451	2
2	0	2	11	11	17452	2
2	0	2	0	0	17453	2
2	0	2	0	0	17454	2
2	0	2	0	0	17455	2
2	0	2	3	3	17456	2
2	0	2	0	0	17457	2
2	0	2	0	0	17458	2
2	0	2	0	0	17459	2
2	0	2	0	0	17460	2
2	0	2	0	0	17461	2
2	0	2	0	0	17462	2
2	0	2	0	0	17463	2
2	0	2	0	0	17464	2
2	0	2	0	0	17465	2
2	0	2	0	0	17466	2
2	0	2	0	0	17467	2
2	0	2	0	0	17468	2
2	0	2	0	0	17469	2
2	0	2	0	0	17470	2
2	0	2	0	0	17471	2
2	0	2	0	0	17472	2
2	0	2	0	0	17473	2
2	0	2	0	0	17474	2
2	0	2	0	0	17475	2
2	0	2	0	0	17476	2
2	0	2	0	0	17477	2
2	0	2	0	0	17478	2
2	0	2	0	0	17479	2
2	0	2	0	0	17480	2
2	0	2	0	0	17481	2
2	0	2	0	0	17482	2
2	0	2	0	0	17483	2
2	0	2	0	0	17484	2
2	0	2	0	0	17485	2
2	0	2	0	0	17486	2
2	0	2	0	0	17487	2
2	0	2	0	0	17488	2
2	0	2	0	0	17489	2
2	0	2	0	0	17490	2
2	0	2	0	0	17491	2
2	0	2	0	0	17492	2
2	0	2	0	0	17493	2
2	0	2	0	0	17494	2
2	0	2	0	0	17495	2
2	0	2	0	0	17496	2
2	0	2	0	0	17497	2
2	0	2	0	0	17498	2
2	0	2	0	0	17499	2
2	0	2	0	0	17500	2
2	0	2	0	0	17501	2
2	0	2	0	0	17502	2
2	0	2	0	0	17503	2
2	0	2	0	0	17504	2
2	0	2	0	0	17505	2
2	0	2	0	0	17506	2
2	0	2	0	0	17507	2
2	0	2	0	0	17508	2
2	0	2	0	0	17509	2
2	0	2	0	0	17510	2
2	0	2	0	0	17511	2
2	0	2	0	0	17512	2
2	0	2	0	0	17513	2
2	0	2	0	0	17514	2
2	0	2	0	0	17515	2
2	0	2	0	0	17516	2
2	0	2	0	0	17517	2
2	0	2	0	0	17518	2
2	0	2	0	0	17519	2
2	0	2	0	0	17520	2
2	0	2	0	0	17521	2
2	0	2	0	0	17522	2
2	0	2	0	0	17523	2
2	0	2	0	0	17524	2
2	0	2	0	0	17525	2
2	0	2	0	0	17526	2
2	0	2	0	0	17527	2
2	0	2	0	0	17528	2
2	0	2	0	0	17529	2
2	0	2	0	0	17530	2
2	0	2	0	0	17531	2
2	0	2	0	0	17532	2
2	0	2	0	0	17533	2
2	0	2	1	1	17534	2
2	0	2	1	1	17535	2
2	0	2	1	1	17536	2
2	0	2	0	0	17537	2
2	0	2	0	0	17538	2
2	0	2	0	0	17539	2
2	0	2	0	0	17540	2
2	0	2	0	0	17541	2
2	0	2	0	0	17542	2
2	0	2	0	0	17543	2
2	0	2	0	0	17544	2
2	0	2	0	0	17545	2
2	0	2	0	0	17546	2
2	0	2	0	0	17547	2
2	0	2	0	0	17548	2
2	0	2	0	0	17549	2
2	0	2	0	0	17550	2
2	0	2	0	0	17551	2
2	0	2	0	0	17552	2
2	0	2	0	0	17553	2
2	0	2	0	0	17554	2
2	0	2	0	0	17555	2
2	0	2	0	0	17556	2
2	0	2	0	0	17557	2
2	0	2	0	0	17558	2
2	0	2	0	0	17559	2
2	0	2	0	0	17560	2
2	0	2	0	0	17561	2
2	0	2	0	0	17562	2
2	0	2	0	0	17563	2
2	0	2	0	0	17564	2
2	0	2	0	0	17565	2
2	0	2	0	0	17566	2
2	0	2	0	0	17567	2
2	0	2	0	0	17568	2
2	0	2	0	0	17569	2
2	0	2	0	0	17570	2
2	0	2	0	0	17571	2
2	0	2	0	0	17572	2
2	0	2	0	0	17573	2
2	0	2	0	0	17574	2
2	0	2	0	0	17575	2
2	0	2	0	0	17576	2
2	0	2	0	0	17577	2
2	0	2	0	0	17578	2
2	0	2	0	0	17579	2
2	0	2	0	0	17580	2
2	0	2	0	0	17581	2
2	0	2	0	0	17582	2
2	0	2	0	0	17583	2
2	2	2	0	2	17584	1
2	0	2	12	12	17585	2
2	0	2	0	0	17586	2
2	0	2	0	0	17587	2
2	1	2	0	1	17588	0
2	0	2	1	1	17589	2
2	0	2	0	0	17590	2
2	0	2	0	0	17591	2
2	0	2	0	0	17592	2
2	0	2	0	0	17593	2
2	0	2	0	0	17594	2
2	0	2	0	0	17595	2
2	0	2	0	0	17596	2
2	0	2	0	0	17597	2
2	0	2	0	0	17598	2
2	0	2	0	0	17599	2
2	0	2	0	0	17600	2
2	0	2	0	0	17601	2
2	0	2	0	0	17602	2
2	0	2	0	0	17603	2
2	0	2	0	0	17604	2
2	0	2	0	0	17605	2
2	0	2	0	0	17606	2
2	0	2	0	0	17607	2
2	0	2	0	0	17608	2
2	0	2	0	0	17609	2
2	0	2	0	0	17610	2
2	0	2	0	0	17611	2
2	0	2	0	0	17612	2
2	0	2	0	0	17613	2
2	0	2	0	0	17614	2
2	0	2	0	0	17615	2
2	0	2	0	0	17616	2
2	0	2	0	0	17617	2
2	0	2	0	0	17618	2
2	0	2	0	0	17619	2
2	0	2	0	0	17620	2
2	0	2	0	0	17621	2
2	0	2	0	0	17622	2
2	0	2	0	0	17623	2
2	0	2	0	0	17624	2
2	0	2	0	0	17625	2
2	0	2	0	0	17626	2
2	0	2	0	0	17627	2
2	0	2	0	0	17628	2
2	0	2	0	0	17629	2
2	0	2	0	0	17630	2
2	0	2	0	0	17631	2
2	0	2	0	0	17632	2
2	0	2	0	0	17633	2
2	0	2	0	0	17634	2
2	0	2	0	0	17635	2
2	0	2	0	0	17636	2
2	0	2	0	0	17637	2
2	0	2	0	0	17638	2
2	0	2	0	0	17639	2
2	0	2	0	0	17640	2
2	0	2	0	0	17641	2
2	0	2	0	0	17642	2
2	0	2	0	0	17643	2
2	0	2	0	0	17644	2
2	0	2	0	0	17645	2
2	0	2	0	0	17646	2
2	0	2	0	0	17647	2
2	0	2	0	0	17648	2
2	0	2	0	0	17649	2
2	0	2	0	0	17650	2
2	0	2	0	0	17651	2
2	0	2	0	0	17652	2
2	0	2	1	1	17653	2
2	0	2	0	0	17654	2
2	0	2	0	0	17655	2
2	0	2	0	0	17656	2
2	0	2	0	0	17657	2
2	0	2	0	0	17658	2
2	0	2	0	0	17659	2
2	0	2	0	0	17660	2
2	0	2	0	0	17661	2
2	0	2	0	0	17662	2
2	0	2	0	0	17663	2
2	0	2	0	0	17664	2
2	0	2	0	0	17665	2
2	0	2	0	0	17666	2
2	0	2	0	0	17667	2
2	0	2	0	0	17668	2
2	0	2	0	0	17669	2
2	0	2	0	0	17670	2
2	0	2	0	0	17671	2
2	0	2	0	0	17672	2
2	0	2	0	0	17673	2
2	0	2	0	0	17674	2
2	0	2	0	0	17675	2
2	0	2	0	0	17676	2
2	0	2	0	0	17677	2
2	0	2	0	0	17678	2
2	0	2	0	0	17679	2
2	0	2	0	0	17680	2
2	0	2	0	0	17681	2
2	0	2	0	0	17682	2
2	0	2	0	0	17683	2
2	0	2	0	0	17684	2
2	0	2	0	0	17685	2
2	0	2	0	0	17686	2
2	0	2	0	0	17687	2
2	0	2	0	0	17688	2
2	0	2	0	0	17689	2
2	0	2	0	0	17690	2
2	0	2	0	0	17691	2
2	0	2	0	0	17692	2
2	0	2	0	0	17693	2
2	0	2	0	0	17694	2
2	0	2	0	0	17695	2
2	0	2	0	0	17696	2
2	0	2	0	0	17697	2
2	0	2	0	0	17698	2
2	0	2	0	0	17699	2
2	0	2	0	0	17700	2
2	0	2	0	0	17701	2
2	0	2	0	0	17702	2
2	0	2	0	0	17703	2
2	0	2	0	0	17704	2
2	0	2	0	0	17705	2
2	0	2	0	0	17706	2
2	0	2	0	0	17707	2
2	0	2	0	0	17708	2
2	0	2	0	0	17709	2
2	0	2	0	0	17710	2
2	0	2	0	0	17711	2
2	0	2	0	0	17712	2
2	0	2	0	0	17713	2
2	0	2	0	0	17714	2
2	0	2	0	0	17715	2
2	0	2	0	0	17716	2
2	0	2	0	0	17717	2
2	0	2	0	0	17718	2
2	0	2	0	0	17719	2
2	0	2	0	0	17720	2
2	0	2	0	0	17721	2
2	0	2	0	0	17722	2
2	0	2	0	0	17723	2
2	0	2	0	0	17724	2
2	0	2	0	0	17725	2
2	0	2	0	0	17726	2
2	0	2	0	0	17727	2
2	0	2	0	0	17728	2
2	0	2	0	0	17729	2
2	0	2	0	0	17730	2
2	0	2	0	0	17731	2
2	0	2	0	0	17732	2
2	0	2	0	0	17733	2
2	0	2	0	0	17734	2
2	0	2	0	0	17735	2
2	0	2	0	0	17736	2
2	0	2	0	0	17737	2
2	0	2	0	0	17738	2
2	0	2	0	0	17739	2
2	0	2	0	0	17740	2
2	0	2	0	0	17741	2
2	0	2	0	0	17742	2
2	0	2	0	0	17743	2
2	0	2	0	0	17744	2
2	0	2	0	0	17745	2
2	0	2	0	0	17746	2
2	0	2	0	0	17747	2
2	0	2	0	0	17748	2
2	0	2	0	0	17749	2
2	0	2	0	0	17750	2
2	0	2	0	0	17751	2
2	0	2	0	0	17752	2
2	0	2	0	0	17753	2
2	0	2	0	0	17754	2
2	0	2	0	0	17755	2
2	0	2	0	0	17756	2
2	0	2	0	0	17757	2
2	0	2	0	0	17758	2
2	0	2	0	0	17759	2
2	0	2	0	0	17760	2
2	0	2	0	0	17761	2
2	0	2	0	0	17762	2
2	0	2	0	0	17763	2
2	0	2	0	0	17764	2
2	0	2	0	0	17765	2
2	0	2	0	0	17766	2
2	0	2	0	0	17767	2
2	0	2	0	0	17768	2
2	0	2	0	0	17769	2
2	0	2	0	0	17770	2
2	0	2	0	0	17771	2
2	0	2	0	0	17772	2
2	0	2	0	0	17773	2
2	0	2	0	0	17774	2
2	0	2	1	1	17775	2
2	0	2	0	0	17776	2
2	0	2	0	0	17777	2
2	0	2	0	0	17778	2
2	0	2	0	0	17779	2
2	0	2	0	0	17780	2
2	0	2	0	0	17781	2
2	0	2	0	0	17782	2
2	0	2	0	0	17783	2
2	0	2	0	0	17784	2
2	0	2	0	0	17785	2
2	0	2	0	0	17786	2
2	0	2	0	0	17787	2
2	0	2	0	0	17788	2
2	0	2	0	0	17789	2
2	0	2	0	0	17790	2
2	0	2	0	0	17791	2
2	0	2	0	0	17792	2
2	0	2	0	0	17793	2
2	0	2	0	0	17794	2
2	0	2	0	0	17795	2
2	0	2	0	0	17796	2
2	0	2	0	0	17797	2
2	0	2	0	0	17798	2
2	0	2	0	0	17799	2
2	0	2	0	0	17800	2
2	0	2	0	0	17801	2
2	0	2	0	0	17802	2
2	0	2	0	0	17803	2
2	0	2	0	0	17804	2
2	0	2	0	0	17805	2
2	0	2	0	0	17806	2
2	0	2	0	0	17807	2
2	0	2	0	0	17808	2
2	0	2	0	0	17809	2
2	0	2	0	0	17810	2
2	0	2	0	0	17811	2
2	0	2	0	0	17812	2
2	0	2	0	0	17813	2
2	0	2	0	0	17814	2
2	0	2	0	0	17815	2
2	0	2	0	0	17816	2
2	0	2	0	0	17817	2
2	0	2	0	0	17818	2
2	0	2	0	0	17819	2
2	0	2	0	0	17820	2
2	0	2	0	0	17821	2
2	0	2	0	0	17822	2
2	0	2	0	0	17823	2
2	0	2	0	0	17824	2
2	0	2	0	0	17825	2
2	0	2	0	0	17826	2
2	0	2	0	0	17827	2
2	0	2	0	0	17828	2
2	0	2	0	0	17829	2
2	0	2	0	0	17830	2
2	0	2	0	0	17831	2
2	0	2	0	0	17832	2
2	0	2	0	0	17833	2
2	0	2	0	0	17834	2
2	0	2	0	0	17835	2
2	0	2	0	0	17836	2
2	0	2	0	0	17837	2
2	0	2	0	0	17838	2
2	0	2	0	0	17839	2
2	0	2	0	0	17840	2
2	0	2	0	0	17841	2
2	0	2	0	0	17842	2
2	0	2	0	0	17843	2
2	0	2	0	0	17844	2
2	0	2	0	0	17845	2
2	0	2	0	0	17846	2
2	0	2	0	0	17847	2
2	0	2	0	0	17848	2
2	0	2	0	0	17849	2
2	0	2	0	0	17850	2
2	0	2	0	0	17851	2
2	0	2	0	0	17852	2
2	0	2	0	0	17853	2
2	0	2	0	0	17854	2
2	0	2	0	0	17855	2
2	0	2	0	0	17856	2
2	0	2	0	0	17857	2
2	0	2	0	0	17858	2
2	0	2	0	0	17859	2
2	0	2	0	0	17860	2
2	0	2	0	0	17861	2
2	0	2	0	0	17862	2
2	0	2	0	0	17863	2
2	0	2	0	0	17864	2
2	0	2	0	0	17865	2
2	0	2	0	0	17866	2
2	0	2	0	0	17867	2
2	0	2	0	0	17868	2
2	0	2	0	0	17869	2
2	0	2	0	0	17870	2
2	0	2	0	0	17871	2
2	0	2	0	0	17872	2
2	0	2	0	0	17873	2
2	0	2	0	0	17874	2
2	0	2	0	0	17875	2
2	0	2	0	0	17876	2
2	0	2	0	0	17877	2
2	0	2	0	0	17878	2
2	0	2	0	0	17879	2
2	0	2	0	0	17880	2
2	0	2	0	0	17881	2
2	0	2	0	0	17882	2
2	0	2	0	0	17883	2
2	0	2	0	0	17884	2
2	0	2	0	0	17885	2
2	0	2	0	0	17886	2
2	0	2	0	0	17887	2
2	0	2	0	0	17888	2
2	0	2	0	0	17889	2
2	0	2	0	0	17890	2
2	0	2	0	0	17891	2
2	0	2	0	0	17892	2
2	0	2	0	0	17893	2
2	0	2	0	0	17894	2
2	0	2	0	0	17895	2
2	0	2	0	0	17896	2
2	0	2	0	0	17897	2
2	0	2	0	0	17898	2
2	0	2	0	0	17899	2
2	0	2	0	0	17900	2
2	0	2	0	0	17901	2
2	0	2	0	0	17902	2
2	0	2	0	0	17903	2
2	0	2	0	0	17904	2
2	0	2	0	0	17905	2
2	0	2	0	0	17906	2
2	27	2	1	28	17907	0
2	11	2	73	84	17908	1
2	0	2	2	2	17909	2
2	0	2	0	0	17910	2
2	8	2	0	8	17911	0
2	0	2	21	21	17912	2
2	0	2	0	0	17913	2
2	0	2	0	0	17914	2
2	0	2	0	0	17915	2
2	0	2	0	0	17916	2
2	0	2	0	0	17917	2
2	0	2	0	0	17918	2
2	0	2	0	0	17919	2
2	0	2	0	0	17920	2
2	0	2	0	0	17921	2
2	0	2	0	0	17922	2
2	0	2	0	0	17923	2
2	0	2	0	0	17924	2
2	0	2	0	0	17925	2
2	0	2	0	0	17926	2
2	0	2	0	0	17927	2
2	0	2	0	0	17928	2
2	0	2	0	0	17929	2
2	0	2	0	0	17930	2
2	0	2	0	0	17931	2
2	0	2	0	0	17932	2
2	0	2	0	0	17933	2
2	0	2	0	0	17934	2
2	0	2	0	0	17935	2
2	0	2	0	0	17936	2
2	0	2	0	0	17937	2
2	0	2	0	0	17938	2
2	0	2	0	0	17939	2
2	0	2	0	0	17940	2
2	0	2	0	0	17941	2
2	0	2	0	0	17942	2
2	0	2	0	0	17943	2
2	0	2	0	0	17944	2
2	0	2	0	0	17945	2
2	0	2	0	0	17946	2
2	0	2	0	0	17947	2
2	0	2	0	0	17948	2
2	0	2	0	0	17949	2
2	0	2	0	0	17950	2
2	0	2	0	0	17951	2
2	0	2	0	0	17952	2
2	0	2	0	0	17953	2
2	0	2	0	0	17954	2
2	0	2	0	0	17955	2
2	1	2	0	1	17956	1
2	0	2	0	0	17957	2
2	0	2	0	0	17958	2
2	1	2	0	1	17959	0
2	0	2	0	0	17960	2
2	0	2	0	0	17961	2
2	0	2	0	0	17962	2
2	0	2	0	0	17963	2
2	0	2	0	0	17964	2
2	0	2	0	0	17965	2
2	0	2	0	0	17966	2
2	0	2	0	0	17967	2
2	0	2	0	0	17968	2
2	0	2	0	0	17969	2
2	0	2	0	0	17970	2
2	0	2	0	0	17971	2
2	0	2	0	0	17972	2
2	0	2	0	0	17973	2
2	0	2	0	0	17974	2
2	0	2	0	0	17975	2
2	0	2	0	0	17976	2
2	0	2	0	0	17977	2
2	0	2	0	0	17978	2
2	0	2	0	0	17979	2
2	0	2	0	0	17980	2
2	0	2	1	1	17981	2
2	0	2	0	0	17982	2
2	0	2	0	0	17983	2
2	0	2	0	0	17984	2
2	0	2	0	0	17985	2
2	0	2	0	0	17986	2
2	0	2	0	0	17987	2
2	0	2	0	0	17988	2
2	0	2	0	0	17989	2
2	0	2	0	0	17990	2
2	0	2	0	0	17991	2
2	0	2	0	0	17992	2
2	0	2	0	0	17993	2
2	0	2	0	0	17994	2
2	0	2	0	0	17995	2
2	0	2	0	0	17996	2
2	0	2	0	0	17997	2
2	0	2	0	0	17998	2
2	0	2	0	0	17999	2
2	0	2	0	0	18000	2
2	0	2	0	0	18001	2
2	0	2	0	0	18002	2
2	0	2	0	0	18003	2
2	0	2	0	0	18004	2
2	0	2	0	0	18005	2
2	0	2	0	0	18006	2
2	0	2	0	0	18007	2
2	0	2	0	0	18008	2
2	0	2	0	0	18009	2
2	0	2	0	0	18010	2
2	0	2	0	0	18011	2
2	0	2	0	0	18012	2
2	0	2	0	0	18013	2
2	0	2	0	0	18014	2
2	0	2	0	0	18015	2
2	0	2	0	0	18016	2
2	0	2	0	0	18017	2
2	0	2	0	0	18018	2
2	0	2	0	0	18019	2
2	0	2	0	0	18020	2
2	0	2	0	0	18021	2
2	0	2	0	0	18022	2
2	0	2	0	0	18023	2
2	0	2	0	0	18024	2
2	0	2	0	0	18025	2
2	0	2	0	0	18026	2
2	0	2	0	0	18027	2
2	0	2	0	0	18028	2
2	0	2	0	0	18029	2
2	0	2	0	0	18030	2
2	0	2	0	0	18031	2
2	0	2	0	0	18032	2
2	0	2	0	0	18033	2
2	0	2	0	0	18034	2
2	0	2	0	0	18035	2
2	0	2	0	0	18036	2
2	0	2	0	0	18037	2
2	0	2	0	0	18038	2
2	0	2	0	0	18039	2
2	0	2	0	0	18040	2
2	0	2	0	0	18041	2
2	0	2	0	0	18042	2
2	0	2	0	0	18043	2
2	0	2	0	0	18044	2
2	0	2	0	0	18045	2
2	0	2	0	0	18046	2
2	0	2	0	0	18047	2
2	0	2	0	0	18048	2
2	0	2	0	0	18049	2
2	0	2	0	0	18050	2
2	0	2	0	0	18051	2
2	0	2	0	0	18052	2
2	0	2	0	0	18053	2
2	0	2	0	0	18054	2
2	0	2	0	0	18055	2
2	0	2	0	0	18056	2
2	0	2	0	0	18057	2
2	0	2	0	0	18058	2
2	0	2	0	0	18059	2
2	0	2	0	0	18060	2
2	0	2	0	0	18061	2
2	0	2	0	0	18062	2
2	0	2	0	0	18063	2
2	0	2	0	0	18064	2
2	0	2	0	0	18065	2
2	0	2	0	0	18066	2
2	0	2	0	0	18067	2
2	0	2	0	0	18068	2
2	0	2	0	0	18069	2
2	0	2	0	0	18070	2
2	0	2	0	0	18071	2
2	0	2	0	0	18072	2
2	0	2	0	0	18073	2
2	0	2	0	0	18074	2
2	0	2	0	0	18075	2
2	0	2	0	0	18076	2
2	0	2	0	0	18077	2
2	0	2	0	0	18078	2
2	0	2	0	0	18079	2
2	0	2	0	0	18080	2
2	0	2	0	0	18081	2
2	0	2	0	0	18082	2
2	0	2	0	0	18083	2
2	0	2	0	0	18084	2
2	0	2	0	0	18085	2
2	0	2	0	0	18086	2
2	0	2	0	0	18087	2
2	0	2	0	0	18088	2
2	0	2	0	0	18089	2
2	0	2	0	0	18090	2
2	0	2	0	0	18091	2
2	0	2	0	0	18092	2
2	0	2	0	0	18093	2
2	0	2	0	0	18094	2
2	0	2	0	0	18095	2
2	0	2	0	0	18096	2
2	0	2	0	0	18097	2
2	0	2	0	0	18098	2
2	0	2	0	0	18099	2
2	0	2	0	0	18100	2
2	0	2	0	0	18101	2
2	0	2	0	0	18102	2
2	0	2	0	0	18103	2
2	0	2	0	0	18104	2
2	0	2	0	0	18105	2
2	0	2	0	0	18106	2
2	0	2	0	0	18107	2
2	0	2	0	0	18108	2
2	0	2	0	0	18109	2
2	0	2	0	0	18110	2
2	0	2	0	0	18111	2
2	0	2	0	0	18112	2
2	0	2	0	0	18113	2
2	0	2	0	0	18114	2
2	0	2	0	0	18115	2
2	0	2	0	0	18116	2
2	0	2	0	0	18117	2
2	0	2	0	0	18118	2
2	0	2	0	0	18119	2
2	0	2	0	0	18120	2
2	0	2	0	0	18121	2
2	0	2	0	0	18122	2
2	0	2	0	0	18123	2
2	0	2	0	0	18124	2
2	0	2	0	0	18125	2
2	0	2	0	0	18126	2
2	0	2	0	0	18127	2
2	0	2	0	0	18128	2
2	0	2	0	0	18129	2
2	0	2	0	0	18130	2
2	0	2	0	0	18131	2
2	0	2	0	0	18132	2
2	0	2	0	0	18133	2
2	0	2	0	0	18134	2
2	0	2	0	0	18135	2
2	0	2	0	0	18136	2
2	0	2	0	0	18137	2
2	0	2	0	0	18138	2
2	0	2	0	0	18139	2
2	0	2	0	0	18140	2
2	0	2	0	0	18141	2
2	0	2	0	0	18142	2
2	0	2	0	0	18143	2
2	0	2	0	0	18144	2
2	0	2	0	0	18145	2
2	0	2	0	0	18146	2
2	0	2	0	0	18147	2
2	0	2	0	0	18148	2
2	0	2	0	0	18149	2
2	0	2	0	0	18150	2
2	0	2	0	0	18151	2
2	0	2	0	0	18152	2
2	0	2	0	0	18153	2
2	0	2	0	0	18154	2
2	0	2	0	0	18155	2
2	0	2	0	0	18156	2
2	0	2	0	0	18157	2
2	0	2	0	0	18158	2
2	0	2	0	0	18159	2
2	0	2	0	0	18160	2
2	0	2	0	0	18161	2
2	0	2	0	0	18162	2
2	0	2	0	0	18163	2
2	0	2	0	0	18164	2
2	0	2	0	0	18165	2
2	0	2	0	0	18166	2
2	0	2	0	0	18167	2
2	0	2	0	0	18168	2
2	0	2	0	0	18169	2
2	0	2	0	0	18170	2
2	0	2	0	0	18171	2
2	0	2	0	0	18172	2
2	0	2	0	0	18173	2
2	0	2	0	0	18174	2
2	0	2	0	0	18175	2
2	0	2	0	0	18176	2
2	0	2	0	0	18177	2
2	0	2	0	0	18178	2
2	0	2	0	0	18179	2
2	0	2	0	0	18180	2
2	0	2	0	0	18181	2
2	0	2	0	0	18182	2
2	0	2	0	0	18183	2
2	0	2	0	0	18184	2
2	0	2	0	0	18185	2
2	0	2	0	0	18186	2
2	0	2	0	0	18187	2
2	0	2	0	0	18188	2
2	0	2	0	0	18189	2
2	0	2	0	0	18190	2
2	0	2	0	0	18191	2
2	0	2	0	0	18192	2
2	0	2	0	0	18193	2
2	0	2	0	0	18194	2
2	0	2	0	0	18195	2
2	0	2	0	0	18196	2
2	0	2	0	0	18197	2
2	0	2	0	0	18198	2
2	0	2	0	0	18199	2
2	0	2	0	0	18200	2
2	0	2	0	0	18201	2
2	0	2	0	0	18202	2
2	0	2	0	0	18203	2
2	0	2	0	0	18204	2
2	0	2	0	0	18205	2
2	0	2	0	0	18206	2
2	0	2	0	0	18207	2
2	0	2	0	0	18208	2
2	0	2	0	0	18209	2
2	0	2	0	0	18210	2
2	1	2	3	4	18211	1
2	0	2	0	0	18212	2
2	0	2	0	0	18213	2
2	0	2	0	0	18214	2
2	0	2	0	0	18215	2
2	0	2	0	0	18216	2
2	0	2	0	0	18217	2
2	0	2	0	0	18218	2
2	0	2	0	0	18219	2
2	0	2	0	0	18220	2
2	0	2	0	0	18221	2
2	0	2	0	0	18222	2
2	0	2	0	0	18223	2
2	0	2	0	0	18224	2
2	0	2	0	0	18225	2
2	0	2	0	0	18226	2
2	0	2	0	0	18227	2
2	0	2	0	0	18228	2
2	0	2	0	0	18229	2
2	0	2	0	0	18230	2
2	0	2	0	0	18231	2
2	0	2	0	0	18232	2
2	0	2	0	0	18233	2
2	0	2	0	0	18234	2
2	0	2	0	0	18235	2
2	0	2	0	0	18236	2
2	0	2	0	0	18237	2
2	0	2	0	0	18238	2
2	0	2	0	0	18239	2
2	0	2	0	0	18240	2
2	0	2	0	0	18241	2
2	0	2	0	0	18242	2
2	0	2	0	0	18243	2
2	0	2	0	0	18244	2
2	0	2	0	0	18245	2
2	0	2	0	0	18246	2
2	0	2	0	0	18247	2
2	0	2	0	0	18248	2
2	0	2	0	0	18249	2
2	0	2	0	0	18250	2
2	0	2	0	0	18251	2
2	0	2	0	0	18252	2
2	0	2	0	0	18253	2
2	0	2	0	0	18254	2
2	0	2	0	0	18255	2
2	0	2	0	0	18256	2
2	0	2	0	0	18257	2
2	0	2	0	0	18258	2
2	0	2	0	0	18259	2
2	0	2	0	0	18260	2
2	0	2	0	0	18261	2
2	0	2	0	0	18262	2
2	0	2	0	0	18263	2
2	0	2	0	0	18264	2
2	0	2	0	0	18265	2
2	0	2	0	0	18266	2
2	0	2	0	0	18267	2
2	0	2	0	0	18268	2
2	0	2	0	0	18269	2
2	0	2	0	0	18270	2
2	0	2	0	0	18271	2
2	0	2	0	0	18272	2
2	0	2	0	0	18273	2
2	0	2	0	0	18274	2
2	0	2	0	0	18275	2
2	0	2	0	0	18276	2
2	0	2	0	0	18277	2
2	0	2	0	0	18278	2
2	0	2	0	0	18279	2
2	0	2	0	0	18280	2
2	0	2	1	1	18281	2
2	0	2	0	0	18282	2
2	0	2	0	0	18283	2
2	0	2	0	0	18284	2
2	0	2	0	0	18285	2
2	1	2	0	1	18286	0
2	0	2	25	25	18287	2
2	0	2	0	0	18288	2
2	0	2	0	0	18289	2
2	0	2	0	0	18290	2
2	0	2	1	1	18291	2
2	0	2	0	0	18292	2
2	0	2	0	0	18293	2
2	0	2	0	0	18294	2
2	0	2	0	0	18295	2
2	0	2	0	0	18296	2
2	0	2	0	0	18297	2
2	0	2	0	0	18298	2
2	0	2	0	0	18299	2
2	0	2	0	0	18300	2
2	0	2	0	0	18301	2
2	0	2	0	0	18302	2
2	0	2	0	0	18303	2
2	0	2	0	0	18304	2
2	0	2	0	0	18305	2
2	0	2	0	0	18306	2
2	0	2	0	0	18307	2
2	0	2	0	0	18308	2
2	0	2	0	0	18309	2
2	0	2	0	0	18310	2
2	0	2	0	0	18311	2
2	0	2	0	0	18312	2
2	0	2	0	0	18313	2
2	0	2	0	0	18314	2
2	0	2	0	0	18315	2
2	0	2	0	0	18316	2
2	0	2	0	0	18317	2
2	0	2	0	0	18318	2
2	0	2	0	0	18319	2
2	0	2	0	0	18320	2
2	0	2	0	0	18321	2
2	0	2	0	0	18322	2
2	0	2	0	0	18323	2
2	0	2	0	0	18324	2
2	0	2	0	0	18325	2
2	0	2	0	0	18326	2
2	0	2	0	0	18327	2
2	0	2	0	0	18328	2
2	0	2	0	0	18329	2
2	0	2	0	0	18330	2
2	0	2	0	0	18331	2
2	0	2	0	0	18332	2
2	0	2	0	0	18333	2
2	0	2	0	0	18334	2
2	0	2	0	0	18335	2
2	0	2	0	0	18336	2
2	0	2	0	0	18337	2
2	0	2	0	0	18338	2
2	0	2	0	0	18339	2
2	0	2	0	0	18340	2
2	0	2	0	0	18341	2
2	0	2	0	0	18342	2
2	0	2	0	0	18343	2
2	0	2	0	0	18344	2
2	0	2	0	0	18345	2
2	0	2	4	4	18346	2
2	0	2	0	0	18347	2
2	0	2	0	0	18348	2
2	0	2	0	0	18349	2
2	0	2	0	0	18350	2
2	0	2	0	0	18351	2
2	0	2	0	0	18352	2
2	0	2	0	0	18353	2
2	0	2	0	0	18354	2
2	0	2	0	0	18355	2
2	0	2	0	0	18356	2
2	0	2	0	0	18357	2
2	0	2	0	0	18358	2
2	0	2	0	0	18359	2
2	0	2	0	0	18360	2
2	0	2	0	0	18361	2
2	0	2	0	0	18362	2
2	0	2	0	0	18363	2
2	0	2	0	0	18364	2
2	0	2	0	0	18365	2
2	0	2	0	0	18366	2
2	0	2	0	0	18367	2
2	0	2	0	0	18368	2
2	0	2	0	0	18369	2
2	0	2	0	0	18370	2
2	0	2	0	0	18371	2
2	0	2	0	0	18372	2
2	0	2	0	0	18373	2
2	0	2	0	0	18374	2
2	0	2	0	0	18375	2
2	0	2	0	0	18376	2
2	0	2	0	0	18377	2
2	0	2	0	0	18378	2
2	0	2	0	0	18379	2
2	0	2	0	0	18380	2
2	0	2	0	0	18381	2
2	0	2	0	0	18382	2
2	0	2	0	0	18383	2
2	0	2	0	0	18384	2
2	0	2	0	0	18385	2
2	0	2	0	0	18386	2
2	0	2	0	0	18387	2
2	0	2	0	0	18388	2
2	0	2	0	0	18389	2
2	0	2	0	0	18390	2
2	0	2	0	0	18391	2
2	0	2	0	0	18392	2
2	0	2	0	0	18393	2
2	0	2	0	0	18394	2
2	0	2	0	0	18395	2
2	0	2	0	0	18396	2
2	0	2	0	0	18397	2
2	0	2	0	0	18398	2
2	0	2	0	0	18399	2
2	0	2	0	0	18400	2
2	0	2	0	0	18401	2
2	0	2	0	0	18402	2
2	0	2	0	0	18403	2
2	0	2	0	0	18404	2
2	0	2	0	0	18405	2
2	0	2	0	0	18406	2
2	0	2	0	0	18407	2
2	0	2	0	0	18408	2
2	0	2	0	0	18409	2
2	0	2	0	0	18410	2
2	0	2	0	0	18411	2
2	0	2	0	0	18412	2
2	0	2	0	0	18413	2
2	0	2	0	0	18414	2
2	0	2	0	0	18415	2
2	0	2	0	0	18416	2
2	0	2	0	0	18417	2
2	0	2	0	0	18418	2
2	0	2	0	0	18419	2
2	0	2	0	0	18420	2
2	0	2	0	0	18421	2
2	0	2	0	0	18422	2
2	0	2	0	0	18423	2
2	0	2	0	0	18424	2
2	0	2	0	0	18425	2
2	0	2	0	0	18426	2
2	0	2	0	0	18427	2
2	0	2	0	0	18428	2
2	0	2	0	0	18429	2
2	0	2	0	0	18430	2
2	0	2	0	0	18431	2
2	0	2	0	0	18432	2
2	0	2	0	0	18433	2
2	0	2	0	0	18434	2
2	0	2	0	0	18435	2
2	0	2	0	0	18436	2
2	0	2	0	0	18437	2
2	0	2	0	0	18438	2
2	0	2	0	0	18439	2
2	0	2	0	0	18440	2
2	0	2	0	0	18441	2
2	0	2	0	0	18442	2
2	0	2	0	0	18443	2
2	0	2	0	0	18444	2
2	0	2	0	0	18445	2
2	0	2	0	0	18446	2
2	0	2	0	0	18447	2
2	0	2	0	0	18448	2
2	0	2	0	0	18449	2
2	0	2	0	0	18450	2
2	0	2	0	0	18451	2
2	0	2	0	0	18452	2
2	0	2	0	0	18453	2
2	0	2	0	0	18454	2
2	0	2	0	0	18455	2
2	0	2	0	0	18456	2
2	0	2	0	0	18457	2
2	0	2	0	0	18458	2
2	0	2	11	11	18459	2
2	0	2	0	0	18460	2
2	0	2	0	0	18461	2
2	0	2	0	0	18462	2
2	0	2	0	0	18463	2
2	0	2	0	0	18464	2
2	0	2	0	0	18465	2
2	0	2	0	0	18466	2
2	0	2	0	0	18467	2
2	0	2	0	0	18468	2
2	0	2	2	2	18469	2
2	0	2	0	0	18470	2
2	0	2	0	0	18471	2
2	0	2	0	0	18472	2
2	0	2	0	0	18473	2
2	0	2	0	0	18474	2
2	0	2	0	0	18475	2
2	0	2	0	0	18476	2
2	0	2	0	0	18477	2
2	0	2	0	0	18478	2
2	0	2	0	0	18479	2
2	0	2	0	0	18480	2
2	0	2	0	0	18481	2
2	0	2	0	0	18482	2
2	0	2	0	0	18483	2
2	0	2	0	0	18484	2
2	0	2	0	0	18485	2
2	0	2	0	0	18486	2
2	0	2	0	0	18487	2
2	0	2	0	0	18488	2
2	0	2	0	0	18489	2
2	0	2	0	0	18490	2
2	0	2	0	0	18491	2
2	0	2	0	0	18492	2
2	0	2	0	0	18493	2
2	0	2	0	0	18494	2
2	0	2	0	0	18495	2
2	0	2	0	0	18496	2
2	0	2	0	0	18497	2
2	0	2	0	0	18498	2
2	0	2	0	0	18499	2
2	0	2	0	0	18500	2
2	0	2	0	0	18501	2
2	0	2	0	0	18502	2
2	0	2	0	0	18503	2
2	0	2	0	0	18504	2
2	0	2	0	0	18505	2
2	0	2	0	0	18506	2
2	0	2	0	0	18507	2
2	0	2	0	0	18508	2
2	0	2	0	0	18509	2
2	0	2	0	0	18510	2
2	0	2	0	0	18511	2
2	0	2	0	0	18512	2
2	0	2	0	0	18513	2
2	0	2	0	0	18514	2
2	0	2	0	0	18515	2
2	0	2	0	0	18516	2
2	0	2	0	0	18517	2
2	0	2	0	0	18518	2
2	0	2	0	0	18519	2
2	0	2	0	0	18520	2
2	0	2	0	0	18521	2
2	0	2	0	0	18522	2
2	0	2	0	0	18523	2
2	0	2	0	0	18524	2
2	0	2	0	0	18525	2
2	0	2	0	0	18526	2
2	0	2	0	0	18527	2
2	0	2	0	0	18528	2
2	0	2	0	0	18529	2
2	0	2	0	0	18530	2
2	0	2	0	0	18531	2
2	0	2	0	0	18532	2
2	0	2	0	0	18533	2
2	0	2	0	0	18534	2
2	0	2	0	0	18535	2
2	0	2	0	0	18536	2
2	0	2	0	0	18537	2
2	0	2	0	0	18538	2
2	0	2	0	0	18539	2
2	0	2	0	0	18540	2
2	0	2	0	0	18541	2
2	0	2	0	0	18542	2
2	0	2	0	0	18543	2
2	0	2	0	0	18544	2
2	0	2	0	0	18545	2
2	0	2	0	0	18546	2
2	0	2	0	0	18547	2
2	0	2	0	0	18548	2
2	0	2	0	0	18549	2
2	0	2	0	0	18550	2
2	0	2	0	0	18551	2
2	0	2	0	0	18552	2
2	0	2	0	0	18553	2
2	0	2	0	0	18554	2
2	0	2	0	0	18555	2
2	0	2	0	0	18556	2
2	0	2	0	0	18557	2
2	0	2	0	0	18558	2
2	0	2	0	0	18559	2
2	2	2	0	2	18560	0
2	0	2	11	11	18561	2
2	0	2	1	1	18562	2
2	0	2	0	0	18563	2
2	1	2	0	1	18564	0
2	0	2	1	1	18565	2
2	0	2	0	0	18566	2
2	0	2	1	1	18567	2
2	0	2	0	0	18568	2
2	0	2	0	0	18569	2
2	0	2	0	0	18570	2
2	0	2	1	1	18571	2
2	0	2	0	0	18572	2
2	0	2	0	0	18573	2
2	0	2	0	0	18574	2
2	0	2	0	0	18575	2
2	0	2	0	0	18576	2
2	0	2	0	0	18577	2
2	0	2	0	0	18578	2
2	0	2	0	0	18579	2
2	0	2	0	0	18580	2
2	0	2	0	0	18581	2
2	0	2	0	0	18582	2
2	0	2	0	0	18583	2
2	0	2	0	0	18584	2
2	0	2	0	0	18585	2
2	0	2	0	0	18586	2
2	0	2	0	0	18587	2
2	0	2	0	0	18588	2
2	0	2	0	0	18589	2
2	0	2	0	0	18590	2
2	0	2	0	0	18591	2
2	0	2	0	0	18592	2
2	0	2	0	0	18593	2
2	0	2	0	0	18594	2
2	0	2	0	0	18595	2
2	0	2	0	0	18596	2
2	0	2	0	0	18597	2
2	0	2	0	0	18598	2
2	0	2	0	0	18599	2
2	0	2	0	0	18600	2
2	0	2	0	0	18601	2
2	0	2	0	0	18602	2
2	0	2	0	0	18603	2
2	0	2	0	0	18604	2
2	0	2	0	0	18605	2
2	0	2	0	0	18606	2
2	0	2	0	0	18607	2
2	0	2	0	0	18608	2
2	0	2	0	0	18609	2
2	0	2	0	0	18610	2
2	0	2	0	0	18611	2
2	0	2	0	0	18612	2
2	0	2	0	0	18613	2
2	0	2	0	0	18614	2
2	0	2	0	0	18615	2
2	0	2	0	0	18616	2
2	0	2	0	0	18617	2
2	0	2	0	0	18618	2
2	0	2	0	0	18619	2
2	0	2	0	0	18620	2
2	0	2	0	0	18621	2
2	0	2	0	0	18622	2
2	0	2	0	0	18623	2
2	0	2	0	0	18624	2
2	0	2	0	0	18625	2
2	0	2	0	0	18626	2
2	0	2	0	0	18627	2
2	0	2	0	0	18628	2
2	0	2	0	0	18629	2
2	0	2	0	0	18630	2
2	0	2	0	0	18631	2
2	0	2	0	0	18632	2
2	0	2	0	0	18633	2
2	0	2	0	0	18634	2
2	0	2	0	0	18635	2
2	0	2	0	0	18636	2
2	0	2	0	0	18637	2
2	0	2	0	0	18638	2
2	0	2	0	0	18639	2
2	0	2	0	0	18640	2
2	0	2	0	0	18641	2
2	0	2	0	0	18642	2
2	0	2	0	0	18643	2
2	0	2	0	0	18644	2
2	0	2	0	0	18645	2
2	0	2	0	0	18646	2
2	0	2	0	0	18647	2
2	0	2	0	0	18648	2
2	0	2	0	0	18649	2
2	0	2	0	0	18650	2
2	0	2	0	0	18651	2
2	0	2	0	0	18652	2
2	0	2	0	0	18653	2
2	0	2	0	0	18654	2
2	0	2	0	0	18655	2
2	0	2	0	0	18656	2
2	0	2	0	0	18657	2
2	0	2	0	0	18658	2
2	0	2	0	0	18659	2
2	0	2	0	0	18660	2
2	0	2	0	0	18661	2
2	0	2	0	0	18662	2
2	0	2	0	0	18663	2
2	0	2	0	0	18664	2
2	0	2	0	0	18665	2
2	0	2	0	0	18666	2
2	0	2	0	0	18667	2
2	0	2	0	0	18668	2
2	0	2	0	0	18669	2
2	0	2	0	0	18670	2
2	0	2	0	0	18671	2
2	0	2	0	0	18672	2
2	0	2	0	0	18673	2
2	0	2	0	0	18674	2
2	0	2	0	0	18675	2
2	0	2	0	0	18676	2
2	0	2	0	0	18677	2
2	0	2	0	0	18678	2
2	0	2	0	0	18679	2
2	0	2	0	0	18680	2
2	0	2	0	0	18681	2
2	0	2	0	0	18682	2
2	0	2	0	0	18683	2
2	0	2	0	0	18684	2
2	0	2	0	0	18685	2
2	0	2	0	0	18686	2
2	0	2	0	0	18687	2
2	0	2	0	0	18688	2
2	0	2	0	0	18689	2
2	0	2	0	0	18690	2
2	0	2	0	0	18691	2
2	0	2	0	0	18692	2
2	0	2	0	0	18693	2
2	0	2	0	0	18694	2
2	0	2	0	0	18695	2
2	0	2	0	0	18696	2
2	0	2	0	0	18697	2
2	0	2	0	0	18698	2
2	0	2	0	0	18699	2
2	0	2	0	0	18700	2
2	0	2	0	0	18701	2
2	0	2	0	0	18702	2
2	0	2	0	0	18703	2
2	0	2	0	0	18704	2
2	0	2	0	0	18705	2
2	0	2	0	0	18706	2
2	0	2	0	0	18707	2
2	0	2	0	0	18708	2
2	0	2	0	0	18709	2
2	0	2	0	0	18710	2
2	0	2	0	0	18711	2
2	0	2	0	0	18712	2
2	0	2	0	0	18713	2
2	0	2	0	0	18714	2
2	0	2	0	0	18715	2
2	0	2	0	0	18716	2
2	0	2	0	0	18717	2
2	0	2	0	0	18718	2
2	0	2	0	0	18719	2
2	0	2	0	0	18720	2
2	0	2	0	0	18721	2
2	0	2	0	0	18722	2
2	0	2	0	0	18723	2
2	0	2	0	0	18724	2
2	0	2	0	0	18725	2
2	0	2	0	0	18726	2
2	0	2	0	0	18727	2
2	0	2	0	0	18728	2
2	0	2	0	0	18729	2
2	0	2	0	0	18730	2
2	0	2	27	27	18731	2
2	0	2	0	0	18732	2
2	0	2	0	0	18733	2
2	0	2	0	0	18734	2
2	0	2	0	0	18735	2
2	0	2	0	0	18736	2
2	0	2	0	0	18737	2
2	0	2	0	0	18738	2
2	0	2	0	0	18739	2
2	0	2	0	0	18740	2
2	0	2	0	0	18741	2
2	0	2	0	0	18742	2
2	0	2	0	0	18743	2
2	0	2	0	0	18744	2
2	0	2	0	0	18745	2
2	0	2	0	0	18746	2
2	0	2	0	0	18747	2
2	0	2	0	0	18748	2
2	0	2	0	0	18749	2
2	0	2	0	0	18750	2
2	0	2	0	0	18751	2
2	0	2	0	0	18752	2
2	0	2	0	0	18753	2
2	0	2	0	0	18754	2
2	0	2	0	0	18755	2
2	0	2	0	0	18756	2
2	0	2	0	0	18757	2
2	0	2	0	0	18758	2
2	0	2	0	0	18759	2
2	0	2	0	0	18760	2
2	0	2	0	0	18761	2
2	0	2	0	0	18762	2
2	0	2	0	0	18763	2
2	0	2	0	0	18764	2
2	0	2	0	0	18765	2
2	0	2	0	0	18766	2
2	0	2	0	0	18767	2
2	0	2	0	0	18768	2
2	0	2	0	0	18769	2
2	0	2	0	0	18770	2
2	0	2	0	0	18771	2
2	0	2	0	0	18772	2
2	0	2	0	0	18773	2
2	0	2	0	0	18774	2
2	0	2	0	0	18775	2
2	0	2	0	0	18776	2
2	0	2	0	0	18777	2
2	0	2	0	0	18778	2
2	0	2	0	0	18779	2
2	0	2	0	0	18780	2
2	0	2	0	0	18781	2
2	0	2	0	0	18782	2
2	0	2	0	0	18783	2
2	0	2	0	0	18784	2
2	0	2	0	0	18785	2
2	0	2	0	0	18786	2
2	0	2	0	0	18787	2
2	0	2	0	0	18788	2
2	0	2	0	0	18789	2
2	0	2	0	0	18790	2
2	0	2	0	0	18791	2
2	0	2	0	0	18792	2
2	0	2	0	0	18793	2
2	0	2	0	0	18794	2
2	0	2	1	1	18795	2
2	0	2	0	0	18796	2
2	0	2	0	0	18797	2
2	0	2	0	0	18798	2
2	0	2	0	0	18799	2
2	0	2	0	0	18800	2
2	0	2	0	0	18801	2
2	0	2	0	0	18802	2
2	0	2	0	0	18803	2
2	0	2	0	0	18804	2
2	0	2	0	0	18805	2
2	0	2	0	0	18806	2
2	0	2	0	0	18807	2
2	0	2	0	0	18808	2
2	0	2	0	0	18809	2
2	0	2	0	0	18810	2
2	0	2	0	0	18811	2
2	0	2	0	0	18812	2
2	0	2	0	0	18813	2
2	0	2	0	0	18814	2
2	0	2	0	0	18815	2
2	0	2	0	0	18816	2
2	0	2	0	0	18817	2
2	0	2	0	0	18818	2
2	0	2	0	0	18819	2
2	0	2	0	0	18820	2
2	0	2	0	0	18821	2
2	0	2	0	0	18822	2
2	0	2	0	0	18823	2
2	0	2	0	0	18824	2
2	0	2	0	0	18825	2
2	0	2	0	0	18826	2
2	0	2	0	0	18827	2
2	0	2	0	0	18828	2
2	0	2	0	0	18829	2
2	0	2	0	0	18830	2
2	0	2	0	0	18831	2
2	0	2	0	0	18832	2
2	0	2	0	0	18833	2
2	0	2	0	0	18834	2
2	0	2	0	0	18835	2
2	0	2	0	0	18836	2
2	0	2	0	0	18837	2
2	0	2	0	0	18838	2
2	0	2	0	0	18839	2
2	0	2	0	0	18840	2
2	0	2	0	0	18841	2
2	0	2	0	0	18842	2
2	0	2	0	0	18843	2
2	0	2	0	0	18844	2
2	0	2	0	0	18845	2
2	0	2	0	0	18846	2
2	0	2	0	0	18847	2
2	0	2	0	0	18848	2
2	0	2	0	0	18849	2
2	0	2	0	0	18850	2
2	0	2	0	0	18851	2
2	0	2	0	0	18852	2
2	0	2	0	0	18853	2
2	0	2	0	0	18854	2
2	0	2	0	0	18855	2
2	0	2	0	0	18856	2
2	0	2	0	0	18857	2
2	0	2	0	0	18858	2
2	0	2	0	0	18859	2
2	0	2	0	0	18860	2
2	0	2	0	0	18861	2
2	0	2	0	0	18862	2
2	0	2	0	0	18863	2
2	0	2	0	0	18864	2
2	0	2	0	0	18865	2
2	0	2	0	0	18866	2
2	0	2	0	0	18867	2
2	0	2	0	0	18868	2
2	0	2	0	0	18869	2
2	0	2	0	0	18870	2
2	0	2	0	0	18871	2
2	0	2	0	0	18872	2
2	0	2	0	0	18873	2
2	0	2	0	0	18874	2
2	0	2	0	0	18875	2
2	0	2	0	0	18876	2
2	0	2	0	0	18877	2
2	0	2	0	0	18878	2
2	0	2	1	1	18879	2
2	0	2	0	0	18880	2
2	0	2	0	0	18881	2
2	0	2	0	0	18882	2
2	0	2	0	0	18883	2
2	0	2	0	0	18884	2
2	0	2	0	0	18885	2
2	0	2	0	0	18886	2
2	0	2	0	0	18887	2
2	0	2	0	0	18888	2
2	0	2	0	0	18889	2
2	0	2	0	0	18890	2
2	0	2	0	0	18891	2
2	0	2	0	0	18892	2
2	0	2	0	0	18893	2
2	0	2	0	0	18894	2
2	0	2	0	0	18895	2
2	0	2	0	0	18896	2
2	0	2	0	0	18897	2
2	0	2	0	0	18898	2
2	0	2	0	0	18899	2
2	0	2	0	0	18900	2
2	0	2	0	0	18901	2
2	0	2	0	0	18902	2
2	0	2	0	0	18903	2
2	0	2	0	0	18904	2
2	0	2	0	0	18905	2
2	0	2	0	0	18906	2
2	0	2	0	0	18907	2
2	0	2	0	0	18908	2
2	0	2	0	0	18909	2
2	0	2	0	0	18910	2
2	0	2	0	0	18911	2
2	0	2	0	0	18912	2
2	0	2	0	0	18913	2
2	0	2	0	0	18914	2
2	0	2	1	1	18915	2
2	0	2	0	0	18916	2
2	0	2	0	0	18917	2
2	0	2	0	0	18918	2
2	0	2	0	0	18919	2
2	0	2	0	0	18920	2
2	0	2	12	12	18921	2
2	0	2	0	0	18922	2
2	0	2	0	0	18923	2
2	0	2	0	0	18924	2
2	0	2	1	1	18925	2
2	0	2	0	0	18926	2
2	0	2	0	0	18927	2
2	0	2	0	0	18928	2
2	0	2	0	0	18929	2
2	0	2	0	0	18930	2
2	0	2	0	0	18931	2
2	0	2	0	0	18932	2
2	0	2	0	0	18933	2
2	0	2	0	0	18934	2
2	0	2	0	0	18935	2
2	0	2	0	0	18936	2
2	0	2	0	0	18937	2
2	0	2	0	0	18938	2
2	0	2	0	0	18939	2
2	0	2	0	0	18940	2
2	0	2	0	0	18941	2
2	0	2	0	0	18942	2
2	0	2	0	0	18943	2
2	0	2	0	0	18944	2
2	0	2	0	0	18945	2
2	0	2	0	0	18946	2
2	0	2	0	0	18947	2
2	0	2	0	0	18948	2
2	0	2	0	0	18949	2
2	0	2	0	0	18950	2
2	0	2	0	0	18951	2
2	0	2	0	0	18952	2
2	0	2	0	0	18953	2
2	0	2	0	0	18954	2
2	0	2	0	0	18955	2
2	0	2	0	0	18956	2
2	0	2	0	0	18957	2
2	0	2	0	0	18958	2
2	0	2	0	0	18959	2
2	0	2	0	0	18960	2
2	0	2	0	0	18961	2
2	0	2	0	0	18962	2
2	0	2	0	0	18963	2
2	0	2	0	0	18964	2
2	0	2	0	0	18965	2
2	0	2	0	0	18966	2
2	0	2	0	0	18967	2
2	0	2	0	0	18968	2
2	0	2	0	0	18969	2
2	0	2	0	0	18970	2
2	0	2	0	0	18971	2
2	0	2	0	0	18972	2
2	0	2	0	0	18973	2
2	0	2	0	0	18974	2
2	0	2	0	0	18975	2
2	0	2	0	0	18976	2
2	0	2	0	0	18977	2
2	0	2	0	0	18978	2
2	0	2	0	0	18979	2
2	0	2	0	0	18980	2
2	0	2	0	0	18981	2
2	0	2	0	0	18982	2
2	0	2	0	0	18983	2
2	0	2	0	0	18984	2
2	0	2	0	0	18985	2
2	0	2	0	0	18986	2
2	0	2	0	0	18987	2
2	0	2	0	0	18988	2
2	0	2	0	0	18989	2
2	0	2	0	0	18990	2
2	0	2	0	0	18991	2
2	0	2	0	0	18992	2
2	0	2	0	0	18993	2
2	0	2	0	0	18994	2
2	0	2	0	0	18995	2
2	0	2	0	0	18996	2
2	0	2	0	0	18997	2
2	0	2	0	0	18998	2
2	0	2	0	0	18999	2
2	0	2	0	0	19000	2
2	0	2	0	0	19001	2
2	0	2	0	0	19002	2
2	0	2	0	0	19003	2
2	0	2	0	0	19004	2
2	0	2	0	0	19005	2
2	0	2	0	0	19006	2
2	0	2	0	0	19007	2
2	0	2	0	0	19008	2
2	0	2	0	0	19009	2
2	0	2	0	0	19010	2
2	0	2	0	0	19011	2
2	0	2	0	0	19012	2
2	0	2	0	0	19013	2
2	0	2	0	0	19014	2
2	0	2	0	0	19015	2
2	0	2	0	0	19016	2
2	0	2	0	0	19017	2
2	0	2	0	0	19018	2
2	0	2	0	0	19019	2
2	0	2	0	0	19020	2
2	0	2	0	0	19021	2
2	0	2	0	0	19022	2
2	0	2	0	0	19023	2
2	0	2	0	0	19024	2
2	0	2	0	0	19025	2
2	0	2	0	0	19026	2
2	0	2	0	0	19027	2
2	0	2	0	0	19028	2
2	0	2	0	0	19029	2
2	0	2	0	0	19030	2
2	0	2	0	0	19031	2
2	0	2	0	0	19032	2
2	0	2	0	0	19033	2
2	0	2	0	0	19034	2
2	0	2	0	0	19035	2
2	0	2	0	0	19036	2
2	0	2	0	0	19037	2
2	0	2	0	0	19038	2
2	0	2	0	0	19039	2
2	0	2	0	0	19040	2
2	0	2	0	0	19041	2
2	0	2	0	0	19042	2
2	0	2	0	0	19043	2
2	0	2	0	0	19044	2
2	0	2	0	0	19045	2
2	0	2	0	0	19046	2
2	0	2	0	0	19047	2
2	0	2	0	0	19048	2
2	0	2	0	0	19049	2
2	0	2	0	0	19050	2
2	0	2	0	0	19051	2
2	0	2	0	0	19052	2
2	0	2	0	0	19053	2
2	0	2	0	0	19054	2
2	0	2	0	0	19055	2
2	0	2	0	0	19056	2
2	0	2	0	0	19057	2
2	0	2	0	0	19058	2
2	0	2	0	0	19059	2
2	0	2	0	0	19060	2
2	0	2	0	0	19061	2
2	0	2	0	0	19062	2
2	0	2	0	0	19063	2
2	0	2	0	0	19064	2
2	0	2	0	0	19065	2
2	0	2	0	0	19066	2
2	0	2	0	0	19067	2
2	0	2	0	0	19068	2
2	0	2	0	0	19069	2
2	0	2	0	0	19070	2
2	0	2	0	0	19071	2
2	0	2	0	0	19072	2
2	0	2	0	0	19073	2
2	0	2	0	0	19074	2
2	0	2	0	0	19075	2
2	0	2	0	0	19076	2
2	0	2	0	0	19077	2
2	0	2	0	0	19078	2
2	1	2	0	1	19079	0
2	0	2	1	1	19080	2
2	0	2	0	0	19081	2
2	0	2	0	0	19082	2
2	0	2	0	0	19083	2
2	0	2	0	0	19084	2
2	0	2	41	41	19085	2
2	0	2	0	0	19086	2
2	0	2	0	0	19087	2
2	0	2	0	0	19088	2
2	0	2	0	0	19089	2
2	0	2	0	0	19090	2
2	0	2	0	0	19091	2
2	0	2	0	0	19092	2
2	0	2	0	0	19093	2
2	0	2	0	0	19094	2
2	0	2	0	0	19095	2
2	3	2	0	3	19096	0
2	0	2	9	9	19097	2
2	0	2	0	0	19098	2
2	0	2	0	0	19099	2
2	0	2	0	0	19100	2
2	0	2	0	0	19101	2
2	0	2	0	0	19102	2
2	0	2	0	0	19103	2
2	0	2	0	0	19104	2
2	0	2	0	0	19105	2
2	0	2	0	0	19106	2
2	0	2	0	0	19107	2
2	2	2	5	7	19108	1
2	0	2	0	0	19109	2
2	0	2	0	0	19110	2
2	0	2	0	0	19111	2
2	0	2	1	1	19112	2
2	0	2	0	0	19113	2
2	0	2	0	0	19114	2
2	0	2	0	0	19115	2
2	0	2	0	0	19116	2
2	0	2	0	0	19117	2
2	0	2	0	0	19118	2
2	0	2	0	0	19119	2
2	0	2	0	0	19120	2
2	0	2	0	0	19121	2
2	0	2	0	0	19122	2
2	0	2	0	0	19123	2
2	0	2	0	0	19124	2
2	0	2	0	0	19125	2
2	0	2	5	5	19126	2
2	0	2	0	0	19127	2
2	0	2	0	0	19128	2
2	0	2	0	0	19129	2
2	0	2	1	1	19130	2
2	0	2	0	0	19131	2
2	0	2	0	0	19132	2
2	0	2	0	0	19133	2
2	0	2	0	0	19134	2
2	0	2	0	0	19135	2
2	0	2	0	0	19136	2
2	0	2	0	0	19137	2
2	0	2	0	0	19138	2
2	0	2	0	0	19139	2
2	0	2	0	0	19140	2
2	0	2	0	0	19141	2
2	0	2	0	0	19142	2
2	0	2	0	0	19143	2
2	0	2	0	0	19144	2
2	0	2	0	0	19145	2
2	0	2	0	0	19146	2
2	0	2	0	0	19147	2
2	0	2	0	0	19148	2
2	0	2	0	0	19149	2
2	0	2	0	0	19150	2
2	0	2	0	0	19151	2
2	0	2	0	0	19152	2
2	0	2	0	0	19153	2
2	0	2	0	0	19154	2
2	0	2	0	0	19155	2
2	0	2	0	0	19156	2
2	0	2	0	0	19157	2
2	0	2	0	0	19158	2
2	2	2	0	2	19159	0
2	0	2	0	0	19160	2
2	0	2	0	0	19161	2
2	0	2	0	0	19162	2
2	0	2	0	0	19163	2
2	0	2	0	0	19164	2
2	0	2	0	0	19165	2
2	0	2	0	0	19166	2
2	0	2	0	0	19167	2
2	0	2	0	0	19168	2
2	0	2	0	0	19169	2
2	0	2	0	0	19170	2
2	0	2	0	0	19171	2
2	0	2	0	0	19172	2
2	0	2	0	0	19173	2
2	0	2	0	0	19174	2
2	0	2	0	0	19175	2
2	0	2	0	0	19176	2
2	0	2	0	0	19177	2
2	0	2	0	0	19178	2
2	0	2	0	0	19179	2
2	0	2	0	0	19180	2
2	0	2	14	14	19181	2
2	0	2	0	0	19182	2
2	0	2	0	0	19183	2
2	0	2	0	0	19184	2
2	0	2	0	0	19185	2
2	0	2	0	0	19186	2
2	0	2	0	0	19187	2
2	0	2	0	0	19188	2
2	0	2	0	0	19189	2
2	0	2	0	0	19190	2
2	0	2	0	0	19191	2
2	0	2	0	0	19192	2
2	0	2	0	0	19193	2
2	0	2	0	0	19194	2
2	0	2	0	0	19195	2
2	0	2	0	0	19196	2
2	0	2	0	0	19197	2
2	0	2	0	0	19198	2
2	0	2	0	0	19199	2
2	0	2	0	0	19200	2
2	0	2	0	0	19201	2
2	0	2	0	0	19202	2
2	0	2	0	0	19203	2
2	0	2	0	0	19204	2
2	0	2	0	0	19205	2
2	0	2	0	0	19206	2
2	0	2	0	0	19207	2
2	0	2	0	0	19208	2
2	0	2	0	0	19209	2
2	0	2	0	0	19210	2
2	0	2	0	0	19211	2
2	0	2	0	0	19212	2
2	0	2	0	0	19213	2
2	0	2	0	0	19214	2
2	0	2	0	0	19215	2
2	0	2	0	0	19216	2
2	0	2	1	1	19217	2
2	0	2	0	0	19218	2
2	0	2	0	0	19219	2
2	0	2	0	0	19220	2
2	0	2	0	0	19221	2
2	0	2	0	0	19222	2
2	0	2	0	0	19223	2
2	0	2	0	0	19224	2
2	0	2	0	0	19225	2
2	0	2	0	0	19226	2
2	0	2	0	0	19227	2
2	0	2	0	0	19228	2
2	0	2	0	0	19229	2
2	0	2	0	0	19230	2
2	0	2	0	0	19231	2
2	0	2	0	0	19232	2
2	0	2	0	0	19233	2
2	0	2	0	0	19234	2
2	0	2	0	0	19235	2
2	0	2	0	0	19236	2
2	0	2	0	0	19237	2
2	0	2	0	0	19238	2
2	0	2	0	0	19239	2
2	0	2	0	0	19240	2
2	0	2	0	0	19241	2
2	0	2	0	0	19242	2
2	0	2	0	0	19243	2
2	0	2	0	0	19244	2
2	0	2	0	0	19245	2
2	0	2	0	0	19246	2
2	0	2	0	0	19247	2
2	0	2	0	0	19248	2
2	0	2	0	0	19249	2
2	0	2	0	0	19250	2
2	0	2	0	0	19251	2
2	0	2	0	0	19252	2
2	0	2	0	0	19253	2
2	0	2	0	0	19254	2
2	0	2	0	0	19255	2
2	0	2	0	0	19256	2
2	0	2	0	0	19257	2
2	0	2	0	0	19258	2
2	0	2	0	0	19259	2
2	0	2	0	0	19260	2
2	0	2	0	0	19261	2
2	0	2	0	0	19262	2
2	0	2	0	0	19263	2
2	0	2	0	0	19264	2
2	0	2	0	0	19265	2
2	0	2	0	0	19266	2
2	0	2	0	0	19267	2
2	0	2	0	0	19268	2
2	0	2	0	0	19269	2
2	0	2	0	0	19270	2
2	0	2	0	0	19271	2
2	0	2	0	0	19272	2
2	0	2	0	0	19273	2
2	0	2	0	0	19274	2
2	0	2	0	0	19275	2
2	0	2	0	0	19276	2
2	0	2	0	0	19277	2
2	0	2	0	0	19278	2
2	257	2	2	259	19279	0
2	286	2	1337	1623	19280	1
2	0	2	50	50	19281	2
2	0	2	0	0	19282	2
2	106	2	6	112	19283	0
2	0	2	777	777	19284	2
2	0	2	0	0	19285	2
2	0	2	0	0	19286	2
2	0	2	0	0	19287	2
2	0	2	0	0	19288	2
2	0	2	0	0	19289	2
2	0	2	0	0	19290	2
2	2	2	0	2	19291	0
2	0	2	3	3	19292	2
2	0	2	0	0	19293	2
2	0	2	0	0	19294	2
2	0	2	0	0	19295	2
2	0	2	707	707	19296	2
2	0	2	0	0	19297	2
2	0	2	0	0	19298	2
2	0	2	0	0	19299	2
2	0	2	0	0	19300	2
2	0	2	0	0	19301	2
2	0	2	0	0	19302	2
2	0	2	0	0	19303	2
2	0	2	0	0	19304	2
2	0	2	0	0	19305	2
2	0	2	0	0	19306	2
2	0	2	0	0	19307	2
2	0	2	0	0	19308	2
2	0	2	0	0	19309	2
2	0	2	0	0	19310	2
2	0	2	0	0	19311	2
2	0	2	0	0	19312	2
2	0	2	0	0	19313	2
2	0	2	0	0	19314	2
2	0	2	0	0	19315	2
2	0	2	0	0	19316	2
2	0	2	2	2	19317	2
2	0	2	0	0	19318	2
2	0	2	0	0	19319	2
2	0	2	0	0	19320	2
2	0	2	0	0	19321	2
2	5	0	88	93	19322	1
2	0	2	0	0	19323	2
2	0	2	0	0	19324	2
2	3	0	14	17	19325	0
2	0	2	4	4	19326	2
2	0	2	0	0	19327	2
2	0	2	0	0	19328	2
2	0	2	0	0	19329	2
2	0	2	0	0	19330	2
2	0	2	0	0	19331	2
2	0	2	0	0	19332	2
2	0	2	0	0	19333	2
2	0	2	0	0	19334	2
2	0	2	0	0	19335	2
2	0	2	0	0	19336	2
2	0	2	0	0	19337	2
2	0	2	0	0	19338	2
2	0	2	0	0	19339	2
2	0	2	0	0	19340	2
2	0	2	0	0	19341	2
2	0	2	0	0	19342	2
2	0	2	0	0	19343	2
2	0	2	0	0	19344	2
2	0	2	0	0	19345	2
2	0	4	0	0	19346	2
2	0	2	0	0	19347	2
2	0	2	0	0	19348	2
2	0	4	0	0	19349	2
2	0	2	0	0	19350	2
2	0	4	1	1	19351	2
2	0	2	0	0	19352	2
2	0	2	0	0	19353	2
2	0	4	99	99	19354	2
2	0	2	0	0	19355	2
2	0	2	0	0	19356	2
2	1	2	0	1	19357	0
2	1	2	26	27	19358	1
2	0	2	0	0	19359	2
2	0	2	0	0	19360	2
2	0	2	1	1	19361	2
2	0	2	0	0	19362	2
2	0	2	0	0	19363	2
2	0	2	0	0	19364	2
2	0	2	0	0	19365	2
2	0	2	0	0	19366	2
2	0	2	0	0	19367	2
2	0	2	0	0	19368	2
2	0	2	0	0	19369	2
2	0	2	0	0	19370	2
2	0	2	0	0	19371	2
2	0	2	0	0	19372	2
2	0	2	0	0	19373	2
2	0	2	0	0	19374	2
2	0	2	0	0	19375	2
2	0	2	0	0	19376	2
2	0	2	0	0	19377	2
2	17	2	0	17	19378	0
2	0	2	40	40	19379	2
2	0	2	1	1	19380	2
2	0	2	0	0	19381	2
2	5	2	0	5	19382	0
2	0	2	16	16	19383	2
2	0	2	0	0	19384	2
2	0	2	0	0	19385	2
2	0	2	0	0	19386	2
2	0	2	0	0	19387	2
2	0	2	0	0	19388	2
2	0	2	0	0	19389	2
2	0	2	0	0	19390	2
2	0	2	0	0	19391	2
2	0	2	0	0	19392	2
2	0	2	0	0	19393	2
2	0	2	0	0	19394	2
2	0	2	0	0	19395	2
2	0	2	0	0	19396	2
2	0	2	0	0	19397	2
2	0	2	0	0	19398	2
2	0	2	0	0	19399	2
2	0	2	0	0	19400	2
2	0	2	0	0	19401	2
2	0	2	0	0	19402	2
2	0	2	0	0	19403	2
2	0	2	0	0	19404	2
2	0	2	0	0	19405	2
2	0	2	0	0	19406	2
2	0	2	0	0	19407	2
2	0	4	0	0	19408	2
2	0	2	0	0	19409	2
2	0	2	0	0	19410	2
2	0	2	0	0	19411	2
2	0	2	0	0	19412	2
2	0	2	0	0	19413	2
2	0	2	0	0	19414	2
2	0	2	0	0	19415	2
2	0	2	0	0	19416	2
2	0	2	0	0	19417	2
2	0	2	0	0	19418	2
2	0	2	0	0	19419	2
2	0	2	0	0	19420	2
2	0	2	0	0	19421	2
2	0	2	0	0	19422	2
2	0	2	0	0	19423	2
2	0	2	0	0	19424	2
2	0	2	0	0	19425	2
2	0	2	0	0	19426	2
2	0	2	0	0	19427	2
2	0	2	0	0	19428	2
2	0	2	0	0	19429	2
2	0	2	0	0	19430	2
2	0	2	0	0	19431	2
2	2	2	0	2	19432	0
2	2	2	27	29	19433	1
2	0	2	0	0	19434	2
2	0	2	0	0	19435	2
2	2	2	0	2	19436	0
2	0	2	8	8	19437	2
2	0	2	0	0	19438	2
2	0	2	0	0	19439	2
2	0	2	0	0	19440	2
2	0	2	0	0	19441	2
2	0	2	0	0	19442	2
2	0	2	0	0	19443	2
2	0	2	0	0	19444	2
2	0	2	0	0	19445	2
2	0	2	0	0	19446	2
2	0	2	0	0	19447	2
2	0	2	0	0	19448	2
2	0	2	0	0	19449	2
2	0	2	0	0	19450	2
2	0	2	0	0	19451	2
2	0	2	0	0	19452	2
2	0	2	0	0	19453	2
2	0	2	0	0	19454	2
2	0	2	0	0	19455	2
2	0	2	0	0	19456	2
2	0	2	1	1	19457	2
2	0	2	0	0	19458	2
2	0	2	0	0	19459	2
2	0	2	0	0	19460	2
2	0	2	0	0	19461	2
2	0	2	0	0	19462	2
2	0	2	0	0	19463	2
2	0	2	0	0	19464	2
2	0	2	0	0	19465	2
2	0	2	0	0	19466	2
2	0	2	0	0	19467	2
2	0	2	0	0	19468	2
2	0	2	0	0	19469	2
2	0	2	0	0	19470	2
2	0	2	0	0	19471	2
2	0	2	0	0	19472	2
2	0	2	0	0	19473	2
2	0	2	0	0	19474	2
2	0	2	0	0	19475	2
2	0	2	0	0	19476	2
2	0	2	0	0	19477	2
2	0	2	0	0	19478	2
2	0	2	0	0	19479	2
2	0	2	0	0	19480	2
2	0	2	0	0	19481	2
2	0	2	0	0	19482	2
2	0	2	0	0	19483	2
2	0	2	0	0	19484	2
2	0	2	0	0	19485	2
2	0	2	0	0	19486	2
2	0	2	0	0	19487	2
2	0	2	0	0	19488	2
2	0	2	0	0	19489	2
2	0	2	0	0	19490	2
2	0	2	0	0	19491	2
2	0	2	0	0	19492	2
2	0	2	0	0	19493	2
2	0	2	0	0	19494	2
2	0	2	0	0	19495	2
2	0	2	0	0	19496	2
2	0	2	0	0	19497	2
2	0	2	0	0	19498	2
2	0	2	0	0	19499	2
2	0	2	0	0	19500	2
2	0	2	0	0	19501	2
2	0	2	0	0	19502	2
2	0	2	0	0	19503	2
2	0	2	0	0	19504	2
2	0	2	0	0	19505	2
2	0	2	0	0	19506	2
2	0	2	0	0	19507	2
2	0	2	0	0	19508	2
2	0	2	0	0	19509	2
2	0	2	0	0	19510	2
2	0	2	2	2	19511	2
2	0	2	0	0	19512	2
2	0	2	0	0	19513	2
2	0	2	0	0	19514	2
2	0	2	1	1	19515	2
2	1	2	0	1	19516	0
2	0	2	1	1	19517	2
2	0	2	0	0	19518	2
2	0	2	0	0	19519	2
2	0	2	0	0	19520	2
2	0	2	0	0	19521	2
2	0	2	0	0	19522	2
2	0	2	0	0	19523	2
2	0	2	0	0	19524	2
2	0	2	0	0	19525	2
2	0	2	6	6	19526	2
2	0	2	0	0	19527	2
2	0	2	0	0	19528	2
2	0	2	0	0	19529	2
2	0	2	4	4	19530	2
2	0	2	0	0	19531	2
2	0	4	1	1	19532	2
2	0	2	0	0	19533	2
2	0	2	0	0	19534	2
2	0	4	12	12	19535	2
2	0	2	0	0	19536	2
2	0	2	0	0	19537	2
2	0	2	0	0	19538	2
2	0	2	0	0	19539	2
2	0	2	0	0	19540	2
2	0	2	0	0	19541	2
2	0	2	0	0	19542	2
2	0	2	0	0	19543	2
2	0	2	0	0	19544	2
2	0	2	0	0	19545	2
2	0	2	0	0	19546	2
2	0	2	0	0	19547	2
2	0	2	0	0	19548	2
2	0	2	0	0	19549	2
2	0	2	0	0	19550	2
2	0	2	0	0	19551	2
2	0	2	0	0	19552	2
2	0	2	0	0	19553	2
2	0	2	0	0	19554	2
2	0	2	0	0	19555	2
2	0	2	0	0	19556	2
2	0	2	0	0	19557	2
2	0	2	0	0	19558	2
2	0	2	0	0	19559	2
2	0	2	0	0	19560	2
2	0	2	0	0	19561	2
2	0	2	0	0	19562	2
2	0	2	0	0	19563	2
2	0	2	0	0	19564	2
2	0	2	0	0	19565	2
2	0	2	0	0	19566	2
2	0	2	0	0	19567	2
2	0	2	0	0	19568	2
2	0	2	8	8	19569	2
2	0	2	0	0	19570	2
2	0	2	0	0	19571	2
2	1	2	0	1	19572	1
2	0	2	1	1	19573	2
2	0	2	0	0	19574	2
2	0	2	0	0	19575	2
2	0	2	0	0	19576	2
2	0	2	0	0	19577	2
2	0	2	0	0	19578	2
2	0	2	0	0	19579	2
2	0	2	0	0	19580	2
2	2	4	6	8	19581	1
2	0	2	0	0	19582	2
2	0	2	0	0	19583	2
2	1	4	0	1	19584	1
2	0	2	1	1	19585	2
2	0	2	0	0	19586	2
2	0	2	0	0	19587	2
2	0	2	0	0	19588	2
2	0	2	0	0	19589	2
2	0	2	0	0	19590	2
2	0	2	0	0	19591	2
2	0	2	0	0	19592	2
2	0	2	0	0	19593	2
2	0	2	0	0	19594	2
2	0	2	0	0	19595	2
2	0	2	0	0	19596	2
2	0	2	0	0	19597	2
2	0	2	0	0	19598	2
2	0	2	0	0	19599	2
2	0	2	0	0	19600	2
2	0	2	0	0	19601	2
2	0	2	0	0	19602	2
2	0	2	0	0	19603	2
2	0	2	0	0	19604	2
2	0	2	0	0	19605	2
2	0	2	0	0	19606	2
2	0	2	0	0	19607	2
2	0	2	0	0	19608	2
2	0	2	0	0	19609	2
2	0	2	0	0	19610	2
2	0	2	0	0	19611	2
2	0	2	0	0	19612	2
2	0	2	0	0	19613	2
2	0	2	0	0	19614	2
2	0	2	0	0	19615	2
2	0	2	0	0	19616	2
2	0	2	0	0	19617	2
2	0	2	0	0	19618	2
2	0	2	2	2	19619	2
2	0	2	3	3	19620	2
2	0	2	0	0	19621	2
2	0	2	0	0	19622	2
2	0	2	0	0	19623	2
2	0	2	0	0	19624	2
2	0	2	0	0	19625	2
2	0	2	0	0	19626	2
2	0	2	0	0	19627	2
2	0	2	0	0	19628	2
2	0	2	0	0	19629	2
2	0	2	0	0	19630	2
2	0	2	0	0	19631	2
2	0	2	0	0	19632	2
2	0	2	0	0	19633	2
2	0	2	0	0	19634	2
2	0	2	0	0	19635	2
2	0	2	0	0	19636	2
2	0	2	0	0	19637	2
2	0	2	0	0	19638	2
2	0	2	0	0	19639	2
2	0	2	1	1	19640	2
2	0	2	0	0	19641	2
2	0	2	0	0	19642	2
2	0	2	0	0	19643	2
2	0	2	1	1	19644	2
2	0	2	0	0	19645	2
2	0	2	0	0	19646	2
2	0	2	0	0	19647	2
2	0	2	0	0	19648	2
2	0	2	0	0	19649	2
2	0	2	0	0	19650	2
2	0	2	0	0	19651	2
2	0	2	0	0	19652	2
2	0	2	0	0	19653	2
2	0	2	0	0	19654	2
2	0	2	0	0	19655	2
2	0	2	0	0	19656	2
2	0	2	0	0	19657	2
2	0	2	0	0	19658	2
2	0	2	0	0	19659	2
2	0	2	0	0	19660	2
2	0	2	0	0	19661	2
2	0	2	0	0	19662	2
2	0	2	0	0	19663	2
2	0	2	0	0	19664	2
2	0	2	0	0	19665	2
2	0	2	0	0	19666	2
2	0	2	0	0	19667	2
2	0	2	0	0	19668	2
2	0	2	0	0	19669	2
2	0	2	0	0	19670	2
2	0	2	0	0	19671	2
2	0	2	2	2	19672	2
2	0	2	0	0	19673	2
2	0	2	0	0	19674	2
2	0	2	0	0	19675	2
2	0	2	0	0	19676	2
2	0	2	0	0	19677	2
2	0	2	0	0	19678	2
2	0	2	0	0	19679	2
2	0	2	0	0	19680	2
2	0	2	0	0	19681	2
2	0	2	0	0	19682	2
2	0	2	2	2	19683	2
2	0	2	0	0	19684	2
2	0	2	0	0	19685	2
2	0	2	0	0	19686	2
2	0	2	0	0	19687	2
2	0	2	0	0	19688	2
2	0	2	0	0	19689	2
2	0	2	0	0	19690	2
2	0	2	0	0	19691	2
2	0	2	0	0	19692	2
2	0	2	0	0	19693	2
2	0	2	0	0	19694	2
2	0	2	0	0	19695	2
2	0	2	0	0	19696	2
2	0	2	0	0	19697	2
2	0	2	0	0	19698	2
2	0	2	0	0	19699	2
2	0	2	0	0	19700	2
2	0	2	0	0	19701	2
2	0	2	0	0	19702	2
2	0	2	0	0	19703	2
2	0	2	0	0	19704	2
2	0	2	0	0	19705	2
2	0	2	0	0	19706	2
2	0	4	0	0	19707	2
2	0	2	0	0	19708	2
2	0	2	0	0	19709	2
2	0	4	1	1	19710	2
2	0	2	0	0	19711	2
2	0	2	0	0	19712	2
2	0	2	0	0	19713	2
2	0	2	0	0	19714	2
2	0	2	0	0	19715	2
2	0	2	0	0	19716	2
2	0	2	0	0	19717	2
2	0	2	0	0	19718	2
2	0	2	0	0	19719	2
2	0	2	0	0	19720	2
2	0	2	0	0	19721	2
2	0	2	1	1	19722	2
2	0	2	0	0	19723	2
2	0	2	0	0	19724	2
2	0	2	0	0	19725	2
2	0	2	0	0	19726	2
2	2	2	14	16	19727	0
2	0	2	0	0	19728	2
2	0	4	24	24	19729	2
2	0	2	0	0	19730	2
2	0	2	0	0	19731	2
2	0	4	2	2	19732	2
2	0	2	0	0	19733	2
2	0	2	0	0	19734	2
2	0	2	0	0	19735	2
2	0	2	0	0	19736	2
2	0	2	0	0	19737	2
2	0	2	0	0	19738	2
2	0	2	0	0	19739	2
2	0	2	0	0	19740	2
2	0	2	0	0	19741	2
2	0	2	0	0	19742	2
2	0	2	0	0	19743	2
2	0	2	0	0	19744	2
2	0	2	0	0	19745	2
2	0	2	0	0	19746	2
2	0	2	0	0	19747	2
2	0	2	2	2	19748	2
2	0	2	0	0	19749	2
2	0	2	0	0	19750	2
2	0	2	0	0	19751	2
2	0	2	0	0	19752	2
2	1	2	0	1	19753	0
2	1	2	15	16	19754	1
2	0	2	0	0	19755	2
2	0	2	0	0	19756	2
2	0	2	0	0	19757	2
2	0	2	3	3	19758	2
2	0	2	1	1	19759	2
2	0	2	0	0	19760	2
2	0	2	0	0	19761	2
2	0	2	0	0	19762	2
2	0	2	0	0	19763	2
2	0	2	0	0	19764	2
2	0	2	0	0	19765	2
2	0	2	0	0	19766	2
2	0	2	0	0	19767	2
2	0	2	0	0	19768	2
2	0	2	0	0	19769	2
2	0	2	0	0	19770	2
2	0	2	2	2	19771	2
2	0	2	0	0	19772	2
2	0	2	0	0	19773	2
2	0	2	0	0	19774	2
2	0	2	0	0	19775	2
2	0	2	0	0	19776	2
2	0	2	0	0	19777	2
2	0	2	0	0	19778	2
2	0	2	0	0	19779	2
2	0	2	0	0	19780	2
2	0	2	0	0	19781	2
2	1	4	0	1	19782	0
2	0	2	0	0	19783	2
2	0	2	0	0	19784	2
2	0	4	2	2	19785	2
2	0	2	0	0	19786	2
2	0	2	0	0	19787	2
2	0	2	0	0	19788	2
2	0	2	0	0	19789	2
2	0	2	0	0	19790	2
2	0	2	0	0	19791	2
2	0	2	0	0	19792	2
2	0	2	0	0	19793	2
2	0	2	0	0	19794	2
2	0	2	0	0	19795	2
2	0	2	0	0	19796	2
2	0	2	0	0	19797	2
2	0	2	0	0	19798	2
2	0	2	0	0	19799	2
2	2	2	0	2	19800	0
2	0	2	17	17	19801	2
2	0	2	0	0	19802	2
2	0	2	0	0	19803	2
2	0	2	0	0	19804	2
2	0	2	1	1	19805	2
2	0	2	0	0	19806	2
2	0	2	0	0	19807	2
2	0	2	0	0	19808	2
2	0	2	0	0	19809	2
2	0	2	0	0	19810	2
2	0	2	0	0	19811	2
2	0	2	0	0	19812	2
2	0	2	0	0	19813	2
2	0	2	0	0	19814	2
2	0	2	0	0	19815	2
2	0	2	0	0	19816	2
2	0	2	0	0	19817	2
2	0	2	0	0	19818	2
2	0	2	0	0	19819	2
2	0	2	0	0	19820	2
2	0	2	0	0	19821	2
2	0	2	0	0	19822	2
2	0	2	0	0	19823	2
2	0	2	0	0	19824	2
2	0	2	0	0	19825	2
2	0	2	0	0	19826	2
2	0	2	0	0	19827	2
2	0	2	0	0	19828	2
2	0	2	0	0	19829	2
2	0	2	0	0	19830	2
2	0	2	10	10	19831	2
2	0	2	0	0	19832	2
2	0	2	0	0	19833	2
2	0	2	0	0	19834	2
2	0	2	0	0	19835	2
2	0	2	0	0	19836	2
2	0	2	0	0	19837	2
2	0	2	0	0	19838	2
2	0	2	0	0	19839	2
2	0	2	0	0	19840	2
2	0	2	0	0	19841	2
2	0	2	0	0	19842	2
2	0	2	0	0	19843	2
2	0	2	0	0	19844	2
2	0	2	0	0	19845	2
2	0	2	0	0	19846	2
2	0	2	0	0	19847	2
2	0	2	0	0	19848	2
2	0	2	0	0	19849	2
2	0	2	0	0	19850	2
2	0	2	0	0	19851	2
2	0	2	0	0	19852	2
2	0	2	0	0	19853	2
2	0	2	0	0	19854	2
2	0	2	1	1	19855	2
2	0	2	0	0	19856	2
2	0	2	0	0	19857	2
2	0	2	0	0	19858	2
2	0	2	0	0	19859	2
2	0	2	0	0	19860	2
2	0	2	1	1	19861	2
2	0	2	0	0	19862	2
2	0	2	0	0	19863	2
2	0	2	0	0	19864	2
2	0	2	2	2	19865	2
2	0	2	0	0	19866	2
2	0	2	0	0	19867	2
2	0	2	0	0	19868	2
2	0	2	0	0	19869	2
2	0	2	0	0	19870	2
2	0	2	0	0	19871	2
2	0	2	0	0	19872	2
2	0	2	0	0	19873	2
2	0	2	0	0	19874	2
2	0	2	0	0	19875	2
2	0	2	0	0	19876	2
2	0	2	0	0	19877	2
2	0	2	0	0	19878	2
2	0	2	0	0	19879	2
2	0	2	0	0	19880	2
2	0	2	0	0	19881	2
2	0	2	0	0	19882	2
2	0	2	0	0	19883	2
2	0	2	0	0	19884	2
2	0	2	0	0	19885	2
2	0	2	0	0	19886	2
2	0	2	0	0	19887	2
2	0	2	0	0	19888	2
2	0	2	0	0	19889	2
2	0	2	0	0	19890	2
2	0	2	0	0	19891	2
2	0	2	0	0	19892	2
2	0	2	0	0	19893	2
2	0	2	0	0	19894	2
2	0	2	0	0	19895	2
2	0	2	0	0	19896	2
2	0	2	0	0	19897	2
2	0	2	0	0	19898	2
2	0	2	0	0	19899	2
2	0	2	0	0	19900	2
2	0	2	0	0	19901	2
2	0	2	0	0	19902	2
2	0	2	0	0	19903	2
2	0	2	0	0	19904	2
2	0	2	0	0	19905	2
2	0	2	0	0	19906	2
2	0	2	0	0	19907	2
4	4548	2	10	4558	19908	0
4	151	2	0	151	19909	0
2	0	2	0	0	19910	2
2	0	2	0	0	19911	2
2	0	2	0	0	19912	2
2	0	2	0	0	19913	2
2	0	2	0	0	19914	2
2	0	2	0	0	19915	2
2	0	2	0	0	19916	2
2	0	2	0	0	19917	2
2	0	2	0	0	19918	2
2	0	2	0	0	19919	2
2	0	2	19	19	19920	2
2	0	2	0	0	19921	2
2	0	2	0	0	19922	2
2	0	2	0	0	19923	2
2	0	2	1	1	19924	2
2	0	2	0	0	19925	2
2	0	2	0	0	19926	2
2	0	2	0	0	19927	2
2	0	2	0	0	19928	2
2	0	2	0	0	19929	2
2	0	2	0	0	19930	2
2	0	2	0	0	19931	2
2	0	2	0	0	19932	2
2	0	2	0	0	19933	2
2	0	2	0	0	19934	2
2	0	2	0	0	19935	2
2	0	2	0	0	19936	2
2	0	2	0	0	19937	2
2	0	2	0	0	19938	2
2	0	2	0	0	19939	2
2	0	2	0	0	19940	2
2	0	2	0	0	19941	2
2	0	2	0	0	19942	2
2	6	2	0	6	19943	0
2	0	2	86	86	19944	2
2	0	2	0	0	19945	2
2	0	2	0	0	19946	2
2	0	2	0	0	19947	2
2	0	2	5	5	19948	2
2	0	2	0	0	19949	2
2	0	2	0	0	19950	2
2	0	2	0	0	19951	2
2	0	2	0	0	19952	2
2	0	2	0	0	19953	2
2	0	2	0	0	19954	2
2	0	2	1	1	19955	2
2	0	2	0	0	19956	2
2	0	2	0	0	19957	2
2	0	2	0	0	19958	2
2	0	2	0	0	19959	2
2	0	2	0	0	19960	2
2	0	2	0	0	19961	2
2	0	2	0	0	19962	2
2	0	2	0	0	19963	2
2	0	2	0	0	19964	2
2	0	2	0	0	19965	2
2	0	2	0	0	19966	2
2	0	2	0	0	19967	2
2	0	2	0	0	19968	2
2	0	2	0	0	19969	2
2	0	2	0	0	19970	2
2	0	2	0	0	19971	2
2	0	2	0	0	19972	2
2	0	2	0	0	19973	2
2	0	2	0	0	19974	2
2	0	2	0	0	19975	2
2	1	2	0	1	19976	1
2	0	2	0	0	19977	2
2	0	2	0	0	19978	2
2	0	2	5	5	19979	2
2	0	2	0	0	19980	2
2	0	2	0	0	19981	2
2	0	2	1	1	19982	2
2	0	2	1	1	19983	2
2	1	2	0	1	19984	0
2	0	2	0	0	19985	2
2	0	2	0	0	19986	2
2	0	2	0	0	19987	2
2	0	2	0	0	19988	2
2	0	2	0	0	19989	2
2	0	2	0	0	19990	2
2	0	2	0	0	19991	2
2	0	2	0	0	19992	2
2	0	2	0	0	19993	2
2	0	2	0	0	19994	2
2	0	2	0	0	19995	2
2	0	2	0	0	19996	2
2	0	0	30	30	19997	2
2	0	2	0	0	19998	2
2	0	2	0	0	19999	2
2	0	0	38	38	20000	2
2	0	2	0	0	20001	2
2	0	2	0	0	20002	2
2	0	2	1	1	20003	2
2	0	2	0	0	20004	2
2	0	2	0	0	20005	2
2	0	2	0	0	20006	2
2	0	2	0	0	20007	2
2	0	2	0	0	20008	2
2	0	4	39	39	20009	2
2	0	2	0	0	20010	2
2	0	2	0	0	20011	2
2	0	4	1	1	20012	2
2	0	2	1	1	20013	2
2	2	2	0	2	20014	0
2	0	2	3	3	20015	2
2	0	2	0	0	20016	2
2	0	2	0	0	20017	2
2	0	2	0	0	20018	2
2	0	2	0	0	20019	2
2	0	2	0	0	20020	2
2	0	2	0	0	20021	2
2	0	2	0	0	20022	2
2	0	2	0	0	20023	2
2	0	2	0	0	20024	2
2	0	2	0	0	20025	2
2	0	2	0	0	20026	2
2	0	2	0	0	20027	2
2	0	2	0	0	20028	2
2	0	2	0	0	20029	2
2	0	2	0	0	20030	2
2	0	2	0	0	20031	2
2	29	2	0	29	20032	0
2	40	2	282	322	20033	1
2	0	2	1	1	20034	2
2	0	2	0	0	20035	2
2	29	2	0	29	20036	0
2	0	2	93	93	20037	2
2	0	2	0	0	20038	2
2	0	2	0	0	20039	2
2	0	2	0	0	20040	2
2	0	2	0	0	20041	2
2	0	2	0	0	20042	2
2	0	2	0	0	20043	2
2	0	2	0	0	20044	2
2	2	2	9	11	20045	1
2	0	2	0	0	20046	2
2	0	2	0	0	20047	2
2	1	2	0	1	20048	0
2	0	2	1	1	20049	2
2	0	2	0	0	20050	2
2	0	2	0	0	20051	2
2	0	2	0	0	20052	2
2	0	2	0	0	20053	2
2	0	2	0	0	20054	2
2	0	2	0	0	20055	2
2	0	2	0	0	20056	2
2	0	2	0	0	20057	2
2	0	2	0	0	20058	2
2	0	2	0	0	20059	2
2	0	2	0	0	20060	2
2	0	2	0	0	20061	2
2	2	2	0	2	20062	0
2	0	2	7	7	20063	2
2	0	2	0	0	20064	2
2	0	2	0	0	20065	2
2	1	2	0	1	20066	1
2	0	2	2	2	20067	2
2	0	2	0	0	20068	2
2	0	2	2	2	20069	2
2	0	2	0	0	20070	2
2	0	2	0	0	20071	2
2	0	2	0	0	20072	2
2	0	2	0	0	20073	2
2	0	2	0	0	20074	2
2	0	2	0	0	20075	2
2	0	2	0	0	20076	2
2	0	2	0	0	20077	2
2	0	2	0	0	20078	2
2	0	2	0	0	20079	2
2	0	2	0	0	20080	2
2	0	2	0	0	20081	2
2	0	2	0	0	20082	2
2	0	2	0	0	20083	2
2	0	2	0	0	20084	2
2	0	2	0	0	20085	2
2	0	2	0	0	20086	2
2	0	2	0	0	20087	2
2	0	2	0	0	20088	2
2	0	2	0	0	20089	2
2	0	2	0	0	20090	2
2	0	2	0	0	20091	2
2	0	2	0	0	20092	2
2	0	2	0	0	20093	2
2	0	2	0	0	20094	2
2	0	2	0	0	20095	2
2	0	2	0	0	20096	2
2	0	2	0	0	20097	2
2	0	2	0	0	20098	2
2	0	2	0	0	20099	2
2	0	2	0	0	20100	2
2	0	2	0	0	20101	2
2	0	2	0	0	20102	2
2	0	2	0	0	20103	2
2	0	2	0	0	20104	2
2	0	2	0	0	20105	2
2	0	2	0	0	20106	2
2	0	2	0	0	20107	2
2	0	2	0	0	20108	2
2	0	2	0	0	20109	2
2	0	2	0	0	20110	2
2	0	2	0	0	20111	2
2	0	2	0	0	20112	2
2	0	2	0	0	20113	2
2	0	2	0	0	20114	2
2	0	2	0	0	20115	2
2	0	2	0	0	20116	2
2	0	2	0	0	20117	2
2	0	2	0	0	20118	2
2	0	2	0	0	20119	2
2	0	2	0	0	20120	2
2	1	2	0	1	20121	0
2	0	2	7	7	20122	2
2	0	2	0	0	20123	2
2	0	2	0	0	20124	2
2	1	2	0	1	20125	0
2	0	2	0	0	20126	2
2	0	2	0	0	20127	2
2	0	2	3	3	20128	2
2	0	2	0	0	20129	2
2	0	2	0	0	20130	2
2	0	2	0	0	20131	2
2	0	2	1	1	20132	2
2	0	2	0	0	20133	2
2	0	2	0	0	20134	2
2	0	2	0	0	20135	2
2	0	2	0	0	20136	2
2	0	0	0	0	20137	2
2	0	2	0	0	20138	2
2	0	2	0	0	20139	2
2	0	0	0	0	20140	2
2	0	2	0	0	20141	2
2	0	2	0	0	20142	2
2	0	2	0	0	20143	2
2	0	2	0	0	20144	2
2	0	2	0	0	20145	2
2	0	2	0	0	20146	2
2	0	2	0	0	20147	2
2	0	2	0	0	20148	2
2	0	2	0	0	20149	2
2	0	2	0	0	20150	2
2	0	2	0	0	20151	2
2	0	2	0	0	20152	2
2	0	2	0	0	20153	2
2	6	2	0	6	20154	0
2	0	2	79	79	20155	2
2	0	2	0	0	20156	2
2	0	2	2	2	20157	2
2	0	2	0	0	20158	2
2	0	2	1	1	20159	2
2	6	2	0	6	20160	0
2	9	2	61	70	20161	1
2	0	2	0	0	20162	2
2	0	2	0	0	20163	2
2	3	2	0	3	20164	0
2	0	2	8	8	20165	2
2	0	2	0	0	20166	2
2	0	2	0	0	20167	2
2	0	2	0	0	20168	2
2	0	2	0	0	20169	2
2	0	2	0	0	20170	2
2	0	2	0	0	20171	2
2	0	2	0	0	20172	2
2	0	2	0	0	20173	2
2	0	2	0	0	20174	2
2	0	2	0	0	20175	2
2	0	2	0	0	20176	2
2	0	2	2	2	20177	2
2	0	2	0	0	20178	2
2	0	2	0	0	20179	2
2	0	2	0	0	20180	2
2	0	2	0	0	20181	2
2	0	2	0	0	20182	2
2	0	2	0	0	20183	2
2	0	2	0	0	20184	2
2	0	2	2	2	20185	2
2	0	2	0	0	20186	2
2	0	2	0	0	20187	2
2	0	2	0	0	20188	2
2	0	2	0	0	20189	2
2	0	2	0	0	20190	2
2	0	2	0	0	20191	2
2	0	2	0	0	20192	2
2	0	2	0	0	20193	2
2	0	2	0	0	20194	2
2	0	2	0	0	20195	2
2	0	2	0	0	20196	2
2	0	2	0	0	20197	2
2	0	2	0	0	20198	2
2	0	2	0	0	20199	2
2	0	2	0	0	20200	2
2	0	2	0	0	20201	2
2	0	2	0	0	20202	2
2	0	2	0	0	20203	2
2	0	2	0	0	20204	2
2	0	2	0	0	20205	2
2	0	2	0	0	20206	2
2	0	2	0	0	20207	2
2	0	2	0	0	20208	2
2	6	2	0	6	20209	0
2	0	2	7	7	20210	2
2	0	2	0	0	20211	2
2	54	2	61	115	20212	1
2	0	2	581	581	20213	2
2	34	2	2	36	20214	0
2	3	2	4709	4712	20215	1
2	0	2	7	7	20216	2
2	0	2	15	15	20217	2
0	101	4	2204	2305	20218	1
2	0	2	0	0	20219	2
2	0	2	0	0	20220	2
2	0	2	0	0	20221	2
2	0	2	0	0	20222	2
2	0	2	0	0	20223	2
2	0	2	0	0	20224	2
2	0	2	0	0	20225	2
2	0	2	0	0	20226	2
2	0	2	0	0	20227	2
2	0	2	0	0	20228	2
2	0	2	0	0	20229	2
2	0	2	0	0	20230	2
2	0	2	0	0	20231	2
2	0	2	0	0	20232	2
2	0	2	0	0	20233	2
2	0	2	0	0	20234	2
2	0	2	3	3	20235	2
2	0	2	0	0	20236	2
2	0	2	0	0	20237	2
2	0	2	0	0	20238	2
2	0	2	1	1	20239	2
2	0	2	0	0	20240	2
2	0	2	0	0	20241	2
2	0	2	0	0	20242	2
2	0	2	0	0	20243	2
2	0	2	0	0	20244	2
2	0	2	0	0	20245	2
2	0	2	0	0	20246	2
2	0	2	0	0	20247	2
2	0	2	0	0	20248	2
2	0	2	0	0	20249	2
2	0	2	0	0	20250	2
2	0	2	0	0	20251	2
2	0	2	0	0	20252	2
2	0	2	0	0	20253	2
2	0	2	0	0	20254	2
2	0	2	0	0	20255	2
2	0	2	0	0	20256	2
2	0	2	0	0	20257	2
2	0	2	0	0	20258	2
2	0	2	0	0	20259	2
2	0	2	0	0	20260	2
2	0	2	0	0	20261	2
2	0	2	0	0	20262	2
2	0	2	0	0	20263	2
2	0	2	0	0	20264	2
2	0	2	0	0	20265	2
2	0	2	0	0	20266	2
2	0	2	0	0	20267	2
2	0	2	0	0	20268	2
2	0	2	0	0	20269	2
2	0	2	0	0	20270	2
2	0	2	0	0	20271	2
2	0	2	0	0	20272	2
2	0	2	0	0	20273	2
2	0	2	0	0	20274	2
2	0	2	0	0	20275	2
2	0	2	0	0	20276	2
2	0	2	0	0	20277	2
2	0	2	0	0	20278	2
2	0	2	0	0	20279	2
2	0	2	1	1	20280	2
2	0	2	0	0	20281	2
2	0	2	0	0	20282	2
2	0	2	0	0	20283	2
2	0	2	0	0	20284	2
2	0	2	0	0	20285	2
2	0	2	0	0	20286	2
2	0	2	0	0	20287	2
2	0	2	0	0	20288	2
2	0	2	0	0	20289	2
2	0	2	0	0	20290	2
2	4	2	0	4	20291	0
2	0	2	0	0	20292	2
2	0	2	0	0	20293	2
2	0	2	0	0	20294	2
2	0	2	0	0	20295	2
2	0	2	0	0	20296	2
2	0	2	0	0	20297	2
2	3	2	0	3	20298	0
2	0	2	22	22	20299	2
2	0	2	31	31	20300	2
2	0	2	0	0	20301	2
2	0	2	0	0	20302	2
2	0	2	0	0	20303	2
2	0	2	0	0	20304	2
2	10	2	0	10	20305	0
2	1	2	23	24	20306	1
2	0	2	12	12	20307	2
2	0	2	0	0	20308	2
2	2	2	0	2	20309	0
2	0	2	17	17	20310	2
2	0	2	0	0	20311	2
2	0	2	0	0	20312	2
2	0	2	0	0	20313	2
2	0	2	0	0	20314	2
2	0	2	0	0	20315	2
2	0	2	0	0	20316	2
2	0	2	0	0	20317	2
2	0	2	0	0	20318	2
2	0	2	0	0	20319	2
2	0	2	0	0	20320	2
2	0	2	0	0	20321	2
2	0	2	0	0	20322	2
2	0	2	0	0	20323	2
2	0	2	0	0	20324	2
2	0	2	0	0	20325	2
2	0	2	0	0	20326	2
2	0	2	0	0	20327	2
2	0	2	0	0	20328	2
2	0	2	0	0	20329	2
2	0	2	0	0	20330	2
2	0	2	0	0	20331	2
2	0	2	0	0	20332	2
2	0	2	0	0	20333	2
2	0	2	0	0	20334	2
2	0	2	0	0	20335	2
2	0	2	0	0	20336	2
2	0	2	0	0	20337	2
2	0	2	0	0	20338	2
2	0	2	0	0	20339	2
2	0	2	0	0	20340	2
2	0	2	0	0	20341	2
2	0	2	0	0	20342	2
2	0	2	0	0	20343	2
2	0	2	0	0	20344	2
2	0	2	0	0	20345	2
2	0	2	0	0	20346	2
2	0	2	1	1	20347	2
2	0	2	0	0	20348	2
2	0	2	0	0	20349	2
2	0	2	0	0	20350	2
2	0	2	0	0	20351	2
2	0	2	0	0	20352	2
2	0	2	0	0	20353	2
2	1	2	0	1	20354	0
2	0	2	11	11	20355	2
2	0	2	0	0	20356	2
2	0	2	0	0	20357	2
2	0	2	0	0	20358	2
2	0	2	1	1	20359	2
2	0	2	0	0	20360	2
2	0	2	0	0	20361	2
2	0	2	0	0	20362	2
2	0	2	0	0	20363	2
2	0	2	0	0	20364	2
2	0	2	0	0	20365	2
2	1	2	0	1	20366	0
2	0	2	0	0	20367	2
2	0	2	0	0	20368	2
2	0	2	0	0	20369	2
2	0	2	0	0	20370	2
2	0	2	0	0	20371	2
2	2	2	0	2	20372	0
2	0	2	18	18	20373	2
2	0	2	0	0	20374	2
2	0	2	0	0	20375	2
2	1	2	2	3	20376	0
2	0	2	0	0	20377	2
2	0	2	0	0	20378	2
2	0	2	0	0	20379	2
2	0	2	0	0	20380	2
2	0	2	0	0	20381	2
2	0	2	0	0	20382	2
2	0	2	0	0	20383	2
2	0	2	0	0	20384	2
2	0	2	0	0	20385	2
2	0	2	0	0	20386	2
2	0	2	0	0	20387	2
2	0	2	0	0	20388	2
2	0	2	0	0	20389	2
2	0	2	0	0	20390	2
2	0	2	0	0	20391	2
2	0	2	0	0	20392	2
2	0	2	0	0	20393	2
2	0	2	0	0	20394	2
2	0	2	0	0	20395	2
2	0	2	0	0	20396	2
2	0	2	0	0	20397	2
2	0	2	0	0	20398	2
2	0	2	0	0	20399	2
2	0	2	0	0	20400	2
2	0	2	0	0	20401	2
2	0	2	0	0	20402	2
2	0	2	0	0	20403	2
2	0	2	0	0	20404	2
2	0	2	0	0	20405	2
2	0	2	0	0	20406	2
2	0	2	0	0	20407	2
2	5	2	0	5	20408	0
2	4	2	18	22	20409	1
2	0	2	1	1	20410	2
2	0	2	0	0	20411	2
2	3	2	0	3	20412	0
2	0	2	28	28	20413	2
2	0	2	0	0	20414	2
2	0	2	0	0	20415	2
2	0	2	0	0	20416	2
2	0	2	0	0	20417	2
2	0	2	0	0	20418	2
2	0	2	0	0	20419	2
2	0	2	0	0	20420	2
2	0	2	0	0	20421	2
2	0	2	0	0	20422	2
2	0	2	0	0	20423	2
2	0	2	0	0	20424	2
2	0	2	0	0	20425	2
2	0	2	87	87	20426	2
2	0	2	0	0	20427	2
2	0	2	0	0	20428	2
2	0	2	0	0	20429	2
2	0	2	0	0	20430	2
2	0	2	0	0	20431	2
2	0	2	0	0	20432	2
2	0	2	0	0	20433	2
2	0	2	0	0	20434	2
2	1	2	1	2	20435	0
2	0	2	2	2	20436	2
2	0	2	0	0	20437	2
2	0	2	0	0	20438	2
2	0	2	0	0	20439	2
2	0	2	0	0	20440	2
2	0	2	0	0	20441	2
2	0	2	0	0	20442	2
2	0	2	0	0	20443	2
2	0	2	0	0	20444	2
2	0	2	0	0	20445	2
2	0	2	0	0	20446	2
2	0	2	0	0	20447	2
2	0	2	0	0	20448	2
2	0	2	0	0	20449	2
2	0	2	0	0	20450	2
2	0	2	0	0	20451	2
2	0	2	0	0	20452	2
2	0	2	0	0	20453	2
2	0	2	0	0	20454	2
2	0	2	0	0	20455	2
2	0	2	12	12	20456	2
2	0	2	0	0	20457	2
2	0	2	0	0	20458	2
2	0	2	0	0	20459	2
2	0	2	0	0	20460	2
2	0	4	17	17	20461	2
2	1	2	0	1	20462	0
2	1	2	1	2	20463	1
2	0	2	0	0	20464	2
2	0	2	0	0	20465	2
2	0	2	0	0	20466	2
2	0	2	0	0	20467	2
2	0	2	0	0	20468	2
2	0	2	0	0	20469	2
2	0	2	0	0	20470	2
2	0	2	0	0	20471	2
2	0	2	0	0	20472	2
2	0	2	0	0	20473	2
2	0	2	0	0	20474	2
2	0	2	0	0	20475	2
2	0	2	0	0	20476	2
2	0	2	0	0	20477	2
2	0	2	0	0	20478	2
2	0	2	0	0	20479	2
4	0	2	0	0	20480	2
4	0	2	0	0	20481	2
2	0	2	0	0	20482	2
2	0	2	0	0	20483	2
2	0	2	0	0	20484	2
2	0	2	0	0	20485	2
2	0	2	0	0	20486	2
2	0	2	0	0	20487	2
2	8	2	0	8	20488	0
2	1	2	0	1	20489	1
2	0	2	0	0	20490	2
2	0	2	0	0	20491	2
2	5	2	0	5	20492	0
2	0	2	0	0	20493	2
2	0	2	0	0	20494	2
2	0	2	0	0	20495	2
2	0	2	0	0	20496	2
2	0	2	0	0	20497	2
2	0	2	0	0	20498	2
2	0	2	0	0	20499	2
2	0	2	0	0	20500	2
2	0	2	0	0	20501	2
2	0	2	0	0	20502	2
2	0	2	0	0	20503	2
2	0	2	0	0	20504	2
2	0	2	0	0	20505	2
2	0	2	0	0	20506	2
2	0	2	0	0	20507	2
2	0	2	0	0	20508	2
2	0	2	0	0	20509	2
2	0	2	0	0	20510	2
2	0	2	0	0	20511	2
2	0	2	0	0	20512	2
2	0	2	0	0	20513	2
2	0	2	0	0	20514	2
2	0	2	0	0	20515	2
2	0	2	0	0	20516	2
2	0	2	0	0	20517	2
2	0	2	0	0	20518	2
2	0	2	0	0	20519	2
2	0	2	0	0	20520	2
2	0	2	1	1	20521	2
2	0	2	0	0	20522	2
2	0	2	0	0	20523	2
2	0	2	0	0	20524	2
2	0	2	0	0	20525	2
2	0	2	0	0	20526	2
2	0	2	0	0	20527	2
2	0	2	0	0	20528	2
2	0	2	0	0	20529	2
2	0	2	0	0	20530	2
2	0	2	0	0	20531	2
2	0	2	0	0	20532	2
2	1	2	0	1	20533	1
2	0	2	2	2	20534	2
2	0	2	0	0	20535	2
2	0	2	2	2	20536	2
2	0	2	0	0	20537	2
2	0	2	0	0	20538	2
2	0	2	0	0	20539	2
2	0	2	0	0	20540	2
2	0	2	0	0	20541	2
2	0	2	0	0	20542	2
2	0	2	0	0	20543	2
2	0	2	0	0	20544	2
2	0	2	0	0	20545	2
2	0	2	0	0	20546	2
2	0	2	0	0	20547	2
2	0	2	0	0	20548	2
2	0	2	3	3	20549	2
2	0	2	0	0	20550	2
2	0	2	0	0	20551	2
2	0	2	0	0	20552	2
2	0	2	0	0	20553	2
2	0	2	0	0	20554	2
2	0	2	0	0	20555	2
2	0	2	0	0	20556	2
2	0	2	0	0	20557	2
2	0	2	0	0	20558	2
2	0	2	0	0	20559	2
2	0	2	2	2	20560	2
2	0	2	0	0	20561	2
2	0	2	0	0	20562	2
2	0	2	0	0	20563	2
2	0	2	0	0	20564	2
2	1	2	0	1	20565	0
2	0	2	2	2	20566	2
2	0	2	1	1	20567	2
2	0	2	0	0	20568	2
2	0	2	0	0	20569	2
2	0	2	0	0	20570	2
2	0	2	0	0	20571	2
2	0	2	0	0	20572	2
2	0	2	0	0	20573	2
2	0	2	0	0	20574	2
2	0	2	0	0	20575	2
2	0	2	0	0	20576	2
2	0	2	0	0	20577	2
2	0	2	0	0	20578	2
2	0	2	0	0	20579	2
2	0	2	0	0	20580	2
2	0	2	0	0	20581	2
2	0	2	0	0	20582	2
2	1	2	0	1	20583	0
2	0	2	1	1	20584	2
2	0	2	0	0	20585	2
2	0	2	0	0	20586	2
2	1	2	1	2	20587	0
2	0	2	0	0	20588	2
2	0	2	0	0	20589	2
2	0	2	0	0	20590	2
2	0	2	0	0	20591	2
2	0	2	0	0	20592	2
2	0	2	0	0	20593	2
2	0	2	0	0	20594	2
2	0	2	0	0	20595	2
2	0	2	0	0	20596	2
2	0	2	0	0	20597	2
2	0	2	0	0	20598	2
2	0	2	0	0	20599	2
2	0	2	0	0	20600	2
2	0	2	0	0	20601	2
2	0	2	0	0	20602	2
2	0	2	0	0	20603	2
2	0	2	0	0	20604	2
2	0	2	0	0	20605	2
2	0	2	0	0	20606	2
2	0	2	0	0	20607	2
2	0	2	0	0	20608	2
2	0	2	0	0	20609	2
2	0	2	0	0	20610	2
2	0	2	0	0	20611	2
2	0	2	0	0	20612	2
2	0	2	0	0	20613	2
2	1	2	2	3	20614	1
2	0	2	0	0	20615	2
2	0	2	0	0	20616	2
2	1	2	0	1	20617	0
2	0	2	1	1	20618	2
2	0	2	0	0	20619	2
2	0	2	0	0	20620	2
2	0	2	0	0	20621	2
2	0	2	0	0	20622	2
2	0	2	0	0	20623	2
2	0	2	0	0	20624	2
2	0	2	0	0	20625	2
2	0	2	0	0	20626	2
2	0	2	0	0	20627	2
2	0	2	0	0	20628	2
2	0	2	0	0	20629	2
2	0	2	0	0	20630	2
2	0	2	0	0	20631	2
2	0	2	0	0	20632	2
2	0	2	4	4	20633	2
2	0	2	0	0	20634	2
2	0	2	0	0	20635	2
2	0	2	0	0	20636	2
2	0	2	0	0	20637	2
2	0	2	0	0	20638	2
2	0	2	0	0	20639	2
2	0	2	0	0	20640	2
2	0	2	0	0	20641	2
2	0	2	0	0	20642	2
2	0	2	0	0	20643	2
2	0	2	0	0	20644	2
2	0	2	0	0	20645	2
2	0	2	0	0	20646	2
2	0	2	0	0	20647	2
2	0	2	0	0	20648	2
2	0	2	0	0	20649	2
2	0	2	1	1	20650	2
2	0	2	0	0	20651	2
2	0	2	0	0	20652	2
2	0	2	0	0	20653	2
2	0	2	0	0	20654	2
2	8	2	0	8	20655	0
2	2	2	66	68	20656	1
2	0	2	0	0	20657	2
2	0	2	0	0	20658	2
2	0	2	0	0	20659	2
2	0	2	11	11	20660	2
2	0	2	0	0	20661	2
2	0	2	0	0	20662	2
2	0	2	0	0	20663	2
2	0	2	0	0	20664	2
2	0	2	0	0	20665	2
2	0	2	0	0	20666	2
2	0	2	0	0	20667	2
2	0	2	0	0	20668	2
2	0	2	0	0	20669	2
2	0	2	0	0	20670	2
2	0	2	0	0	20671	2
2	0	2	0	0	20672	2
2	0	2	0	0	20673	2
2	0	2	0	0	20674	2
2	0	2	0	0	20675	2
2	0	2	0	0	20676	2
2	0	2	0	0	20677	2
2	0	2	0	0	20678	2
2	0	2	0	0	20679	2
2	0	2	0	0	20680	2
2	0	2	7	7	20681	2
2	0	2	0	0	20682	2
2	0	2	0	0	20683	2
2	0	2	0	0	20684	2
2	0	2	1	1	20685	2
2	0	2	0	0	20686	2
2	0	2	0	0	20687	2
2	0	2	0	0	20688	2
2	0	2	0	0	20689	2
2	0	2	0	0	20690	2
2	0	2	0	0	20691	2
2	0	2	0	0	20692	2
2	0	2	0	0	20693	2
2	0	2	0	0	20694	2
2	0	2	0	0	20695	2
2	0	2	0	0	20696	2
2	0	2	0	0	20697	2
2	0	2	0	0	20698	2
2	0	2	0	0	20699	2
2	0	2	0	0	20700	2
2	0	2	0	0	20701	2
2	0	2	0	0	20702	2
2	0	2	0	0	20703	2
2	0	2	0	0	20704	2
2	0	2	0	0	20705	2
2	0	2	0	0	20706	2
2	0	2	0	0	20707	2
2	0	2	0	0	20708	2
2	0	2	0	0	20709	2
2	0	2	0	0	20710	2
2	0	2	0	0	20711	2
2	0	2	0	0	20712	2
2	0	2	0	0	20713	2
2	0	2	0	0	20714	2
2	0	2	0	0	20715	2
2	0	2	0	0	20716	2
2	0	2	0	0	20717	2
2	0	2	0	0	20718	2
2	0	2	0	0	20719	2
2	0	2	0	0	20720	2
2	0	2	0	0	20721	2
2	0	2	0	0	20722	2
2	0	2	0	0	20723	2
2	0	2	0	0	20724	2
2	0	2	0	0	20725	2
2	0	2	0	0	20726	2
2	0	2	0	0	20727	2
2	0	2	0	0	20728	2
2	0	2	0	0	20729	2
2	0	2	0	0	20730	2
2	0	2	0	0	20731	2
2	0	2	0	0	20732	2
2	0	2	0	0	20733	2
2	0	2	0	0	20734	2
2	0	2	0	0	20735	2
2	0	2	0	0	20736	2
2	0	2	0	0	20737	2
2	0	2	0	0	20738	2
2	0	2	0	0	20739	2
2	0	2	0	0	20740	2
2	0	2	0	0	20741	2
2	0	2	0	0	20742	2
2	0	2	0	0	20743	2
2	0	2	0	0	20744	2
2	0	2	0	0	20745	2
2	0	2	0	0	20746	2
2	0	2	0	0	20747	2
2	0	2	0	0	20748	2
2	0	2	0	0	20749	2
2	0	2	0	0	20750	2
2	0	2	0	0	20751	2
2	0	2	0	0	20752	2
2	0	2	0	0	20753	2
2	0	2	0	0	20754	2
2	0	2	0	0	20755	2
2	0	2	0	0	20756	2
2	0	2	0	0	20757	2
2	0	2	0	0	20758	2
2	0	2	0	0	20759	2
2	0	2	0	0	20760	2
2	0	2	0	0	20761	2
2	0	2	0	0	20762	2
2	0	2	0	0	20763	2
2	0	2	0	0	20764	2
2	0	2	0	0	20765	2
2	0	2	0	0	20766	2
2	0	2	1	1	20767	2
2	0	2	0	0	20768	2
2	0	2	0	0	20769	2
2	0	2	0	0	20770	2
2	1	2	0	1	20771	0
2	0	2	0	0	20772	2
2	0	2	0	0	20773	2
2	0	2	0	0	20774	2
2	0	2	0	0	20775	2
2	0	2	0	0	20776	2
2	0	2	0	0	20777	2
2	0	2	0	0	20778	2
2	0	2	0	0	20779	2
2	0	2	0	0	20780	2
2	0	2	0	0	20781	2
2	0	2	0	0	20782	2
2	0	2	0	0	20783	2
2	0	2	0	0	20784	2
2	0	2	0	0	20785	2
2	0	2	0	0	20786	2
2	0	2	0	0	20787	2
2	0	2	0	0	20788	2
2	0	2	0	0	20789	2
2	0	2	0	0	20790	2
2	0	2	0	0	20791	2
2	0	2	0	0	20792	2
2	0	2	0	0	20793	2
2	0	2	3	3	20794	2
2	0	2	0	0	20795	2
2	0	2	0	0	20796	2
2	2	2	0	2	20797	1
2	0	2	0	0	20798	2
2	0	2	0	0	20799	2
2	0	2	0	0	20800	2
2	0	2	0	0	20801	2
2	0	2	0	0	20802	2
2	0	2	0	0	20803	2
2	0	2	0	0	20804	2
2	0	2	0	0	20805	2
2	0	2	0	0	20806	2
2	0	2	0	0	20807	2
2	0	2	0	0	20808	2
2	0	2	0	0	20809	2
2	0	2	0	0	20810	2
2	0	2	0	0	20811	2
2	0	2	0	0	20812	2
2	0	2	0	0	20813	2
2	0	2	0	0	20814	2
2	0	2	0	0	20815	2
2	0	2	0	0	20816	2
2	0	2	0	0	20817	2
2	0	2	0	0	20818	2
2	0	2	0	0	20819	2
2	0	2	0	0	20820	2
2	0	2	0	0	20821	2
2	0	2	0	0	20822	2
2	0	2	0	0	20823	2
2	0	2	0	0	20824	2
2	0	2	0	0	20825	2
2	0	2	0	0	20826	2
2	0	2	0	0	20827	2
2	0	2	0	0	20828	2
2	0	2	0	0	20829	2
2	0	2	0	0	20830	2
2	0	2	0	0	20831	2
2	0	2	0	0	20832	2
2	0	2	0	0	20833	2
2	0	2	0	0	20834	2
2	0	2	0	0	20835	2
2	0	2	0	0	20836	2
2	0	2	0	0	20837	2
2	0	2	0	0	20838	2
2	0	2	0	0	20839	2
2	0	2	0	0	20840	2
2	0	2	0	0	20841	2
2	0	2	0	0	20842	2
2	0	2	0	0	20843	2
2	0	2	0	0	20844	2
2	0	2	0	0	20845	2
2	0	2	0	0	20846	2
2	0	2	0	0	20847	2
2	0	2	0	0	20848	2
2	0	2	0	0	20849	2
2	0	2	0	0	20850	2
2	0	2	0	0	20851	2
2	0	2	0	0	20852	2
2	0	2	2	2	20853	2
2	0	2	0	0	20854	2
2	0	2	0	0	20855	2
2	0	2	0	0	20856	2
2	0	2	1	1	20857	2
2	0	2	0	0	20858	2
2	0	2	0	0	20859	2
2	0	2	0	0	20860	2
2	0	2	0	0	20861	2
2	0	2	0	0	20862	2
2	0	2	0	0	20863	2
2	0	2	0	0	20864	2
2	0	2	0	0	20865	2
2	0	2	0	0	20866	2
2	0	2	0	0	20867	2
2	0	2	1	1	20868	2
2	0	2	0	0	20869	2
2	0	2	0	0	20870	2
2	0	2	0	0	20871	2
2	0	2	0	0	20872	2
2	0	2	0	0	20873	2
2	0	2	6	6	20874	2
2	0	2	0	0	20875	2
2	0	2	0	0	20876	2
2	0	2	0	0	20877	2
2	0	2	1	1	20878	2
2	0	2	0	0	20879	2
2	0	2	0	0	20880	2
2	0	2	0	0	20881	2
2	0	2	0	0	20882	2
2	0	2	0	0	20883	2
2	0	2	0	0	20884	2
2	0	2	0	0	20885	2
2	0	2	0	0	20886	2
2	0	2	0	0	20887	2
2	0	2	0	0	20888	2
2	0	2	0	0	20889	2
2	0	2	0	0	20890	2
2	0	2	0	0	20891	2
2	0	2	0	0	20892	2
2	0	2	0	0	20893	2
2	0	2	0	0	20894	2
2	0	2	0	0	20895	2
2	0	2	0	0	20896	2
2	0	2	0	0	20897	2
2	0	2	2	2	20898	2
2	0	2	0	0	20899	2
2	0	2	0	0	20900	2
2	0	2	0	0	20901	2
2	0	2	0	0	20902	2
2	0	2	0	0	20903	2
2	0	2	0	0	20904	2
2	0	2	0	0	20905	2
2	0	2	0	0	20906	2
2	0	2	0	0	20907	2
2	0	2	0	0	20908	2
2	0	2	0	0	20909	2
2	0	2	0	0	20910	2
2	0	2	0	0	20911	2
2	0	2	0	0	20912	2
2	0	2	0	0	20913	2
2	0	2	0	0	20914	2
2	0	2	0	0	20915	2
2	0	2	0	0	20916	2
2	0	2	0	0	20917	2
2	0	2	0	0	20918	2
2	0	2	0	0	20919	2
2	0	2	0	0	20920	2
2	0	2	0	0	20921	2
2	0	2	0	0	20922	2
2	0	2	0	0	20923	2
2	0	2	0	0	20924	2
2	0	2	0	0	20925	2
2	0	2	0	0	20926	2
2	0	2	0	0	20927	2
2	0	2	0	0	20928	2
2	0	2	0	0	20929	2
2	0	2	0	0	20930	2
2	0	2	0	0	20931	2
2	0	2	0	0	20932	2
2	0	2	0	0	20933	2
2	0	2	0	0	20934	2
2	0	2	0	0	20935	2
2	0	2	0	0	20936	2
2	0	2	0	0	20937	2
2	0	2	0	0	20938	2
2	0	2	0	0	20939	2
2	0	2	0	0	20940	2
2	0	2	0	0	20941	2
2	0	2	0	0	20942	2
2	0	2	0	0	20943	2
2	0	2	0	0	20944	2
2	0	2	0	0	20945	2
2	0	2	0	0	20946	2
2	0	2	0	0	20947	2
2	0	2	0	0	20948	2
2	0	2	0	0	20949	2
2	0	2	0	0	20950	2
2	0	2	0	0	20951	2
2	0	2	0	0	20952	2
2	0	2	0	0	20953	2
2	0	2	0	0	20954	2
2	0	2	0	0	20955	2
2	0	2	0	0	20956	2
2	0	2	0	0	20957	2
2	0	2	0	0	20958	2
2	0	2	0	0	20959	2
2	0	2	0	0	20960	2
2	0	2	0	0	20961	2
2	0	2	0	0	20962	2
2	0	2	0	0	20963	2
2	0	2	0	0	20964	2
2	0	2	0	0	20965	2
2	0	2	0	0	20966	2
2	0	2	0	0	20967	2
2	0	2	0	0	20968	2
2	0	2	0	0	20969	2
2	0	2	0	0	20970	2
2	0	2	0	0	20971	2
2	0	2	0	0	20972	2
2	0	2	0	0	20973	2
2	0	2	0	0	20974	2
2	0	2	0	0	20975	2
2	0	2	0	0	20976	2
2	0	2	0	0	20977	2
2	0	2	0	0	20978	2
2	0	2	0	0	20979	2
2	0	2	0	0	20980	2
2	0	2	0	0	20981	2
2	0	2	0	0	20982	2
2	0	2	0	0	20983	2
2	0	2	0	0	20984	2
2	0	2	0	0	20985	2
2	0	2	0	0	20986	2
2	0	2	0	0	20987	2
2	0	2	0	0	20988	2
2	0	2	0	0	20989	2
2	0	2	0	0	20990	2
2	0	2	5	5	20991	2
2	0	2	0	0	20992	2
2	0	2	0	0	20993	2
2	0	2	0	0	20994	2
2	0	2	0	0	20995	2
2	0	2	0	0	20996	2
2	0	2	0	0	20997	2
2	0	2	0	0	20998	2
2	0	2	0	0	20999	2
2	0	2	0	0	21000	2
2	0	2	0	0	21001	2
2	0	2	0	0	21002	2
2	0	2	1	1	21003	2
2	0	2	0	0	21004	2
2	0	2	0	0	21005	2
2	0	2	0	0	21006	2
2	0	2	0	0	21007	2
2	0	2	0	0	21008	2
2	0	2	0	0	21009	2
2	0	2	0	0	21010	2
2	0	2	0	0	21011	2
2	0	2	0	0	21012	2
2	0	2	0	0	21013	2
2	0	2	0	0	21014	2
2	0	2	0	0	21015	2
2	0	2	0	0	21016	2
2	0	2	0	0	21017	2
2	0	2	0	0	21018	2
2	0	2	0	0	21019	2
2	0	2	0	0	21020	2
2	0	2	0	0	21021	2
2	0	2	0	0	21022	2
2	0	2	0	0	21023	2
2	0	2	0	0	21024	2
2	0	2	0	0	21025	2
0	0	2	0	0	21026	2
2	0	2	0	0	21027	2
2	0	2	0	0	21028	2
2	0	2	0	0	21029	2
2	0	2	0	0	21030	2
2	0	2	0	0	21031	2
2	0	2	0	0	21032	2
2	0	2	0	0	21033	2
2	0	2	0	0	21034	2
2	0	2	0	0	21035	2
2	0	2	0	0	21036	2
2	0	2	0	0	21037	2
2	0	2	0	0	21038	2
2	0	2	0	0	21039	2
2	0	2	0	0	21040	2
2	0	2	0	0	21041	2
2	0	2	0	0	21042	2
2	0	2	0	0	21043	2
2	0	2	0	0	21044	2
2	0	2	0	0	21045	2
2	0	2	0	0	21046	2
2	0	2	0	0	21047	2
2	0	2	0	0	21048	2
2	0	2	0	0	21049	2
2	0	2	0	0	21050	2
2	0	2	0	0	21051	2
2	0	2	0	0	21052	2
2	0	2	0	0	21053	2
2	0	2	0	0	21054	2
2	0	2	0	0	21055	2
2	3	2	0	3	21056	0
2	0	2	15	15	21057	2
2	0	2	0	0	21058	2
2	0	2	0	0	21059	2
2	3	2	0	3	21060	0
2	0	2	3	3	21061	2
2	0	2	0	0	21062	2
2	0	0	0	0	21063	2
2	0	2	0	0	21064	2
2	0	0	0	0	21065	2
2	0	2	0	0	21066	2
2	0	2	0	0	21067	2
2	0	2	0	0	21068	2
2	0	2	0	0	21069	2
2	0	2	0	0	21070	2
2	0	2	0	0	21071	2
2	0	2	0	0	21072	2
2	0	2	0	0	21073	2
2	0	2	0	0	21074	2
2	0	2	0	0	21075	2
2	0	2	0	0	21076	2
2	0	2	0	0	21077	2
2	0	2	0	0	21078	2
2	0	2	0	0	21079	2
2	0	2	0	0	21080	2
2	0	2	0	0	21081	2
2	0	2	0	0	21082	2
2	0	2	0	0	21083	2
2	0	2	0	0	21084	2
2	0	2	0	0	21085	2
2	0	2	0	0	21086	2
2	0	2	0	0	21087	2
2	0	2	0	0	21088	2
2	0	2	0	0	21089	2
2	0	2	0	0	21090	2
2	0	2	0	0	21091	2
2	0	2	0	0	21092	2
2	0	2	0	0	21093	2
2	0	2	0	0	21094	2
2	0	2	0	0	21095	2
2	2	2	4	6	21096	1
2	0	2	0	0	21097	2
2	0	2	0	0	21098	2
2	0	2	0	0	21099	2
2	0	2	3	3	21100	2
2	0	2	6	6	21101	2
2	0	2	0	0	21102	2
2	0	2	0	0	21103	2
2	1	2	0	1	21104	1
2	0	2	2	2	21105	2
2	0	2	0	0	21106	2
2	0	2	0	0	21107	2
2	0	2	0	0	21108	2
2	0	2	0	0	21109	2
2	0	2	0	0	21110	2
2	0	2	0	0	21111	2
2	0	2	0	0	21112	2
2	0	2	3	3	21113	2
2	0	2	0	0	21114	2
2	0	2	0	0	21115	2
2	0	2	0	0	21116	2
2	0	2	0	0	21117	2
2	0	2	0	0	21118	2
2	0	2	0	0	21119	2
2	0	2	0	0	21120	2
2	0	2	0	0	21121	2
2	0	2	0	0	21122	2
2	0	2	0	0	21123	2
2	0	2	0	0	21124	2
2	0	2	0	0	21125	2
2	0	2	0	0	21126	2
2	0	2	0	0	21127	2
2	0	2	0	0	21128	2
2	0	2	0	0	21129	2
2	0	2	0	0	21130	2
2	0	2	0	0	21131	2
2	0	2	0	0	21132	2
2	0	2	0	0	21133	2
2	0	2	0	0	21134	2
2	0	2	0	0	21135	2
2	0	2	0	0	21136	2
2	0	2	0	0	21137	2
2	0	2	0	0	21138	2
2	0	2	0	0	21139	2
2	0	2	0	0	21140	2
2	0	2	0	0	21141	2
2	0	2	0	0	21142	2
2	0	2	0	0	21143	2
2	0	2	0	0	21144	2
2	0	2	0	0	21145	2
2	0	2	0	0	21146	2
2	0	2	0	0	21147	2
2	0	2	0	0	21148	2
2	0	2	0	0	21149	2
2	0	2	0	0	21150	2
2	0	2	0	0	21151	2
2	0	2	0	0	21152	2
2	0	2	0	0	21153	2
2	0	2	0	0	21154	2
2	0	2	0	0	21155	2
2	0	2	0	0	21156	2
2	0	2	0	0	21157	2
2	0	2	0	0	21158	2
2	0	2	2	2	21159	2
2	0	2	0	0	21160	2
2	0	2	0	0	21161	2
2	0	2	0	0	21162	2
2	0	2	0	0	21163	2
2	35	2	1	36	21164	0
2	13	0	533	546	21165	1
2	0	2	7	7	21166	2
2	0	2	5	5	21167	2
2	20	0	21	41	21168	0
2	0	2	86	86	21169	2
2	0	2	0	0	21170	2
2	0	2	0	0	21171	2
2	0	2	0	0	21172	2
2	0	2	0	0	21173	2
2	0	2	0	0	21174	2
2	0	2	0	0	21175	2
2	0	2	0	0	21176	2
2	0	2	0	0	21177	2
2	0	2	0	0	21178	2
2	0	2	0	0	21179	2
2	0	2	0	0	21180	2
2	0	2	0	0	21181	2
2	0	2	0	0	21182	2
2	0	2	0	0	21183	2
2	0	2	0	0	21184	2
2	0	2	0	0	21185	2
2	0	2	0	0	21186	2
2	0	2	0	0	21187	2
2	0	2	0	0	21188	2
2	0	2	0	0	21189	2
2	0	2	0	0	21190	2
2	0	2	0	0	21191	2
2	0	2	0	0	21192	2
2	0	2	0	0	21193	2
2	0	2	0	0	21194	2
2	0	2	0	0	21195	2
2	0	2	0	0	21196	2
2	0	2	0	0	21197	2
2	0	2	0	0	21198	2
2	0	2	0	0	21199	2
2	1	2	0	1	21200	0
2	0	2	1	1	21201	2
2	0	2	2	2	21202	2
2	0	2	0	0	21203	2
2	0	2	0	0	21204	2
2	0	2	0	0	21205	2
2	0	2	0	0	21206	2
2	0	2	0	0	21207	2
2	0	2	0	0	21208	2
2	0	2	0	0	21209	2
2	0	2	0	0	21210	2
2	0	2	0	0	21211	2
2	0	2	0	0	21212	2
2	0	2	0	0	21213	2
2	0	2	0	0	21214	2
2	0	2	0	0	21215	2
2	0	2	0	0	21216	2
2	0	2	0	0	21217	2
2	0	2	0	0	21218	2
2	0	2	0	0	21219	2
2	0	2	0	0	21220	2
2	0	2	0	0	21221	2
2	0	2	0	0	21222	2
2	0	2	0	0	21223	2
2	25	2	14	39	21224	0
2	0	2	78	78	21225	2
2	0	2	0	0	21226	2
2	0	2	0	0	21227	2
2	0	2	0	0	21228	2
2	0	2	0	0	21229	2
2	0	2	0	0	21230	2
2	0	2	0	0	21231	2
2	0	2	0	0	21232	2
2	0	2	0	0	21233	2
2	0	2	0	0	21234	2
2	84	2	2	86	21235	0
2	46	2	679	725	21236	1
2	0	2	2	2	21237	2
2	0	2	0	0	21238	2
2	34	2	0	34	21239	0
2	16	2	0	16	21240	0
2	0	2	22	22	21241	2
2	30	2	152	182	21242	1
2	0	2	4	4	21243	2
2	0	2	0	0	21244	2
2	0	2	0	0	21245	2
2	0	2	0	0	21246	2
2	0	2	0	0	21247	2
2	0	2	0	0	21248	2
2	0	2	0	0	21249	2
2	0	2	0	0	21250	2
2	2	2	0	2	21251	0
2	4	2	21	25	21252	1
2	0	2	0	0	21253	2
2	0	2	0	0	21254	2
2	2	2	1	3	21255	0
2	0	2	5	5	21256	2
2	0	2	0	0	21257	2
2	1	2	0	1	21258	1
2	0	2	0	0	21259	2
2	0	2	0	0	21260	2
2	0	2	0	0	21261	2
2	0	2	0	0	21262	2
2	0	2	0	0	21263	2
2	0	2	0	0	21264	2
2	0	2	0	0	21265	2
2	0	2	0	0	21266	2
2	0	2	0	0	21267	2
2	0	2	0	0	21268	2
2	0	2	0	0	21269	2
2	0	2	0	0	21270	2
2	0	2	0	0	21271	2
2	0	2	0	0	21272	2
2	0	2	0	0	21273	2
2	0	2	0	0	21274	2
2	0	2	0	0	21275	2
2	0	2	2	2	21276	2
2	0	2	0	0	21277	2
2	0	2	0	0	21278	2
2	0	2	0	0	21279	2
2	0	2	0	0	21280	2
2	0	2	0	0	21281	2
2	0	2	0	0	21282	2
2	0	2	0	0	21283	2
2	0	2	0	0	21284	2
2	0	2	0	0	21285	2
2	0	2	0	0	21286	2
2	0	2	0	0	21287	2
2	0	2	0	0	21288	2
2	0	2	1	1	21289	2
2	0	2	0	0	21290	2
2	0	2	0	0	21291	2
2	0	2	0	0	21292	2
2	0	2	0	0	21293	2
2	0	2	0	0	21294	2
2	0	2	0	0	21295	2
2	0	2	0	0	21296	2
2	0	2	0	0	21297	2
2	0	2	0	0	21298	2
2	0	2	0	0	21299	2
2	0	2	0	0	21300	2
2	0	2	0	0	21301	2
2	0	2	0	0	21302	2
2	0	2	0	0	21303	2
2	0	2	0	0	21304	2
2	0	2	0	0	21305	2
2	0	2	0	0	21306	2
2	0	2	0	0	21307	2
2	0	2	0	0	21308	2
2	0	2	0	0	21309	2
2	0	2	0	0	21310	2
2	0	2	0	0	21311	2
2	0	2	0	0	21312	2
2	0	2	0	0	21313	2
2	0	2	0	0	21314	2
2	0	2	0	0	21315	2
2	0	2	0	0	21316	2
2	0	2	0	0	21317	2
2	0	2	0	0	21318	2
2	0	2	0	0	21319	2
2	0	2	0	0	21320	2
2	0	2	0	0	21321	2
2	0	2	0	0	21322	2
2	0	2	0	0	21323	2
2	0	2	0	0	21324	2
2	0	2	0	0	21325	2
2	0	2	0	0	21326	2
2	0	2	0	0	21327	2
2	0	2	0	0	21328	2
2	0	2	0	0	21329	2
2	0	2	0	0	21330	2
2	0	2	0	0	21331	2
2	0	2	0	0	21332	2
2	0	2	0	0	21333	2
2	0	2	0	0	21334	2
2	0	2	1	1	21335	2
2	0	2	0	0	21336	2
2	1	2	0	1	21337	1
2	0	2	0	0	21338	2
2	0	2	0	0	21339	2
2	0	2	0	0	21340	2
2	0	2	0	0	21341	2
2	0	2	0	0	21342	2
2	0	2	0	0	21343	2
2	0	2	0	0	21344	2
2	0	2	0	0	21345	2
2	0	2	0	0	21346	2
2	0	2	0	0	21347	2
2	0	2	0	0	21348	2
2	0	2	148	148	21349	2
2	9	2	0	9	21350	0
2	0	2	13	13	21351	2
2	0	2	0	0	21352	2
2	0	2	1	1	21353	2
2	0	2	0	0	21354	2
2	0	2	0	0	21355	2
2	0	2	0	0	21356	2
2	0	2	0	0	21357	2
2	0	2	0	0	21358	2
2	1	2	0	1	21359	1
2	0	2	0	0	21360	2
2	0	2	0	0	21361	2
2	0	2	0	0	21362	2
2	0	2	0	0	21363	2
2	0	2	0	0	21364	2
2	0	2	7	7	21365	2
2	0	2	0	0	21366	2
2	0	2	0	0	21367	2
2	0	2	0	0	21368	2
2	0	2	0	0	21369	2
2	0	2	0	0	21370	2
2	0	2	0	0	21371	2
2	0	2	0	0	21372	2
2	0	2	0	0	21373	2
2	0	2	0	0	21374	2
2	0	2	0	0	21375	2
2	0	2	0	0	21376	2
2	0	2	0	0	21377	2
2	0	2	0	0	21378	2
2	0	2	0	0	21379	2
2	0	2	0	0	21380	2
2	0	2	0	0	21381	2
2	0	2	0	0	21382	2
2	0	2	1	1	21383	2
2	0	2	0	0	21384	2
2	0	2	0	0	21385	2
2	0	2	0	0	21386	2
2	0	2	0	0	21387	2
2	0	2	0	0	21388	2
2	0	2	0	0	21389	2
2	0	2	0	0	21390	2
2	0	2	0	0	21391	2
2	0	2	0	0	21392	2
2	0	2	0	0	21393	2
2	0	2	0	0	21394	2
2	4	2	0	4	21395	0
2	0	4	46	46	21396	2
2	0	2	1	1	21397	2
2	0	2	0	0	21398	2
2	6	4	86	92	21399	0
2	0	2	10	10	21400	2
2	0	2	0	0	21401	2
2	0	2	0	0	21402	2
2	0	2	0	0	21403	2
2	0	2	0	0	21404	2
2	0	2	0	0	21405	2
2	0	2	0	0	21406	2
2	0	2	0	0	21407	2
2	0	2	7	7	21408	2
2	0	2	0	0	21409	2
2	0	2	0	0	21410	2
2	0	2	0	0	21411	2
2	0	2	0	0	21412	2
2	0	2	0	0	21413	2
2	0	2	0	0	21414	2
2	0	2	0	0	21415	2
2	0	2	0	0	21416	2
2	0	2	0	0	21417	2
2	0	2	0	0	21418	2
2	0	2	0	0	21419	2
2	0	2	0	0	21420	2
2	0	2	0	0	21421	2
2	0	2	0	0	21422	2
2	3	2	0	3	21423	0
2	0	2	16	16	21424	2
2	0	2	0	0	21425	2
2	0	2	0	0	21426	2
2	1	2	0	1	21427	1
2	0	2	2	2	21428	2
2	0	2	0	0	21429	2
2	0	2	0	0	21430	2
2	0	2	0	0	21431	2
2	0	2	0	0	21432	2
2	0	2	0	0	21433	2
2	0	2	0	0	21434	2
2	0	2	0	0	21435	2
2	0	2	0	0	21436	2
2	0	2	0	0	21437	2
2	0	2	0	0	21438	2
2	0	2	0	0	21439	2
2	0	2	0	0	21440	2
2	0	2	0	0	21441	2
2	0	2	0	0	21442	2
2	0	2	0	0	21443	2
2	0	2	0	0	21444	2
2	0	2	0	0	21445	2
2	0	2	0	0	21446	2
2	0	2	0	0	21447	2
2	0	2	0	0	21448	2
2	0	2	0	0	21449	2
2	0	2	0	0	21450	2
2	0	2	0	0	21451	2
2	0	2	0	0	21452	2
2	0	2	0	0	21453	2
2	0	2	0	0	21454	2
2	0	2	0	0	21455	2
2	0	2	0	0	21456	2
2	0	2	0	0	21457	2
2	0	2	0	0	21458	2
2	0	2	0	0	21459	2
2	0	2	0	0	21460	2
2	0	2	0	0	21461	2
2	0	2	0	0	21462	2
2	0	2	0	0	21463	2
2	0	2	0	0	21464	2
2	0	2	0	0	21465	2
2	0	2	0	0	21466	2
2	0	2	0	0	21467	2
2	0	2	0	0	21468	2
2	0	2	0	0	21469	2
2	0	2	0	0	21470	2
2	1	2	0	1	21471	0
2	0	2	3	3	21472	2
2	0	2	0	0	21473	2
2	0	2	0	0	21474	2
2	0	2	0	0	21475	2
2	0	2	0	0	21476	2
2	2	2	0	2	21477	0
2	0	2	1	1	21478	2
2	0	2	0	0	21479	2
2	0	2	0	0	21480	2
2	0	2	0	0	21481	2
2	0	2	2	2	21482	2
2	0	2	0	0	21483	2
2	0	2	0	0	21484	2
2	0	2	0	0	21485	2
2	0	2	0	0	21486	2
2	0	2	0	0	21487	2
2	0	2	0	0	21488	2
2	0	2	0	0	21489	2
2	0	2	0	0	21490	2
2	0	2	0	0	21491	2
2	0	2	0	0	21492	2
2	0	2	0	0	21493	2
2	0	2	0	0	21494	2
2	0	2	0	0	21495	2
2	0	2	0	0	21496	2
2	0	2	0	0	21497	2
2	0	2	0	0	21498	2
2	0	2	0	0	21499	2
2	0	2	0	0	21500	2
2	0	2	0	0	21501	2
2	0	2	0	0	21502	2
2	0	2	0	0	21503	2
2	0	2	0	0	21504	2
2	0	2	0	0	21505	2
2	0	2	0	0	21506	2
2	0	2	0	0	21507	2
2	0	2	0	0	21508	2
2	0	2	0	0	21509	2
2	0	2	0	0	21510	2
2	0	2	0	0	21511	2
2	0	2	0	0	21512	2
2	0	2	0	0	21513	2
2	0	2	0	0	21514	2
2	0	2	0	0	21515	2
2	0	2	0	0	21516	2
2	0	2	0	0	21517	2
2	0	2	0	0	21518	2
2	0	2	0	0	21519	2
2	0	2	0	0	21520	2
2	0	2	0	0	21521	2
2	0	2	0	0	21522	2
2	0	2	0	0	21523	2
2	0	2	0	0	21524	2
2	0	2	0	0	21525	2
2	0	2	0	0	21526	2
2	0	2	0	0	21527	2
2	0	2	0	0	21528	2
2	0	2	0	0	21529	2
2	0	2	0	0	21530	2
2	0	2	0	0	21531	2
2	0	2	0	0	21532	2
2	0	2	0	0	21533	2
2	0	2	0	0	21534	2
2	0	2	0	0	21535	2
2	0	2	0	0	21536	2
2	0	2	0	0	21537	2
2	0	2	0	0	21538	2
2	0	2	0	0	21539	2
2	1	2	0	1	21540	0
2	0	2	5	5	21541	2
2	0	2	0	0	21542	2
2	0	2	0	0	21543	2
2	2	2	1	3	21544	0
2	0	2	3	3	21545	2
2	0	2	0	0	21546	2
2	0	2	0	0	21547	2
2	0	2	0	0	21548	2
2	0	2	0	0	21549	2
2	0	2	0	0	21550	2
2	0	2	0	0	21551	2
2	0	2	0	0	21552	2
2	0	2	1	1	21553	2
2	0	2	0	0	21554	2
2	0	2	0	0	21555	2
2	0	2	0	0	21556	2
2	0	2	0	0	21557	2
2	0	2	0	0	21558	2
2	0	2	17	17	21559	2
2	0	2	0	0	21560	2
2	0	2	0	0	21561	2
2	0	2	0	0	21562	2
2	0	2	0	0	21563	2
2	0	2	0	0	21564	2
2	0	2	0	0	21565	2
2	0	2	0	0	21566	2
2	0	2	0	0	21567	2
2	0	2	0	0	21568	2
2	0	2	0	0	21569	2
2	0	2	0	0	21570	2
2	0	2	0	0	21571	2
2	0	2	0	0	21572	2
2	0	2	0	0	21573	2
2	0	2	0	0	21574	2
2	0	2	0	0	21575	2
2	0	2	0	0	21576	2
2	0	2	0	0	21577	2
2	0	2	0	0	21578	2
2	0	2	0	0	21579	2
2	5	2	0	5	21580	0
2	0	2	98	98	21581	2
2	0	2	0	0	21582	2
2	0	2	0	0	21583	2
2	0	2	0	0	21584	2
2	0	2	0	0	21585	2
2	0	2	0	0	21586	2
2	0	2	0	0	21587	2
2	0	2	0	0	21588	2
2	0	2	0	0	21589	2
2	0	2	0	0	21590	2
2	0	2	0	0	21591	2
2	1	2	0	1	21592	0
2	0	2	0	0	21593	2
2	0	2	0	0	21594	2
2	0	2	3	3	21595	2
2	0	2	0	0	21596	2
2	0	2	0	0	21597	2
2	0	2	0	0	21598	2
2	0	2	0	0	21599	2
2	0	2	0	0	21600	2
2	0	2	0	0	21601	2
2	0	2	0	0	21602	2
2	0	2	0	0	21603	2
2	0	2	2	2	21604	2
2	0	2	0	0	21605	2
2	0	2	0	0	21606	2
2	0	2	0	0	21607	2
2	0	2	0	0	21608	2
2	0	2	0	0	21609	2
2	0	2	0	0	21610	2
2	0	2	0	0	21611	2
2	0	2	0	0	21612	2
2	0	2	0	0	21613	2
2	0	2	0	0	21614	2
2	0	2	0	0	21615	2
2	0	2	0	0	21616	2
2	0	2	0	0	21617	2
2	0	2	0	0	21618	2
2	0	2	0	0	21619	2
2	0	2	0	0	21620	2
2	0	2	0	0	21621	2
2	0	2	0	0	21622	2
2	0	2	0	0	21623	2
2	0	2	0	0	21624	2
2	0	2	1	1	21625	2
2	0	2	0	0	21626	2
2	0	2	0	0	21627	2
2	0	2	0	0	21628	2
2	0	2	0	0	21629	2
2	0	2	0	0	21630	2
2	0	2	0	0	21631	2
2	0	2	0	0	21632	2
2	0	2	0	0	21633	2
2	0	2	0	0	21634	2
2	0	2	0	0	21635	2
2	0	2	0	0	21636	2
2	0	2	0	0	21637	2
2	0	2	0	0	21638	2
2	0	2	0	0	21639	2
2	0	2	0	0	21640	2
2	0	2	0	0	21641	2
2	0	2	0	0	21642	2
2	0	2	0	0	21643	2
2	0	2	0	0	21644	2
2	0	2	0	0	21645	2
2	0	2	0	0	21646	2
2	0	2	0	0	21647	2
2	0	2	0	0	21648	2
2	0	2	0	0	21649	2
2	0	2	0	0	21650	2
2	0	2	0	0	21651	2
2	0	2	0	0	21652	2
2	0	2	0	0	21653	2
2	0	2	0	0	21654	2
2	0	2	0	0	21655	2
2	0	2	0	0	21656	2
2	0	2	0	0	21657	2
2	0	2	0	0	21658	2
2	0	2	0	0	21659	2
2	0	2	0	0	21660	2
2	0	2	0	0	21661	2
2	0	2	0	0	21662	2
2	0	2	0	0	21663	2
2	0	2	0	0	21664	2
2	0	2	0	0	21665	2
2	0	2	0	0	21666	2
2	0	2	0	0	21667	2
2	0	2	0	0	21668	2
2	0	2	0	0	21669	2
2	0	2	0	0	21670	2
2	0	2	0	0	21671	2
2	0	2	0	0	21672	2
2	0	2	0	0	21673	2
2	0	2	0	0	21674	2
2	0	2	0	0	21675	2
2	0	2	0	0	21676	2
2	0	2	0	0	21677	2
2	0	2	0	0	21678	2
2	0	2	0	0	21679	2
2	0	2	0	0	21680	2
2	0	2	0	0	21681	2
2	0	2	0	0	21682	2
2	0	2	0	0	21683	2
2	0	2	0	0	21684	2
2	0	2	0	0	21685	2
2	0	2	0	0	21686	2
2	0	2	0	0	21687	2
2	0	2	0	0	21688	2
2	0	2	0	0	21689	2
2	0	2	0	0	21690	2
2	0	2	0	0	21691	2
2	30	2	0	30	21692	0
2	123	2	2238	2361	21693	1
2	0	2	20	20	21694	2
2	0	2	0	0	21695	2
2	0	2	0	0	21696	2
2	0	2	0	0	21697	2
2	0	2	0	0	21698	2
2	0	2	0	0	21699	2
2	0	2	0	0	21700	2
2	0	2	0	0	21701	2
2	0	2	0	0	21702	2
2	0	2	0	0	21703	2
2	0	2	0	0	21704	2
2	0	2	0	0	21705	2
2	0	2	0	0	21706	2
2	0	2	0	0	21707	2
2	0	2	0	0	21708	2
2	1	2	15	16	21709	1
2	0	2	0	0	21710	2
2	0	2	0	0	21711	2
2	2	2	0	2	21712	0
2	0	2	1	1	21713	2
2	17	2	1	18	21714	0
2	0	2	114	114	21715	2
2	0	2	0	0	21716	2
2	0	2	0	0	21717	2
2	0	2	0	0	21718	2
2	0	2	0	0	21719	2
2	0	2	0	0	21720	2
2	0	2	0	0	21721	2
2	0	2	0	0	21722	2
2	0	2	0	0	21723	2
2	0	2	0	0	21724	2
2	0	2	0	0	21725	2
2	0	2	0	0	21726	2
2	0	2	0	0	21727	2
2	0	2	0	0	21728	2
2	0	2	0	0	21729	2
2	0	2	0	0	21730	2
2	0	2	0	0	21731	2
2	0	2	0	0	21732	2
2	0	2	0	0	21733	2
2	0	2	0	0	21734	2
2	0	2	0	0	21735	2
2	0	2	0	0	21736	2
2	0	2	0	0	21737	2
2	0	2	0	0	21738	2
2	0	2	0	0	21739	2
2	0	2	0	0	21740	2
2	0	2	0	0	21741	2
2	0	2	0	0	21742	2
2	0	2	0	0	21743	2
2	0	2	0	0	21744	2
2	0	2	0	0	21745	2
2	0	2	0	0	21746	2
2	0	2	0	0	21747	2
2	0	2	0	0	21748	2
2	0	2	0	0	21749	2
2	0	2	1	1	21750	2
2	0	2	0	0	21751	2
2	0	2	0	0	21752	2
2	0	2	0	0	21753	2
2	0	2	0	0	21754	2
2	0	2	0	0	21755	2
2	0	2	0	0	21756	2
2	0	2	0	0	21757	2
2	0	2	0	0	21758	2
2	0	2	0	0	21759	2
2	0	2	0	0	21760	2
2	0	2	0	0	21761	2
2	0	2	0	0	21762	2
2	0	2	0	0	21763	2
2	0	2	0	0	21764	2
2	0	2	0	0	21765	2
2	0	2	0	0	21766	2
2	0	2	0	0	21767	2
2	0	2	0	0	21768	2
2	0	2	0	0	21769	2
2	0	2	0	0	21770	2
2	0	2	0	0	21771	2
2	0	2	0	0	21772	2
2	0	2	0	0	21773	2
2	0	2	0	0	21774	2
2	0	2	0	0	21775	2
2	0	2	0	0	21776	2
2	0	2	0	0	21777	2
2	0	2	0	0	21778	2
2	0	2	0	0	21779	2
2	0	2	0	0	21780	2
2	0	2	0	0	21781	2
2	0	2	0	0	21782	2
2	1	2	6	7	21783	1
2	0	2	0	0	21784	2
2	0	2	0	0	21785	2
2	0	2	0	0	21786	2
2	0	2	0	0	21787	2
2	0	2	0	0	21788	2
2	0	2	0	0	21789	2
2	0	2	0	0	21790	2
2	0	2	0	0	21791	2
2	0	2	1	1	21792	2
2	0	2	0	0	21793	2
2	0	2	0	0	21794	2
2	0	2	0	0	21795	2
2	0	2	0	0	21796	2
2	0	2	0	0	21797	2
2	0	2	0	0	21798	2
2	0	2	0	0	21799	2
2	0	2	0	0	21800	2
2	1	2	16	17	21801	1
2	0	2	0	0	21802	2
2	0	2	0	0	21803	2
2	0	2	0	0	21804	2
2	0	2	1	1	21805	2
2	149	2	0	149	21806	0
2	0	2	0	0	21807	2
2	0	2	0	0	21808	2
2	0	2	0	0	21809	2
2	0	2	0	0	21810	2
2	0	2	0	0	21811	2
2	0	2	0	0	21812	2
2	13	2	416	429	21813	1
2	0	2	18	18	21814	2
2	0	2	0	0	21815	2
2	42	2	0	42	21816	0
2	0	2	189	189	21817	2
2	0	2	0	0	21818	2
2	0	2	0	0	21819	2
2	2	2	0	2	21820	0
2	0	2	4	4	21821	2
2	0	2	0	0	21822	2
2	0	2	0	0	21823	2
2	2	2	1	3	21824	0
2	0	2	1	1	21825	2
2	0	2	0	0	21826	2
2	0	2	0	0	21827	2
2	0	2	0	0	21828	2
2	0	2	0	0	21829	2
2	0	2	0	0	21830	2
2	0	2	0	0	21831	2
2	0	2	0	0	21832	2
2	0	2	0	0	21833	2
2	0	2	0	0	21834	2
2	0	2	0	0	21835	2
2	0	2	0	0	21836	2
2	0	2	0	0	21837	2
2	0	2	0	0	21838	2
2	0	2	0	0	21839	2
2	0	2	0	0	21840	2
2	0	2	0	0	21841	2
2	0	2	0	0	21842	2
2	0	2	0	0	21843	2
2	0	2	0	0	21844	2
2	0	2	0	0	21845	2
2	0	2	0	0	21846	2
2	0	2	0	0	21847	2
2	0	2	0	0	21848	2
2	0	2	0	0	21849	2
2	0	2	0	0	21850	2
2	0	2	0	0	21851	2
2	0	2	0	0	21852	2
2	0	2	0	0	21853	2
2	0	2	0	0	21854	2
2	0	2	0	0	21855	2
2	0	2	1	1	21856	2
2	0	2	0	0	21857	2
2	0	2	0	0	21858	2
2	0	2	0	0	21859	2
2	0	2	0	0	21860	2
2	0	2	0	0	21861	2
2	0	2	0	0	21862	2
2	0	2	0	0	21863	2
2	0	2	0	0	21864	2
2	0	2	0	0	21865	2
2	0	2	0	0	21866	2
2	0	2	0	0	21867	2
2	0	2	0	0	21868	2
2	0	2	0	0	21869	2
2	0	2	0	0	21870	2
2	0	2	0	0	21871	2
2	1	2	0	1	21872	0
2	0	2	2	2	21873	2
2	0	2	0	0	21874	2
2	0	2	0	0	21875	2
2	0	2	0	0	21876	2
2	0	2	0	0	21877	2
2	0	2	0	0	21878	2
2	0	2	0	0	21879	2
2	0	2	0	0	21880	2
2	0	2	0	0	21881	2
2	0	2	0	0	21882	2
2	0	2	0	0	21883	2
2	0	2	0	0	21884	2
2	0	2	0	0	21885	2
2	0	2	0	0	21886	2
2	0	2	0	0	21887	2
2	0	2	0	0	21888	2
2	0	2	0	0	21889	2
2	0	2	0	0	21890	2
2	2	2	0	2	21891	1
2	0	2	0	0	21892	2
2	0	2	0	0	21893	2
2	1	2	0	1	21894	1
2	0	2	0	0	21895	2
2	5	2	0	5	21896	0
2	3	4	45	48	21897	1
2	0	2	4	4	21898	2
2	0	2	0	0	21899	2
2	6	4	61	67	21900	0
2	0	2	3	3	21901	2
2	0	2	0	0	21902	2
2	0	2	0	0	21903	2
2	0	2	0	0	21904	2
2	0	2	0	0	21905	2
2	0	2	0	0	21906	2
2	0	2	0	0	21907	2
2	0	2	33	33	21908	2
2	0	2	4	4	21909	2
2	0	4	22	22	21910	2
2	0	2	0	0	21911	2
2	0	2	0	0	21912	2
2	0	2	0	0	21913	2
2	0	2	0	0	21914	2
2	0	2	0	0	21915	2
2	0	4	19	19	21916	2
2	0	2	2	2	21917	2
2	0	2	0	0	21918	2
2	0	2	0	0	21919	2
2	0	2	0	0	21920	2
2	0	2	0	0	21921	2
2	0	2	0	0	21922	2
2	0	2	0	0	21923	2
2	0	2	0	0	21924	2
2	0	2	0	0	21925	2
2	0	2	0	0	21926	2
2	0	2	0	0	21927	2
2	0	2	0	0	21928	2
2	0	2	0	0	21929	2
2	0	2	0	0	21930	2
2	0	2	0	0	21931	2
2	0	2	0	0	21932	2
2	0	2	0	0	21933	2
2	0	2	0	0	21934	2
2	0	2	0	0	21935	2
2	0	2	0	0	21936	2
2	0	2	0	0	21937	2
2	0	2	0	0	21938	2
2	0	2	0	0	21939	2
2	0	2	0	0	21940	2
2	0	2	0	0	21941	2
2	0	2	0	0	21942	2
2	0	2	0	0	21943	2
2	0	2	0	0	21944	2
2	0	2	0	0	21945	2
2	0	2	0	0	21946	2
2	0	2	0	0	21947	2
2	0	2	0	0	21948	2
2	0	2	0	0	21949	2
2	0	2	0	0	21950	2
2	0	2	0	0	21951	2
2	0	2	0	0	21952	2
2	0	2	0	0	21953	2
2	0	2	0	0	21954	2
2	0	2	0	0	21955	2
2	0	2	0	0	21956	2
2	0	2	0	0	21957	2
2	0	2	0	0	21958	2
2	0	2	0	0	21959	2
2	0	2	0	0	21960	2
2	0	2	0	0	21961	2
2	0	2	0	0	21962	2
2	0	2	0	0	21963	2
2	0	2	0	0	21964	2
2	0	2	0	0	21965	2
2	0	2	0	0	21966	2
2	0	2	0	0	21967	2
2	0	2	0	0	21968	2
2	0	2	0	0	21969	2
2	0	2	1	1	21970	2
2	0	2	0	0	21971	2
2	0	2	0	0	21972	2
2	0	2	0	0	21973	2
2	0	2	0	0	21974	2
2	0	2	0	0	21975	2
2	0	2	0	0	21976	2
2	0	2	0	0	21977	2
2	0	2	0	0	21978	2
2	0	2	0	0	21979	2
2	0	2	0	0	21980	2
2	0	2	0	0	21981	2
2	0	2	2	2	21982	2
2	0	2	0	0	21983	2
2	0	2	0	0	21984	2
2	0	2	0	0	21985	2
2	0	2	2	2	21986	2
2	0	2	0	0	21987	2
2	0	2	0	0	21988	2
2	0	2	0	0	21989	2
2	0	2	0	0	21990	2
2	0	2	0	0	21991	2
2	0	2	0	0	21992	2
2	0	2	0	0	21993	2
2	0	2	0	0	21994	2
2	0	2	0	0	21995	2
2	0	2	0	0	21996	2
2	0	2	0	0	21997	2
2	0	2	0	0	21998	2
2	0	2	0	0	21999	2
2	0	2	0	0	22000	2
2	0	2	0	0	22001	2
2	0	2	0	0	22002	2
2	0	2	0	0	22003	2
2	0	2	0	0	22004	2
2	0	2	0	0	22005	2
2	0	2	0	0	22006	2
2	0	2	0	0	22007	2
2	0	2	0	0	22008	2
2	0	2	0	0	22009	2
2	0	2	0	0	22010	2
2	0	2	0	0	22011	2
2	0	2	0	0	22012	2
2	0	2	0	0	22013	2
2	0	2	0	0	22014	2
2	1	2	0	1	22015	0
2	0	2	3	3	22016	2
2	0	2	0	0	22017	2
2	0	2	0	0	22018	2
2	0	2	1	1	22019	2
2	0	2	1	1	22020	2
2	0	2	0	0	22021	2
2	0	2	0	0	22022	2
2	0	2	0	0	22023	2
2	0	2	0	0	22024	2
2	0	2	0	0	22025	2
2	0	2	0	0	22026	2
2	0	2	0	0	22027	2
2	0	2	0	0	22028	2
2	0	2	0	0	22029	2
2	0	2	0	0	22030	2
2	0	2	0	0	22031	2
2	0	2	0	0	22032	2
2	0	2	0	0	22033	2
2	0	2	0	0	22034	2
2	0	2	0	0	22035	2
2	0	2	0	0	22036	2
2	0	2	0	0	22037	2
2	0	2	0	0	22038	2
2	0	2	0	0	22039	2
2	0	2	0	0	22040	2
2	0	2	0	0	22041	2
2	0	2	0	0	22042	2
2	0	2	0	0	22043	2
2	0	2	0	0	22044	2
2	0	2	0	0	22045	2
2	0	2	0	0	22046	2
2	0	2	0	0	22047	2
2	0	2	0	0	22048	2
2	0	2	0	0	22049	2
2	0	2	0	0	22050	2
2	0	2	0	0	22051	2
2	0	2	0	0	22052	2
2	0	2	0	0	22053	2
2	0	2	0	0	22054	2
2	0	2	0	0	22055	2
2	0	2	0	0	22056	2
2	0	2	0	0	22057	2
2	0	2	0	0	22058	2
2	0	2	0	0	22059	2
2	0	2	0	0	22060	2
2	0	2	0	0	22061	2
2	0	2	0	0	22062	2
2	0	2	0	0	22063	2
2	1	2	0	1	22064	1
2	1	2	8	9	22065	1
2	0	2	0	0	22066	2
2	0	2	0	0	22067	2
2	0	2	0	0	22068	2
2	0	2	1	1	22069	2
2	0	2	0	0	22070	2
2	0	2	0	0	22071	2
2	0	2	0	0	22072	2
2	0	2	0	0	22073	2
2	0	2	0	0	22074	2
2	0	2	0	0	22075	2
2	0	2	0	0	22076	2
2	0	2	0	0	22077	2
2	0	2	0	0	22078	2
2	0	2	0	0	22079	2
2	11	2	0	11	22080	0
2	0	2	0	0	22081	2
2	0	2	0	0	22082	2
2	0	2	0	0	22083	2
2	0	2	0	0	22084	2
2	0	2	0	0	22085	2
2	0	2	0	0	22086	2
2	1	2	0	1	22087	1
2	1	2	29	30	22088	1
2	0	2	1	1	22089	2
2	0	2	0	0	22090	2
2	3	2	0	3	22091	0
2	0	2	11	11	22092	2
2	0	2	0	0	22093	2
2	0	2	0	0	22094	2
2	0	2	0	0	22095	2
2	0	2	0	0	22096	2
2	0	2	0	0	22097	2
2	0	2	0	0	22098	2
2	0	2	0	0	22099	2
2	0	2	0	0	22100	2
2	0	2	0	0	22101	2
2	0	2	0	0	22102	2
2	0	2	0	0	22103	2
2	0	2	0	0	22104	2
2	0	2	0	0	22105	2
2	0	2	0	0	22106	2
2	0	2	0	0	22107	2
2	0	2	0	0	22108	2
2	0	2	0	0	22109	2
2	0	2	0	0	22110	2
2	0	2	0	0	22111	2
2	0	2	0	0	22112	2
2	0	2	0	0	22113	2
2	0	2	0	0	22114	2
2	0	2	0	0	22115	2
2	0	2	0	0	22116	2
2	0	2	0	0	22117	2
2	1	2	0	1	22118	0
2	0	2	27	27	22119	2
2	0	2	0	0	22120	2
2	0	2	0	0	22121	2
2	0	2	0	0	22122	2
2	0	2	0	0	22123	2
2	0	2	0	0	22124	2
2	0	2	0	0	22125	2
2	0	2	0	0	22126	2
2	0	2	0	0	22127	2
2	0	2	0	0	22128	2
2	0	2	0	0	22129	2
2	0	2	0	0	22130	2
2	0	2	0	0	22131	2
2	0	2	0	0	22132	2
2	0	2	0	0	22133	2
2	0	2	0	0	22134	2
2	0	2	0	0	22135	2
2	0	2	0	0	22136	2
2	0	2	0	0	22137	2
2	0	2	0	0	22138	2
2	0	2	0	0	22139	2
2	0	2	0	0	22140	2
2	0	2	0	0	22141	2
2	0	2	3	3	22142	2
2	10	2	161	171	22143	1
2	0	2	6	6	22144	2
2	0	2	0	0	22145	2
2	12	2	0	12	22146	0
2	0	2	1	1	22147	2
2	0	2	0	0	22148	2
2	0	2	0	0	22149	2
2	0	2	0	0	22150	2
2	0	2	0	0	22151	2
2	0	2	1	1	22152	2
2	0	2	0	0	22153	2
2	1	2	0	1	22154	0
2	0	2	20	20	22155	2
2	0	2	0	0	22156	2
2	0	2	0	0	22157	2
2	0	2	2	2	22158	2
2	0	2	2	2	22159	2
2	0	2	3154	3154	22160	2
4	30	2	2	32	22161	0
2	0	2	1	1	22162	2
2	0	2	7	7	22163	2
0	578	2	6	584	22164	0
0	4	2	6	10	22165	1
2	1	2	13	14	22166	1
2	0	2	98	98	22167	2
2	13	2	0	13	22168	0
2	1	2	243	244	22169	1
2	0	2	4	4	22170	2
2	0	2	0	0	22171	2
2	7	2	4	11	22172	0
2	0	2	82	82	22173	2
2	0	2	0	0	22174	2
2	0	2	0	0	22175	2
2	0	2	0	0	22176	2
2	0	2	0	0	22177	2
2	0	2	0	0	22178	2
2	0	2	0	0	22179	2
2	52	2	0	52	22180	0
2	21	2	535	556	22181	1
2	0	2	2	2	22182	2
2	0	2	1	1	22183	2
2	5	2	3	8	22184	0
2	0	2	84	84	22185	2
2	0	2	0	0	22186	2
2	0	2	0	0	22187	2
2	0	2	0	0	22188	2
2	0	2	0	0	22189	2
2	22	2	0	22	22190	0
2	13	2	101	114	22191	1
2	0	2	0	0	22192	2
2	0	2	0	0	22193	2
2	13	2	0	13	22194	0
2	0	2	41	41	22195	2
2	302	2	0	302	22196	0
2	51	2	1658	1709	22197	1
2	0	2	10	10	22198	2
2	0	2	3	3	22199	2
2	38	2	3	41	22200	0
2	0	2	261	261	22201	2
2	0	2	0	0	22202	2
2	0	2	19	19	22203	2
2	0	2	0	0	22204	2
2	0	2	0	0	22205	2
2	1	2	1	2	22206	1
2	0	2	1	1	22207	2
2	109	2	25	134	22208	0
2	43	2	4	47	22209	0
2	0	2	190	190	22210	2
2	1	2	0	1	22211	0
2	4	2	17	21	22212	1
2	0	2	0	0	22213	2
2	0	2	0	0	22214	2
2	0	2	0	0	22215	2
2	0	2	1	1	22216	2
2	0	2	0	0	22217	2
2	0	2	0	0	22218	2
2	0	2	0	0	22219	2
2	0	2	0	0	22220	2
2	0	2	0	0	22221	2
2	0	2	0	0	22222	2
2	0	2	0	0	22223	2
2	0	2	0	0	22224	2
2	0	2	0	0	22225	2
2	0	2	0	0	22226	2
2	0	2	0	0	22227	2
2	0	2	0	0	22228	2
2	0	2	0	0	22229	2
2	0	2	0	0	22230	2
2	0	2	0	0	22231	2
2	0	2	0	0	22232	2
2	1	2	1	2	22233	1
2	0	2	0	0	22234	2
2	0	2	0	0	22235	2
2	0	2	0	0	22236	2
2	0	2	0	0	22237	2
2	3	4	3517	3520	22238	0
2	2	2	0	2	22239	0
2	0	2	26	26	22240	2
2	0	2	1	1	22241	2
2	0	2	0	0	22242	2
2	1	2	0	1	22243	1
2	0	2	0	0	22244	2
2	0	2	0	0	22245	2
2	0	2	0	0	22246	2
2	1	2	0	1	22247	0
2	8	2	10	18	22248	1
2	0	2	0	0	22249	2
2	0	2	0	0	22250	2
2	0	2	0	0	22251	2
2	0	2	0	0	22252	2
2	4	2	0	4	22253	0
2	0	7	28	28	22254	2
2	0	2	0	0	22255	2
2	0	2	0	0	22256	2
2	1	2	0	1	22257	1
2	0	2	5	5	22258	2
2	0	2	0	0	22259	2
2	0	4	0	0	22260	2
2	0	2	0	0	22261	2
2	0	2	0	0	22262	2
2	0	4	1	1	22263	2
2	0	2	0	0	22264	2
2	0	2	0	0	22265	2
2	0	2	2	2	22266	2
2	0	2	0	0	22267	2
2	0	2	0	0	22268	2
2	1	2	0	1	22269	1
2	0	2	1	1	22270	2
2	0	2	0	0	22271	2
2	0	2	0	0	22272	2
2	0	2	0	0	22273	2
2	0	2	0	0	22274	2
2	0	2	0	0	22275	2
2	0	2	0	0	22276	2
2	0	2	0	0	22277	2
2	0	4	101	101	22278	2
2	0	2	0	0	22279	2
2	0	2	0	0	22280	2
2	0	4	13	13	22281	2
2	0	2	0	0	22282	2
2	0	2	0	0	22283	2
2	0	2	0	0	22284	2
2	0	2	0	0	22285	2
2	0	2	0	0	22286	2
2	0	2	0	0	22287	2
2	0	2	0	0	22288	2
2	6	2	0	6	22289	0
2	4	2	72	76	22290	1
2	0	2	0	0	22291	2
2	0	2	0	0	22292	2
2	1	2	0	1	22293	0
2	0	2	7	7	22294	2
0	1465	2	20	1485	22295	0
0	36	2	72	108	22296	0
0	22	2	0	22	22297	0
2	0	2	0	0	22298	2
2	0	2	1	1	22299	2
2	0	2	0	0	22300	2
2	0	2	0	0	22301	2
2	0	2	0	0	22302	2
2	0	2	0	0	22303	2
2	0	2	0	0	22304	2
2	0	4	1741	1741	22305	2
2	0	2	0	0	22306	2
2	0	2	0	0	22307	2
2	0	4	800	800	22308	2
2	0	2	0	0	22309	2
2	0	2	0	0	22310	2
2	0	2	0	0	22311	2
2	0	2	0	0	22312	2
2	0	2	0	0	22313	2
2	0	2	0	0	22314	2
2	0	2	0	0	22315	2
2	0	2	0	0	22316	2
2	0	2	0	0	22317	2
2	0	2	0	0	22318	2
2	0	2	0	0	22319	2
2	0	2	0	0	22320	2
2	0	2	0	0	22321	2
2	5	2	0	5	22322	0
2	2	2	7	9	22323	0
2	0	2	31	31	22324	2
2	0	2	9	9	22325	2
2	0	2	7	7	22326	2
2	0	2	0	0	22327	2
2	0	2	0	0	22328	2
2	0	2	0	0	22329	2
2	0	2	0	0	22330	2
2	0	2	0	0	22331	2
2	0	2	4	4	22332	2
2	0	2	0	0	22333	2
2	0	4	624	624	22334	2
2	0	2	0	0	22335	2
2	0	2	0	0	22336	2
2	0	4	759	759	22337	2
2	0	2	0	0	22338	2
2	0	2	0	0	22339	2
2	0	2	0	0	22340	2
2	0	2	0	0	22341	2
2	0	2	0	0	22342	2
2	0	2	0	0	22343	2
2	0	2	0	0	22344	2
2	101	2	0	101	22345	0
2	11	2	796	807	22346	1
2	0	2	3	3	22347	2
2	0	2	4	4	22348	2
2	6	2	6	12	22349	1
2	0	2	24	24	22350	2
2	0	2	0	0	22351	2
2	0	2	0	0	22352	2
2	0	2	0	0	22353	2
2	0	2	0	0	22354	2
2	0	2	0	0	22355	2
2	0	2	0	0	22356	2
2	6	2	0	6	22357	0
2	2	2	22	24	22358	1
2	0	2	0	0	22359	2
2	0	2	0	0	22360	2
2	2	2	0	2	22361	1
2	0	2	17	17	22362	2
2	26	2	2	28	22363	0
2	18	2	198	216	22364	1
2	0	2	1	1	22365	2
2	0	2	0	0	22366	2
2	18	2	2	20	22367	0
2	0	2	100	100	22368	2
4	0	4	0	0	22369	2
4	0	4	0	0	22370	2
4	0	4	0	0	22371	2
4	0	4	0	0	22372	2
2	0	2	0	0	22373	2
2	0	2	5	5	22374	2
2	0	2	0	0	22375	2
2	0	2	0	0	22376	2
2	0	2	0	0	22377	2
2	0	2	4	4	22378	2
2	12	2	0	12	22379	0
2	2	2	365	367	22380	1
2	0	2	0	0	22381	2
2	0	2	0	0	22382	2
2	3	2	20	23	22383	0
2	0	2	0	0	22384	2
2	10	2	0	10	22385	0
4	8993	2	365	9358	22386	0
4	7554	2	20	7574	22387	0
2	0	2	0	0	22388	2
2	0	2	0	0	22389	2
2	74	2	0	74	22390	0
2	3	2	465	468	22391	1
2	0	2	1	1	22392	2
2	0	2	1	1	22393	2
2	5	2	1	6	22394	0
2	0	2	46	46	22395	2
2	0	2	0	0	22396	2
2	0	2	0	0	22397	2
2	1	2	859	860	22398	1
2	8	2	0	8	22399	0
2	0	2	45	45	22400	2
2	0	2	0	0	22401	2
2	0	2	2	2	22402	2
2	0	2	0	0	22403	2
2	0	2	0	0	22404	2
2	0	2	0	0	22405	2
2	0	2	0	0	22406	2
2	0	2	0	0	22407	2
2	0	2	0	0	22408	2
2	0	2	0	0	22409	2
2	0	2	0	0	22410	2
2	0	2	0	0	22411	2
2	0	2	0	0	22412	2
2	5	2	0	5	22413	0
2	1	2	111	112	22414	1
2	0	2	0	0	22415	2
2	0	2	0	0	22416	2
2	2	2	0	2	22417	0
2	0	2	3	3	22418	2
2	0	2	0	0	22419	2
2	0	2	0	0	22420	2
2	0	2	0	0	22421	2
2	1	2	0	1	22422	0
2	0	2	5	5	22423	2
2	0	2	0	0	22424	2
2	0	2	0	0	22425	2
2	0	2	0	0	22426	2
2	0	2	0	0	22427	2
2	0	2	0	0	22428	2
2	0	2	0	0	22429	2
2	0	2	0	0	22430	2
2	0	2	0	0	22431	2
2	0	2	0	0	22432	2
2	0	2	1	1	22433	2
2	0	2	0	0	22434	2
2	3	2	0	3	22435	0
2	0	2	9	9	22436	2
2	0	2	0	0	22437	2
2	0	2	0	0	22438	2
2	0	2	0	0	22439	2
2	0	2	1	1	22440	2
2	0	4	868	868	22441	2
2	0	2	0	0	22442	2
2	0	2	0	0	22443	2
2	0	4	727	727	22444	2
2	0	2	5	5	22445	2
2	643	2	522	1165	22446	0
2	1	2	2553	2554	22447	1
2	0	2	0	0	22448	2
2	0	2	0	0	22449	2
2	0	2	0	0	22450	2
2	0	2	0	0	22451	2
2	0	2	0	0	22452	2
2	0	2	0	0	22453	2
2	0	2	0	0	22454	2
2	0	2	6	6	22455	2
2	0	2	0	0	22456	2
2	0	2	0	0	22457	2
2	0	2	0	0	22458	2
2	0	2	2	2	22459	2
2	2	2	0	2	22460	0
2	0	2	14	14	22461	2
2	0	2	0	0	22462	2
2	0	2	0	0	22463	2
2	0	2	0	0	22464	2
2	1	2	1	2	22465	1
2	0	2	0	0	22466	2
2	0	2	0	0	22467	2
2	0	2	0	0	22468	2
2	0	2	0	0	22469	2
2	0	2	0	0	22470	2
2	0	2	0	0	22471	2
4	367	2	0	367	22472	0
4	91	2	0	91	22473	0
2	0	2	0	0	22474	2
2	3	2	8	11	22475	1
2	0	2	0	0	22476	2
2	0	2	0	0	22477	2
2	1	2	0	1	22478	1
2	0	2	6	6	22479	2
2	0	2	0	0	22480	2
2	0	2	0	0	22481	2
2	0	2	0	0	22482	2
2	0	2	0	0	22483	2
2	0	2	0	0	22484	2
2	0	2	1	1	22485	2
4	0	2	1	1	22486	2
2	0	2	2	2	22487	2
2	0	2	0	0	22488	2
2	0	2	0	0	22489	2
2	0	2	4	4	22490	2
2	0	2	0	0	22491	2
2	0	2	0	0	22492	2
2	0	2	0	0	22493	2
2	0	2	1	1	22494	2
2	0	2	0	0	22495	2
2	0	2	15	15	22496	2
2	0	2	0	0	22497	2
2	0	2	0	0	22498	2
2	0	2	1	1	22499	2
2	0	2	1	1	22500	2
2	0	2	0	0	22501	2
2	0	2	2	2	22502	2
2	0	2	0	0	22503	2
2	0	2	0	0	22504	2
2	0	2	0	0	22505	2
2	0	2	1	1	22506	2
2	0	2	0	0	22507	2
2	0	2	1	1	22508	2
2	0	2	0	0	22509	2
2	0	2	0	0	22510	2
2	0	2	0	0	22511	2
2	0	2	0	0	22512	2
2	12	2	0	12	22513	0
2	0	2	0	0	22514	2
2	0	2	0	0	22515	2
2	0	2	0	0	22516	2
2	3	2	0	3	22517	0
2	0	2	4	4	22518	2
2	0	2	0	0	22519	2
2	0	2	0	0	22520	2
2	0	2	0	0	22521	2
2	0	2	4	4	22522	2
2	0	4	60	60	22523	2
2	0	2	0	0	22524	2
2	0	2	0	0	22525	2
2	1	4	0	1	22526	1
2	0	2	1	1	22527	2
2	2	2	4	6	22528	0
2	0	2	0	0	22529	2
2	0	2	0	0	22530	2
2	0	2	0	0	22531	2
2	0	2	0	0	22532	2
2	0	2	0	0	22533	2
2	0	2	48	48	22534	2
2	0	2	0	0	22535	2
2	0	2	1	1	22536	2
2	0	2	0	0	22537	2
2	0	2	0	0	22538	2
2	0	2	1	1	22539	2
2	0	2	0	0	22540	2
2	0	4	40	40	22541	2
2	0	2	2	2	22542	2
2	0	2	0	0	22543	2
2	0	4	7	7	22544	2
2	0	2	86	86	22545	2
2	0	2	0	0	22546	2
2	6	4	229	235	22547	1
2	0	2	0	0	22548	2
2	0	2	0	0	22549	2
2	0	4	222	222	22550	2
2	0	2	0	0	22551	2
4	0	4	0	0	22552	2
4	0	4	0	0	22553	2
2	5	2	0	5	22554	0
2	7	2	77	84	22555	1
2	0	2	2	2	22556	2
2	0	2	0	0	22557	2
0	15	2	2	17	22558	1
0	2	2	0	2	22559	0
2	5	2	0	5	22560	0
2	0	2	13	13	22561	2
2	0	2	0	0	22562	2
2	0	2	1	1	22563	2
2	0	2	0	0	22564	2
2	0	2	0	0	22565	2
2	0	2	0	0	22566	2
2	0	2	0	0	22567	2
4	1368	2	3	1371	22568	0
2	146	2	4	150	22569	0
2	0	2	29	29	22570	2
2	0	2	0	0	22571	2
2	7	2	0	7	22572	0
2	0	2	0	0	22573	2
2	0	2	0	0	22574	2
2	0	2	0	0	22575	2
2	0	4	12	12	22576	2
2	0	2	0	0	22577	2
2	0	2	0	0	22578	2
2	0	4	1	1	22579	2
2	0	2	0	0	22580	2
2	0	2	0	0	22581	2
2	0	2	0	0	22582	2
2	0	2	0	0	22583	2
2	0	2	0	0	22584	2
2	0	2	0	0	22585	2
2	0	2	0	0	22586	2
2	0	2	0	0	22587	2
2	0	2	0	0	22588	2
2	0	2	0	0	22589	2
2	2	2	0	2	22590	0
2	1	4	1658	1659	22591	1
2	0	2	0	0	22592	2
2	0	2	0	0	22593	2
0	47	2	1	48	22594	0
0	110	2	0	110	22595	0
2	1	4	419	420	22596	1
2	0	2	1	1	22597	2
2	0	2	0	0	22598	2
2	2	2	11	13	22599	1
2	0	2	0	0	22600	2
2	0	2	0	0	22601	2
2	0	2	4	4	22602	2
0	39	2	11	50	22603	0
0	24	2	4	28	22604	0
2	0	2	0	0	22605	2
2	0	2	0	0	22606	2
2	0	2	0	0	22607	2
2	0	2	0	0	22608	2
2	0	2	1	1	22609	2
2	0	2	0	0	22610	2
2	0	2	0	0	22611	2
2	0	2	38	38	22612	2
2	0	2	4	4	22613	2
2	0	2	0	0	22614	2
2	1	2	0	1	22615	1
2	0	2	6	6	22616	2
2	0	2	0	0	22617	2
2	0	2	1	1	22618	2
2	0	2	0	0	22619	2
2	0	2	0	0	22620	2
2	0	2	0	0	22621	2
2	0	2	0	0	22622	2
2	9	2	0	9	22623	0
2	0	2	133	133	22624	2
2	0	2	0	0	22625	2
2	0	2	0	0	22626	2
2	2	2	0	2	22627	0
2	0	2	61	61	22628	2
2	9	2	0	9	22629	0
2	9	4	360	369	22630	1
2	0	2	2	2	22631	2
2	0	2	0	0	22632	2
2	10	4	876	886	22633	0
2	0	2	325	325	22634	2
2	0	2	0	0	22635	2
2	0	2	0	0	22636	2
2	0	2	0	0	22637	2
2	0	2	0	0	22638	2
2	0	2	0	0	22639	2
2	0	2	0	0	22640	2
2	121	2	0	121	22641	0
2	0	2	120	120	22642	2
2	0	2	0	0	22643	2
2	2	2	0	2	22644	0
2	0	4	179	179	22645	2
2	0	2	0	0	22646	2
2	0	2	0	0	22647	2
2	2	4	92	94	22648	0
2	0	2	5	5	22649	2
2	0	2	0	0	22650	2
2	0	2	4	4	22651	2
2	0	2	0	0	22652	2
2	0	2	0	0	22653	2
2	0	2	0	0	22654	2
2	0	2	0	0	22655	2
2	0	2	0	0	22656	2
2	1	2	0	1	22657	0
2	0	2	2	2	22658	2
2	1	2	3	4	22659	1
2	0	2	0	0	22660	2
2	0	2	0	0	22661	2
2	3	2	0	3	22662	0
2	3	2	34	37	22663	1
2	0	2	0	0	22664	2
2	0	2	0	0	22665	2
2	2	2	0	2	22666	1
2	0	2	9	9	22667	2
2	0	2	0	0	22668	2
2	0	2	1	1	22669	2
2	0	2	0	0	22670	2
2	0	2	0	0	22671	2
2	0	2	0	0	22672	2
2	0	2	0	0	22673	2
2	0	2	3	3	22674	2
2	0	2	1	1	22675	2
2	0	2	0	0	22676	2
2	0	2	1	1	22677	2
2	0	2	0	0	22678	2
2	0	2	0	0	22679	2
2	0	2	0	0	22680	2
2	0	2	0	0	22681	2
4	0	4	0	0	22682	2
4	0	4	0	0	22683	2
2	17	2	0	17	22684	0
2	48	2	319	367	22685	1
2	0	2	4	4	22686	2
2	0	2	1	1	22687	2
2	18	2	17	35	22688	0
2	0	2	42	42	22689	2
2	4	2	0	4	22690	0
2	3	4	109	112	22691	1
2	0	2	0	0	22692	2
2	0	2	0	0	22693	2
2	4	4	11	15	22694	0
2	0	2	37	37	22695	2
2	0	2	0	0	22696	2
2	0	2	0	0	22697	2
2	0	2	0	0	22698	2
2	2	2	1	3	22699	0
2	13	0	188	201	22700	1
2	0	2	1	1	22701	2
2	0	2	0	0	22702	2
2	7	0	184	191	22703	0
2	0	2	9	9	22704	2
2	210	2	0	210	22705	0
2	20	2	3856	3876	22706	1
2	1	2	187	188	22707	1
2	0	2	17	17	22708	2
2	81	2	18	99	22709	1
2	0	2	625	625	22710	2
2	7	2	0	7	22711	0
2	183	4	1455	1638	22712	1
2	0	2	2	2	22713	2
2	0	2	0	0	22714	2
2	4	4	950	954	22715	0
2	0	2	6	6	22716	2
2	0	2	0	0	22717	2
2	0	2	0	0	22718	2
2	0	2	1	1	22719	2
2	0	2	0	0	22720	2
2	0	2	0	0	22721	2
2	0	2	1	1	22722	2
2	0	2	0	0	22723	2
2	0	2	0	0	22724	2
2	0	2	0	0	22725	2
2	0	2	0	0	22726	2
2	0	2	0	0	22727	2
2	0	2	0	0	22728	2
2	0	2	0	0	22729	2
2	0	2	0	0	22730	2
2	0	2	0	0	22731	2
2	0	2	0	0	22732	2
2	0	2	0	0	22733	2
2	0	2	5	5	22734	2
2	0	2	0	0	22735	2
2	0	2	0	0	22736	2
2	0	2	0	0	22737	2
2	0	2	2	2	22738	2
2	0	2	0	0	22739	2
2	0	2	1	1	22740	2
2	0	2	0	0	22741	2
2	11	2	0	11	22742	0
2	72	2	107	179	22743	1
2	0	2	2	2	22744	2
2	0	2	0	0	22745	2
2	27	2	1	28	22746	1
2	0	2	32	32	22747	2
2	0	2	0	0	22748	2
2	0	2	1	1	22749	2
2	0	2	0	0	22750	2
2	1	2	1	2	22751	1
2	0	2	0	0	22752	2
2	0	2	0	0	22753	2
2	0	2	0	0	22754	2
2	0	2	0	0	22755	2
2	0	2	0	0	22756	2
2	0	2	0	0	22757	2
2	0	2	0	0	22758	2
2	0	2	0	0	22759	2
2	0	2	0	0	22760	2
2	0	2	0	0	22761	2
2	0	2	0	0	22762	2
2	0	2	16	16	22763	2
2	0	2	1	1	22764	2
2	0	2	0	0	22765	2
2	0	2	0	0	22766	2
2	0	2	4	4	22767	2
2	13	2	0	13	22768	0
2	12	2	40	52	22769	1
2	0	2	1	1	22770	2
2	0	2	0	0	22771	2
2	8	2	0	8	22772	0
2	0	2	24	24	22773	2
2	0	2	0	0	22774	2
2	0	2	27	27	22775	2
2	0	2	0	0	22776	2
2	0	2	0	0	22777	2
2	0	2	0	0	22778	2
2	0	2	0	0	22779	2
2	0	2	748	748	22780	2
2	20	2	0	20	22781	0
2	0	2	25	25	22782	2
2	0	2	0	0	22783	2
2	0	2	0	0	22784	2
2	0	2	0	0	22785	2
2	0	2	0	0	22786	2
2	0	2	0	0	22787	2
2	0	2	0	0	22788	2
2	13	2	0	13	22789	0
2	0	2	1	1	22790	2
2	0	2	0	0	22791	2
0	0	2	0	0	22792	2
2	4	2	0	4	22793	0
2	6	2	88	94	22794	1
2	0	2	2	2	22795	2
2	0	2	0	0	22796	2
2	4	2	7	11	22797	0
2	0	2	0	0	22798	2
2	3	2	0	3	22799	0
2	0	2	12	12	22800	2
2	0	2	0	0	22801	2
2	0	2	0	0	22802	2
2	7	2	0	7	22803	0
2	0	2	4	4	22804	2
2	0	2	0	0	22805	2
2	0	2	0	0	22806	2
2	0	2	0	0	22807	2
2	0	2	0	0	22808	2
2	0	2	0	0	22809	2
2	0	2	0	0	22810	2
2	20	2	0	20	22811	0
2	0	2	210	210	22812	2
2	0	2	1	1	22813	2
2	0	2	0	0	22814	2
2	3	2	2	5	22815	0
2	0	2	54	54	22816	2
2	7	2	0	7	22817	0
2	0	2	0	0	22818	2
2	5	2	10	15	22819	0
2	0	2	9	9	22820	2
2	0	2	0	0	22821	2
2	0	2	304	304	22822	2
4	5588	2	88	5676	22823	0
4	1071	2	7	1078	22824	0
2	0	2	0	0	22825	2
2	0	2	0	0	22826	2
2	12	2	0	12	22827	0
2	0	2	120	120	22828	2
2	1	2	0	1	22829	0
2	0	2	3	3	22830	2
4	2	4	6	8	22831	0
4	2	4	0	2	22832	0
2	0	2	0	0	22833	2
2	0	2	0	0	22834	2
2	0	2	0	0	22835	2
2	0	2	0	0	22836	2
2	0	2	0	0	22837	2
2	0	2	0	0	22838	2
4	0	2	746	746	22839	2
2	0	2	0	0	22840	2
2	0	2	0	0	22841	2
2	0	2	0	0	22842	2
2	0	2	0	0	22843	2
2	0	2	0	0	22844	2
2	0	2	0	0	22845	2
2	0	2	0	0	22846	2
2	0	2	0	0	22847	2
2	0	2	0	0	22848	2
2	0	2	5	5	22849	2
2	0	2	0	0	22850	2
2	0	2	0	0	22851	2
2	2	2	0	2	22852	0
2	0	2	0	0	22853	2
2	0	2	0	0	22854	2
2	4	2	0	4	22855	0
2	1	2	8	9	22856	1
2	0	2	0	0	22857	2
2	0	2	0	0	22858	2
2	0	2	0	0	22859	2
2	0	2	6	6	22860	2
2	3	2	0	3	22861	0
2	0	2	3	3	22862	2
2	0	2	0	0	22863	2
2	53	2	0	53	22864	0
2	0	2	9	9	22865	2
2	0	2	0	0	22866	2
2	0	2	0	0	22867	2
2	0	2	1	1	22868	2
2	0	2	0	0	22869	2
2	0	2	0	0	22870	2
2	0	2	0	0	22871	2
2	0	2	0	0	22872	2
2	0	2	0	0	22873	2
2	0	4	489	489	22874	2
2	0	2	0	0	22875	2
2	0	2	0	0	22876	2
2	0	4	496	496	22877	2
2	0	2	4	4	22878	2
2	2	2	1	3	22879	0
2	12	2	9	21	22880	1
2	0	2	0	0	22881	2
2	0	2	1	1	22882	2
2	2	2	0	2	22883	0
2	0	2	0	0	22884	2
2	4	2	0	4	22885	0
2	5	2	0	5	22886	0
2	0	2	17	17	22887	2
2	1	2	14	15	22888	1
2	0	2	0	0	22889	2
2	0	2	0	0	22890	2
4	0	4	1	1	22891	2
4	0	4	0	0	22892	2
2	7	2	0	7	22893	0
2	16	2	0	16	22894	0
2	3	2	2	5	22895	0
2	0	2	28	28	22896	2
2	1	2	37	38	22897	1
2	0	2	3	3	22898	2
2	0	2	0	0	22899	2
2	6	4	29	35	22900	1
2	0	2	1	1	22901	2
2	0	2	1	1	22902	2
4	0	2	2	2	22903	2
4	0	2	0	0	22904	2
2	1	4	820	821	22905	1
2	0	2	4	4	22906	2
4	1	2	2	3	22907	0
2	0	2	0	0	22908	2
2	0	2	0	0	22909	2
2	0	2	0	0	22910	2
2	0	2	0	0	22911	2
2	0	2	0	0	22912	2
2	0	2	0	0	22913	2
2	0	2	0	0	22914	2
2	47	4	218	265	22915	1
2	0	2	0	0	22916	2
2	0	2	0	0	22917	2
2	0	4	13	13	22918	2
2	0	2	0	0	22919	2
2	1	2	0	1	22920	0
2	12	2	161	173	22921	1
2	0	2	1	1	22922	2
2	0	2	0	0	22923	2
0	2	2	1	3	22924	0
0	0	2	0	0	22925	2
2	0	2	0	0	22926	2
2	0	2	6	6	22927	2
4	34	4	15	49	22928	1
4	1	4	1	2	22929	1
2	0	2	0	0	22930	2
2	0	2	0	0	22931	2
2	0	2	0	0	22932	2
2	0	2	0	0	22933	2
2	0	2	0	0	22934	2
2	0	2	0	0	22935	2
2	0	2	0	0	22936	2
2	0	2	0	0	22937	2
2	0	2	0	0	22938	2
2	0	2	0	0	22939	2
2	0	2	0	0	22940	2
2	0	2	0	0	22941	2
2	0	2	0	0	22942	2
2	0	2	6	6	22943	2
2	0	2	0	0	22944	2
2	0	2	5	5	22945	2
2	0	2	0	0	22946	2
2	0	2	0	0	22947	2
2	0	2	0	0	22948	2
2	0	2	0	0	22949	2
2	0	2	0	0	22950	2
2	0	2	0	0	22951	2
2	0	2	0	0	22952	2
2	0	2	0	0	22953	2
2	0	2	0	0	22954	2
2	0	2	0	0	22955	2
2	0	2	0	0	22956	2
2	0	2	0	0	22957	2
2	0	2	0	0	22958	2
2	0	2	0	0	22959	2
2	0	2	0	0	22960	2
2	0	2	2	2	22961	2
2	0	2	5	5	22962	2
2	0	2	0	0	22963	2
2	0	2	0	0	22964	2
2	0	2	0	0	22965	2
2	0	2	0	0	22966	2
2	0	2	0	0	22967	2
2	0	2	0	0	22968	2
2	0	2	0	0	22969	2
2	0	2	0	0	22970	2
2	1	2	11	12	22971	1
2	0	2	0	0	22972	2
2	0	2	0	0	22973	2
2	0	2	3	3	22974	2
2	0	2	1	1	22975	2
2	0	2	0	0	22976	2
2	0	2	0	0	22977	2
2	0	2	0	0	22978	2
2	0	2	0	0	22979	2
0	18	2	0	18	22980	1
0	3	2	0	3	22981	0
2	0	2	0	0	22982	2
2	0	2	0	0	22983	2
2	21	2	0	21	22984	0
0	57	4	62	119	22985	0
0	0	0	3	3	22986	2
0	0	0	3	3	22987	2
2	29	2	319	348	22988	1
2	0	2	0	0	22989	2
2	0	2	1	1	22990	2
2	9	2	3	12	22991	1
2	0	2	4899	4899	22992	2
4	35	2	46	81	22993	0
2	0	2	0	0	22994	2
2	0	2	0	0	22995	2
2	0	2	0	0	22996	2
2	0	2	0	0	22997	2
2	0	2	0	0	22998	2
2	0	2	0	0	22999	2
2	0	2	0	0	23000	2
2	0	2	0	0	23001	2
2	0	2	0	0	23002	2
2	0	2	0	0	23003	2
2	0	2	0	0	23004	2
2	0	2	0	0	23005	2
2	0	4	27	27	23006	2
2	0	2	0	0	23007	2
2	0	2	0	0	23008	2
0	601	2	17	618	23009	0
0	685	2	11	696	23010	0
0	315	2	3	318	23011	0
2	0	4	3	3	23012	2
2	0	2	6	6	23013	2
2	0	2	2	2	23014	2
4	0	4	62	62	23015	2
4	0	0	3	3	23016	2
2	2625	2	15	2640	23017	0
2	0	2	0	0	23018	2
2	0	2	0	0	23019	2
2	0	2	0	0	23020	2
2	0	2	0	0	23021	2
2	0	2	0	0	23022	2
2	0	2	0	0	23023	2
2	696	4	16824	17520	23024	0
2	3	2	915	918	23025	1
2	0	2	15	15	23026	2
2	850	4	32681	33531	23027	0
2	4	2	3638	3642	23028	0
2	0	2	0	0	23029	2
2	0	4	5	5	23030	2
2	0	2	0	0	23031	2
2	0	2	0	0	23032	2
2	0	4	0	0	23033	2
2	0	2	0	0	23034	2
2	11	2	1	12	23035	0
2	0	2	0	0	23036	2
2	0	2	0	0	23037	2
2	0	2	0	0	23038	2
2	0	2	0	0	23039	2
2	0	2	0	0	23040	2
2	0	2	0	0	23041	2
2	0	2	0	0	23042	2
2	0	2	0	0	23043	2
2	0	2	0	0	23044	2
2	0	2	0	0	23045	2
2	0	2	0	0	23046	2
2	0	2	0	0	23047	2
2	0	2	0	0	23048	2
2	0	2	1	1	23049	2
2	0	2	0	0	23050	2
2	0	2	0	0	23051	2
2	1	2	0	1	23052	1
2	0	2	0	0	23053	2
2	2	2	25	27	23054	1
2	0	2	8	8	23055	2
2	0	2	2	2	23056	2
2	7	2	14	21	23057	1
2	0	2	0	0	23058	2
2	0	2	0	0	23059	2
2	0	2	0	0	23060	2
2	0	2	0	0	23061	2
2	0	2	0	0	23062	2
2	0	2	0	0	23063	2
2	0	2	0	0	23064	2
2	0	2	5	5	23065	2
2	0	2	1	1	23066	2
2	0	2	0	0	23067	2
0	1	2	2	3	23068	0
0	0	2	2	2	23069	2
2	0	2	1	1	23070	2
2	0	2	586	586	23071	2
2	56	2	1	57	23072	0
2	0	2	0	0	23073	2
2	0	2	0	0	23074	2
2	0	2	0	0	23075	2
2	0	2	0	0	23076	2
2	0	2	0	0	23077	2
2	0	2	0	0	23078	2
0	141	3	2948	3089	23079	0
0	2	3	2948	2950	23080	0
2	7	2	154	161	23081	1
2	0	2	7	7	23082	2
2	0	2	0	0	23083	2
2	18	2	1	19	23084	0
2	0	2	151	151	23085	2
2	0	2	0	0	23086	2
2	0	2	0	0	23087	2
2	0	4	0	0	23088	2
2	0	2	0	0	23089	2
2	0	2	0	0	23090	2
2	0	4	1	1	23091	2
2	0	2	0	0	23092	2
2	0	4	12	12	23093	2
2	0	2	0	0	23094	2
2	0	4	6	6	23095	2
2	0	2	0	0	23096	2
2	0	2	0	0	23097	2
2	0	2	0	0	23098	2
2	0	2	3	3	23099	2
2	0	2	0	0	23100	2
2	0	2	0	0	23101	2
2	0	2	0	0	23102	2
2	0	2	1	1	23103	2
2	0	2	0	0	23104	2
2	0	2	0	0	23105	2
2	0	2	0	0	23106	2
2	0	2	0	0	23107	2
2	0	2	1	1	23108	2
2	0	2	0	0	23109	2
2	0	2	0	0	23110	2
2	0	2	0	0	23111	2
2	1	2	0	1	23112	1
2	1	2	81	82	23113	1
2	0	2	0	0	23114	2
2	0	2	0	0	23115	2
2	0	2	0	0	23116	2
2	0	2	4	4	23117	2
4	0	4	0	0	23118	2
2	0	2	0	0	23119	2
2	0	2	0	0	23120	2
2	0	2	0	0	23121	2
2	0	2	0	0	23122	2
2	0	2	0	0	23123	2
2	0	2	0	0	23124	2
0	75	0	7580	7655	23125	0
2	0	2	0	0	23126	2
2	0	2	4	4	23127	2
2	0	2	0	0	23128	2
2	0	2	0	0	23129	2
2	0	2	0	0	23130	2
2	0	2	2	2	23131	2
2	0	2	0	0	23132	2
2	0	2	0	0	23133	2
2	0	2	0	0	23134	2
2	0	2	0	0	23135	2
2	0	2	0	0	23136	2
2	0	2	0	0	23137	2
2	0	2	0	0	23138	2
2	0	2	0	0	23139	2
2	0	2	0	0	23140	2
2	0	2	0	0	23141	2
2	0	2	0	0	23142	2
2	0	2	0	0	23143	2
2	0	2	0	0	23144	2
2	0	2	1	1	23145	2
2	0	2	0	0	23146	2
2	0	2	0	0	23147	2
2	0	2	0	0	23148	2
2	0	4	3920	3920	23149	2
2	0	2	0	0	23150	2
2	0	4	1285	1285	23151	2
2	0	2	0	0	23152	2
2	0	2	0	0	23153	2
2	0	2	0	0	23154	2
2	0	2	0	0	23155	2
2	0	2	0	0	23156	2
2	0	2	0	0	23157	2
2	0	2	0	0	23158	2
2	0	2	0	0	23159	2
2	0	2	0	0	23160	2
2	0	4	0	0	23161	2
2	0	2	0	0	23162	2
2	0	2	0	0	23163	2
2	0	4	1	1	23164	2
2	0	2	0	0	23165	2
2	0	2	0	0	23166	2
2	0	2	0	0	23167	2
2	0	2	0	0	23168	2
2	0	2	0	0	23169	2
2	0	2	0	0	23170	2
2	0	2	0	0	23171	2
2	0	2	0	0	23172	2
2	0	4	484	484	23173	2
2	0	2	0	0	23174	2
2	0	2	0	0	23175	2
2	0	4	759	759	23176	2
2	0	2	1	1	23177	2
2	0	2	0	0	23178	2
2	0	2	0	0	23179	2
2	0	2	0	0	23180	2
2	0	2	0	0	23181	2
2	0	2	0	0	23182	2
2	0	2	0	0	23183	2
2	58	2	1	59	23184	0
2	6	2	122	128	23185	1
2	0	2	28	28	23186	2
2	0	2	0	0	23187	2
2	5	2	3222	3227	23188	0
2	0	2	66	66	23189	2
2	157	2	2	159	23190	0
2	0	2	974	974	23191	2
2	2	4	0	2	23192	1
2	0	2	2	2	23193	2
2	0	2	0	0	23194	2
2	0	4	0	0	23195	2
2	0	2	0	0	23196	2
2	0	2	0	0	23197	2
2	0	2	0	0	23198	2
2	0	2	0	0	23199	2
2	0	2	0	0	23200	2
2	0	2	0	0	23201	2
2	0	2	0	0	23202	2
2	0	2	0	0	23203	2
2	65	2	0	65	23204	0
2	1	2	381	382	23205	1
2	0	2	3	3	23206	2
2	0	2	0	0	23207	2
2	7	2	0	7	23208	0
2	0	2	42	42	23209	2
2	237	2	2	239	23210	0
2	613	0	2323	2936	23211	0
2	0	2	2	2	23212	2
2	0	2	0	0	23213	2
2	41	2	5	46	23214	0
2	28	0	1034	1062	23215	0
2	0	2	132	132	23216	2
2	0	2	0	0	23217	2
2	0	4	158	158	23218	2
2	0	2	0	0	23219	2
2	0	2	0	0	23220	2
2	0	4	39	39	23221	2
2	0	2	1	1	23222	2
2	0	2	3	3	23223	2
2	0	2	0	0	23224	2
3	4	3	1	5	23225	1
4	0	4	0	0	23226	2
3	14	3	3	17	23227	1
4	0	4	0	0	23228	2
4	2	4	15	17	23229	1
4	1	4	2	3	23230	1
4	1501	4	396	1897	23231	0
4	2	4	2	4	23232	1
4	9	0	5	14	23233	1
4	6	0	11	17	23234	1
4	187	2	9	196	23235	0
0	0	2	15	15	23236	2
0	0	2	0	0	23237	2
4	15	4	1	16	23238	1
4	31	4	1	32	23239	1
4	0	4	0	0	23240	2
4	0	4	0	0	23241	2
4	924	2	7	931	23242	0
4	27	2	46	73	23243	0
0	42	4	3	45	23244	0
2	12542	4	16824	29366	23245	0
4	3	0	2	5	23246	0
4	0	0	0	0	23247	2
2	126	4	32681	32807	23248	1
4	0	4	5	5	23249	2
4	1	2	381	382	23250	0
4	0	2	0	0	23251	2
2	3	2	0	3	23252	0
2	3	2	23	26	23253	1
2	0	2	0	0	23254	2
2	0	2	0	0	23255	2
2	1	2	7	8	23256	1
2	0	2	269	269	23257	2
2	0	2	0	0	23258	2
2	0	2	0	0	23259	2
2	0	2	0	0	23260	2
2	0	2	0	0	23261	2
2	1	2	0	1	23262	0
2	0	2	3	3	23263	2
2	0	2	0	0	23264	2
2	0	2	0	0	23265	2
2	0	2	0	0	23266	2
2	0	2	0	0	23267	2
2	0	2	0	0	23268	2
2	0	2	0	0	23269	2
0	0	4	0	0	23270	2
2	0	2	0	0	23271	2
2	10	2	3	13	23272	1
2	0	2	1	1	23273	2
2	0	2	0	0	23274	2
2	1	2	0	1	23275	0
2	0	2	0	0	23276	2
2	5	2	0	5	23277	0
2	66	4	3226	3292	23278	1
2	0	2	0	0	23279	2
2	0	2	6	6	23280	2
2	5	4	4	9	23281	0
2	0	2	29	29	23282	2
2	2	2	0	2	23283	0
2	13	2	43	56	23284	1
2	0	2	1	1	23285	2
2	0	2	1	1	23286	2
2	0	2	0	0	23287	2
2	0	2	1	1	23288	2
2	0	2	0	0	23289	2
2	0	2	0	0	23290	2
2	0	2	0	0	23291	2
2	0	2	1	1	23292	2
2	1	2	0	1	23293	1
2	0	2	9	9	23294	2
2	0	2	0	0	23295	2
2	0	2	0	0	23296	2
2	95	2	0	95	23297	0
2	17	2	211	228	23298	1
2	0	2	11	11	23299	2
2	0	2	0	0	23300	2
2	31	2	0	31	23301	0
2	0	2	0	0	23302	2
2	0	2	0	0	23303	2
2	0	2	0	0	23304	2
2	0	2	0	0	23305	2
2	0	2	0	0	23306	2
2	0	2	0	0	23307	2
2	0	2	0	0	23308	2
2	0	2	0	0	23309	2
2	0	2	0	0	23310	2
2	0	2	0	0	23311	2
2	0	2	0	0	23312	2
2	0	2	0	0	23313	2
2	0	2	0	0	23314	2
2	0	2	0	0	23315	2
4	36	2	1	37	23316	0
4	15	2	0	15	23317	0
2	0	2	0	0	23318	2
2	0	2	0	0	23319	2
2	0	2	0	0	23320	2
2	0	2	0	0	23321	2
2	0	2	0	0	23322	2
2	0	2	0	0	23323	2
4	0	4	1	1	23324	2
4	0	4	0	0	23325	2
2	0	2	0	0	23326	2
2	0	2	0	0	23327	2
2	0	2	0	0	23328	2
2	0	2	0	0	23329	2
2	0	2	0	0	23330	2
2	0	2	0	0	23331	2
2	0	2	0	0	23332	2
2	0	2	0	0	23333	2
2	0	2	0	0	23334	2
2	0	2	0	0	23335	2
2	0	2	0	0	23336	2
2	0	2	0	0	23337	2
2	0	2	0	0	23338	2
2	0	2	0	0	23339	2
2	0	2	0	0	23340	2
2	0	2	0	0	23341	2
2	0	2	0	0	23342	2
2	0	2	0	0	23343	2
2	0	2	0	0	23344	2
2	0	2	0	0	23345	2
2	0	2	0	0	23346	2
2	0	2	0	0	23347	2
2	0	2	0	0	23348	2
2	0	2	0	0	23349	2
2	0	2	0	0	23350	2
2	0	2	0	0	23351	2
2	0	2	0	0	23352	2
2	0	2	0	0	23353	2
2	0	2	0	0	23354	2
2	0	2	0	0	23355	2
2	0	2	0	0	23356	2
2	0	2	0	0	23357	2
2	0	2	0	0	23358	2
2	0	2	0	0	23359	2
2	0	2	0	0	23360	2
2	0	2	0	0	23361	2
2	0	2	0	0	23362	2
2	0	2	0	0	23363	2
2	3	2	0	3	23364	0
2	2	4	42	44	23365	1
2	0	2	1	1	23366	2
2	0	2	0	0	23367	2
2	0	4	0	0	23368	2
2	0	2	3	3	23369	2
2	0	2	0	0	23370	2
2	0	2	0	0	23371	2
2	0	2	0	0	23372	2
2	0	2	0	0	23373	2
2	0	2	0	0	23374	2
2	0	2	0	0	23375	2
2	0	2	0	0	23376	2
2	0	2	0	0	23377	2
2	0	2	0	0	23378	2
2	0	2	0	0	23379	2
2	0	2	0	0	23380	2
2	0	2	0	0	23381	2
2	0	2	0	0	23382	2
2	0	2	0	0	23383	2
2	0	2	0	0	23384	2
2	0	2	0	0	23385	2
2	0	2	0	0	23386	2
2	0	2	0	0	23387	2
2	0	2	0	0	23388	2
2	0	2	0	0	23389	2
2	0	2	0	0	23390	2
2	0	2	0	0	23391	2
2	0	2	0	0	23392	2
2	0	2	0	0	23393	2
2	0	2	0	0	23394	2
2	0	2	0	0	23395	2
2	0	2	0	0	23396	2
2	0	2	0	0	23397	2
2	0	2	0	0	23398	2
2	0	2	0	0	23399	2
2	0	2	0	0	23400	2
2	0	2	0	0	23401	2
2	0	2	0	0	23402	2
2	0	2	0	0	23403	2
2	0	2	0	0	23404	2
2	0	2	0	0	23405	2
2	0	2	0	0	23406	2
2	0	2	0	0	23407	2
2	0	2	0	0	23408	2
2	0	2	0	0	23409	2
2	0	2	0	0	23410	2
2	0	2	0	0	23411	2
2	0	2	0	0	23412	2
2	0	2	1	1	23413	2
2	0	2	0	0	23414	2
2	0	2	0	0	23415	2
2	0	2	0	0	23416	2
2	0	2	0	0	23417	2
2	0	2	0	0	23418	2
2	0	2	0	0	23419	2
2	0	2	0	0	23420	2
2	0	2	0	0	23421	2
2	0	2	0	0	23422	2
2	0	2	0	0	23423	2
2	0	2	0	0	23424	2
2	0	2	0	0	23425	2
2	0	2	0	0	23426	2
2	0	2	0	0	23427	2
2	0	2	0	0	23428	2
2	0	2	0	0	23429	2
2	0	2	0	0	23430	2
2	0	2	0	0	23431	2
2	0	2	0	0	23432	2
2	0	2	0	0	23433	2
2	0	2	0	0	23434	2
2	0	2	0	0	23435	2
2	0	2	0	0	23436	2
2	0	2	0	0	23437	2
2	0	2	0	0	23438	2
2	0	2	0	0	23439	2
2	0	2	0	0	23440	2
2	0	2	0	0	23441	2
2	0	2	0	0	23442	2
2	0	2	0	0	23443	2
2	0	2	0	0	23444	2
2	0	2	0	0	23445	2
2	0	2	0	0	23446	2
2	0	2	0	0	23447	2
2	0	2	0	0	23448	2
2	0	2	0	0	23449	2
2	10	2	1	11	23450	0
2	0	2	0	0	23451	2
2	0	2	0	0	23452	2
2	0	2	0	0	23453	2
2	0	2	0	0	23454	2
2	0	2	0	0	23455	2
2	0	2	0	0	23456	2
2	0	2	0	0	23457	2
2	0	2	0	0	23458	2
2	0	2	0	0	23459	2
2	0	2	0	0	23460	2
2	0	2	0	0	23461	2
2	0	2	0	0	23462	2
2	0	2	0	0	23463	2
2	0	2	0	0	23464	2
2	0	2	0	0	23465	2
2	0	2	0	0	23466	2
2	0	2	0	0	23467	2
2	0	2	0	0	23468	2
2	0	2	0	0	23469	2
2	0	2	0	0	23470	2
2	0	2	0	0	23471	2
2	0	2	0	0	23472	2
2	0	2	0	0	23473	2
2	0	2	0	0	23474	2
2	0	2	0	0	23475	2
2	0	2	0	0	23476	2
2	0	2	0	0	23477	2
2	0	2	0	0	23478	2
2	0	2	0	0	23479	2
2	0	2	0	0	23480	2
2	0	2	0	0	23481	2
2	0	2	0	0	23482	2
2	0	2	0	0	23483	2
2	0	2	0	0	23484	2
2	0	2	0	0	23485	2
2	0	2	0	0	23486	2
2	0	2	0	0	23487	2
2	0	2	0	0	23488	2
2	0	2	0	0	23489	2
2	0	2	0	0	23490	2
2	0	2	0	0	23491	2
2	1	2	1	2	23492	0
2	0	2	2	2	23493	2
2	0	2	18	18	23494	2
2	0	2	0	0	23495	2
2	0	2	0	0	23496	2
4	0	2	0	0	23497	2
2	0	2	4	4	23498	2
2	0	2	2	2	23499	2
2	0	2	0	0	23500	2
2	0	2	4	4	23501	2
2	0	2	0	0	23502	2
2	0	2	0	0	23503	2
2	0	2	0	0	23504	2
2	0	2	0	0	23505	2
2	0	2	0	0	23506	2
2	0	2	8	8	23507	2
2	0	2	0	0	23508	2
2	0	2	0	0	23509	2
2	0	2	0	0	23510	2
2	0	2	0	0	23511	2
2	221	2	0	221	23512	0
2	29	2	335	364	23513	1
2	1	2	59	60	23514	1
2	0	2	0	0	23515	2
2	125	2	0	125	23516	1
2	0	2	654	654	23517	2
2	2	2	0	2	23518	0
2	0	2	1	1	23519	2
2	0	2	0	0	23520	2
2	0	2	0	0	23521	2
2	0	2	0	0	23522	2
2	0	2	0	0	23523	2
2	0	2	0	0	23524	2
2	0	2	2	2	23525	2
2	0	2	0	0	23526	2
2	0	2	0	0	23527	2
2	0	2	0	0	23528	2
2	0	2	0	0	23529	2
2	0	2	0	0	23530	2
2	0	2	1	1	23531	2
2	0	2	0	0	23532	2
2	0	2	0	0	23533	2
2	0	2	0	0	23534	2
2	0	2	0	0	23535	2
2	0	2	0	0	23536	2
2	0	2	0	0	23537	2
2	0	2	0	0	23538	2
2	0	2	0	0	23539	2
2	0	2	0	0	23540	2
2	0	2	0	0	23541	2
2	0	2	0	0	23542	2
2	0	2	0	0	23543	2
2	0	2	0	0	23544	2
2	0	2	0	0	23545	2
2	0	2	0	0	23546	2
2	0	2	0	0	23547	2
2	0	2	0	0	23548	2
2	0	2	3	3	23549	2
2	0	2	0	0	23550	2
2	0	2	0	0	23551	2
2	0	2	0	0	23552	2
2	0	2	0	0	23553	2
2	24	2	0	24	23554	0
2	0	2	7	7	23555	2
2	0	2	0	0	23556	2
2	52	2	1	53	23557	0
2	30	2	474	504	23558	1
2	0	2	4	4	23559	2
2	0	2	0	0	23560	2
2	14	2	1	15	23561	0
2	0	2	67	67	23562	2
4	0	2	5	5	23563	2
2	0	2	0	0	23564	2
2	0	2	0	0	23565	2
2	0	2	0	0	23566	2
2	513	2	1	514	23567	0
2	44	2	3120	3164	23568	1
2	0	2	26	26	23569	2
2	0	2	9	9	23570	2
2	67	2	50	117	23571	0
2	0	2	311	311	23572	2
2	3	2	0	3	23573	0
2	26	2	100	126	23574	1
2	0	2	0	0	23575	2
2	0	2	0	0	23576	2
2	2	2	0	2	23577	1
2	0	2	0	0	23578	2
2	0	2	0	0	23579	2
2	1	2	0	1	23580	1
2	0	2	0	0	23581	2
2	0	2	0	0	23582	2
2	0	2	0	0	23583	2
2	0	2	1	1	23584	2
2	0	2	0	0	23585	2
2	0	2	0	0	23586	2
2	0	2	0	0	23587	2
2	0	2	0	0	23588	2
2	0	2	0	0	23589	2
2	0	2	0	0	23590	2
2	6	2	0	6	23591	0
2	0	2	3	3	23592	2
2	0	2	0	0	23593	2
2	0	2	0	0	23594	2
2	0	2	0	0	23595	2
2	2	2	0	2	23596	0
2	2	2	0	2	23597	0
2	0	2	1	1	23598	2
2	0	2	0	0	23599	2
2	0	2	0	0	23600	2
2	1	2	0	1	23601	1
2	0	2	5	5	23602	2
2	2	2	121	123	23603	1
2	0	2	0	0	23604	2
2	0	2	0	0	23605	2
2	3	2	0	3	23606	1
2	0	2	15	15	23607	2
4	0	2	0	0	23608	2
2	0	2	0	0	23609	2
2	0	2	0	0	23610	2
2	0	2	0	0	23611	2
2	0	2	0	0	23612	2
2	0	2	0	0	23613	2
2	0	2	0	0	23614	2
2	0	2	0	0	23615	2
2	0	2	0	0	23616	2
2	0	2	0	0	23617	2
2	0	2	0	0	23618	2
2	0	2	0	0	23619	2
2	0	2	0	0	23620	2
2	0	2	0	0	23621	2
2	0	2	0	0	23622	2
2	0	2	0	0	23623	2
2	0	2	0	0	23624	2
2	0	2	0	0	23625	2
2	0	2	0	0	23626	2
2	0	2	0	0	23627	2
2	0	2	0	0	23628	2
2	0	2	0	0	23629	2
2	0	2	0	0	23630	2
2	0	2	0	0	23631	2
2	0	2	0	0	23632	2
2	0	2	0	0	23633	2
2	0	2	0	0	23634	2
2	0	2	0	0	23635	2
2	0	2	0	0	23636	2
2	0	2	0	0	23637	2
2	0	2	0	0	23638	2
2	0	2	0	0	23639	2
2	0	2	0	0	23640	2
2	0	2	0	0	23641	2
2	0	2	0	0	23642	2
2	0	2	0	0	23643	2
2	0	2	0	0	23644	2
2	0	2	0	0	23645	2
2	0	2	0	0	23646	2
2	0	2	0	0	23647	2
2	0	2	0	0	23648	2
2	0	2	0	0	23649	2
2	0	2	0	0	23650	2
2	0	2	0	0	23651	2
2	0	2	0	0	23652	2
2	0	2	0	0	23653	2
2	0	2	0	0	23654	2
2	0	2	1	1	23655	2
2	0	2	0	0	23656	2
2	0	2	0	0	23657	2
2	0	2	0	0	23658	2
2	0	2	0	0	23659	2
2	0	2	0	0	23660	2
2	0	2	0	0	23661	2
2	0	2	0	0	23662	2
2	0	2	0	0	23663	2
2	0	2	0	0	23664	2
2	0	2	0	0	23665	2
2	0	2	0	0	23666	2
2	0	2	0	0	23667	2
2	0	2	0	0	23668	2
2	0	2	0	0	23669	2
2	0	2	0	0	23670	2
2	0	2	0	0	23671	2
2	0	2	0	0	23672	2
2	0	2	0	0	23673	2
2	0	2	0	0	23674	2
2	0	2	0	0	23675	2
2	0	2	0	0	23676	2
2	0	2	0	0	23677	2
2	0	2	0	0	23678	2
2	0	2	0	0	23679	2
2	0	2	0	0	23680	2
2	0	2	0	0	23681	2
2	0	4	34	34	23682	2
2	0	2	0	0	23683	2
2	0	2	0	0	23684	2
2	0	2	0	0	23685	2
2	0	2	0	0	23686	2
2	0	2	0	0	23687	2
2	0	2	0	0	23688	2
2	0	2	0	0	23689	2
2	0	2	0	0	23690	2
2	0	2	0	0	23691	2
2	0	2	0	0	23692	2
2	0	2	0	0	23693	2
2	0	2	0	0	23694	2
2	0	2	0	0	23695	2
2	0	2	0	0	23696	2
2	0	2	0	0	23697	2
2	0	2	0	0	23698	2
2	0	2	0	0	23699	2
2	0	2	0	0	23700	2
2	0	2	0	0	23701	2
2	0	2	0	0	23702	2
2	0	2	0	0	23703	2
2	0	2	0	0	23704	2
2	0	2	0	0	23705	2
2	0	2	0	0	23706	2
2	0	2	0	0	23707	2
2	0	2	0	0	23708	2
2	0	2	0	0	23709	2
2	0	2	0	0	23710	2
2	0	2	0	0	23711	2
2	0	2	0	0	23712	2
2	0	2	0	0	23713	2
2	0	2	0	0	23714	2
2	0	2	0	0	23715	2
2	0	2	0	0	23716	2
2	0	2	0	0	23717	2
2	0	2	0	0	23718	2
2	2	2	1	3	23719	1
2	1	2	0	1	23720	1
2	0	2	0	0	23721	2
2	0	2	0	0	23722	2
2	0	2	0	0	23723	2
2	0	2	0	0	23724	2
2	0	2	0	0	23725	2
2	0	2	0	0	23726	2
2	0	2	0	0	23727	2
2	0	2	0	0	23728	2
2	0	2	0	0	23729	2
2	0	2	4	4	23730	2
2	0	2	0	0	23731	2
2	0	2	0	0	23732	2
2	0	2	0	0	23733	2
2	0	2	0	0	23734	2
2	0	2	0	0	23735	2
2	0	2	0	0	23736	2
2	0	2	1	1	23737	2
2	0	2	1	1	23738	2
2	0	2	0	0	23739	2
2	0	2	0	0	23740	2
2	0	2	0	0	23741	2
2	0	2	0	0	23742	2
2	0	2	0	0	23743	2
2	0	2	0	0	23744	2
2	0	2	0	0	23745	2
2	0	2	0	0	23746	2
2	0	2	0	0	23747	2
2	0	2	0	0	23748	2
2	0	2	0	0	23749	2
2	0	2	0	0	23750	2
2	0	2	0	0	23751	2
2	0	2	0	0	23752	2
2	0	2	0	0	23753	2
2	0	2	0	0	23754	2
2	0	2	0	0	23755	2
2	0	2	0	0	23756	2
2	0	2	0	0	23757	2
2	0	2	0	0	23758	2
2	0	2	0	0	23759	2
2	0	2	0	0	23760	2
2	0	2	0	0	23761	2
2	0	2	0	0	23762	2
2	0	2	0	0	23763	2
2	0	2	1	1	23764	2
2	0	2	0	0	23765	2
2	0	2	0	0	23766	2
2	0	2	1	1	23767	2
2	0	2	1	1	23768	2
2	0	2	0	0	23769	2
2	0	2	0	0	23770	2
2	0	2	0	0	23771	2
2	0	2	0	0	23772	2
2	0	2	0	0	23773	2
2	0	2	0	0	23774	2
2	0	2	0	0	23775	2
2	0	2	0	0	23776	2
2	0	2	0	0	23777	2
2	0	2	0	0	23778	2
2	0	2	0	0	23779	2
2	0	2	0	0	23780	2
2	0	2	0	0	23781	2
2	0	2	1	1	23782	2
2	0	2	1	1	23783	2
2	7	2	0	7	23784	0
2	38	2	34	72	23785	1
2	0	2	6	6	23786	2
2	0	2	0	0	23787	2
2	0	2	0	0	23788	2
2	0	2	0	0	23789	2
2	0	2	1	1	23790	2
2	0	2	0	0	23791	2
2	0	2	0	0	23792	2
2	0	2	0	0	23793	2
2	0	2	0	0	23794	2
2	0	2	0	0	23795	2
2	0	2	0	0	23796	2
2	0	2	0	0	23797	2
2	0	2	0	0	23798	2
2	0	2	0	0	23799	2
2	0	2	0	0	23800	2
2	0	2	0	0	23801	2
2	0	2	0	0	23802	2
2	1	2	22	23	23803	1
2	0	2	0	0	23804	2
2	0	2	0	0	23805	2
2	0	2	0	0	23806	2
2	0	2	0	0	23807	2
2	0	2	0	0	23808	2
2	0	2	0	0	23809	2
2	0	2	1	1	23810	2
2	0	2	0	0	23811	2
2	4	2	1	5	23812	0
2	0	2	160	160	23813	2
2	0	2	0	0	23814	2
2	0	2	0	0	23815	2
2	0	2	0	0	23816	2
2	0	2	0	0	23817	2
2	0	2	0	0	23818	2
2	2	2	2	4	23819	1
2	0	2	0	0	23820	2
2	0	2	0	0	23821	2
2	0	2	0	0	23822	2
2	0	2	0	0	23823	2
2	0	2	0	0	23824	2
2	0	2	0	0	23825	2
2	0	2	0	0	23826	2
2	0	2	0	0	23827	2
2	0	2	0	0	23828	2
2	0	2	1	1	23829	2
2	0	2	0	0	23830	2
2	0	2	0	0	23831	2
2	0	2	0	0	23832	2
2	0	2	0	0	23833	2
2	0	2	0	0	23834	2
2	0	2	0	0	23835	2
2	0	2	0	0	23836	2
2	0	2	0	0	23837	2
2	0	2	0	0	23838	2
2	0	2	0	0	23839	2
2	0	2	0	0	23840	2
2	0	2	0	0	23841	2
2	0	2	0	0	23842	2
2	0	2	0	0	23843	2
2	0	2	0	0	23844	2
2	0	2	0	0	23845	2
2	0	2	0	0	23846	2
2	0	2	0	0	23847	2
2	0	2	0	0	23848	2
2	0	2	0	0	23849	2
2	0	2	0	0	23850	2
2	0	2	0	0	23851	2
2	0	2	0	0	23852	2
2	0	2	0	0	23853	2
2	0	2	0	0	23854	2
2	0	2	0	0	23855	2
2	0	2	0	0	23856	2
2	0	2	0	0	23857	2
2	0	2	0	0	23858	2
2	0	2	0	0	23859	2
2	0	2	0	0	23860	2
2	0	2	0	0	23861	2
2	0	2	0	0	23862	2
2	0	2	0	0	23863	2
2	0	2	0	0	23864	2
2	0	2	0	0	23865	2
2	0	2	0	0	23866	2
2	0	2	0	0	23867	2
2	0	2	0	0	23868	2
2	0	2	0	0	23869	2
2	0	2	0	0	23870	2
2	0	2	0	0	23871	2
2	0	2	0	0	23872	2
2	0	2	0	0	23873	2
2	0	2	0	0	23874	2
2	0	2	0	0	23875	2
2	0	2	0	0	23876	2
2	0	2	0	0	23877	2
2	0	2	0	0	23878	2
2	0	2	0	0	23879	2
2	0	2	0	0	23880	2
2	0	2	0	0	23881	2
2	0	2	0	0	23882	2
2	0	2	0	0	23883	2
2	0	2	0	0	23884	2
2	0	2	0	0	23885	2
2	0	2	0	0	23886	2
2	0	2	0	0	23887	2
2	0	2	0	0	23888	2
2	0	2	0	0	23889	2
2	0	2	0	0	23890	2
2	0	2	0	0	23891	2
2	0	2	0	0	23892	2
2	0	2	0	0	23893	2
2	0	2	0	0	23894	2
2	0	2	0	0	23895	2
2	0	2	0	0	23896	2
2	0	2	0	0	23897	2
2	0	2	0	0	23898	2
2	0	2	0	0	23899	2
2	0	2	0	0	23900	2
2	0	2	0	0	23901	2
2	0	2	0	0	23902	2
2	0	2	2	2	23903	2
2	0	2	0	0	23904	2
2	0	2	0	0	23905	2
2	0	2	0	0	23906	2
2	0	2	0	0	23907	2
2	0	2	0	0	23908	2
2	0	2	0	0	23909	2
2	0	2	0	0	23910	2
2	0	2	0	0	23911	2
2	0	2	0	0	23912	2
2	0	2	0	0	23913	2
2	0	2	0	0	23914	2
2	0	2	0	0	23915	2
2	0	2	0	0	23916	2
2	0	2	0	0	23917	2
2	0	4	1	1	23918	2
2	0	2	0	0	23919	2
2	0	2	0	0	23920	2
2	0	4	0	0	23921	2
2	0	2	0	0	23922	2
2	0	2	0	0	23923	2
2	0	2	0	0	23924	2
2	0	2	0	0	23925	2
2	0	2	1	1	23926	2
2	0	2	0	0	23927	2
2	0	2	0	0	23928	2
2	0	2	0	0	23929	2
2	0	2	0	0	23930	2
2	0	2	0	0	23931	2
2	0	2	0	0	23932	2
2	0	2	0	0	23933	2
2	0	2	0	0	23934	2
2	0	2	8	8	23935	2
2	0	2	0	0	23936	2
2	0	2	0	0	23937	2
2	0	2	1	1	23938	2
2	0	2	159	159	23939	2
2	0	2	0	0	23940	2
2	0	2	0	0	23941	2
2	0	2	0	0	23942	2
2	0	2	0	0	23943	2
2	0	2	0	0	23944	2
2	0	2	0	0	23945	2
2	0	2	0	0	23946	2
2	0	2	0	0	23947	2
2	0	2	0	0	23948	2
2	0	2	0	0	23949	2
2	0	2	0	0	23950	2
2	0	2	0	0	23951	2
2	0	2	1	1	23952	2
2	0	2	0	0	23953	2
2	0	2	0	0	23954	2
2	0	2	0	0	23955	2
2	0	2	0	0	23956	2
2	0	2	0	0	23957	2
2	0	2	0	0	23958	2
2	0	2	0	0	23959	2
2	0	2	0	0	23960	2
2	0	2	0	0	23961	2
2	0	2	0	0	23962	2
2	0	2	0	0	23963	2
2	0	2	1	1	23964	2
2	0	2	0	0	23965	2
2	0	2	0	0	23966	2
2	0	2	0	0	23967	2
2	0	2	0	0	23968	2
2	0	2	0	0	23969	2
2	0	2	0	0	23970	2
2	0	2	0	0	23971	2
2	0	2	0	0	23972	2
2	0	2	0	0	23973	2
2	0	2	0	0	23974	2
2	0	2	0	0	23975	2
2	0	2	0	0	23976	2
2	0	2	0	0	23977	2
2	0	2	0	0	23978	2
2	0	2	0	0	23979	2
2	0	2	0	0	23980	2
2	0	2	0	0	23981	2
2	0	2	0	0	23982	2
2	0	2	0	0	23983	2
2	0	2	0	0	23984	2
2	0	2	0	0	23985	2
2	0	2	0	0	23986	2
2	0	2	0	0	23987	2
2	0	2	0	0	23988	2
2	0	2	0	0	23989	2
2	0	2	0	0	23990	2
2	0	2	0	0	23991	2
2	0	2	0	0	23992	2
2	0	2	0	0	23993	2
2	0	2	0	0	23994	2
2	0	2	0	0	23995	2
2	0	2	0	0	23996	2
2	0	2	0	0	23997	2
2	0	2	0	0	23998	2
2	0	2	0	0	23999	2
2	0	2	0	0	24000	2
2	0	2	0	0	24001	2
2	0	2	0	0	24002	2
2	0	2	0	0	24003	2
2	1	2	0	1	24004	1
2	0	2	0	0	24005	2
2	0	2	0	0	24006	2
2	0	2	0	0	24007	2
2	0	2	0	0	24008	2
2	0	2	0	0	24009	2
2	0	2	0	0	24010	2
2	0	2	0	0	24011	2
2	0	2	0	0	24012	2
2	0	2	0	0	24013	2
2	0	2	0	0	24014	2
2	0	2	0	0	24015	2
2	0	2	0	0	24016	2
2	0	2	0	0	24017	2
2	0	2	0	0	24018	2
2	0	2	1	1	24019	2
2	0	2	0	0	24020	2
2	0	2	0	0	24021	2
2	0	2	0	0	24022	2
2	0	2	1	1	24023	2
2	0	2	0	0	24024	2
2	1	2	0	1	24025	0
2	0	2	23	23	24026	2
2	0	2	0	0	24027	2
2	0	2	0	0	24028	2
2	1	2	0	1	24029	1
2	0	2	0	0	24030	2
2	0	2	0	0	24031	2
2	0	2	1	1	24032	2
2	0	2	0	0	24033	2
2	0	2	0	0	24034	2
2	1	2	0	1	24035	0
2	2	2	55	57	24036	1
2	0	2	1	1	24037	2
2	0	2	0	0	24038	2
2	1	2	1	2	24039	0
2	0	2	2	2	24040	2
2	0	2	0	0	24041	2
2	0	2	0	0	24042	2
2	0	2	0	0	24043	2
2	0	2	0	0	24044	2
2	0	2	0	0	24045	2
2	0	2	0	0	24046	2
2	0	2	0	0	24047	2
2	0	2	0	0	24048	2
2	0	2	0	0	24049	2
2	0	2	0	0	24050	2
2	0	2	0	0	24051	2
2	0	2	0	0	24052	2
2	0	2	0	0	24053	2
2	0	2	0	0	24054	2
2	0	2	0	0	24055	2
2	0	2	0	0	24056	2
2	0	2	0	0	24057	2
2	0	2	0	0	24058	2
2	0	2	0	0	24059	2
2	0	2	0	0	24060	2
2	0	2	0	0	24061	2
2	0	2	0	0	24062	2
2	0	2	0	0	24063	2
2	0	2	0	0	24064	2
2	0	2	0	0	24065	2
2	0	2	0	0	24066	2
2	0	2	0	0	24067	2
2	0	2	0	0	24068	2
2	0	2	0	0	24069	2
2	0	2	0	0	24070	2
2	0	2	0	0	24071	2
2	0	2	0	0	24072	2
2	0	2	0	0	24073	2
2	0	2	0	0	24074	2
2	0	2	0	0	24075	2
2	0	2	0	0	24076	2
2	0	2	0	0	24077	2
2	0	2	0	0	24078	2
2	0	2	0	0	24079	2
2	0	2	0	0	24080	2
2	0	2	0	0	24081	2
2	0	2	0	0	24082	2
2	0	2	0	0	24083	2
2	0	2	0	0	24084	2
2	0	2	0	0	24085	2
2	0	2	0	0	24086	2
2	0	2	0	0	24087	2
2	0	2	0	0	24088	2
2	0	2	0	0	24089	2
2	0	2	1	1	24090	2
2	0	2	0	0	24091	2
2	0	2	0	0	24092	2
2	0	2	0	0	24093	2
2	0	2	0	0	24094	2
2	0	2	0	0	24095	2
2	0	2	0	0	24096	2
2	0	2	0	0	24097	2
2	0	2	0	0	24098	2
2	0	2	0	0	24099	2
2	0	2	0	0	24100	2
2	1	2	0	1	24101	0
2	1	2	15	16	24102	1
2	0	2	0	0	24103	2
2	0	2	0	0	24104	2
2	1	2	0	1	24105	1
2	0	2	5	5	24106	2
2	0	2	0	0	24107	2
2	0	2	0	0	24108	2
2	0	2	0	0	24109	2
2	0	2	0	0	24110	2
2	0	2	0	0	24111	2
2	0	2	0	0	24112	2
2	0	2	0	0	24113	2
2	0	2	0	0	24114	2
2	0	2	0	0	24115	2
2	0	2	0	0	24116	2
2	0	2	0	0	24117	2
2	0	2	0	0	24118	2
2	0	2	0	0	24119	2
2	0	2	0	0	24120	2
2	0	2	0	0	24121	2
2	0	2	0	0	24122	2
2	0	2	0	0	24123	2
2	0	2	0	0	24124	2
2	0	2	0	0	24125	2
2	0	2	0	0	24126	2
2	2	4	0	2	24127	1
2	0	2	0	0	24128	2
2	0	2	0	0	24129	2
2	0	4	0	0	24130	2
2	0	2	0	0	24131	2
2	0	2	0	0	24132	2
2	0	2	0	0	24133	2
2	0	2	0	0	24134	2
2	0	2	0	0	24135	2
2	0	2	0	0	24136	2
2	0	2	0	0	24137	2
2	0	2	0	0	24138	2
2	0	2	0	0	24139	2
2	0	2	4	4	24140	2
2	0	2	0	0	24141	2
2	0	2	0	0	24142	2
2	0	2	0	0	24143	2
2	0	2	0	0	24144	2
2	0	2	0	0	24145	2
2	0	2	0	0	24146	2
2	0	2	0	0	24147	2
2	0	2	0	0	24148	2
2	0	2	0	0	24149	2
2	0	2	0	0	24150	2
2	0	2	0	0	24151	2
2	0	2	0	0	24152	2
2	0	2	0	0	24153	2
2	0	2	0	0	24154	2
2	0	2	0	0	24155	2
2	0	2	0	0	24156	2
2	0	2	0	0	24157	2
2	0	2	0	0	24158	2
2	0	2	0	0	24159	2
2	0	2	0	0	24160	2
2	0	2	0	0	24161	2
2	0	2	0	0	24162	2
2	0	2	0	0	24163	2
2	0	2	0	0	24164	2
2	0	2	0	0	24165	2
2	0	2	0	0	24166	2
2	0	2	0	0	24167	2
2	0	2	0	0	24168	2
2	0	2	0	0	24169	2
2	0	2	0	0	24170	2
2	0	2	1	1	24171	2
2	0	2	0	0	24172	2
2	0	2	0	0	24173	2
2	0	2	0	0	24174	2
2	0	2	0	0	24175	2
2	0	2	0	0	24176	2
2	0	2	0	0	24177	2
2	0	2	0	0	24178	2
2	0	2	0	0	24179	2
2	0	2	0	0	24180	2
2	0	2	0	0	24181	2
2	0	2	0	0	24182	2
2	0	2	0	0	24183	2
2	0	2	0	0	24184	2
2	0	2	0	0	24185	2
2	0	2	0	0	24186	2
2	0	2	0	0	24187	2
2	0	2	0	0	24188	2
2	0	2	0	0	24189	2
2	0	2	0	0	24190	2
2	0	2	0	0	24191	2
2	0	2	0	0	24192	2
2	0	2	0	0	24193	2
2	0	2	1	1	24194	2
2	0	2	0	0	24195	2
2	0	2	0	0	24196	2
2	0	2	0	0	24197	2
2	0	2	0	0	24198	2
2	0	2	0	0	24199	2
2	0	2	0	0	24200	2
2	0	2	0	0	24201	2
2	0	2	0	0	24202	2
2	0	2	0	0	24203	2
2	0	2	1	1	24204	2
2	0	2	0	0	24205	2
2	0	2	0	0	24206	2
2	0	2	0	0	24207	2
2	0	2	0	0	24208	2
2	0	2	0	0	24209	2
2	0	2	1	1	24210	2
2	0	2	0	0	24211	2
2	0	2	0	0	24212	2
2	0	2	0	0	24213	2
2	0	2	0	0	24214	2
2	0	2	0	0	24215	2
2	0	2	0	0	24216	2
2	0	2	0	0	24217	2
2	0	2	0	0	24218	2
2	0	2	0	0	24219	2
2	0	2	0	0	24220	2
2	0	2	0	0	24221	2
2	0	2	0	0	24222	2
2	0	2	0	0	24223	2
2	0	2	0	0	24224	2
2	0	2	0	0	24225	2
2	1	2	2	3	24226	1
2	0	2	0	0	24227	2
2	0	2	0	0	24228	2
2	0	2	0	0	24229	2
2	0	2	0	0	24230	2
2	0	2	0	0	24231	2
2	0	2	0	0	24232	2
2	0	2	0	0	24233	2
2	0	2	0	0	24234	2
2	0	2	0	0	24235	2
2	0	2	0	0	24236	2
2	0	2	0	0	24237	2
2	0	2	0	0	24238	2
2	0	2	0	0	24239	2
2	0	2	0	0	24240	2
2	0	2	0	0	24241	2
2	0	2	0	0	24242	2
2	0	2	0	0	24243	2
2	0	2	0	0	24244	2
2	0	2	0	0	24245	2
2	0	2	0	0	24246	2
2	0	2	0	0	24247	2
2	0	2	0	0	24248	2
2	0	2	0	0	24249	2
2	0	2	0	0	24250	2
2	0	2	0	0	24251	2
2	0	2	0	0	24252	2
2	0	2	0	0	24253	2
2	0	2	0	0	24254	2
2	0	2	0	0	24255	2
2	0	2	0	0	24256	2
2	0	2	0	0	24257	2
2	0	2	0	0	24258	2
2	0	2	0	0	24259	2
2	0	2	0	0	24260	2
2	0	2	0	0	24261	2
2	0	0	1	1	24262	2
2	0	2	0	0	24263	2
2	0	0	2	2	24264	2
2	0	2	0	0	24265	2
2	0	2	0	0	24266	2
2	0	2	0	0	24267	2
2	0	2	0	0	24268	2
2	0	2	0	0	24269	2
2	0	2	0	0	24270	2
2	0	2	0	0	24271	2
2	0	2	0	0	24272	2
2	0	2	0	0	24273	2
2	0	2	0	0	24274	2
2	0	2	0	0	24275	2
2	0	2	0	0	24276	2
2	0	2	0	0	24277	2
2	0	2	0	0	24278	2
2	0	2	0	0	24279	2
2	0	2	0	0	24280	2
2	0	2	0	0	24281	2
2	0	2	0	0	24282	2
2	0	2	0	0	24283	2
2	0	4	0	0	24284	2
2	0	2	0	0	24285	2
2	0	2	0	0	24286	2
2	0	4	0	0	24287	2
2	0	2	0	0	24288	2
2	0	2	0	0	24289	2
2	0	2	0	0	24290	2
2	0	2	0	0	24291	2
2	0	2	0	0	24292	2
2	0	2	0	0	24293	2
2	0	2	0	0	24294	2
2	0	2	0	0	24295	2
2	0	2	0	0	24296	2
2	0	2	0	0	24297	2
2	0	2	0	0	24298	2
2	0	2	0	0	24299	2
2	0	2	0	0	24300	2
2	0	2	0	0	24301	2
2	0	2	0	0	24302	2
2	0	2	0	0	24303	2
2	0	2	0	0	24304	2
2	0	2	0	0	24305	2
2	0	2	0	0	24306	2
2	0	2	0	0	24307	2
2	0	2	0	0	24308	2
2	0	2	0	0	24309	2
2	0	2	0	0	24310	2
2	0	2	0	0	24311	2
2	0	2	0	0	24312	2
2	0	2	0	0	24313	2
2	0	2	0	0	24314	2
2	0	2	0	0	24315	2
2	0	2	0	0	24316	2
2	0	2	0	0	24317	2
2	0	2	0	0	24318	2
2	0	2	0	0	24319	2
2	0	2	0	0	24320	2
2	0	2	0	0	24321	2
2	0	2	0	0	24322	2
2	0	2	0	0	24323	2
2	0	2	0	0	24324	2
2	0	2	0	0	24325	2
2	0	2	0	0	24326	2
2	0	2	0	0	24327	2
2	0	2	0	0	24328	2
2	0	2	0	0	24329	2
2	0	2	0	0	24330	2
2	0	2	0	0	24331	2
2	0	2	0	0	24332	2
2	0	2	0	0	24333	2
2	0	2	1	1	24334	2
2	0	2	0	0	24335	2
2	0	2	0	0	24336	2
2	0	2	0	0	24337	2
2	0	2	0	0	24338	2
2	0	2	0	0	24339	2
2	0	2	0	0	24340	2
2	0	2	0	0	24341	2
2	0	2	0	0	24342	2
2	0	2	0	0	24343	2
2	0	2	17	17	24344	2
2	0	2	0	0	24345	2
2	0	2	0	0	24346	2
2	3	2	1	4	24347	0
2	0	2	2	2	24348	2
2	0	2	0	0	24349	2
2	0	2	0	0	24350	2
2	0	2	1	1	24351	2
2	0	2	0	0	24352	2
2	0	2	0	0	24353	2
2	0	2	0	0	24354	2
2	0	2	0	0	24355	2
2	0	2	0	0	24356	2
2	0	2	0	0	24357	2
2	0	2	0	0	24358	2
2	0	2	0	0	24359	2
2	0	2	0	0	24360	2
2	0	2	0	0	24361	2
2	0	2	0	0	24362	2
2	0	2	0	0	24363	2
2	3	2	0	3	24364	0
2	0	2	5	5	24365	2
2	0	2	0	0	24366	2
2	0	2	0	0	24367	2
2	0	2	0	0	24368	2
2	0	2	2	2	24369	2
2	0	2	0	0	24370	2
2	0	2	0	0	24371	2
2	0	2	0	0	24372	2
2	2	2	0	2	24373	0
2	0	2	6	6	24374	2
2	0	2	0	0	24375	2
2	0	2	0	0	24376	2
2	0	2	0	0	24377	2
2	0	2	2	2	24378	2
2	0	2	0	0	24379	2
2	0	2	0	0	24380	2
2	0	2	0	0	24381	2
2	0	2	0	0	24382	2
2	0	2	0	0	24383	2
2	0	2	0	0	24384	2
2	1	2	0	1	24385	0
2	0	2	7	7	24386	2
2	0	2	0	0	24387	2
2	0	2	0	0	24388	2
2	0	2	0	0	24389	2
2	0	2	0	0	24390	2
0	0	4	212	212	24391	2
0	1	2	55	56	24392	0
0	0	4	50	50	24393	2
0	0	2	1	1	24394	2
2	9	2	0	9	24395	0
2	0	2	0	0	24396	2
2	0	2	0	0	24397	2
2	0	2	0	0	24398	2
2	0	2	0	0	24399	2
2	0	2	0	0	24400	2
2	0	2	0	0	24401	2
2	0	2	0	0	24402	2
2	0	2	0	0	24403	2
2	3	2	3004	3007	24404	1
2	94	2	0	94	24405	0
2	3	2	290	293	24406	0
2	0	2	0	0	24407	2
2	4	2	30	34	24408	1
2	0	2	0	0	24409	2
2	0	2	0	0	24410	2
2	0	2	0	0	24411	2
2	0	2	1	1	24412	2
2	2	2	0	2	24413	0
2	7	2	131	138	24414	1
2	0	2	1	1	24415	2
2	0	2	0	0	24416	2
2	2	2	0	2	24417	0
2	0	2	6	6	24418	2
2	0	2	0	0	24419	2
2	56	2	23	79	24420	1
2	0	2	0	0	24421	2
2	0	2	0	0	24422	2
2	2	2	1	3	24423	0
2	0	2	6	6	24424	2
2	108	2	0	108	24425	0
2	2	2	602	604	24426	1
2	0	2	3	3	24427	2
2	0	2	1	1	24428	2
2	4	2	2	6	24429	0
2	0	2	39	39	24430	2
2	0	2	0	0	24431	2
2	0	2	0	0	24432	2
2	0	2	0	0	24433	2
2	0	2	0	0	24434	2
2	0	2	0	0	24435	2
2	0	2	0	0	24436	2
2	0	2	0	0	24437	2
2	0	2	0	0	24438	2
2	0	2	0	0	24439	2
2	2	2	0	2	24440	0
2	0	2	0	0	24441	2
2	0	2	0	0	24442	2
2	0	2	0	0	24443	2
2	0	2	0	0	24444	2
2	0	2	0	0	24445	2
2	0	2	0	0	24446	2
2	0	2	0	0	24447	2
2	0	2	0	0	24448	2
2	0	2	0	0	24449	2
2	0	2	0	0	24450	2
2	0	2	0	0	24451	2
2	0	2	2	2	24452	2
2	0	2	0	0	24453	2
2	0	2	0	0	24454	2
2	0	2	0	0	24455	2
2	0	2	0	0	24456	2
2	0	2	0	0	24457	2
2	0	2	0	0	24458	2
2	0	2	0	0	24459	2
2	0	2	0	0	24460	2
2	0	2	0	0	24461	2
2	0	2	0	0	24462	2
2	0	2	0	0	24463	2
2	0	2	0	0	24464	2
2	0	2	0	0	24465	2
2	0	2	0	0	24466	2
2	0	2	0	0	24467	2
2	0	2	0	0	24468	2
2	0	2	0	0	24469	2
2	0	2	0	0	24470	2
2	0	2	0	0	24471	2
2	0	2	0	0	24472	2
2	0	2	0	0	24473	2
2	0	2	0	0	24474	2
2	0	2	0	0	24475	2
2	0	2	0	0	24476	2
2	0	2	0	0	24477	2
2	0	2	0	0	24478	2
2	0	2	0	0	24479	2
2	0	2	0	0	24480	2
2	0	2	0	0	24481	2
2	0	2	0	0	24482	2
2	0	2	7	7	24483	2
2	0	2	0	0	24484	2
2	0	2	0	0	24485	2
2	0	2	0	0	24486	2
2	0	2	0	0	24487	2
2	0	2	0	0	24488	2
2	0	2	0	0	24489	2
2	0	2	0	0	24490	2
2	0	2	0	0	24491	2
2	0	2	0	0	24492	2
2	0	2	0	0	24493	2
2	0	2	0	0	24494	2
2	0	2	0	0	24495	2
2	0	2	0	0	24496	2
2	0	2	0	0	24497	2
2	0	2	0	0	24498	2
2	0	2	0	0	24499	2
2	0	2	0	0	24500	2
2	0	2	0	0	24501	2
2	0	2	0	0	24502	2
2	0	2	0	0	24503	2
2	0	2	0	0	24504	2
2	0	2	0	0	24505	2
2	0	2	0	0	24506	2
2	0	2	0	0	24507	2
2	0	2	0	0	24508	2
2	0	2	0	0	24509	2
2	0	2	0	0	24510	2
2	0	2	0	0	24511	2
2	0	2	0	0	24512	2
2	0	2	0	0	24513	2
2	0	2	0	0	24514	2
2	1	2	0	1	24515	0
2	0	2	0	0	24516	2
2	1	2	157	158	24517	1
2	0	2	0	0	24518	2
2	0	2	0	0	24519	2
2	0	2	0	0	24520	2
2	0	2	0	0	24521	2
2	0	2	0	0	24522	2
2	0	2	0	0	24523	2
2	0	2	0	0	24524	2
2	0	2	0	0	24525	2
2	0	2	0	0	24526	2
2	0	2	0	0	24527	2
2	0	2	0	0	24528	2
2	0	2	0	0	24529	2
2	0	2	0	0	24530	2
2	0	2	0	0	24531	2
2	0	2	0	0	24532	2
2	0	2	0	0	24533	2
2	1	2	0	1	24534	0
2	0	2	13	13	24535	2
2	0	2	0	0	24536	2
2	0	2	0	0	24537	2
2	0	2	0	0	24538	2
2	0	2	0	0	24539	2
2	0	2	0	0	24540	2
2	0	2	0	0	24541	2
2	0	2	0	0	24542	2
2	0	2	0	0	24543	2
2	0	2	0	0	24544	2
2	0	2	0	0	24545	2
2	0	2	0	0	24546	2
2	0	2	0	0	24547	2
2	0	2	0	0	24548	2
2	0	2	0	0	24549	2
2	0	2	0	0	24550	2
2	0	2	0	0	24551	2
2	0	2	0	0	24552	2
2	0	2	0	0	24553	2
2	0	4	39	39	24554	2
2	0	2	0	0	24555	2
2	0	2	0	0	24556	2
2	1	4	0	1	24557	1
2	0	2	1	1	24558	2
2	0	2	0	0	24559	2
2	0	2	0	0	24560	2
2	0	2	0	0	24561	2
2	0	2	0	0	24562	2
2	0	2	0	0	24563	2
2	0	2	0	0	24564	2
2	0	2	0	0	24565	2
2	0	2	0	0	24566	2
2	0	2	0	0	24567	2
2	0	2	0	0	24568	2
2	0	2	0	0	24569	2
2	0	2	0	0	24570	2
2	0	2	0	0	24571	2
2	0	2	0	0	24572	2
2	0	2	0	0	24573	2
2	0	2	0	0	24574	2
2	0	2	0	0	24575	2
2	0	2	0	0	24576	2
2	0	2	0	0	24577	2
2	0	2	0	0	24578	2
2	0	2	0	0	24579	2
2	0	2	0	0	24580	2
2	0	2	0	0	24581	2
2	0	2	0	0	24582	2
2	0	2	0	0	24583	2
2	0	2	0	0	24584	2
2	0	2	0	0	24585	2
2	0	2	0	0	24586	2
2	0	2	0	0	24587	2
2	0	2	0	0	24588	2
2	0	2	0	0	24589	2
2	0	2	0	0	24590	2
2	0	2	0	0	24591	2
2	0	2	0	0	24592	2
2	0	2	0	0	24593	2
2	0	2	0	0	24594	2
2	0	2	0	0	24595	2
2	0	2	0	0	24596	2
2	0	2	0	0	24597	2
2	0	2	0	0	24598	2
2	0	2	1	1	24599	2
2	0	2	0	0	24600	2
2	0	2	0	0	24601	2
2	0	2	0	0	24602	2
2	0	2	0	0	24603	2
2	0	2	1	1	24604	2
2	0	2	0	0	24605	2
2	0	2	0	0	24606	2
2	0	2	0	0	24607	2
2	0	2	0	0	24608	2
2	0	2	0	0	24609	2
2	0	2	0	0	24610	2
2	0	2	0	0	24611	2
2	0	2	0	0	24612	2
2	0	2	0	0	24613	2
2	0	2	0	0	24614	2
2	0	2	0	0	24615	2
2	0	2	0	0	24616	2
2	0	2	0	0	24617	2
2	0	2	3	3	24618	2
2	0	2	0	0	24619	2
2	0	2	0	0	24620	2
2	0	2	0	0	24621	2
2	0	2	0	0	24622	2
2	0	2	0	0	24623	2
2	0	2	0	0	24624	2
2	0	2	0	0	24625	2
2	0	2	0	0	24626	2
2	0	2	0	0	24627	2
2	0	2	0	0	24628	2
2	0	2	0	0	24629	2
2	0	2	0	0	24630	2
2	0	2	0	0	24631	2
2	0	2	0	0	24632	2
2	0	2	0	0	24633	2
2	0	2	0	0	24634	2
2	0	2	0	0	24635	2
2	0	2	46	46	24636	2
2	0	2	0	0	24637	2
2	0	2	0	0	24638	2
2	0	2	0	0	24639	2
2	0	2	0	0	24640	2
2	0	2	0	0	24641	2
2	0	2	0	0	24642	2
2	0	2	0	0	24643	2
2	0	2	0	0	24644	2
2	0	2	0	0	24645	2
2	0	2	0	0	24646	2
2	0	2	0	0	24647	2
2	0	2	0	0	24648	2
2	0	2	0	0	24649	2
2	0	2	0	0	24650	2
2	0	2	0	0	24651	2
2	0	2	0	0	24652	2
2	0	2	0	0	24653	2
2	0	2	0	0	24654	2
2	0	2	0	0	24655	2
2	0	2	0	0	24656	2
2	0	2	0	0	24657	2
2	0	2	0	0	24658	2
2	0	2	0	0	24659	2
2	0	2	0	0	24660	2
2	0	2	5	5	24661	2
2	0	2	0	0	24662	2
2	0	2	0	0	24663	2
2	1	2	0	1	24664	1
2	0	2	1	1	24665	2
2	0	2	0	0	24666	2
2	0	2	0	0	24667	2
2	0	2	0	0	24668	2
2	0	2	0	0	24669	2
2	0	2	0	0	24670	2
2	0	2	0	0	24671	2
2	0	2	0	0	24672	2
2	0	2	0	0	24673	2
2	0	2	0	0	24674	2
2	0	2	0	0	24675	2
2	0	2	0	0	24676	2
2	0	2	0	0	24677	2
2	0	2	0	0	24678	2
2	0	2	0	0	24679	2
2	0	2	0	0	24680	2
2	0	2	0	0	24681	2
2	0	2	0	0	24682	2
2	0	2	0	0	24683	2
2	0	2	0	0	24684	2
2	0	2	0	0	24685	2
2	0	2	0	0	24686	2
2	0	2	0	0	24687	2
2	0	2	0	0	24688	2
2	0	2	0	0	24689	2
2	0	2	0	0	24690	2
2	0	2	0	0	24691	2
2	0	2	0	0	24692	2
2	0	2	0	0	24693	2
2	0	2	0	0	24694	2
2	0	2	0	0	24695	2
2	1	2	0	1	24696	0
2	0	2	0	0	24697	2
2	0	2	0	0	24698	2
2	0	2	0	0	24699	2
2	0	2	0	0	24700	2
2	0	2	0	0	24701	2
2	0	2	0	0	24702	2
2	0	2	2	2	24703	2
2	0	2	0	0	24704	2
2	0	2	0	0	24705	2
2	0	2	0	0	24706	2
2	0	2	3	3	24707	2
2	0	2	0	0	24708	2
2	0	2	0	0	24709	2
2	0	2	0	0	24710	2
2	0	2	0	0	24711	2
2	0	2	0	0	24712	2
2	0	2	0	0	24713	2
2	0	2	0	0	24714	2
2	0	2	0	0	24715	2
2	0	2	0	0	24716	2
2	0	2	0	0	24717	2
2	0	2	0	0	24718	2
2	0	2	0	0	24719	2
2	0	2	0	0	24720	2
2	0	2	0	0	24721	2
2	0	2	0	0	24722	2
2	1	2	0	1	24723	1
2	0	2	0	0	24724	2
2	0	2	0	0	24725	2
2	0	2	0	0	24726	2
2	0	2	0	0	24727	2
2	0	2	0	0	24728	2
2	0	2	0	0	24729	2
2	0	2	0	0	24730	2
2	0	2	0	0	24731	2
2	0	2	0	0	24732	2
2	0	2	0	0	24733	2
2	0	2	0	0	24734	2
2	0	2	0	0	24735	2
2	0	2	0	0	24736	2
2	0	2	0	0	24737	2
2	0	2	0	0	24738	2
2	0	2	0	0	24739	2
2	0	2	0	0	24740	2
2	0	2	0	0	24741	2
2	0	2	0	0	24742	2
2	0	2	0	0	24743	2
2	0	2	0	0	24744	2
2	0	2	0	0	24745	2
2	0	2	0	0	24746	2
2	0	2	0	0	24747	2
2	0	4	15	15	24748	2
2	2	2	0	2	24749	0
2	2	2	27	29	24750	1
2	0	2	0	0	24751	2
2	0	2	0	0	24752	2
2	0	2	2	2	24753	2
2	0	2	2	2	24754	2
2	0	2	0	0	24755	2
2	0	2	2	2	24756	2
2	0	2	0	0	24757	2
2	0	2	0	0	24758	2
2	0	2	0	0	24759	2
2	0	2	0	0	24760	2
2	0	2	0	0	24761	2
2	0	2	0	0	24762	2
2	0	2	0	0	24763	2
2	0	2	0	0	24764	2
2	0	2	0	0	24765	2
2	0	2	0	0	24766	2
2	0	2	0	0	24767	2
2	0	2	0	0	24768	2
2	0	2	10	10	24769	2
2	0	2	0	0	24770	2
2	0	2	0	0	24771	2
2	1	2	1	2	24772	1
2	0	2	0	0	24773	2
2	0	2	0	0	24774	2
2	0	2	0	0	24775	2
2	0	2	0	0	24776	2
2	0	2	0	0	24777	2
2	0	2	0	0	24778	2
2	0	2	0	0	24779	2
2	0	2	0	0	24780	2
2	0	2	0	0	24781	2
2	0	2	0	0	24782	2
2	0	2	0	0	24783	2
2	0	2	0	0	24784	2
2	0	2	0	0	24785	2
2	0	2	0	0	24786	2
2	0	2	0	0	24787	2
2	0	2	0	0	24788	2
2	0	2	0	0	24789	2
2	0	2	0	0	24790	2
2	0	2	0	0	24791	2
2	0	2	0	0	24792	2
2	0	2	0	0	24793	2
2	0	2	0	0	24794	2
2	0	2	0	0	24795	2
2	0	2	0	0	24796	2
2	0	2	0	0	24797	2
2	0	2	0	0	24798	2
2	0	2	0	0	24799	2
2	0	2	0	0	24800	2
2	0	2	4	4	24801	2
2	0	2	0	0	24802	2
2	0	2	0	0	24803	2
2	0	2	1	1	24804	2
2	0	2	0	0	24805	2
2	0	2	0	0	24806	2
2	0	2	0	0	24807	2
2	0	2	0	0	24808	2
2	0	2	0	0	24809	2
2	0	2	0	0	24810	2
2	0	2	0	0	24811	2
2	0	2	0	0	24812	2
2	0	2	0	0	24813	2
2	0	2	0	0	24814	2
2	0	2	0	0	24815	2
2	0	2	0	0	24816	2
2	0	2	0	0	24817	2
2	0	2	0	0	24818	2
2	0	2	0	0	24819	2
2	0	2	0	0	24820	2
2	0	2	0	0	24821	2
2	0	2	0	0	24822	2
2	0	2	0	0	24823	2
2	0	2	0	0	24824	2
2	0	2	0	0	24825	2
2	0	2	0	0	24826	2
2	0	2	2	2	24827	2
2	0	2	0	0	24828	2
2	0	2	0	0	24829	2
2	0	2	0	0	24830	2
2	0	2	0	0	24831	2
2	0	2	0	0	24832	2
2	0	2	0	0	24833	2
2	0	2	0	0	24834	2
2	0	2	0	0	24835	2
2	0	2	0	0	24836	2
2	0	2	0	0	24837	2
2	0	2	0	0	24838	2
2	0	2	0	0	24839	2
2	0	2	1	1	24840	2
2	0	2	0	0	24841	2
2	0	2	0	0	24842	2
2	1	2	0	1	24843	0
2	0	2	0	0	24844	2
2	0	2	0	0	24845	2
2	0	2	0	0	24846	2
2	0	2	0	0	24847	2
2	0	2	0	0	24848	2
2	0	2	0	0	24849	2
2	0	2	0	0	24850	2
2	0	2	0	0	24851	2
2	0	2	0	0	24852	2
2	0	2	0	0	24853	2
2	0	2	0	0	24854	2
2	0	2	0	0	24855	2
2	0	2	0	0	24856	2
2	0	2	0	0	24857	2
2	0	2	0	0	24858	2
2	0	2	0	0	24859	2
2	0	2	0	0	24860	2
2	0	2	0	0	24861	2
2	0	2	0	0	24862	2
2	0	2	0	0	24863	2
2	0	2	0	0	24864	2
2	0	2	0	0	24865	2
2	0	2	0	0	24866	2
2	0	2	0	0	24867	2
2	0	2	0	0	24868	2
2	0	2	0	0	24869	2
2	0	2	0	0	24870	2
2	0	2	0	0	24871	2
2	0	2	0	0	24872	2
2	0	2	0	0	24873	2
2	0	2	0	0	24874	2
2	0	2	0	0	24875	2
2	0	2	0	0	24876	2
2	0	2	0	0	24877	2
2	0	2	0	0	24878	2
2	0	2	0	0	24879	2
2	0	2	0	0	24880	2
2	1	2	28	29	24881	1
2	0	2	0	0	24882	2
2	0	2	0	0	24883	2
2	1	2	0	1	24884	1
2	0	2	0	0	24885	2
2	0	2	0	0	24886	2
2	0	2	0	0	24887	2
2	0	2	0	0	24888	2
2	0	2	0	0	24889	2
2	0	2	0	0	24890	2
2	0	2	0	0	24891	2
2	0	2	0	0	24892	2
2	0	2	0	0	24893	2
2	1	2	0	1	24894	0
2	0	2	0	0	24895	2
2	0	2	0	0	24896	2
2	0	2	0	0	24897	2
2	0	2	0	0	24898	2
2	0	2	0	0	24899	2
2	0	2	0	0	24900	2
2	0	2	0	0	24901	2
2	0	2	0	0	24902	2
2	0	2	0	0	24903	2
2	0	2	0	0	24904	2
2	0	2	0	0	24905	2
2	0	2	0	0	24906	2
2	0	2	0	0	24907	2
2	0	2	14	14	24908	2
2	0	2	0	0	24909	2
2	0	2	0	0	24910	2
2	0	2	0	0	24911	2
2	0	2	0	0	24912	2
2	0	2	0	0	24913	2
2	0	2	2	2	24914	2
2	0	2	0	0	24915	2
2	0	2	0	0	24916	2
2	0	2	0	0	24917	2
2	0	2	0	0	24918	2
2	0	2	0	0	24919	2
2	0	2	0	0	24920	2
2	0	2	0	0	24921	2
2	0	2	0	0	24922	2
2	0	2	0	0	24923	2
2	0	2	0	0	24924	2
2	0	2	0	0	24925	2
2	0	2	0	0	24926	2
2	0	2	0	0	24927	2
2	0	2	0	0	24928	2
2	0	2	0	0	24929	2
2	0	2	0	0	24930	2
2	0	2	0	0	24931	2
2	0	2	0	0	24932	2
2	0	2	0	0	24933	2
2	0	2	0	0	24934	2
2	0	2	0	0	24935	2
2	0	2	0	0	24936	2
2	5	4	740	745	24937	1
2	0	2	0	0	24938	2
2	0	2	0	0	24939	2
2	3	4	0	3	24940	0
2	0	2	26	26	24941	2
2	8	2	0	8	24942	0
2	0	2	0	0	24943	2
2	0	2	0	0	24944	2
2	0	2	0	0	24945	2
2	0	2	0	0	24946	2
2	0	2	0	0	24947	2
2	0	2	0	0	24948	2
2	0	2	0	0	24949	2
2	0	2	0	0	24950	2
2	0	2	0	0	24951	2
2	0	2	0	0	24952	2
2	0	2	0	0	24953	2
2	0	2	0	0	24954	2
2	3	2	24	27	24955	1
2	0	2	3	3	24956	2
2	0	2	0	0	24957	2
2	2	2	3	5	24958	0
2	0	2	6	6	24959	2
2	0	2	0	0	24960	2
2	0	2	0	0	24961	2
2	0	2	0	0	24962	2
2	0	2	0	0	24963	2
2	0	2	0	0	24964	2
2	0	2	0	0	24965	2
2	0	2	0	0	24966	2
2	0	2	0	0	24967	2
2	0	2	16	16	24968	2
2	0	2	1	1	24969	2
2	0	2	0	0	24970	2
2	0	2	0	0	24971	2
2	0	2	0	0	24972	2
2	0	2	0	0	24973	2
2	0	2	0	0	24974	2
2	0	2	0	0	24975	2
2	0	2	0	0	24976	2
2	0	2	0	0	24977	2
2	0	2	0	0	24978	2
2	0	2	0	0	24979	2
2	0	2	0	0	24980	2
2	0	2	0	0	24981	2
2	0	2	0	0	24982	2
2	0	2	0	0	24983	2
2	0	2	0	0	24984	2
2	0	2	0	0	24985	2
2	0	2	0	0	24986	2
2	0	2	0	0	24987	2
2	0	2	0	0	24988	2
2	0	2	0	0	24989	2
2	0	2	0	0	24990	2
2	0	2	0	0	24991	2
2	0	2	0	0	24992	2
2	0	2	0	0	24993	2
2	0	2	0	0	24994	2
2	0	2	0	0	24995	2
2	0	2	0	0	24996	2
2	0	2	0	0	24997	2
2	0	2	0	0	24998	2
2	0	2	0	0	24999	2
2	0	2	0	0	25000	2
2	0	2	0	0	25001	2
2	0	2	10	10	25002	2
2	0	2	0	0	25003	2
2	0	2	0	0	25004	2
2	0	2	0	0	25005	2
2	0	2	0	0	25006	2
2	0	2	0	0	25007	2
2	0	2	0	0	25008	2
2	0	2	0	0	25009	2
2	0	2	0	0	25010	2
2	0	2	1	1	25011	2
2	0	2	0	0	25012	2
2	0	2	0	0	25013	2
2	0	2	0	0	25014	2
2	0	2	0	0	25015	2
0	0	4	0	0	25016	2
2	357	2	4	361	25017	1
2	0	2	0	0	25018	2
2	0	2	0	0	25019	2
2	2	2	0	2	25020	1
2	0	2	0	0	25021	2
2	0	2	0	0	25022	2
2	0	2	0	0	25023	2
2	0	2	0	0	25024	2
2	0	2	0	0	25025	2
2	0	2	0	0	25026	2
2	0	2	0	0	25027	2
2	0	2	0	0	25028	2
2	0	2	0	0	25029	2
2	0	2	0	0	25030	2
2	0	2	0	0	25031	2
2	0	2	0	0	25032	2
2	0	2	0	0	25033	2
2	0	2	0	0	25034	2
2	0	2	0	0	25035	2
2	0	2	0	0	25036	2
2	0	2	0	0	25037	2
2	0	2	0	0	25038	2
2	0	2	0	0	25039	2
2	0	2	0	0	25040	2
2	0	2	0	0	25041	2
2	0	2	0	0	25042	2
2	0	2	0	0	25043	2
2	0	2	0	0	25044	2
2	0	2	0	0	25045	2
2	0	2	0	0	25046	2
2	0	2	0	0	25047	2
2	0	2	0	0	25048	2
2	0	2	0	0	25049	2
2	0	2	0	0	25050	2
2	0	2	0	0	25051	2
2	0	2	0	0	25052	2
2	0	2	0	0	25053	2
2	0	2	0	0	25054	2
2	0	2	0	0	25055	2
2	0	2	0	0	25056	2
2	0	2	0	0	25057	2
2	0	2	0	0	25058	2
2	0	2	0	0	25059	2
2	0	2	0	0	25060	2
2	0	2	0	0	25061	2
2	0	2	0	0	25062	2
2	0	2	0	0	25063	2
2	0	2	0	0	25064	2
2	0	2	0	0	25065	2
2	0	2	0	0	25066	2
2	0	2	0	0	25067	2
2	0	2	0	0	25068	2
2	0	2	0	0	25069	2
2	0	2	0	0	25070	2
2	0	2	0	0	25071	2
2	0	2	0	0	25072	2
2	0	2	0	0	25073	2
2	0	2	0	0	25074	2
2	0	2	0	0	25075	2
2	0	2	1	1	25076	2
2	0	2	0	0	25077	2
2	0	2	0	0	25078	2
2	0	2	0	0	25079	2
2	0	2	0	0	25080	2
2	0	2	0	0	25081	2
2	0	2	0	0	25082	2
2	0	2	0	0	25083	2
2	0	2	0	0	25084	2
2	0	2	0	0	25085	2
2	0	2	0	0	25086	2
2	0	2	0	0	25087	2
2	0	2	0	0	25088	2
2	0	2	0	0	25089	2
2	0	2	0	0	25090	2
2	0	2	0	0	25091	2
2	0	2	0	0	25092	2
2	0	2	1	1	25093	2
2	0	2	0	0	25094	2
2	0	2	0	0	25095	2
2	0	2	0	0	25096	2
2	0	2	0	0	25097	2
2	0	2	0	0	25098	2
2	1	2	0	1	25099	0
2	0	2	0	0	25100	2
2	0	2	0	0	25101	2
2	0	2	0	0	25102	2
2	0	2	0	0	25103	2
2	0	2	0	0	25104	2
2	0	2	0	0	25105	2
2	2	4	265	267	25106	1
2	0	2	0	0	25107	2
2	0	2	0	0	25108	2
2	0	4	27	27	25109	2
2	0	2	1	1	25110	2
0	0	2	1	1	25111	2
2	0	2	0	0	25112	2
2	0	2	0	0	25113	2
2	0	2	0	0	25114	2
2	0	2	0	0	25115	2
2	0	2	0	0	25116	2
2	0	2	0	0	25117	2
2	11	2	0	11	25118	0
2	0	2	0	0	25119	2
2	0	2	0	0	25120	2
2	0	2	0	0	25121	2
2	0	2	0	0	25122	2
2	0	2	0	0	25123	2
2	0	2	0	0	25124	2
2	0	2	0	0	25125	2
2	0	2	0	0	25126	2
2	7	4	1	8	25127	0
2	0	2	14	14	25128	2
2	0	2	1	1	25129	2
2	0	2	0	0	25130	2
2	0	2	0	0	25131	2
2	0	2	0	0	25132	2
2	0	2	0	0	25133	2
2	0	2	0	0	25134	2
2	0	2	0	0	25135	2
2	0	2	0	0	25136	2
2	0	2	0	0	25137	2
2	0	2	0	0	25138	2
2	0	2	0	0	25139	2
2	0	2	0	0	25140	2
2	0	2	0	0	25141	2
2	0	2	0	0	25142	2
2	0	2	0	0	25143	2
2	0	2	0	0	25144	2
2	0	2	0	0	25145	2
2	0	2	0	0	25146	2
2	0	2	0	0	25147	2
2	0	2	0	0	25148	2
2	0	2	0	0	25149	2
2	0	2	0	0	25150	2
2	0	2	0	0	25151	2
2	0	2	0	0	25152	2
2	0	2	0	0	25153	2
2	0	2	0	0	25154	2
2	0	2	0	0	25155	2
2	0	2	0	0	25156	2
2	0	2	0	0	25157	2
2	0	2	0	0	25158	2
2	0	2	0	0	25159	2
2	0	2	0	0	25160	2
2	0	2	0	0	25161	2
2	0	2	0	0	25162	2
2	0	2	0	0	25163	2
2	0	2	0	0	25164	2
2	0	2	0	0	25165	2
2	0	2	0	0	25166	2
2	0	2	1	1	25167	2
2	0	2	0	0	25168	2
2	0	2	0	0	25169	2
2	0	2	0	0	25170	2
2	0	2	0	0	25171	2
2	0	2	0	0	25172	2
2	0	2	0	0	25173	2
2	0	2	0	0	25174	2
2	0	2	14	14	25175	2
2	0	2	0	0	25176	2
2	0	2	0	0	25177	2
2	0	2	2	2	25178	2
2	0	2	0	0	25179	2
2	0	4	46	46	25180	2
2	0	2	0	0	25181	2
2	0	2	0	0	25182	2
2	0	4	31	31	25183	2
2	0	2	0	0	25184	2
2	1	2	0	1	25185	0
2	0	2	0	0	25186	2
2	0	2	0	0	25187	2
2	0	2	0	0	25188	2
2	0	2	0	0	25189	2
2	0	2	0	0	25190	2
2	0	2	0	0	25191	2
2	0	2	0	0	25192	2
2	0	2	0	0	25193	2
2	0	2	0	0	25194	2
2	0	2	0	0	25195	2
2	0	2	0	0	25196	2
2	0	2	0	0	25197	2
2	0	2	0	0	25198	2
2	0	2	0	0	25199	2
2	0	2	0	0	25200	2
2	0	2	0	0	25201	2
2	0	2	0	0	25202	2
2	0	2	0	0	25203	2
2	0	2	0	0	25204	2
2	0	2	0	0	25205	2
2	0	2	0	0	25206	2
2	0	2	0	0	25207	2
2	0	2	0	0	25208	2
2	0	2	0	0	25209	2
2	0	2	0	0	25210	2
2	0	2	0	0	25211	2
2	0	2	0	0	25212	2
2	0	2	0	0	25213	2
2	0	2	0	0	25214	2
2	0	2	0	0	25215	2
2	0	2	0	0	25216	2
2	0	2	0	0	25217	2
2	0	2	0	0	25218	2
2	0	2	0	0	25219	2
2	0	2	0	0	25220	2
2	0	2	0	0	25221	2
2	0	2	0	0	25222	2
2	0	2	0	0	25223	2
2	0	2	0	0	25224	2
2	0	2	0	0	25225	2
2	0	2	0	0	25226	2
2	0	2	0	0	25227	2
2	0	2	0	0	25228	2
2	0	2	0	0	25229	2
2	0	2	0	0	25230	2
2	0	2	0	0	25231	2
2	0	2	0	0	25232	2
2	0	2	0	0	25233	2
2	0	2	0	0	25234	2
2	0	2	0	0	25235	2
2	0	2	0	0	25236	2
2	0	2	0	0	25237	2
2	0	2	0	0	25238	2
2	0	2	0	0	25239	2
2	0	2	0	0	25240	2
2	0	2	0	0	25241	2
2	3	2	0	3	25242	0
2	0	2	7	7	25243	2
2	0	2	0	0	25244	2
2	0	2	0	0	25245	2
2	0	2	0	0	25246	2
2	0	2	3	3	25247	2
2	0	2	0	0	25248	2
2	0	2	0	0	25249	2
2	0	2	0	0	25250	2
2	0	2	0	0	25251	2
2	0	2	0	0	25252	2
2	0	2	0	0	25253	2
2	0	2	0	0	25254	2
2	0	2	0	0	25255	2
2	0	2	0	0	25256	2
2	0	2	0	0	25257	2
2	0	2	0	0	25258	2
2	0	2	0	0	25259	2
2	0	2	0	0	25260	2
2	0	2	0	0	25261	2
2	0	2	0	0	25262	2
2	0	2	0	0	25263	2
2	0	2	0	0	25264	2
2	0	2	0	0	25265	2
2	0	2	0	0	25266	2
2	0	2	0	0	25267	2
2	0	2	0	0	25268	2
2	0	2	0	0	25269	2
2	0	2	0	0	25270	2
2	0	2	0	0	25271	2
2	74	2	0	74	25272	0
2	21	2	204	225	25273	1
2	0	2	3	3	25274	2
2	0	2	0	0	25275	2
2	8	2	1	9	25276	1
2	0	2	99	99	25277	2
2	0	2	0	0	25278	2
2	0	2	0	0	25279	2
2	0	2	0	0	25280	2
2	0	2	0	0	25281	2
2	0	2	0	0	25282	2
2	0	2	0	0	25283	2
2	0	2	0	0	25284	2
2	0	2	0	0	25285	2
2	0	2	0	0	25286	2
2	0	2	0	0	25287	2
2	0	2	0	0	25288	2
2	0	2	0	0	25289	2
2	0	2	0	0	25290	2
2	0	2	0	0	25291	2
2	0	2	0	0	25292	2
2	0	2	0	0	25293	2
2	0	2	0	0	25294	2
2	0	2	0	0	25295	2
2	1	2	0	1	25296	1
2	0	2	3	3	25297	2
2	0	2	0	0	25298	2
2	0	2	0	0	25299	2
2	0	2	0	0	25300	2
2	0	2	0	0	25301	2
2	0	2	0	0	25302	2
2	0	2	0	0	25303	2
2	0	2	0	0	25304	2
2	0	2	0	0	25305	2
2	0	2	0	0	25306	2
2	0	2	0	0	25307	2
2	0	2	2	2	25308	2
2	0	2	0	0	25309	2
2	0	2	0	0	25310	2
2	0	2	0	0	25311	2
2	0	2	0	0	25312	2
2	0	2	0	0	25313	2
2	0	2	0	0	25314	2
2	0	2	0	0	25315	2
2	3	2	0	3	25316	0
2	1	2	28	29	25317	1
2	0	2	0	0	25318	2
2	0	2	0	0	25319	2
2	21	2	0	21	25320	0
2	0	2	133	133	25321	2
2	0	2	0	0	25322	2
2	0	2	0	0	25323	2
2	0	2	4	4	25324	2
2	0	2	12	12	25325	2
2	0	2	0	0	25326	2
2	0	2	0	0	25327	2
2	0	2	0	0	25328	2
2	0	2	0	0	25329	2
2	0	2	0	0	25330	2
2	0	2	0	0	25331	2
2	0	2	0	0	25332	2
2	0	2	0	0	25333	2
2	0	2	0	0	25334	2
2	0	2	0	0	25335	2
2	0	2	0	0	25336	2
2	0	2	0	0	25337	2
2	0	2	0	0	25338	2
2	0	2	0	0	25339	2
2	0	2	0	0	25340	2
2	0	2	0	0	25341	2
2	0	2	0	0	25342	2
2	0	2	0	0	25343	2
2	0	2	0	0	25344	2
2	0	2	0	0	25345	2
2	0	2	0	0	25346	2
2	0	2	0	0	25347	2
2	0	2	0	0	25348	2
2	0	2	0	0	25349	2
2	0	2	0	0	25350	2
2	6	2	0	6	25351	0
2	0	2	2	2	25352	2
2	0	2	0	0	25353	2
2	0	2	0	0	25354	2
2	0	2	1	1	25355	2
2	0	2	0	0	25356	2
2	0	2	0	0	25357	2
2	0	2	0	0	25358	2
2	0	2	0	0	25359	2
2	0	2	0	0	25360	2
2	0	2	1	1	25361	2
2	0	2	0	0	25362	2
2	0	2	0	0	25363	2
2	0	2	0	0	25364	2
2	0	2	0	0	25365	2
2	0	2	0	0	25366	2
2	0	2	0	0	25367	2
2	0	2	0	0	25368	2
2	0	2	0	0	25369	2
2	0	2	0	0	25370	2
2	0	2	0	0	25371	2
2	0	2	0	0	25372	2
2	0	2	0	0	25373	2
2	0	2	0	0	25374	2
2	0	2	0	0	25375	2
2	0	2	0	0	25376	2
2	0	2	0	0	25377	2
2	0	2	0	0	25378	2
2	0	2	0	0	25379	2
2	0	2	0	0	25380	2
2	0	2	0	0	25381	2
2	0	2	0	0	25382	2
2	0	2	0	0	25383	2
2	0	2	0	0	25384	2
2	0	2	0	0	25385	2
2	0	2	0	0	25386	2
2	0	2	0	0	25387	2
2	0	2	0	0	25388	2
2	0	2	0	0	25389	2
2	0	2	0	0	25390	2
2	0	2	0	0	25391	2
2	0	2	0	0	25392	2
2	0	2	0	0	25393	2
2	0	2	0	0	25394	2
2	0	2	0	0	25395	2
2	0	2	0	0	25396	2
2	0	2	0	0	25397	2
2	0	2	0	0	25398	2
2	0	2	0	0	25399	2
2	0	2	0	0	25400	2
2	0	2	0	0	25401	2
2	0	2	0	0	25402	2
2	0	2	0	0	25403	2
2	0	2	0	0	25404	2
2	0	2	0	0	25405	2
2	0	2	0	0	25406	2
2	0	2	0	0	25407	2
2	0	2	0	0	25408	2
2	0	2	0	0	25409	2
2	0	2	3	3	25410	2
2	0	2	0	0	25411	2
2	0	2	0	0	25412	2
2	0	2	0	0	25413	2
2	0	2	0	0	25414	2
2	0	2	0	0	25415	2
2	0	2	0	0	25416	2
2	0	2	0	0	25417	2
2	0	2	0	0	25418	2
2	0	2	0	0	25419	2
2	0	2	0	0	25420	2
2	0	2	0	0	25421	2
2	0	2	0	0	25422	2
2	0	2	0	0	25423	2
2	0	2	0	0	25424	2
2	0	2	0	0	25425	2
2	0	2	0	0	25426	2
2	0	2	0	0	25427	2
2	0	2	0	0	25428	2
2	0	2	0	0	25429	2
2	0	2	0	0	25430	2
2	0	2	0	0	25431	2
2	0	2	0	0	25432	2
2	0	2	0	0	25433	2
2	0	2	0	0	25434	2
2	0	2	0	0	25435	2
2	0	2	0	0	25436	2
2	0	2	0	0	25437	2
2	0	2	0	0	25438	2
2	0	2	0	0	25439	2
2	0	2	0	0	25440	2
2	0	2	0	0	25441	2
2	0	2	0	0	25442	2
2	0	2	0	0	25443	2
2	0	2	0	0	25444	2
2	0	2	0	0	25445	2
2	0	2	0	0	25446	2
2	0	2	0	0	25447	2
2	45	2	0	45	25448	0
2	0	2	0	0	25449	2
2	0	2	0	0	25450	2
2	0	2	0	0	25451	2
2	0	2	0	0	25452	2
2	0	2	0	0	25453	2
2	0	2	0	0	25454	2
2	14	2	215	229	25455	1
2	0	2	8	8	25456	2
2	0	2	0	0	25457	2
2	24	2	18	42	25458	0
2	0	2	109	109	25459	2
2	0	2	69	69	25460	2
2	0	2	0	0	25461	2
2	0	2	0	0	25462	2
2	0	2	0	0	25463	2
2	0	2	0	0	25464	2
2	0	2	0	0	25465	2
2	0	2	0	0	25466	2
2	0	2	0	0	25467	2
2	0	2	0	0	25468	2
2	0	2	0	0	25469	2
2	0	2	0	0	25470	2
2	0	2	0	0	25471	2
2	0	2	0	0	25472	2
2	0	2	0	0	25473	2
2	0	2	0	0	25474	2
2	0	2	0	0	25475	2
2	0	2	0	0	25476	2
2	0	2	0	0	25477	2
2	0	2	0	0	25478	2
2	0	2	0	0	25479	2
2	0	2	0	0	25480	2
2	0	2	0	0	25481	2
2	0	2	0	0	25482	2
2	0	2	0	0	25483	2
2	0	2	0	0	25484	2
2	0	2	0	0	25485	2
2	0	2	0	0	25486	2
2	0	2	0	0	25487	2
2	0	2	0	0	25488	2
2	0	2	0	0	25489	2
2	0	2	0	0	25490	2
2	0	2	0	0	25491	2
2	0	2	0	0	25492	2
2	0	2	0	0	25493	2
2	0	2	0	0	25494	2
2	0	2	0	0	25495	2
2	0	2	0	0	25496	2
2	0	2	0	0	25497	2
2	0	2	0	0	25498	2
2	0	2	0	0	25499	2
2	0	2	0	0	25500	2
2	0	2	0	0	25501	2
2	0	2	0	0	25502	2
2	0	2	0	0	25503	2
2	0	2	0	0	25504	2
2	251	2	0	251	25505	0
2	0	2	0	0	25506	2
2	0	4	525	525	25507	2
2	0	2	0	0	25508	2
2	0	2	0	0	25509	2
2	0	4	673	673	25510	2
2	0	2	0	0	25511	2
2	5	2	2657	2662	25512	0
2	42	2	0	42	25513	0
2	0	2	257	257	25514	2
2	6	2	0	6	25515	0
2	1	2	19	20	25516	1
2	0	2	0	0	25517	2
2	0	2	0	0	25518	2
2	0	2	3	3	25519	2
2	0	2	2	2	25520	2
2	1	2	0	1	25521	0
2	14	2	61	75	25522	1
2	0	2	0	0	25523	2
2	0	2	0	0	25524	2
2	3	2	0	3	25525	0
2	0	2	10	10	25526	2
2	0	2	0	0	25527	2
2	0	2	0	0	25528	2
2	0	2	0	0	25529	2
2	0	2	0	0	25530	2
2	0	2	0	0	25531	2
2	0	2	0	0	25532	2
2	0	2	0	0	25533	2
2	0	2	0	0	25534	2
2	0	2	0	0	25535	2
2	0	2	0	0	25536	2
2	0	2	0	0	25537	2
2	0	2	0	0	25538	2
2	0	2	0	0	25539	2
2	0	2	0	0	25540	2
2	0	2	0	0	25541	2
2	0	2	0	0	25542	2
2	0	2	0	0	25543	2
2	0	2	0	0	25544	2
2	0	2	0	0	25545	2
2	0	2	0	0	25546	2
2	0	4	4	4	25547	2
2	0	2	0	0	25548	2
2	0	2	0	0	25549	2
2	0	4	1	1	25550	2
2	0	2	1	1	25551	2
2	0	2	0	0	25552	2
2	0	2	0	0	25553	2
2	0	2	0	0	25554	2
2	0	2	0	0	25555	2
2	85	2	1162	1247	25556	1
2	0	2	34	34	25557	2
2	0	2	6	6	25558	2
2	107	2	704	811	25559	0
2	763	2	2	765	25560	0
2	0	2	704	704	25561	2
2	34	2	2	36	25562	1
2	0	2	169	169	25563	2
2	0	2	0	0	25564	2
2	0	2	0	0	25565	2
2	0	2	0	0	25566	2
2	0	2	1	1	25567	2
2	0	2	0	0	25568	2
2	0	2	0	0	25569	2
2	0	2	0	0	25570	2
2	0	2	0	0	25571	2
2	0	2	0	0	25572	2
2	0	2	0	0	25573	2
2	0	2	0	0	25574	2
2	0	2	0	0	25575	2
2	1	2	9	10	25576	1
2	0	2	0	0	25577	2
2	0	2	0	0	25578	2
2	1	2	0	1	25579	1
2	0	2	0	0	25580	2
2	0	2	0	0	25581	2
2	0	2	0	0	25582	2
2	0	2	0	0	25583	2
2	0	2	0	0	25584	2
2	0	2	0	0	25585	2
2	0	2	0	0	25586	2
2	4	2	0	4	25587	0
2	0	2	0	0	25588	2
2	0	2	0	0	25589	2
2	0	2	0	0	25590	2
2	0	2	0	0	25591	2
2	0	2	0	0	25592	2
2	0	2	0	0	25593	2
2	1	2	44	45	25594	1
2	0	2	0	0	25595	2
2	0	2	1	1	25596	2
2	1	2	0	1	25597	1
2	0	2	5	5	25598	2
2	1028	4	19	1047	25599	1
2	13	4	19	32	25600	0
2	0	2	0	0	25601	2
2	0	2	0	0	25602	2
2	0	2	0	0	25603	2
2	0	2	0	0	25604	2
2	0	2	0	0	25605	2
2	0	2	0	0	25606	2
2	0	2	0	0	25607	2
2	0	2	0	0	25608	2
2	0	2	0	0	25609	2
2	0	2	0	0	25610	2
2	0	2	0	0	25611	2
2	0	2	0	0	25612	2
2	0	2	0	0	25613	2
2	0	2	0	0	25614	2
2	0	2	0	0	25615	2
2	0	2	0	0	25616	2
2	0	2	0	0	25617	2
2	0	2	0	0	25618	2
2	7	2	0	7	25619	0
2	0	2	0	0	25620	2
2	0	2	0	0	25621	2
2	0	2	0	0	25622	2
2	0	2	0	0	25623	2
2	0	2	0	0	25624	2
2	0	2	0	0	25625	2
2	17	2	127	144	25626	1
2	0	2	0	0	25627	2
2	0	2	0	0	25628	2
2	5	2	17	22	25629	0
2	0	2	11	11	25630	2
2	0	2	0	0	25631	2
2	0	2	0	0	25632	2
2	0	2	0	0	25633	2
2	0	2	0	0	25634	2
2	0	2	0	0	25635	2
2	0	2	0	0	25636	2
2	0	2	0	0	25637	2
2	1	2	10	11	25638	1
2	0	2	0	0	25639	2
2	0	2	0	0	25640	2
2	0	2	0	0	25641	2
2	0	2	8	8	25642	2
2	0	2	0	0	25643	2
2	0	2	0	0	25644	2
2	0	2	0	0	25645	2
2	0	2	0	0	25646	2
2	0	2	0	0	25647	2
2	0	2	0	0	25648	2
2	0	2	0	0	25649	2
2	0	2	0	0	25650	2
2	0	2	0	0	25651	2
2	0	2	0	0	25652	2
2	0	2	0	0	25653	2
2	0	2	0	0	25654	2
2	0	2	0	0	25655	2
2	0	2	0	0	25656	2
2	0	2	0	0	25657	2
2	0	2	0	0	25658	2
2	0	2	0	0	25659	2
2	0	2	0	0	25660	2
2	0	2	0	0	25661	2
2	0	2	0	0	25662	2
2	0	2	0	0	25663	2
2	0	2	0	0	25664	2
2	0	2	0	0	25665	2
2	0	2	0	0	25666	2
2	0	2	0	0	25667	2
2	0	2	0	0	25668	2
2	0	2	0	0	25669	2
2	0	2	0	0	25670	2
2	0	2	0	0	25671	2
2	0	2	0	0	25672	2
2	0	2	0	0	25673	2
2	0	2	0	0	25674	2
2	0	2	0	0	25675	2
2	0	2	0	0	25676	2
2	0	2	0	0	25677	2
2	0	2	0	0	25678	2
2	0	2	0	0	25679	2
2	0	2	0	0	25680	2
2	0	2	0	0	25681	2
2	0	2	0	0	25682	2
2	0	2	0	0	25683	2
2	0	2	0	0	25684	2
2	0	2	0	0	25685	2
2	0	2	0	0	25686	2
2	0	2	0	0	25687	2
2	0	2	0	0	25688	2
2	0	2	0	0	25689	2
2	0	2	0	0	25690	2
2	0	2	0	0	25691	2
2	0	2	0	0	25692	2
2	0	2	0	0	25693	2
2	0	2	0	0	25694	2
2	0	2	0	0	25695	2
2	0	2	0	0	25696	2
2	0	2	0	0	25697	2
2	0	2	0	0	25698	2
2	0	2	0	0	25699	2
2	0	2	0	0	25700	2
2	0	2	0	0	25701	2
2	0	2	0	0	25702	2
2	0	2	0	0	25703	2
2	0	2	0	0	25704	2
2	0	2	0	0	25705	2
2	0	2	0	0	25706	2
2	0	2	0	0	25707	2
2	0	2	0	0	25708	2
2	0	2	0	0	25709	2
2	0	2	0	0	25710	2
2	0	2	0	0	25711	2
2	0	2	1	1	25712	2
2	0	2	0	0	25713	2
2	0	2	0	0	25714	2
2	0	2	0	0	25715	2
2	0	2	0	0	25716	2
2	0	2	0	0	25717	2
2	0	2	1	1	25718	2
2	0	2	0	0	25719	2
2	0	2	0	0	25720	2
2	0	2	0	0	25721	2
2	0	2	0	0	25722	2
2	0	2	1	1	25723	2
2	0	2	0	0	25724	2
2	0	2	0	0	25725	2
2	0	2	0	0	25726	2
2	0	2	0	0	25727	2
2	0	2	0	0	25728	2
2	0	2	0	0	25729	2
2	0	2	0	0	25730	2
2	0	2	0	0	25731	2
2	0	2	0	0	25732	2
2	0	2	0	0	25733	2
2	0	2	0	0	25734	2
2	0	2	0	0	25735	2
2	0	2	0	0	25736	2
2	0	2	0	0	25737	2
2	0	2	0	0	25738	2
2	0	2	0	0	25739	2
2	0	2	0	0	25740	2
2	0	2	0	0	25741	2
2	0	2	0	0	25742	2
2	0	2	0	0	25743	2
2	0	2	19	19	25744	2
2	0	2	0	0	25745	2
2	0	2	0	0	25746	2
2	1	2	2	3	25747	1
2	0	2	1	1	25748	2
2	0	2	0	0	25749	2
2	0	2	0	0	25750	2
2	0	2	0	0	25751	2
2	0	2	0	0	25752	2
2	0	2	0	0	25753	2
2	0	2	0	0	25754	2
2	0	2	0	0	25755	2
2	0	2	0	0	25756	2
2	0	2	0	0	25757	2
2	0	2	0	0	25758	2
2	0	2	0	0	25759	2
2	0	2	0	0	25760	2
2	0	2	0	0	25761	2
2	0	2	0	0	25762	2
2	0	2	0	0	25763	2
2	0	2	0	0	25764	2
2	0	2	0	0	25765	2
2	0	2	0	0	25766	2
2	18	2	1	19	25767	0
2	0	2	0	0	25768	2
2	0	2	0	0	25769	2
2	0	2	0	0	25770	2
2	0	2	0	0	25771	2
2	0	2	0	0	25772	2
2	0	2	0	0	25773	2
2	1	2	378	379	25774	1
2	0	2	1	1	25775	2
2	0	2	1	1	25776	2
2	6	2	5	11	25777	1
2	0	2	50	50	25778	2
2	0	2	0	0	25779	2
2	0	2	0	0	25780	2
2	0	2	0	0	25781	2
2	0	2	0	0	25782	2
2	0	2	0	0	25783	2
2	0	2	0	0	25784	2
2	0	2	0	0	25785	2
2	0	2	0	0	25786	2
2	0	2	0	0	25787	2
2	0	2	0	0	25788	2
2	0	2	0	0	25789	2
2	0	2	0	0	25790	2
2	0	2	0	0	25791	2
2	0	2	0	0	25792	2
2	0	2	0	0	25793	2
2	0	2	0	0	25794	2
2	0	2	0	0	25795	2
2	0	2	0	0	25796	2
2	0	2	0	0	25797	2
2	0	2	0	0	25798	2
2	0	2	0	0	25799	2
2	0	2	0	0	25800	2
2	0	2	1	1	25801	2
2	0	2	0	0	25802	2
2	0	2	0	0	25803	2
2	0	2	0	0	25804	2
2	0	2	0	0	25805	2
2	0	2	0	0	25806	2
2	0	2	0	0	25807	2
2	0	2	0	0	25808	2
2	0	2	0	0	25809	2
2	0	2	0	0	25810	2
2	0	2	0	0	25811	2
2	0	2	0	0	25812	2
2	0	2	0	0	25813	2
2	0	2	0	0	25814	2
2	0	2	0	0	25815	2
2	0	2	0	0	25816	2
2	0	2	0	0	25817	2
2	0	2	0	0	25818	2
2	1	2	0	1	25819	0
2	0	2	0	0	25820	2
2	6	2	11	17	25821	1
2	0	2	1	1	25822	2
2	0	2	0	0	25823	2
2	5	2	1	6	25824	0
2	0	2	3	3	25825	2
2	0	2	0	0	25826	2
2	0	2	0	0	25827	2
2	0	2	0	0	25828	2
2	0	2	0	0	25829	2
2	0	2	0	0	25830	2
2	0	2	0	0	25831	2
2	0	2	0	0	25832	2
2	0	2	0	0	25833	2
2	0	2	0	0	25834	2
2	0	2	0	0	25835	2
2	0	2	0	0	25836	2
2	0	2	0	0	25837	2
2	0	2	0	0	25838	2
2	0	2	0	0	25839	2
2	0	2	0	0	25840	2
2	0	2	0	0	25841	2
2	0	2	0	0	25842	2
2	0	2	0	0	25843	2
2	0	2	0	0	25844	2
2	1	2	0	1	25845	1
2	0	2	0	0	25846	2
2	0	2	0	0	25847	2
2	0	2	0	0	25848	2
2	0	2	0	0	25849	2
2	0	2	0	0	25850	2
2	0	2	0	0	25851	2
2	0	2	0	0	25852	2
2	0	2	0	0	25853	2
2	0	2	0	0	25854	2
2	0	2	0	0	25855	2
2	0	2	0	0	25856	2
2	0	2	0	0	25857	2
2	0	2	0	0	25858	2
2	0	2	0	0	25859	2
2	0	2	0	0	25860	2
2	0	2	0	0	25861	2
2	0	2	0	0	25862	2
2	0	2	0	0	25863	2
2	0	2	0	0	25864	2
2	0	2	0	0	25865	2
2	0	2	0	0	25866	2
2	0	2	0	0	25867	2
2	7	2	0	7	25868	0
2	2	2	62	64	25869	1
2	0	2	3	3	25870	2
2	0	2	0	0	25871	2
2	1	2	0	1	25872	0
2	0	2	15	15	25873	2
2	0	2	0	0	25874	2
2	0	2	0	0	25875	2
2	0	2	0	0	25876	2
2	0	2	0	0	25877	2
2	0	2	0	0	25878	2
2	0	2	0	0	25879	2
2	0	2	0	0	25880	2
2	0	2	0	0	25881	2
2	0	2	0	0	25882	2
2	0	2	0	0	25883	2
2	0	2	0	0	25884	2
2	0	2	0	0	25885	2
2	0	2	0	0	25886	2
2	0	2	0	0	25887	2
2	0	2	0	0	25888	2
2	0	2	0	0	25889	2
2	0	2	0	0	25890	2
2	0	2	0	0	25891	2
2	0	2	0	0	25892	2
2	0	2	0	0	25893	2
2	0	2	0	0	25894	2
2	0	2	0	0	25895	2
2	0	2	0	0	25896	2
2	0	2	0	0	25897	2
2	0	2	0	0	25898	2
2	0	2	0	0	25899	2
2	0	2	0	0	25900	2
2	0	2	0	0	25901	2
2	0	2	0	0	25902	2
2	0	2	0	0	25903	2
2	0	2	0	0	25904	2
2	50	2	0	50	25905	0
2	3	2	602	605	25906	1
2	0	2	0	0	25907	2
2	0	2	0	0	25908	2
4	0	2	282	282	25909	2
4	0	2	0	0	25910	2
2	1	2	2	3	25911	1
2	0	2	5	5	25912	2
2	0	2	0	0	25913	2
2	0	2	0	0	25914	2
2	0	2	0	0	25915	2
2	0	2	0	0	25916	2
2	0	2	0	0	25917	2
2	0	2	0	0	25918	2
2	0	2	0	0	25919	2
2	0	2	0	0	25920	2
2	0	2	0	0	25921	2
2	0	2	0	0	25922	2
2	0	2	0	0	25923	2
2	0	2	0	0	25924	2
2	0	2	0	0	25925	2
2	0	2	0	0	25926	2
2	0	2	0	0	25927	2
2	0	2	0	0	25928	2
2	0	2	0	0	25929	2
2	0	2	0	0	25930	2
2	0	2	0	0	25931	2
2	0	2	0	0	25932	2
2	0	2	0	0	25933	2
2	0	2	0	0	25934	2
2	0	2	0	0	25935	2
2	0	2	0	0	25936	2
2	0	2	0	0	25937	2
2	0	2	0	0	25938	2
2	0	2	0	0	25939	2
2	0	2	0	0	25940	2
2	0	2	0	0	25941	2
2	0	2	0	0	25942	2
2	0	2	0	0	25943	2
2	0	2	0	0	25944	2
2	0	2	0	0	25945	2
2	0	2	0	0	25946	2
2	0	2	0	0	25947	2
2	0	2	0	0	25948	2
2	0	2	0	0	25949	2
2	0	2	0	0	25950	2
2	0	2	0	0	25951	2
2	0	2	0	0	25952	2
2	0	2	0	0	25953	2
2	0	2	0	0	25954	2
2	0	2	0	0	25955	2
2	0	2	0	0	25956	2
2	0	2	0	0	25957	2
2	0	2	0	0	25958	2
2	0	2	0	0	25959	2
2	0	2	0	0	25960	2
2	0	2	0	0	25961	2
2	0	2	0	0	25962	2
2	0	2	0	0	25963	2
2	0	2	0	0	25964	2
2	0	2	0	0	25965	2
2	0	2	0	0	25966	2
2	0	2	0	0	25967	2
2	0	2	0	0	25968	2
2	0	2	0	0	25969	2
2	0	2	0	0	25970	2
2	0	2	0	0	25971	2
2	0	2	0	0	25972	2
2	0	2	0	0	25973	2
2	0	2	0	0	25974	2
2	0	2	0	0	25975	2
2	0	2	0	0	25976	2
2	0	2	0	0	25977	2
2	0	2	0	0	25978	2
2	0	2	0	0	25979	2
2	0	2	0	0	25980	2
2	0	2	0	0	25981	2
2	0	2	0	0	25982	2
2	0	2	0	0	25983	2
2	0	2	0	0	25984	2
2	0	2	0	0	25985	2
2	0	2	0	0	25986	2
2	0	2	0	0	25987	2
2	0	2	0	0	25988	2
2	0	2	0	0	25989	2
2	0	2	0	0	25990	2
2	0	2	0	0	25991	2
2	0	2	0	0	25992	2
2	0	2	0	0	25993	2
2	0	2	0	0	25994	2
2	0	2	3	3	25995	2
2	0	2	0	0	25996	2
2	0	2	0	0	25997	2
2	0	2	2	2	25998	2
2	0	2	0	0	25999	2
2	0	2	0	0	26000	2
2	0	2	0	0	26001	2
2	0	2	13	13	26002	2
2	0	2	0	0	26003	2
2	0	2	0	0	26004	2
2	0	2	0	0	26005	2
2	0	2	1	1	26006	2
2	0	2	2	2	26007	2
2	0	2	0	0	26008	2
2	0	2	0	0	26009	2
2	0	2	0	0	26010	2
2	0	2	0	0	26011	2
2	0	2	0	0	26012	2
2	0	2	0	0	26013	2
2	0	2	0	0	26014	2
2	0	2	0	0	26015	2
2	0	2	0	0	26016	2
2	0	2	0	0	26017	2
2	0	2	0	0	26018	2
2	0	2	0	0	26019	2
2	0	2	0	0	26020	2
2	0	2	0	0	26021	2
2	0	2	0	0	26022	2
2	0	2	0	0	26023	2
2	10	2	0	10	26024	0
2	68	2	105	173	26025	1
2	0	2	0	0	26026	2
2	0	2	0	0	26027	2
2	6	2	2	8	26028	0
2	0	2	22	22	26029	2
2	0	2	0	0	26030	2
2	0	2	0	0	26031	2
2	0	2	0	0	26032	2
2	0	2	0	0	26033	2
2	0	2	0	0	26034	2
2	0	2	0	0	26035	2
2	0	2	0	0	26036	2
2	0	2	0	0	26037	2
2	0	2	0	0	26038	2
2	0	2	0	0	26039	2
2	0	2	0	0	26040	2
2	0	2	0	0	26041	2
2	0	2	0	0	26042	2
2	0	2	0	0	26043	2
2	0	2	0	0	26044	2
2	0	2	0	0	26045	2
2	0	2	0	0	26046	2
2	0	2	0	0	26047	2
2	2	2	0	2	26048	0
2	0	2	0	0	26049	2
2	0	2	0	0	26050	2
2	0	2	0	0	26051	2
2	0	2	0	0	26052	2
2	0	2	0	0	26053	2
2	0	2	0	0	26054	2
2	0	2	0	0	26055	2
2	0	2	0	0	26056	2
2	0	2	0	0	26057	2
2	0	2	0	0	26058	2
2	0	2	0	0	26059	2
2	0	2	0	0	26060	2
2	0	2	0	0	26061	2
2	0	2	0	0	26062	2
2	0	2	0	0	26063	2
2	0	2	0	0	26064	2
2	0	2	0	0	26065	2
2	0	2	0	0	26066	2
2	0	2	0	0	26067	2
2	0	2	0	0	26068	2
2	0	2	0	0	26069	2
2	0	2	0	0	26070	2
2	0	2	0	0	26071	2
2	0	2	0	0	26072	2
2	0	2	0	0	26073	2
2	0	2	0	0	26074	2
2	0	2	0	0	26075	2
2	0	2	0	0	26076	2
2	0	2	0	0	26077	2
2	0	2	0	0	26078	2
2	8	2	0	8	26079	0
2	4	2	0	4	26080	0
2	1	4	107	108	26081	1
2	0	2	0	0	26082	2
2	0	2	0	0	26083	2
2	1	2	0	1	26084	1
2	0	2	8	8	26085	2
2	0	2	0	0	26086	2
2	0	2	0	0	26087	2
2	0	2	0	0	26088	2
2	0	2	0	0	26089	2
2	0	2	0	0	26090	2
2	0	2	0	0	26091	2
2	230	2	0	230	26092	0
2	56	2	11	67	26093	0
2	0	2	275	275	26094	2
2	123	2	547	670	26095	1
2	0	2	40	40	26096	2
2	0	2	2	2	26097	2
2	0	2	0	0	26098	2
2	0	2	0	0	26099	2
2	0	2	0	0	26100	2
2	0	2	0	0	26101	2
2	0	2	0	0	26102	2
2	0	2	0	0	26103	2
2	0	2	0	0	26104	2
2	0	2	0	0	26105	2
2	0	2	0	0	26106	2
2	0	2	0	0	26107	2
2	0	2	0	0	26108	2
2	0	2	0	0	26109	2
2	0	2	0	0	26110	2
2	0	2	0	0	26111	2
2	0	2	0	0	26112	2
2	0	2	0	0	26113	2
2	0	2	0	0	26114	2
2	0	2	0	0	26115	2
2	1	2	0	1	26116	0
2	0	2	0	0	26117	2
2	0	2	0	0	26118	2
2	0	2	0	0	26119	2
2	0	2	0	0	26120	2
2	0	2	4	4	26121	2
2	0	2	0	0	26122	2
2	0	2	0	0	26123	2
2	0	2	0	0	26124	2
2	0	2	0	0	26125	2
2	0	2	0	0	26126	2
2	0	2	0	0	26127	2
2	0	2	0	0	26128	2
2	0	2	0	0	26129	2
2	0	2	0	0	26130	2
2	0	2	0	0	26131	2
2	0	2	0	0	26132	2
2	0	2	0	0	26133	2
2	0	2	0	0	26134	2
2	0	2	43	43	26135	2
2	0	2	0	0	26136	2
2	0	2	0	0	26137	2
2	0	2	0	0	26138	2
2	0	2	0	0	26139	2
2	8	6	93095	93103	26140	1
2	0	2	1	1	26141	2
2	0	2	0	0	26142	2
2	2	2	0	2	26143	0
2	0	2	4	4	26144	2
2	0	2	1	1	26145	2
2	0	2	0	0	26146	2
2	1	2	1	2	26147	0
2	0	2	0	0	26148	2
2	0	2	0	0	26149	2
2	0	2	0	0	26150	2
2	0	2	0	0	26151	2
2	0	2	0	0	26152	2
2	0	2	0	0	26153	2
2	0	2	1	1	26154	2
2	0	2	0	0	26155	2
2	0	2	0	0	26156	2
2	0	2	0	0	26157	2
2	0	2	0	0	26158	2
2	0	2	0	0	26159	2
2	0	2	0	0	26160	2
2	0	2	0	0	26161	2
2	0	2	0	0	26162	2
2	0	2	0	0	26163	2
2	0	2	0	0	26164	2
2	0	2	0	0	26165	2
2	0	2	0	0	26166	2
2	0	2	0	0	26167	2
2	0	2	1	1	26168	2
2	0	2	0	0	26169	2
2	0	2	0	0	26170	2
2	0	2	0	0	26171	2
2	0	2	0	0	26172	2
2	0	2	0	0	26173	2
2	0	2	0	0	26174	2
2	0	2	0	0	26175	2
2	0	2	0	0	26176	2
2	0	2	0	0	26177	2
2	0	2	0	0	26178	2
2	0	2	0	0	26179	2
2	0	2	0	0	26180	2
2	0	2	0	0	26181	2
2	0	2	0	0	26182	2
2	0	2	0	0	26183	2
2	0	2	0	0	26184	2
2	0	2	1	1	26185	2
2	0	2	0	0	26186	2
2	0	2	0	0	26187	2
2	0	2	0	0	26188	2
2	0	2	0	0	26189	2
2	0	2	0	0	26190	2
2	0	2	0	0	26191	2
2	0	2	0	0	26192	2
2	0	2	0	0	26193	2
2	0	2	0	0	26194	2
2	0	2	0	0	26195	2
2	0	2	0	0	26196	2
2	0	2	0	0	26197	2
2	0	2	0	0	26198	2
2	0	2	0	0	26199	2
2	0	2	0	0	26200	2
2	0	2	0	0	26201	2
2	0	2	0	0	26202	2
2	0	2	0	0	26203	2
2	0	2	0	0	26204	2
2	0	2	0	0	26205	2
2	0	2	0	0	26206	2
2	1	2	0	1	26207	0
2	0	2	1	1	26208	2
2	0	2	0	0	26209	2
2	0	2	0	0	26210	2
2	0	2	0	0	26211	2
2	0	2	0	0	26212	2
2	0	2	0	0	26213	2
2	0	2	0	0	26214	2
2	0	2	0	0	26215	2
2	0	2	0	0	26216	2
2	0	2	0	0	26217	2
2	0	2	0	0	26218	2
2	0	2	0	0	26219	2
2	0	2	0	0	26220	2
2	0	2	12	12	26221	2
2	0	2	0	0	26222	2
2	0	2	0	0	26223	2
2	0	2	0	0	26224	2
2	0	2	0	0	26225	2
2	0	2	0	0	26226	2
2	0	2	0	0	26227	2
2	0	2	0	0	26228	2
2	0	2	0	0	26229	2
2	0	2	0	0	26230	2
2	0	2	0	0	26231	2
2	0	2	0	0	26232	2
2	0	2	0	0	26233	2
2	0	2	0	0	26234	2
2	0	2	0	0	26235	2
2	0	2	0	0	26236	2
2	0	2	1	1	26237	2
2	0	2	0	0	26238	2
2	0	2	10	10	26239	2
2	0	2	0	0	26240	2
2	0	2	0	0	26241	2
2	0	2	0	0	26242	2
2	0	2	1	1	26243	2
2	0	2	0	0	26244	2
2	0	2	0	0	26245	2
2	0	2	5	5	26246	2
2	1	2	6	7	26247	1
2	0	2	0	0	26248	2
2	0	2	0	0	26249	2
2	0	2	0	0	26250	2
2	0	2	0	0	26251	2
2	0	2	0	0	26252	2
2	0	2	0	0	26253	2
2	0	2	0	0	26254	2
2	0	2	0	0	26255	2
2	0	2	0	0	26256	2
2	0	2	0	0	26257	2
2	0	2	0	0	26258	2
2	0	2	0	0	26259	2
2	0	2	0	0	26260	2
2	0	2	0	0	26261	2
2	0	2	0	0	26262	2
2	0	2	0	0	26263	2
2	0	2	0	0	26264	2
2	0	2	0	0	26265	2
2	0	2	0	0	26266	2
2	0	2	0	0	26267	2
2	0	2	0	0	26268	2
2	13	2	0	13	26269	1
2	0	2	0	0	26270	2
2	0	2	0	0	26271	2
2	10	2	342	352	26272	0
2	0	2	0	0	26273	2
2	0	2	0	0	26274	2
2	6	2	0	6	26275	0
2	0	2	24	24	26276	2
2	0	2	0	0	26277	2
2	0	2	2	2	26278	2
2	0	2	0	0	26279	2
2	0	2	0	0	26280	2
2	0	2	0	0	26281	2
2	0	2	0	0	26282	2
2	0	2	0	0	26283	2
2	0	2	0	0	26284	2
2	0	2	0	0	26285	2
2	0	2	0	0	26286	2
2	0	2	0	0	26287	2
2	0	2	0	0	26288	2
2	0	2	0	0	26289	2
2	0	2	0	0	26290	2
2	0	2	0	0	26291	2
2	0	2	0	0	26292	2
2	0	2	0	0	26293	2
2	0	2	0	0	26294	2
2	0	2	0	0	26295	2
2	0	2	0	0	26296	2
2	2	2	0	2	26297	0
2	2	2	16	18	26298	1
2	0	2	1	1	26299	2
2	0	2	0	0	26300	2
2	0	2	0	0	26301	2
2	0	2	0	0	26302	2
2	0	2	0	0	26303	2
2	0	2	0	0	26304	2
2	0	2	0	0	26305	2
2	0	2	0	0	26306	2
2	0	2	0	0	26307	2
2	0	2	0	0	26308	2
2	0	2	0	0	26309	2
2	0	2	0	0	26310	2
2	0	2	0	0	26311	2
2	0	2	0	0	26312	2
2	0	2	0	0	26313	2
2	0	2	0	0	26314	2
2	0	2	0	0	26315	2
2	0	2	0	0	26316	2
2	0	2	0	0	26317	2
2	0	2	0	0	26318	2
2	0	2	0	0	26319	2
2	0	2	0	0	26320	2
2	0	2	0	0	26321	2
2	0	2	0	0	26322	2
2	0	2	0	0	26323	2
2	0	2	0	0	26324	2
2	0	2	0	0	26325	2
2	0	2	0	0	26326	2
2	0	2	0	0	26327	2
2	0	2	0	0	26328	2
2	0	2	0	0	26329	2
2	0	2	0	0	26330	2
2	0	2	0	0	26331	2
2	0	2	0	0	26332	2
2	0	2	0	0	26333	2
2	0	2	0	0	26334	2
2	0	2	0	0	26335	2
2	0	2	0	0	26336	2
2	0	2	0	0	26337	2
2	3	2	0	3	26338	0
2	0	2	0	0	26339	2
2	2	2	83	85	26340	1
2	0	2	1	1	26341	2
2	0	2	0	0	26342	2
2	1	2	1	2	26343	0
2	0	2	11	11	26344	2
2	0	2	0	0	26345	2
2	0	2	0	0	26346	2
2	0	2	1	1	26347	2
2	0	2	0	0	26348	2
2	0	2	0	0	26349	2
2	0	2	0	0	26350	2
2	0	2	0	0	26351	2
2	0	2	0	0	26352	2
2	0	2	0	0	26353	2
2	0	2	0	0	26354	2
2	0	2	0	0	26355	2
2	0	2	0	0	26356	2
2	0	2	0	0	26357	2
2	0	2	0	0	26358	2
2	0	2	0	0	26359	2
2	0	2	0	0	26360	2
2	0	2	0	0	26361	2
2	0	2	0	0	26362	2
2	0	2	0	0	26363	2
2	0	2	0	0	26364	2
2	0	2	0	0	26365	2
2	7	2	13	20	26366	1
2	0	2	0	0	26367	2
2	0	2	0	0	26368	2
2	1	2	0	1	26369	1
2	0	2	0	0	26370	2
2	0	2	0	0	26371	2
2	0	2	0	0	26372	2
2	0	2	0	0	26373	2
2	0	2	0	0	26374	2
2	0	2	0	0	26375	2
2	0	2	0	0	26376	2
2	0	2	0	0	26377	2
2	0	2	0	0	26378	2
2	0	2	2	2	26379	2
2	0	2	0	0	26380	2
2	0	2	0	0	26381	2
2	0	2	0	0	26382	2
2	0	2	0	0	26383	2
2	0	2	0	0	26384	2
2	1	2	0	1	26385	1
2	0	2	0	0	26386	2
2	0	2	0	0	26387	2
2	0	2	0	0	26388	2
2	0	2	0	0	26389	2
2	0	2	0	0	26390	2
2	0	2	0	0	26391	2
2	0	2	0	0	26392	2
2	0	2	0	0	26393	2
2	0	2	0	0	26394	2
2	0	2	0	0	26395	2
2	0	2	1	1	26396	2
2	0	2	0	0	26397	2
2	0	2	0	0	26398	2
2	0	2	0	0	26399	2
2	0	2	0	0	26400	2
2	0	2	0	0	26401	2
2	0	2	0	0	26402	2
2	0	2	0	0	26403	2
2	0	2	0	0	26404	2
2	0	2	0	0	26405	2
2	0	2	0	0	26406	2
2	0	2	0	0	26407	2
2	0	2	0	0	26408	2
2	0	2	0	0	26409	2
2	0	2	0	0	26410	2
2	0	2	0	0	26411	2
2	0	2	0	0	26412	2
2	0	2	0	0	26413	2
2	0	0	4	4	26414	2
2	0	2	0	0	26415	2
2	0	2	0	0	26416	2
2	0	0	1	1	26417	2
2	0	2	0	0	26418	2
2	0	2	0	0	26419	2
2	0	2	0	0	26420	2
2	0	2	0	0	26421	2
2	0	2	0	0	26422	2
2	0	2	0	0	26423	2
2	0	2	0	0	26424	2
2	0	2	0	0	26425	2
2	0	2	0	0	26426	2
2	0	2	0	0	26427	2
2	0	2	0	0	26428	2
2	0	2	0	0	26429	2
2	0	2	0	0	26430	2
2	0	2	0	0	26431	2
2	0	2	0	0	26432	2
2	0	2	0	0	26433	2
2	0	2	0	0	26434	2
2	0	2	0	0	26435	2
2	0	2	0	0	26436	2
2	0	2	0	0	26437	2
2	0	2	0	0	26438	2
2	0	2	0	0	26439	2
2	0	2	1	1	26440	2
2	0	2	0	0	26441	2
2	0	2	0	0	26442	2
2	0	2	0	0	26443	2
2	0	2	2	2	26444	2
2	0	2	0	0	26445	2
2	0	2	0	0	26446	2
2	0	2	0	0	26447	2
2	0	2	0	0	26448	2
2	0	2	0	0	26449	2
2	0	2	7	7	26450	2
2	0	2	0	0	26451	2
2	0	2	0	0	26452	2
2	0	2	0	0	26453	2
2	0	2	0	0	26454	2
2	0	2	0	0	26455	2
2	0	2	0	0	26456	2
2	0	2	0	0	26457	2
2	0	2	0	0	26458	2
2	0	2	0	0	26459	2
2	0	2	0	0	26460	2
2	0	2	0	0	26461	2
2	0	2	0	0	26462	2
2	0	2	0	0	26463	2
2	0	2	0	0	26464	2
2	0	2	0	0	26465	2
2	0	2	0	0	26466	2
2	0	2	0	0	26467	2
2	0	2	0	0	26468	2
2	0	2	0	0	26469	2
2	0	2	0	0	26470	2
2	0	2	0	0	26471	2
2	0	2	0	0	26472	2
2	0	2	0	0	26473	2
2	0	2	0	0	26474	2
2	0	2	0	0	26475	2
2	0	2	0	0	26476	2
2	0	2	0	0	26477	2
2	0	2	0	0	26478	2
2	0	2	0	0	26479	2
2	0	2	3	3	26480	2
2	0	2	0	0	26481	2
2	0	2	0	0	26482	2
2	0	2	1	1	26483	2
2	0	2	1	1	26484	2
2	0	2	0	0	26485	2
2	0	2	0	0	26486	2
2	0	2	0	0	26487	2
2	0	2	0	0	26488	2
2	0	2	2	2	26489	2
2	0	2	0	0	26490	2
2	1	2	0	1	26491	0
2	0	2	0	0	26492	2
2	0	2	0	0	26493	2
2	0	2	0	0	26494	2
2	0	2	0	0	26495	2
2	0	2	0	0	26496	2
2	0	2	0	0	26497	2
2	0	2	0	0	26498	2
2	0	2	0	0	26499	2
2	0	2	0	0	26500	2
2	0	2	0	0	26501	2
2	0	2	0	0	26502	2
2	0	2	0	0	26503	2
2	0	2	0	0	26504	2
2	0	2	0	0	26505	2
2	0	2	0	0	26506	2
2	0	2	0	0	26507	2
2	0	2	0	0	26508	2
2	0	2	0	0	26509	2
2	0	2	0	0	26510	2
2	0	2	0	0	26511	2
2	0	2	0	0	26512	2
2	0	2	165	165	26513	2
2	0	2	0	0	26514	2
2	0	2	0	0	26515	2
2	0	2	61	61	26516	2
2	0	2	0	0	26517	2
2	0	2	0	0	26518	2
2	0	2	0	0	26519	2
2	0	2	0	0	26520	2
2	0	2	0	0	26521	2
2	0	2	0	0	26522	2
2	0	2	0	0	26523	2
2	0	2	0	0	26524	2
2	0	2	0	0	26525	2
2	0	2	0	0	26526	2
2	0	2	0	0	26527	2
2	0	2	0	0	26528	2
2	0	2	0	0	26529	2
2	0	2	0	0	26530	2
2	0	2	0	0	26531	2
2	0	2	0	0	26532	2
2	0	2	0	0	26533	2
2	0	2	0	0	26534	2
2	0	2	0	0	26535	2
2	0	2	0	0	26536	2
2	0	2	0	0	26537	2
2	0	2	0	0	26538	2
2	0	2	0	0	26539	2
2	0	2	0	0	26540	2
2	0	2	0	0	26541	2
2	0	2	0	0	26542	2
2	0	2	0	0	26543	2
2	0	2	0	0	26544	2
2	0	2	0	0	26545	2
2	0	2	0	0	26546	2
2	0	2	0	0	26547	2
2	0	2	0	0	26548	2
2	0	2	0	0	26549	2
2	0	2	0	0	26550	2
2	0	2	0	0	26551	2
2	0	2	0	0	26552	2
2	0	2	0	0	26553	2
2	0	2	0	0	26554	2
2	0	2	0	0	26555	2
2	0	2	0	0	26556	2
2	0	2	0	0	26557	2
2	0	2	0	0	26558	2
2	0	2	0	0	26559	2
2	0	2	0	0	26560	2
2	0	2	0	0	26561	2
2	0	2	0	0	26562	2
2	0	2	0	0	26563	2
2	0	2	0	0	26564	2
2	0	2	0	0	26565	2
2	0	2	0	0	26566	2
2	0	2	0	0	26567	2
2	0	2	0	0	26568	2
2	0	2	0	0	26569	2
2	0	2	0	0	26570	2
2	0	2	0	0	26571	2
2	0	2	0	0	26572	2
2	0	2	0	0	26573	2
2	0	2	0	0	26574	2
2	0	2	0	0	26575	2
2	0	2	0	0	26576	2
2	0	2	0	0	26577	2
2	0	2	0	0	26578	2
2	0	2	0	0	26579	2
2	0	2	0	0	26580	2
2	0	2	0	0	26581	2
2	0	2	0	0	26582	2
2	0	2	0	0	26583	2
2	0	2	0	0	26584	2
2	0	2	0	0	26585	2
2	0	2	0	0	26586	2
2	0	2	0	0	26587	2
2	0	2	0	0	26588	2
2	0	2	0	0	26589	2
2	0	2	0	0	26590	2
2	0	2	0	0	26591	2
2	0	2	0	0	26592	2
2	0	2	0	0	26593	2
2	0	2	0	0	26594	2
2	0	2	0	0	26595	2
2	1	2	0	1	26596	0
2	0	2	0	0	26597	2
2	0	2	0	0	26598	2
2	0	2	0	0	26599	2
2	0	2	2	2	26600	2
2	0	2	1	1	26601	2
2	0	2	0	0	26602	2
2	0	2	0	0	26603	2
2	0	2	0	0	26604	2
2	0	2	0	0	26605	2
2	0	2	0	0	26606	2
2	14	2	0	14	26607	0
2	14	2	70	84	26608	1
2	0	2	1	1	26609	2
2	0	2	0	0	26610	2
2	7	2	1	8	26611	0
2	0	2	18	18	26612	2
2	0	2	0	0	26613	2
2	0	2	3	3	26614	2
2	0	2	0	0	26615	2
2	0	2	0	0	26616	2
2	0	2	0	0	26617	2
2	0	2	0	0	26618	2
2	0	2	0	0	26619	2
2	0	2	0	0	26620	2
2	0	2	0	0	26621	2
2	0	2	0	0	26622	2
2	0	2	0	0	26623	2
2	0	2	0	0	26624	2
2	0	2	0	0	26625	2
2	0	2	0	0	26626	2
2	5	2	0	5	26627	0
2	0	2	1	1	26628	2
2	0	2	0	0	26629	2
2	0	2	0	0	26630	2
2	0	2	0	0	26631	2
2	0	2	0	0	26632	2
2	0	2	0	0	26633	2
2	0	2	0	0	26634	2
2	0	2	0	0	26635	2
2	0	2	0	0	26636	2
2	0	2	0	0	26637	2
2	1	2	0	1	26638	0
2	1	2	0	1	26639	0
2	0	2	0	0	26640	2
2	0	2	0	0	26641	2
2	0	2	46	46	26642	2
2	0	2	0	0	26643	2
2	0	2	0	0	26644	2
2	0	2	0	0	26645	2
2	0	2	0	0	26646	2
2	0	2	0	0	26647	2
2	0	2	0	0	26648	2
2	0	2	0	0	26649	2
2	0	2	0	0	26650	2
2	0	2	0	0	26651	2
2	0	2	0	0	26652	2
2	0	2	0	0	26653	2
2	0	2	0	0	26654	2
2	12	2	0	12	26655	0
2	0	2	60	60	26656	2
2	53	2	0	53	26657	0
2	37	2	241	278	26658	1
2	0	2	9	9	26659	2
2	0	2	0	0	26660	2
2	0	2	0	0	26661	2
2	0	2	1	1	26662	2
2	0	2	0	0	26663	2
2	0	2	0	0	26664	2
2	0	2	1	1	26665	2
2	0	2	0	0	26666	2
2	0	2	0	0	26667	2
2	0	2	0	0	26668	2
2	0	2	0	0	26669	2
2	0	2	0	0	26670	2
2	0	2	0	0	26671	2
2	0	2	0	0	26672	2
2	0	2	0	0	26673	2
2	0	2	0	0	26674	2
2	0	2	0	0	26675	2
2	0	2	0	0	26676	2
2	0	2	0	0	26677	2
2	0	2	0	0	26678	2
2	0	2	0	0	26679	2
2	0	2	0	0	26680	2
2	0	2	0	0	26681	2
2	0	2	0	0	26682	2
2	0	2	0	0	26683	2
2	0	2	0	0	26684	2
2	0	2	0	0	26685	2
2	0	4	0	0	26686	2
2	0	2	0	0	26687	2
2	0	2	0	0	26688	2
2	0	4	0	0	26689	2
2	0	2	0	0	26690	2
2	0	2	0	0	26691	2
2	0	2	0	0	26692	2
2	0	2	0	0	26693	2
2	0	2	0	0	26694	2
2	0	2	0	0	26695	2
2	0	2	0	0	26696	2
2	0	2	0	0	26697	2
2	0	2	0	0	26698	2
2	0	2	0	0	26699	2
2	0	2	0	0	26700	2
2	0	2	0	0	26701	2
2	0	2	0	0	26702	2
2	0	2	0	0	26703	2
2	0	2	0	0	26704	2
2	0	2	0	0	26705	2
2	0	2	0	0	26706	2
2	0	2	0	0	26707	2
2	0	2	0	0	26708	2
2	0	2	0	0	26709	2
2	0	2	0	0	26710	2
2	0	2	0	0	26711	2
2	0	2	0	0	26712	2
2	0	2	0	0	26713	2
2	0	2	0	0	26714	2
2	0	2	0	0	26715	2
2	0	2	0	0	26716	2
2	0	2	0	0	26717	2
2	0	2	0	0	26718	2
2	0	2	0	0	26719	2
2	0	2	0	0	26720	2
2	0	2	0	0	26721	2
2	0	2	0	0	26722	2
2	0	2	0	0	26723	2
2	0	2	0	0	26724	2
2	0	2	0	0	26725	2
2	0	2	0	0	26726	2
2	0	2	0	0	26727	2
2	0	2	0	0	26728	2
2	0	2	0	0	26729	2
2	0	2	0	0	26730	2
2	0	2	0	0	26731	2
2	0	2	0	0	26732	2
2	0	2	0	0	26733	2
2	0	2	0	0	26734	2
2	0	2	0	0	26735	2
2	0	2	0	0	26736	2
2	0	2	0	0	26737	2
2	0	2	0	0	26738	2
2	0	2	0	0	26739	2
2	0	2	0	0	26740	2
2	0	2	2	2	26741	2
2	0	2	0	0	26742	2
2	0	2	0	0	26743	2
2	0	2	0	0	26744	2
2	0	2	1	1	26745	2
2	0	2	0	0	26746	2
2	0	2	0	0	26747	2
2	0	2	0	0	26748	2
2	0	2	0	0	26749	2
2	0	2	0	0	26750	2
2	0	2	0	0	26751	2
2	0	2	0	0	26752	2
2	0	2	0	0	26753	2
2	0	2	0	0	26754	2
2	0	2	0	0	26755	2
2	0	2	0	0	26756	2
2	0	2	0	0	26757	2
2	0	2	0	0	26758	2
2	0	2	0	0	26759	2
2	0	2	0	0	26760	2
2	0	2	0	0	26761	2
2	0	2	0	0	26762	2
2	0	2	0	0	26763	2
2	0	2	0	0	26764	2
2	0	2	0	0	26765	2
2	0	2	0	0	26766	2
2	0	2	0	0	26767	2
2	0	2	0	0	26768	2
2	0	2	0	0	26769	2
2	0	2	0	0	26770	2
2	0	2	0	0	26771	2
2	0	2	0	0	26772	2
2	0	2	0	0	26773	2
2	0	2	0	0	26774	2
2	0	2	0	0	26775	2
2	0	2	0	0	26776	2
2	0	2	0	0	26777	2
2	0	2	0	0	26778	2
2	0	2	0	0	26779	2
2	0	2	0	0	26780	2
2	0	2	0	0	26781	2
2	0	2	0	0	26782	2
2	0	2	0	0	26783	2
2	0	2	0	0	26784	2
2	0	2	0	0	26785	2
2	0	2	0	0	26786	2
2	0	2	0	0	26787	2
2	0	2	0	0	26788	2
2	1	2	0	1	26789	0
2	0	2	0	0	26790	2
2	0	2	0	0	26791	2
2	0	2	0	0	26792	2
2	0	2	0	0	26793	2
2	0	2	0	0	26794	2
2	0	2	0	0	26795	2
2	0	2	0	0	26796	2
2	0	2	0	0	26797	2
2	0	2	0	0	26798	2
2	0	2	0	0	26799	2
2	0	2	0	0	26800	2
2	0	2	0	0	26801	2
2	1	2	9	10	26802	1
2	0	2	1	1	26803	2
2	0	2	0	0	26804	2
2	0	2	0	0	26805	2
2	0	2	1	1	26806	2
2	24	2	0	24	26807	0
2	0	2	111	111	26808	2
2	0	2	1	1	26809	2
2	0	2	0	0	26810	2
2	0	2	0	0	26811	2
2	0	2	5	5	26812	2
2	0	2	0	0	26813	2
2	0	2	0	0	26814	2
2	0	2	0	0	26815	2
2	0	2	0	0	26816	2
2	0	2	0	0	26817	2
2	0	2	0	0	26818	2
2	0	2	0	0	26819	2
2	0	2	0	0	26820	2
2	0	2	0	0	26821	2
2	0	2	0	0	26822	2
2	0	2	0	0	26823	2
2	0	2	0	0	26824	2
2	0	2	0	0	26825	2
2	0	2	0	0	26826	2
2	0	2	0	0	26827	2
2	0	2	0	0	26828	2
2	0	2	0	0	26829	2
2	0	2	0	0	26830	2
2	0	2	0	0	26831	2
2	0	2	0	0	26832	2
2	0	2	0	0	26833	2
2	0	2	0	0	26834	2
2	0	2	0	0	26835	2
2	0	2	0	0	26836	2
2	0	2	0	0	26837	2
2	0	2	0	0	26838	2
2	0	2	0	0	26839	2
2	0	2	0	0	26840	2
2	0	2	0	0	26841	2
2	0	2	0	0	26842	2
2	0	2	0	0	26843	2
2	0	2	0	0	26844	2
2	0	2	0	0	26845	2
2	0	2	0	0	26846	2
2	0	2	0	0	26847	2
2	0	2	0	0	26848	2
2	0	2	0	0	26849	2
2	0	2	0	0	26850	2
2	0	2	0	0	26851	2
2	0	2	0	0	26852	2
2	0	2	0	0	26853	2
2	0	2	0	0	26854	2
2	0	2	0	0	26855	2
2	0	2	0	0	26856	2
2	0	2	0	0	26857	2
2	0	2	0	0	26858	2
2	0	2	0	0	26859	2
2	0	2	0	0	26860	2
2	0	2	0	0	26861	2
2	0	2	0	0	26862	2
2	0	2	0	0	26863	2
2	0	2	0	0	26864	2
2	0	2	0	0	26865	2
2	0	2	0	0	26866	2
2	0	2	0	0	26867	2
2	0	2	0	0	26868	2
2	0	2	0	0	26869	2
2	0	2	0	0	26870	2
2	0	2	0	0	26871	2
2	0	2	0	0	26872	2
2	0	2	0	0	26873	2
2	0	2	0	0	26874	2
2	0	2	0	0	26875	2
2	0	2	0	0	26876	2
2	0	2	0	0	26877	2
2	0	2	0	0	26878	2
2	36	2	15	51	26879	1
2	0	2	1	1	26880	2
2	0	2	0	0	26881	2
2	3	2	0	3	26882	1
2	0	2	7	7	26883	2
2	0	2	0	0	26884	2
2	0	2	0	0	26885	2
2	0	2	0	0	26886	2
2	0	2	0	0	26887	2
2	0	2	0	0	26888	2
2	0	2	0	0	26889	2
2	0	2	0	0	26890	2
2	0	2	0	0	26891	2
2	0	2	0	0	26892	2
2	0	2	0	0	26893	2
2	4	2	0	4	26894	0
2	0	2	4	4	26895	2
2	0	2	0	0	26896	2
2	0	2	0	0	26897	2
2	0	2	0	0	26898	2
2	0	2	0	0	26899	2
2	0	2	0	0	26900	2
2	0	2	0	0	26901	2
2	0	2	0	0	26902	2
2	0	2	0	0	26903	2
2	0	2	0	0	26904	2
2	1	2	0	1	26905	0
2	0	2	0	0	26906	2
2	11	2	1	12	26907	1
2	0	2	0	0	26908	2
2	0	2	0	0	26909	2
2	0	2	0	0	26910	2
2	0	2	0	0	26911	2
2	0	2	0	0	26912	2
2	0	2	0	0	26913	2
2	0	2	0	0	26914	2
2	0	2	0	0	26915	2
2	0	2	0	0	26916	2
2	0	2	0	0	26917	2
2	0	2	0	0	26918	2
2	0	2	0	0	26919	2
2	0	2	0	0	26920	2
2	0	2	0	0	26921	2
2	0	2	0	0	26922	2
2	0	2	0	0	26923	2
2	0	2	0	0	26924	2
2	0	2	0	0	26925	2
2	0	2	0	0	26926	2
2	0	2	0	0	26927	2
2	4	2	0	4	26928	0
2	3	2	14	17	26929	1
2	0	2	1	1	26930	2
2	0	2	1	1	26931	2
2	4	2	0	4	26932	0
2	0	2	3	3	26933	2
2	1	2	0	1	26934	0
2	1	2	2	3	26935	1
2	0	2	0	0	26936	2
2	0	2	0	0	26937	2
2	0	2	0	0	26938	2
2	0	2	1	1	26939	2
2	0	2	0	0	26940	2
2	1	2	96	97	26941	1
2	0	2	0	0	26942	2
2	0	2	0	0	26943	2
2	2	2	6	8	26944	0
2	0	2	9	9	26945	2
2	0	2	0	0	26946	2
2	0	2	0	0	26947	2
2	0	2	0	0	26948	2
2	0	2	0	0	26949	2
2	0	2	0	0	26950	2
2	0	2	0	0	26951	2
2	0	2	0	0	26952	2
2	0	2	1	1	26953	2
2	0	2	0	0	26954	2
2	0	2	0	0	26955	2
2	0	2	0	0	26956	2
2	0	2	0	0	26957	2
2	1	2	0	1	26958	0
2	10	2	67	77	26959	1
2	0	2	2	2	26960	2
2	0	2	0	0	26961	2
2	0	2	0	0	26962	2
2	0	2	12	12	26963	2
2	0	2	0	0	26964	2
2	0	2	0	0	26965	2
2	0	2	0	0	26966	2
2	0	2	0	0	26967	2
2	0	2	0	0	26968	2
2	0	2	0	0	26969	2
2	0	2	0	0	26970	2
2	0	2	0	0	26971	2
2	0	2	0	0	26972	2
2	0	2	0	0	26973	2
2	0	2	0	0	26974	2
2	0	2	0	0	26975	2
2	0	2	0	0	26976	2
2	0	2	0	0	26977	2
2	0	2	0	0	26978	2
2	0	2	0	0	26979	2
2	0	2	0	0	26980	2
2	0	2	0	0	26981	2
2	0	2	0	0	26982	2
2	0	2	0	0	26983	2
2	0	2	0	0	26984	2
2	0	2	0	0	26985	2
2	0	2	0	0	26986	2
2	0	2	0	0	26987	2
2	0	2	0	0	26988	2
2	0	2	0	0	26989	2
2	0	2	0	0	26990	2
2	0	2	0	0	26991	2
2	0	2	0	0	26992	2
2	0	2	0	0	26993	2
2	0	2	1	1	26994	2
2	0	2	0	0	26995	2
2	0	2	0	0	26996	2
2	0	2	0	0	26997	2
2	0	2	0	0	26998	2
2	0	2	0	0	26999	2
2	0	2	17	17	27000	2
2	0	2	0	0	27001	2
2	0	2	0	0	27002	2
2	0	2	1	1	27003	2
2	0	2	6	6	27004	2
2	0	2	0	0	27005	2
2	0	2	0	0	27006	2
2	0	2	0	0	27007	2
2	0	2	1	1	27008	2
2	0	2	0	0	27009	2
2	0	2	0	0	27010	2
2	0	2	0	0	27011	2
2	0	2	0	0	27012	2
2	0	2	0	0	27013	2
2	0	2	0	0	27014	2
2	0	2	0	0	27015	2
2	0	2	0	0	27016	2
2	0	2	0	0	27017	2
2	0	2	0	0	27018	2
2	0	2	0	0	27019	2
2	0	2	0	0	27020	2
2	0	2	0	0	27021	2
2	0	2	0	0	27022	2
2	0	2	0	0	27023	2
2	0	2	0	0	27024	2
2	0	2	0	0	27025	2
2	0	2	0	0	27026	2
2	0	2	0	0	27027	2
2	0	2	0	0	27028	2
2	0	2	0	0	27029	2
2	0	2	0	0	27030	2
2	0	2	0	0	27031	2
2	0	2	4	4	27032	2
2	0	2	0	0	27033	2
2	0	2	0	0	27034	2
2	0	2	0	0	27035	2
2	0	2	3	3	27036	2
2	0	2	0	0	27037	2
2	0	2	1	1	27038	2
2	0	2	0	0	27039	2
2	0	2	0	0	27040	2
2	0	2	0	0	27041	2
2	0	2	0	0	27042	2
2	0	4	0	0	27043	2
2	0	2	0	0	27044	2
2	0	2	0	0	27045	2
2	0	4	11	11	27046	2
2	0	2	0	0	27047	2
2	0	2	0	0	27048	2
2	0	2	0	0	27049	2
2	0	2	0	0	27050	2
2	0	2	0	0	27051	2
2	8	2	0	8	27052	0
2	0	2	14	14	27053	2
2	0	2	0	0	27054	2
2	4	2	0	4	27055	0
2	11	2	0	11	27056	1
2	0	2	0	0	27057	2
2	0	2	0	0	27058	2
2	17	2	0	17	27059	0
2	0	2	0	0	27060	2
2	5	2	0	5	27061	1
2	0	2	0	0	27062	2
2	0	2	0	0	27063	2
2	2	2	0	2	27064	1
2	0	2	0	0	27065	2
2	1	2	0	1	27066	1
2	0	2	0	0	27067	2
2	0	2	0	0	27068	2
2	0	2	0	0	27069	2
2	0	2	1	1	27070	2
2	0	2	0	0	27071	2
2	0	2	0	0	27072	2
2	0	2	0	0	27073	2
2	0	2	0	0	27074	2
2	0	2	0	0	27075	2
2	0	2	0	0	27076	2
2	0	2	0	0	27077	2
2	0	2	1	1	27078	2
2	0	2	0	0	27079	2
2	0	2	0	0	27080	2
2	0	2	0	0	27081	2
2	0	2	0	0	27082	2
2	9	2	0	9	27083	0
2	0	2	0	0	27084	2
2	0	2	0	0	27085	2
2	6	2	52	58	27086	1
2	0	2	0	0	27087	2
2	0	2	0	0	27088	2
2	3	2	3	6	27089	0
2	0	2	10	10	27090	2
2	0	2	0	0	27091	2
2	0	2	0	0	27092	2
2	0	2	0	0	27093	2
2	0	2	0	0	27094	2
2	0	2	0	0	27095	2
2	0	2	0	0	27096	2
2	0	2	0	0	27097	2
2	0	2	0	0	27098	2
2	0	2	0	0	27099	2
2	0	2	0	0	27100	2
2	0	2	0	0	27101	2
2	0	2	0	0	27102	2
2	0	2	0	0	27103	2
2	0	2	0	0	27104	2
2	0	2	0	0	27105	2
2	0	2	0	0	27106	2
2	0	2	0	0	27107	2
2	0	2	0	0	27108	2
2	0	2	0	0	27109	2
2	0	2	0	0	27110	2
2	0	2	0	0	27111	2
2	0	2	2	2	27112	2
2	0	2	0	0	27113	2
2	0	2	0	0	27114	2
2	0	2	0	0	27115	2
2	0	2	0	0	27116	2
2	0	2	0	0	27117	2
2	0	2	0	0	27118	2
2	0	2	0	0	27119	2
2	0	2	0	0	27120	2
2	0	2	0	0	27121	2
2	0	2	0	0	27122	2
2	0	2	0	0	27123	2
2	0	2	0	0	27124	2
2	0	2	0	0	27125	2
2	0	2	0	0	27126	2
2	0	2	0	0	27127	2
2	0	2	0	0	27128	2
2	0	2	0	0	27129	2
2	0	2	0	0	27130	2
2	0	2	0	0	27131	2
2	0	2	0	0	27132	2
2	0	2	0	0	27133	2
2	0	2	0	0	27134	2
2	0	2	0	0	27135	2
2	0	2	0	0	27136	2
2	0	2	0	0	27137	2
2	0	2	0	0	27138	2
2	0	2	0	0	27139	2
2	0	2	0	0	27140	2
2	0	2	0	0	27141	2
2	0	2	0	0	27142	2
2	0	2	0	0	27143	2
2	0	2	0	0	27144	2
2	0	2	0	0	27145	2
2	0	2	0	0	27146	2
2	0	2	0	0	27147	2
2	0	2	0	0	27148	2
2	0	2	0	0	27149	2
2	0	2	0	0	27150	2
2	0	2	0	0	27151	2
2	0	2	0	0	27152	2
2	0	2	0	0	27153	2
2	0	2	0	0	27154	2
2	0	2	0	0	27155	2
2	0	2	0	0	27156	2
2	0	2	0	0	27157	2
2	0	2	0	0	27158	2
2	0	2	0	0	27159	2
2	0	2	0	0	27160	2
2	0	2	0	0	27161	2
2	0	2	0	0	27162	2
2	0	2	0	0	27163	2
2	0	2	0	0	27164	2
2	0	2	0	0	27165	2
2	0	2	0	0	27166	2
2	0	2	0	0	27167	2
2	0	2	0	0	27168	2
2	0	2	0	0	27169	2
2	0	2	0	0	27170	2
2	0	2	0	0	27171	2
2	0	2	0	0	27172	2
2	0	2	0	0	27173	2
2	0	2	0	0	27174	2
2	0	2	0	0	27175	2
2	0	2	0	0	27176	2
2	0	2	0	0	27177	2
2	0	2	0	0	27178	2
2	0	2	0	0	27179	2
2	0	2	0	0	27180	2
2	0	2	0	0	27181	2
2	0	2	0	0	27182	2
2	0	2	0	0	27183	2
2	0	2	0	0	27184	2
2	0	2	0	0	27185	2
2	0	2	0	0	27186	2
2	0	2	0	0	27187	2
2	0	2	0	0	27188	2
2	0	2	0	0	27189	2
2	0	2	0	0	27190	2
2	0	2	0	0	27191	2
2	0	2	0	0	27192	2
2	0	2	0	0	27193	2
2	0	2	0	0	27194	2
2	0	2	0	0	27195	2
2	0	2	0	0	27196	2
2	0	2	0	0	27197	2
2	0	2	0	0	27198	2
2	0	2	0	0	27199	2
2	0	2	0	0	27200	2
2	0	2	0	0	27201	2
2	0	2	0	0	27202	2
2	0	2	0	0	27203	2
2	0	2	0	0	27204	2
2	0	2	0	0	27205	2
2	0	2	0	0	27206	2
2	0	2	0	0	27207	2
2	0	2	0	0	27208	2
2	0	2	0	0	27209	2
2	0	2	0	0	27210	2
2	0	2	0	0	27211	2
2	0	2	0	0	27212	2
2	0	2	0	0	27213	2
2	0	2	0	0	27214	2
2	0	2	0	0	27215	2
2	0	2	0	0	27216	2
2	0	2	0	0	27217	2
2	0	2	0	0	27218	2
2	0	2	0	0	27219	2
2	0	2	0	0	27220	2
2	0	2	0	0	27221	2
2	0	2	0	0	27222	2
2	0	2	0	0	27223	2
2	0	2	0	0	27224	2
2	0	2	0	0	27225	2
2	0	2	0	0	27226	2
2	0	2	0	0	27227	2
2	0	2	0	0	27228	2
2	0	2	0	0	27229	2
2	0	2	0	0	27230	2
2	0	2	0	0	27231	2
2	0	2	0	0	27232	2
2	0	2	0	0	27233	2
2	0	2	0	0	27234	2
2	0	2	0	0	27235	2
2	0	2	0	0	27236	2
2	0	2	0	0	27237	2
2	0	2	0	0	27238	2
2	0	2	0	0	27239	2
2	0	2	0	0	27240	2
2	0	2	0	0	27241	2
2	0	2	0	0	27242	2
2	0	2	0	0	27243	2
2	0	2	0	0	27244	2
2	0	2	0	0	27245	2
2	0	2	0	0	27246	2
2	0	2	0	0	27247	2
2	0	2	0	0	27248	2
2	0	2	0	0	27249	2
2	0	2	0	0	27250	2
2	0	2	0	0	27251	2
2	0	2	0	0	27252	2
2	0	2	0	0	27253	2
2	0	2	0	0	27254	2
2	0	2	0	0	27255	2
2	0	2	0	0	27256	2
2	0	2	0	0	27257	2
2	0	2	0	0	27258	2
2	0	2	0	0	27259	2
2	0	2	0	0	27260	2
2	0	2	0	0	27261	2
2	0	2	0	0	27262	2
2	0	2	0	0	27263	2
2	0	2	0	0	27264	2
2	0	2	0	0	27265	2
2	0	2	0	0	27266	2
2	0	2	0	0	27267	2
2	0	2	0	0	27268	2
2	0	2	0	0	27269	2
2	0	2	0	0	27270	2
2	0	2	0	0	27271	2
2	1	2	0	1	27272	0
2	0	2	0	0	27273	2
2	0	2	0	0	27274	2
2	0	2	0	0	27275	2
2	0	2	0	0	27276	2
2	0	2	0	0	27277	2
2	0	2	0	0	27278	2
2	0	2	0	0	27279	2
2	0	2	0	0	27280	2
2	0	2	0	0	27281	2
2	0	2	0	0	27282	2
2	0	2	0	0	27283	2
2	0	2	0	0	27284	2
2	2	4	44	46	27285	1
2	0	2	0	0	27286	2
2	0	2	0	0	27287	2
2	1	4	0	1	27288	0
2	0	2	1	1	27289	2
2	0	2	0	0	27290	2
2	0	2	0	0	27291	2
2	0	2	0	0	27292	2
2	0	2	0	0	27293	2
2	0	2	0	0	27294	2
2	0	2	0	0	27295	2
2	0	2	0	0	27296	2
2	0	2	0	0	27297	2
2	0	2	0	0	27298	2
2	0	2	0	0	27299	2
2	0	2	0	0	27300	2
2	0	2	0	0	27301	2
2	0	2	0	0	27302	2
2	0	2	1	1	27303	2
2	0	2	0	0	27304	2
2	0	2	0	0	27305	2
2	0	2	0	0	27306	2
2	0	2	0	0	27307	2
2	0	2	0	0	27308	2
2	0	2	0	0	27309	2
2	0	2	0	0	27310	2
2	0	2	0	0	27311	2
2	0	2	0	0	27312	2
2	0	2	0	0	27313	2
2	0	2	0	0	27314	2
2	0	2	0	0	27315	2
2	0	2	0	0	27316	2
2	0	2	0	0	27317	2
2	0	2	0	0	27318	2
2	0	2	0	0	27319	2
2	0	2	0	0	27320	2
2	0	2	0	0	27321	2
2	0	2	0	0	27322	2
2	13	2	0	13	27323	0
2	5	2	134	139	27324	1
2	0	2	5	5	27325	2
2	0	2	0	0	27326	2
2	0	2	0	0	27327	2
2	0	2	0	0	27328	2
2	0	2	0	0	27329	2
2	0	2	0	0	27330	2
2	0	2	0	0	27331	2
2	0	2	0	0	27332	2
2	0	2	0	0	27333	2
2	0	2	0	0	27334	2
2	0	2	0	0	27335	2
2	0	2	0	0	27336	2
2	0	2	0	0	27337	2
2	0	2	0	0	27338	2
2	0	2	0	0	27339	2
2	0	2	0	0	27340	2
2	0	2	0	0	27341	2
2	0	2	0	0	27342	2
2	0	2	0	0	27343	2
2	0	2	0	0	27344	2
2	0	2	0	0	27345	2
2	0	2	0	0	27346	2
2	0	2	0	0	27347	2
2	44	2	1	45	27348	0
2	57	2	190	247	27349	1
2	0	2	4	4	27350	2
2	0	2	0	0	27351	2
2	24	2	2	26	27352	0
2	0	2	65	65	27353	2
2	0	2	0	0	27354	2
2	0	2	0	0	27355	2
2	0	2	0	0	27356	2
2	0	2	0	0	27357	2
2	0	2	0	0	27358	2
2	0	2	0	0	27359	2
2	6	2	1	7	27360	0
2	0	2	36	36	27361	2
2	0	2	0	0	27362	2
2	0	2	0	0	27363	2
2	0	2	0	0	27364	2
2	0	2	0	0	27365	2
2	0	2	0	0	27366	2
2	0	2	0	0	27367	2
2	0	2	0	0	27368	2
2	0	2	0	0	27369	2
2	0	2	0	0	27370	2
2	0	2	0	0	27371	2
2	0	2	0	0	27372	2
2	0	2	0	0	27373	2
2	0	2	0	0	27374	2
2	0	2	0	0	27375	2
2	0	2	0	0	27376	2
2	0	2	0	0	27377	2
2	0	2	0	0	27378	2
2	0	2	0	0	27379	2
2	0	2	0	0	27380	2
2	0	2	0	0	27381	2
2	0	2	0	0	27382	2
2	0	2	0	0	27383	2
2	0	2	0	0	27384	2
2	0	2	0	0	27385	2
2	0	2	0	0	27386	2
2	0	2	0	0	27387	2
2	0	2	3	3	27388	2
2	0	2	0	0	27389	2
2	0	2	0	0	27390	2
2	0	2	0	0	27391	2
2	0	2	0	0	27392	2
2	0	2	0	0	27393	2
2	0	2	2	2	27394	2
2	0	2	0	0	27395	2
2	0	2	0	0	27396	2
2	0	2	0	0	27397	2
2	0	2	0	0	27398	2
2	0	2	0	0	27399	2
2	1	2	0	1	27400	1
2	0	2	0	0	27401	2
2	0	2	0	0	27402	2
2	0	2	0	0	27403	2
2	0	2	0	0	27404	2
2	0	2	0	0	27405	2
2	0	2	0	0	27406	2
2	139	2	0	139	27407	0
2	0	2	14	14	27408	2
2	0	2	0	0	27409	2
2	0	2	0	0	27410	2
2	0	2	0	0	27411	2
2	0	2	0	0	27412	2
2	0	2	0	0	27413	2
2	8	2	0	8	27414	0
2	0	2	0	0	27415	2
2	1	2	0	1	27416	1
2	0	2	0	0	27417	2
2	0	2	0	0	27418	2
2	2	2	0	2	27419	1
2	0	2	0	0	27420	2
2	0	2	0	0	27421	2
2	0	2	0	0	27422	2
2	0	2	0	0	27423	2
2	0	2	0	0	27424	2
2	0	2	0	0	27425	2
2	0	2	0	0	27426	2
2	0	2	0	0	27427	2
2	0	2	0	0	27428	2
2	0	2	0	0	27429	2
2	0	2	0	0	27430	2
2	0	2	0	0	27431	2
2	0	2	0	0	27432	2
2	0	2	0	0	27433	2
2	0	2	0	0	27434	2
2	0	2	0	0	27435	2
2	0	2	0	0	27436	2
2	0	2	0	0	27437	2
2	0	2	0	0	27438	2
2	0	2	0	0	27439	2
2	0	2	0	0	27440	2
2	0	2	0	0	27441	2
2	0	2	0	0	27442	2
2	0	2	0	0	27443	2
2	0	2	0	0	27444	2
2	0	2	0	0	27445	2
2	1	2	0	1	27446	1
2	0	2	0	0	27447	2
2	0	2	0	0	27448	2
2	0	2	0	0	27449	2
2	0	2	0	0	27450	2
2	0	2	0	0	27451	2
2	0	2	0	0	27452	2
2	0	2	0	0	27453	2
2	0	2	0	0	27454	2
2	0	2	0	0	27455	2
2	0	2	0	0	27456	2
2	0	2	0	0	27457	2
2	0	2	0	0	27458	2
2	0	2	0	0	27459	2
2	0	2	0	0	27460	2
2	0	2	0	0	27461	2
2	0	2	0	0	27462	2
2	137	2	0	137	27463	0
2	69	2	2240	2309	27464	1
2	0	2	140	140	27465	2
2	0	2	1	1	27466	2
2	21	2	12	33	27467	0
2	0	2	130	130	27468	2
2	0	2	0	0	27469	2
2	0	2	0	0	27470	2
2	0	2	0	0	27471	2
2	0	2	0	0	27472	2
2	0	2	0	0	27473	2
2	0	2	0	0	27474	2
2	0	2	0	0	27475	2
2	0	2	0	0	27476	2
2	0	2	0	0	27477	2
2	0	2	0	0	27478	2
2	0	2	0	0	27479	2
2	0	2	0	0	27480	2
2	0	2	0	0	27481	2
2	0	2	0	0	27482	2
2	0	2	0	0	27483	2
2	0	2	0	0	27484	2
2	0	2	0	0	27485	2
2	0	2	0	0	27486	2
2	2	2	0	2	27487	0
2	0	2	0	0	27488	2
2	14	2	9	23	27489	1
2	0	2	0	0	27490	2
2	0	2	0	0	27491	2
2	1	2	0	1	27492	0
2	0	2	0	0	27493	2
2	0	2	5	5	27494	2
2	0	2	0	0	27495	2
2	0	2	0	0	27496	2
2	0	2	0	0	27497	2
2	0	2	0	0	27498	2
2	0	2	0	0	27499	2
2	0	2	0	0	27500	2
2	0	2	0	0	27501	2
2	0	2	0	0	27502	2
2	0	2	0	0	27503	2
2	0	2	0	0	27504	2
2	0	2	0	0	27505	2
2	0	2	0	0	27506	2
2	0	2	0	0	27507	2
2	0	2	0	0	27508	2
2	0	2	0	0	27509	2
2	0	2	0	0	27510	2
2	0	2	0	0	27511	2
2	0	2	0	0	27512	2
2	0	2	1	1	27513	2
2	0	2	0	0	27514	2
2	0	2	0	0	27515	2
2	0	2	0	0	27516	2
2	0	2	0	0	27517	2
2	0	2	0	0	27518	2
2	0	2	0	0	27519	2
2	0	2	0	0	27520	2
2	0	2	0	0	27521	2
2	0	2	0	0	27522	2
2	0	2	0	0	27523	2
2	0	2	0	0	27524	2
2	0	2	0	0	27525	2
2	0	2	0	0	27526	2
2	0	2	0	0	27527	2
2	0	2	0	0	27528	2
2	0	2	0	0	27529	2
2	0	2	0	0	27530	2
2	0	2	0	0	27531	2
2	0	2	0	0	27532	2
2	0	2	0	0	27533	2
2	0	2	0	0	27534	2
2	0	2	0	0	27535	2
2	0	2	0	0	27536	2
2	0	2	0	0	27537	2
2	0	2	0	0	27538	2
2	0	2	0	0	27539	2
2	0	2	2	2	27540	2
2	0	2	0	0	27541	2
2	0	2	0	0	27542	2
2	0	2	0	0	27543	2
2	0	2	0	0	27544	2
2	0	2	0	0	27545	2
2	0	2	0	0	27546	2
2	0	2	0	0	27547	2
2	0	2	0	0	27548	2
2	0	2	0	0	27549	2
2	0	2	0	0	27550	2
2	0	2	0	0	27551	2
2	0	2	0	0	27552	2
2	0	2	0	0	27553	2
2	0	2	0	0	27554	2
2	0	2	0	0	27555	2
2	0	2	0	0	27556	2
2	0	2	0	0	27557	2
2	0	2	2	2	27558	2
2	0	2	0	0	27559	2
2	0	2	0	0	27560	2
2	0	2	0	0	27561	2
2	0	2	0	0	27562	2
2	0	2	0	0	27563	2
2	0	2	0	0	27564	2
2	0	2	0	0	27565	2
2	0	2	0	0	27566	2
2	0	2	0	0	27567	2
2	0	2	0	0	27568	2
2	0	2	0	0	27569	2
2	0	4	5	5	27570	2
2	0	2	0	0	27571	2
2	0	2	0	0	27572	2
2	0	4	0	0	27573	2
2	0	2	0	0	27574	2
2	0	2	0	0	27575	2
2	0	2	0	0	27576	2
2	0	2	0	0	27577	2
2	0	2	0	0	27578	2
2	0	2	0	0	27579	2
2	0	2	0	0	27580	2
2	0	2	0	0	27581	2
2	0	2	0	0	27582	2
2	0	2	0	0	27583	2
2	0	2	0	0	27584	2
2	0	2	0	0	27585	2
2	0	2	0	0	27586	2
2	0	2	0	0	27587	2
2	0	2	0	0	27588	2
2	0	2	0	0	27589	2
2	0	2	0	0	27590	2
2	0	2	0	0	27591	2
2	0	2	4	4	27592	2
2	0	2	0	0	27593	2
2	0	2	0	0	27594	2
2	0	2	0	0	27595	2
2	0	2	4	4	27596	2
2	0	2	0	0	27597	2
2	0	2	0	0	27598	2
2	0	2	0	0	27599	2
2	0	2	0	0	27600	2
2	0	2	0	0	27601	2
2	0	2	0	0	27602	2
2	0	2	0	0	27603	2
2	0	2	0	0	27604	2
2	0	2	0	0	27605	2
2	0	2	0	0	27606	2
2	0	2	0	0	27607	2
2	0	2	0	0	27608	2
2	0	2	0	0	27609	2
2	0	2	0	0	27610	2
2	0	2	0	0	27611	2
2	0	2	0	0	27612	2
2	0	2	0	0	27613	2
2	0	2	0	0	27614	2
2	0	2	0	0	27615	2
2	0	2	0	0	27616	2
2	0	2	0	0	27617	2
2	0	2	0	0	27618	2
2	0	2	0	0	27619	2
2	0	2	0	0	27620	2
2	0	2	0	0	27621	2
2	0	2	0	0	27622	2
2	0	2	0	0	27623	2
2	0	2	0	0	27624	2
2	0	2	0	0	27625	2
2	0	2	0	0	27626	2
2	0	2	0	0	27627	2
2	0	2	0	0	27628	2
2	0	2	0	0	27629	2
2	0	2	0	0	27630	2
2	0	2	0	0	27631	2
2	0	2	0	0	27632	2
2	0	2	0	0	27633	2
2	0	2	0	0	27634	2
2	0	2	0	0	27635	2
2	0	2	0	0	27636	2
2	0	2	0	0	27637	2
2	0	2	0	0	27638	2
2	0	2	0	0	27639	2
2	0	2	0	0	27640	2
2	0	2	0	0	27641	2
2	0	2	0	0	27642	2
2	0	2	0	0	27643	2
2	0	2	0	0	27644	2
2	0	2	0	0	27645	2
2	0	2	0	0	27646	2
2	0	2	0	0	27647	2
2	0	2	0	0	27648	2
2	0	2	0	0	27649	2
2	0	2	0	0	27650	2
2	0	2	0	0	27651	2
2	0	2	0	0	27652	2
2	0	2	0	0	27653	2
2	0	2	0	0	27654	2
2	0	2	0	0	27655	2
2	16	2	0	16	27656	0
2	2	2	611	613	27657	1
2	0	2	1	1	27658	2
2	0	2	0	0	27659	2
2	1	2	7	8	27660	1
2	0	2	15	15	27661	2
4	0	2	3	3	27662	2
2	5	2	0	5	27663	0
2	2	2	116	118	27664	1
2	0	2	6	6	27665	2
2	0	2	0	0	27666	2
2	4	2	12	16	27667	1
2	0	2	34	34	27668	2
2	0	2	0	0	27669	2
2	0	2	0	0	27670	2
2	0	2	0	0	27671	2
2	0	2	0	0	27672	2
2	0	2	0	0	27673	2
2	0	2	0	0	27674	2
2	0	2	0	0	27675	2
2	0	2	0	0	27676	2
2	0	2	0	0	27677	2
2	0	2	0	0	27678	2
2	0	2	0	0	27679	2
2	0	2	0	0	27680	2
2	0	2	0	0	27681	2
2	0	2	0	0	27682	2
2	0	2	0	0	27683	2
2	0	2	0	0	27684	2
2	0	2	0	0	27685	2
2	0	2	0	0	27686	2
2	0	2	0	0	27687	2
2	0	2	0	0	27688	2
2	0	2	0	0	27689	2
2	0	2	0	0	27690	2
2	0	2	0	0	27691	2
2	0	2	0	0	27692	2
2	0	2	0	0	27693	2
2	0	2	0	0	27694	2
2	0	2	0	0	27695	2
2	0	2	0	0	27696	2
2	0	2	0	0	27697	2
2	0	2	0	0	27698	2
2	0	2	0	0	27699	2
2	0	2	0	0	27700	2
2	0	2	0	0	27701	2
2	0	2	0	0	27702	2
2	0	2	0	0	27703	2
2	0	2	0	0	27704	2
2	0	2	0	0	27705	2
2	0	2	0	0	27706	2
2	0	2	0	0	27707	2
2	0	2	0	0	27708	2
2	0	2	0	0	27709	2
2	0	2	0	0	27710	2
2	0	2	0	0	27711	2
2	0	2	0	0	27712	2
2	0	2	0	0	27713	2
2	0	2	0	0	27714	2
2	0	2	1	1	27715	2
2	0	2	0	0	27716	2
2	1	2	0	1	27717	1
2	0	2	0	0	27718	2
2	0	2	0	0	27719	2
2	0	2	0	0	27720	2
2	0	2	0	0	27721	2
2	0	2	0	0	27722	2
2	0	2	0	0	27723	2
2	0	2	0	0	27724	2
2	0	2	0	0	27725	2
2	0	2	0	0	27726	2
2	0	2	0	0	27727	2
2	0	2	0	0	27728	2
2	0	2	1	1	27729	2
2	0	2	0	0	27730	2
2	0	2	0	0	27731	2
2	0	2	0	0	27732	2
2	0	2	0	0	27733	2
2	0	2	0	0	27734	2
2	0	2	0	0	27735	2
2	0	2	0	0	27736	2
2	0	2	0	0	27737	2
2	0	2	0	0	27738	2
2	0	2	0	0	27739	2
2	0	2	0	0	27740	2
2	0	2	0	0	27741	2
2	0	2	0	0	27742	2
2	0	2	0	0	27743	2
2	0	2	0	0	27744	2
2	0	2	0	0	27745	2
2	0	2	0	0	27746	2
2	0	2	0	0	27747	2
2	0	2	0	0	27748	2
2	0	2	0	0	27749	2
2	0	2	0	0	27750	2
2	0	2	0	0	27751	2
2	0	2	0	0	27752	2
2	0	2	0	0	27753	2
2	0	2	0	0	27754	2
2	0	2	0	0	27755	2
2	0	2	0	0	27756	2
2	0	2	0	0	27757	2
2	0	2	0	0	27758	2
2	0	2	0	0	27759	2
2	0	2	0	0	27760	2
2	0	2	0	0	27761	2
2	0	2	0	0	27762	2
2	0	2	0	0	27763	2
2	0	2	0	0	27764	2
2	0	2	0	0	27765	2
2	0	2	0	0	27766	2
2	0	2	0	0	27767	2
2	0	2	0	0	27768	2
2	0	2	0	0	27769	2
2	0	2	0	0	27770	2
2	0	2	0	0	27771	2
2	0	2	0	0	27772	2
2	0	2	0	0	27773	2
2	0	2	0	0	27774	2
2	0	2	0	0	27775	2
2	0	2	0	0	27776	2
2	0	2	0	0	27777	2
2	0	2	0	0	27778	2
2	0	2	0	0	27779	2
2	17	2	0	17	27780	0
2	2	2	2	4	27781	0
2	0	2	17	17	27782	2
2	11	2	152	163	27783	1
2	0	2	2	2	27784	2
2	0	2	0	0	27785	2
2	0	2	0	0	27786	2
2	0	2	0	0	27787	2
2	0	2	0	0	27788	2
2	0	2	0	0	27789	2
2	0	2	0	0	27790	2
2	0	2	0	0	27791	2
2	9	2	0	9	27792	0
2	23	2	70	93	27793	1
2	0	2	0	0	27794	2
2	0	2	0	0	27795	2
2	2	2	0	2	27796	1
2	0	2	3	3	27797	2
2	0	2	0	0	27798	2
2	0	2	0	0	27799	2
2	0	2	0	0	27800	2
2	0	2	0	0	27801	2
2	0	2	0	0	27802	2
2	0	2	0	0	27803	2
2	0	2	0	0	27804	2
2	0	2	0	0	27805	2
2	0	2	0	0	27806	2
2	0	2	0	0	27807	2
2	0	2	0	0	27808	2
2	0	2	0	0	27809	2
2	0	2	0	0	27810	2
2	0	2	0	0	27811	2
2	0	2	0	0	27812	2
2	0	2	0	0	27813	2
2	0	2	0	0	27814	2
2	0	2	0	0	27815	2
2	0	2	0	0	27816	2
2	0	4	2	2	27817	2
2	0	2	1	1	27818	2
2	0	2	0	0	27819	2
2	1	4	0	1	27820	0
2	0	2	1	1	27821	2
2	0	2	0	0	27822	2
2	0	2	0	0	27823	2
2	0	2	0	0	27824	2
2	0	2	0	0	27825	2
2	0	2	0	0	27826	2
2	0	2	0	0	27827	2
2	0	2	0	0	27828	2
2	0	2	0	0	27829	2
2	0	2	0	0	27830	2
2	0	2	0	0	27831	2
2	0	2	0	0	27832	2
2	0	2	0	0	27833	2
2	15	2	0	15	27834	0
2	2	2	253	255	27835	1
2	0	2	0	0	27836	2
2	0	2	0	0	27837	2
2	9	2	0	9	27838	1
2	0	2	73	73	27839	2
2	0	2	0	0	27840	2
2	0	2	0	0	27841	2
2	0	2	0	0	27842	2
2	0	2	0	0	27843	2
2	0	2	0	0	27844	2
2	0	2	0	0	27845	2
2	0	2	0	0	27846	2
2	0	2	0	0	27847	2
2	0	2	0	0	27848	2
2	0	2	0	0	27849	2
2	3	2	0	3	27850	0
2	0	2	0	0	27851	2
2	0	2	0	0	27852	2
2	0	2	0	0	27853	2
2	0	2	1	1	27854	2
2	0	2	0	0	27855	2
2	0	2	0	0	27856	2
2	0	2	0	0	27857	2
2	0	2	0	0	27858	2
2	0	2	0	0	27859	2
2	0	2	0	0	27860	2
2	0	2	0	0	27861	2
2	0	2	0	0	27862	2
2	0	2	0	0	27863	2
2	0	2	0	0	27864	2
2	0	2	0	0	27865	2
2	0	2	0	0	27866	2
2	0	2	0	0	27867	2
2	0	2	0	0	27868	2
2	0	2	0	0	27869	2
2	0	2	0	0	27870	2
2	0	2	0	0	27871	2
2	0	2	0	0	27872	2
2	0	2	0	0	27873	2
2	0	2	0	0	27874	2
2	0	2	0	0	27875	2
2	0	2	0	0	27876	2
2	0	2	0	0	27877	2
2	0	2	0	0	27878	2
2	0	2	0	0	27879	2
2	0	2	0	0	27880	2
2	0	2	0	0	27881	2
2	0	2	0	0	27882	2
2	0	2	0	0	27883	2
2	0	2	0	0	27884	2
2	0	2	0	0	27885	2
2	0	2	0	0	27886	2
2	0	2	0	0	27887	2
2	0	2	0	0	27888	2
2	0	2	0	0	27889	2
2	0	2	0	0	27890	2
2	0	2	0	0	27891	2
2	0	2	0	0	27892	2
2	0	2	0	0	27893	2
2	0	2	0	0	27894	2
2	0	2	0	0	27895	2
2	0	2	0	0	27896	2
2	0	2	0	0	27897	2
2	0	2	0	0	27898	2
2	0	2	0	0	27899	2
2	0	2	0	0	27900	2
2	0	2	0	0	27901	2
2	0	2	0	0	27902	2
2	0	2	0	0	27903	2
2	0	2	0	0	27904	2
2	0	2	0	0	27905	2
2	0	2	0	0	27906	2
2	0	2	0	0	27907	2
2	0	2	0	0	27908	2
2	0	2	0	0	27909	2
2	0	2	0	0	27910	2
2	0	2	0	0	27911	2
2	0	2	0	0	27912	2
2	0	2	0	0	27913	2
2	0	2	0	0	27914	2
2	11	2	0	11	27915	0
2	0	2	0	0	27916	2
2	0	2	0	0	27917	2
2	0	2	0	0	27918	2
2	0	2	0	0	27919	2
2	0	2	0	0	27920	2
2	0	2	0	0	27921	2
2	0	2	0	0	27922	2
2	0	2	0	0	27923	2
2	0	2	0	0	27924	2
2	0	2	0	0	27925	2
2	0	2	0	0	27926	2
2	0	2	0	0	27927	2
2	0	2	0	0	27928	2
2	0	2	0	0	27929	2
2	0	2	1	1	27930	2
2	0	2	0	0	27931	2
2	0	2	0	0	27932	2
2	0	2	0	0	27933	2
2	0	2	0	0	27934	2
2	0	2	0	0	27935	2
2	0	2	0	0	27936	2
2	0	2	0	0	27937	2
2	0	2	0	0	27938	2
2	0	2	0	0	27939	2
2	0	2	0	0	27940	2
2	0	2	0	0	27941	2
2	0	2	0	0	27942	2
2	0	2	0	0	27943	2
2	0	2	0	0	27944	2
2	0	2	0	0	27945	2
2	0	2	0	0	27946	2
2	0	2	0	0	27947	2
2	0	2	0	0	27948	2
2	0	2	0	0	27949	2
2	0	2	0	0	27950	2
2	0	2	0	0	27951	2
2	0	2	0	0	27952	2
2	0	2	1	1	27953	2
2	0	2	0	0	27954	2
2	0	2	0	0	27955	2
2	0	2	0	0	27956	2
2	0	2	0	0	27957	2
2	0	2	0	0	27958	2
2	0	2	0	0	27959	2
2	0	2	8	8	27960	2
2	0	2	0	0	27961	2
2	0	2	0	0	27962	2
2	0	2	2	2	27963	2
2	0	2	1	1	27964	2
2	0	2	1	1	27965	2
2	0	2	0	0	27966	2
2	1	2	2	3	27967	1
2	0	2	0	0	27968	2
2	0	2	0	0	27969	2
2	0	2	0	0	27970	2
2	0	2	0	0	27971	2
2	0	2	0	0	27972	2
2	0	2	0	0	27973	2
2	0	2	0	0	27974	2
2	0	2	0	0	27975	2
2	0	2	0	0	27976	2
2	0	2	0	0	27977	2
2	0	2	0	0	27978	2
2	0	2	0	0	27979	2
2	0	2	0	0	27980	2
2	0	2	0	0	27981	2
2	0	4	0	0	27982	2
2	0	2	0	0	27983	2
2	0	2	0	0	27984	2
2	0	4	0	0	27985	2
2	0	2	0	0	27986	2
2	0	2	0	0	27987	2
2	0	2	0	0	27988	2
2	0	2	0	0	27989	2
2	0	2	0	0	27990	2
2	0	2	0	0	27991	2
2	0	2	0	0	27992	2
2	1	2	0	1	27993	0
2	0	2	0	0	27994	2
2	0	2	0	0	27995	2
2	0	2	0	0	27996	2
2	0	2	0	0	27997	2
2	0	2	0	0	27998	2
2	0	2	0	0	27999	2
2	0	2	0	0	28000	2
2	0	2	0	0	28001	2
2	0	2	0	0	28002	2
2	0	2	0	0	28003	2
2	0	2	0	0	28004	2
2	0	2	0	0	28005	2
2	0	2	0	0	28006	2
2	0	2	0	0	28007	2
2	0	2	0	0	28008	2
2	0	2	0	0	28009	2
2	0	2	0	0	28010	2
2	0	2	0	0	28011	2
2	0	2	0	0	28012	2
2	0	2	0	0	28013	2
2	0	2	0	0	28014	2
2	0	2	0	0	28015	2
2	0	2	0	0	28016	2
2	0	2	0	0	28017	2
2	0	2	0	0	28018	2
2	0	2	0	0	28019	2
2	0	2	0	0	28020	2
2	0	2	0	0	28021	2
2	0	2	0	0	28022	2
2	0	2	0	0	28023	2
2	0	2	0	0	28024	2
2	0	2	0	0	28025	2
2	0	2	0	0	28026	2
2	0	2	0	0	28027	2
2	0	2	0	0	28028	2
2	0	2	0	0	28029	2
2	0	2	0	0	28030	2
2	0	2	0	0	28031	2
2	0	2	0	0	28032	2
2	0	2	0	0	28033	2
2	0	2	0	0	28034	2
2	0	2	0	0	28035	2
2	0	2	0	0	28036	2
2	0	4	9	9	28037	2
2	0	2	0	0	28038	2
2	0	2	0	0	28039	2
2	0	4	85	85	28040	2
2	0	2	1	1	28041	2
2	0	2	0	0	28042	2
2	0	2	0	0	28043	2
2	0	2	0	0	28044	2
2	0	2	0	0	28045	2
2	0	2	0	0	28046	2
2	0	2	0	0	28047	2
2	0	2	0	0	28048	2
2	0	2	0	0	28049	2
2	0	2	0	0	28050	2
2	0	2	0	0	28051	2
2	0	2	0	0	28052	2
2	0	2	0	0	28053	2
2	0	2	0	0	28054	2
2	0	2	0	0	28055	2
2	0	2	0	0	28056	2
2	0	2	0	0	28057	2
2	0	2	0	0	28058	2
2	0	2	0	0	28059	2
2	0	2	0	0	28060	2
2	0	2	0	0	28061	2
2	0	2	0	0	28062	2
2	0	2	0	0	28063	2
2	0	2	0	0	28064	2
2	0	2	0	0	28065	2
2	0	2	0	0	28066	2
2	0	2	0	0	28067	2
2	0	2	0	0	28068	2
2	0	2	0	0	28069	2
2	0	2	0	0	28070	2
2	0	2	0	0	28071	2
2	0	2	0	0	28072	2
2	0	2	0	0	28073	2
2	0	2	0	0	28074	2
2	0	2	0	0	28075	2
2	0	2	0	0	28076	2
2	0	2	0	0	28077	2
2	0	2	0	0	28078	2
2	0	2	0	0	28079	2
2	0	2	0	0	28080	2
2	0	2	0	0	28081	2
2	0	2	0	0	28082	2
2	0	2	0	0	28083	2
2	0	2	0	0	28084	2
2	0	2	0	0	28085	2
2	0	2	0	0	28086	2
2	0	2	0	0	28087	2
2	0	2	0	0	28088	2
2	0	2	0	0	28089	2
2	0	2	0	0	28090	2
2	0	4	0	0	28091	2
2	0	2	0	0	28092	2
2	0	2	0	0	28093	2
2	0	4	0	0	28094	2
2	0	2	0	0	28095	2
2	0	2	0	0	28096	2
2	0	2	0	0	28097	2
2	0	2	0	0	28098	2
2	0	2	0	0	28099	2
2	0	2	0	0	28100	2
2	0	2	0	0	28101	2
2	0	2	0	0	28102	2
2	0	2	0	0	28103	2
2	0	2	0	0	28104	2
2	0	2	0	0	28105	2
2	0	2	0	0	28106	2
2	0	2	0	0	28107	2
2	0	2	0	0	28108	2
2	0	2	1	1	28109	2
2	0	2	0	0	28110	2
2	0	2	0	0	28111	2
2	0	2	0	0	28112	2
2	0	2	0	0	28113	2
2	0	2	0	0	28114	2
2	1	2	0	1	28115	1
2	0	2	0	0	28116	2
2	0	2	0	0	28117	2
2	0	2	0	0	28118	2
2	0	2	0	0	28119	2
2	0	2	0	0	28120	2
2	0	2	0	0	28121	2
2	0	2	0	0	28122	2
2	0	2	0	0	28123	2
2	0	2	0	0	28124	2
2	0	2	0	0	28125	2
2	0	2	0	0	28126	2
2	0	2	0	0	28127	2
2	0	2	0	0	28128	2
2	0	2	0	0	28129	2
2	0	2	0	0	28130	2
2	0	2	0	0	28131	2
2	0	2	0	0	28132	2
2	0	2	0	0	28133	2
2	0	2	0	0	28134	2
2	0	2	0	0	28135	2
2	0	2	0	0	28136	2
2	0	2	0	0	28137	2
2	0	2	0	0	28138	2
2	0	2	0	0	28139	2
2	0	2	0	0	28140	2
2	0	2	0	0	28141	2
2	0	2	0	0	28142	2
2	0	2	0	0	28143	2
2	0	2	0	0	28144	2
2	0	2	0	0	28145	2
2	0	2	0	0	28146	2
2	0	2	0	0	28147	2
2	0	2	0	0	28148	2
2	0	2	0	0	28149	2
2	0	2	0	0	28150	2
2	0	2	0	0	28151	2
2	0	2	0	0	28152	2
2	7	2	0	7	28153	0
2	0	2	16	16	28154	2
2	0	2	2	2	28155	2
2	0	2	0	0	28156	2
2	0	2	0	0	28157	2
2	0	2	0	0	28158	2
2	0	2	0	0	28159	2
2	0	2	0	0	28160	2
2	0	2	0	0	28161	2
2	0	2	0	0	28162	2
2	0	2	0	0	28163	2
2	0	2	0	0	28164	2
2	0	2	0	0	28165	2
2	0	2	0	0	28166	2
2	0	2	0	0	28167	2
2	0	2	0	0	28168	2
2	0	2	0	0	28169	2
2	0	2	0	0	28170	2
2	0	2	0	0	28171	2
2	0	2	0	0	28172	2
2	0	2	0	0	28173	2
2	0	2	0	0	28174	2
2	0	2	0	0	28175	2
2	0	2	0	0	28176	2
2	4	2	0	4	28177	0
2	18	2	23	41	28178	1
2	0	2	2	2	28179	2
2	0	2	0	0	28180	2
2	6	2	0	6	28181	0
2	0	2	11	11	28182	2
2	1	2	0	1	28183	0
2	0	2	0	0	28184	2
2	0	2	0	0	28185	2
2	0	2	0	0	28186	2
2	2	2	1	3	28187	1
2	0	2	8	8	28188	2
2	0	2	0	0	28189	2
2	0	2	0	0	28190	2
2	0	2	0	0	28191	2
2	0	2	0	0	28192	2
2	0	2	0	0	28193	2
2	0	2	0	0	28194	2
2	0	2	0	0	28195	2
2	0	2	0	0	28196	2
2	0	2	0	0	28197	2
2	0	2	0	0	28198	2
2	0	2	0	0	28199	2
2	0	2	0	0	28200	2
2	0	2	0	0	28201	2
2	0	2	0	0	28202	2
2	0	2	0	0	28203	2
2	0	2	0	0	28204	2
2	0	2	0	0	28205	2
2	0	2	0	0	28206	2
2	0	2	0	0	28207	2
2	0	2	0	0	28208	2
2	0	2	0	0	28209	2
2	0	2	0	0	28210	2
2	0	2	0	0	28211	2
2	0	2	0	0	28212	2
2	0	2	0	0	28213	2
2	0	2	0	0	28214	2
2	0	2	0	0	28215	2
2	0	2	0	0	28216	2
2	0	2	0	0	28217	2
2	0	2	0	0	28218	2
2	0	2	0	0	28219	2
2	0	2	0	0	28220	2
2	0	2	0	0	28221	2
2	0	2	0	0	28222	2
2	0	2	0	0	28223	2
2	0	2	0	0	28224	2
2	0	2	0	0	28225	2
2	0	2	0	0	28226	2
2	0	2	0	0	28227	2
2	0	2	0	0	28228	2
2	0	2	0	0	28229	2
2	0	2	0	0	28230	2
2	0	2	0	0	28231	2
2	0	2	0	0	28232	2
2	0	2	0	0	28233	2
2	0	2	0	0	28234	2
2	0	2	2	2	28235	2
2	0	2	0	0	28236	2
2	0	2	0	0	28237	2
2	0	2	0	0	28238	2
2	0	2	0	0	28239	2
2	19	2	0	19	28240	0
2	5	2	481	486	28241	1
2	0	2	1	1	28242	2
2	0	2	1	1	28243	2
2	0	2	0	0	28244	2
2	0	2	0	0	28245	2
2	0	2	0	0	28246	2
2	0	2	0	0	28247	2
2	0	2	0	0	28248	2
2	0	2	0	0	28249	2
2	0	2	0	0	28250	2
2	0	2	0	0	28251	2
2	0	2	0	0	28252	2
2	0	2	0	0	28253	2
2	0	2	0	0	28254	2
2	0	2	0	0	28255	2
2	0	2	0	0	28256	2
2	0	2	0	0	28257	2
2	0	2	0	0	28258	2
2	0	2	0	0	28259	2
2	0	2	0	0	28260	2
2	0	2	0	0	28261	2
2	0	2	0	0	28262	2
2	0	2	0	0	28263	2
2	0	2	0	0	28264	2
2	0	2	0	0	28265	2
2	0	2	0	0	28266	2
2	0	2	0	0	28267	2
2	0	2	0	0	28268	2
2	0	2	0	0	28269	2
2	0	2	0	0	28270	2
2	0	2	0	0	28271	2
2	0	2	0	0	28272	2
2	0	2	0	0	28273	2
2	0	2	0	0	28274	2
2	0	2	0	0	28275	2
2	0	2	0	0	28276	2
2	0	2	0	0	28277	2
2	0	2	0	0	28278	2
2	0	2	0	0	28279	2
2	0	2	0	0	28280	2
2	0	2	0	0	28281	2
2	0	2	0	0	28282	2
2	0	2	0	0	28283	2
2	0	2	1	1	28284	2
2	0	2	0	0	28285	2
2	0	2	0	0	28286	2
2	0	2	0	0	28287	2
2	0	2	0	0	28288	2
2	0	2	0	0	28289	2
2	0	2	0	0	28290	2
2	0	2	0	0	28291	2
2	0	2	0	0	28292	2
2	0	2	0	0	28293	2
2	0	2	0	0	28294	2
2	0	2	0	0	28295	2
2	0	2	0	0	28296	2
2	0	2	0	0	28297	2
2	0	2	0	0	28298	2
2	0	2	0	0	28299	2
2	1	2	1	2	28300	1
2	0	2	0	0	28301	2
2	0	2	0	0	28302	2
2	0	2	0	0	28303	2
2	0	2	0	0	28304	2
2	0	2	0	0	28305	2
2	0	2	0	0	28306	2
2	0	2	0	0	28307	2
2	0	2	0	0	28308	2
2	0	2	0	0	28309	2
2	0	2	0	0	28310	2
2	0	2	0	0	28311	2
2	0	2	0	0	28312	2
2	0	2	0	0	28313	2
2	0	2	0	0	28314	2
2	0	2	0	0	28315	2
2	0	2	0	0	28316	2
2	0	2	0	0	28317	2
2	0	2	0	0	28318	2
2	0	2	0	0	28319	2
2	0	2	0	0	28320	2
2	0	2	0	0	28321	2
2	0	2	0	0	28322	2
2	0	2	0	0	28323	2
2	0	2	0	0	28324	2
2	0	2	0	0	28325	2
2	0	2	0	0	28326	2
2	0	2	0	0	28327	2
2	0	2	0	0	28328	2
2	0	2	0	0	28329	2
2	0	2	0	0	28330	2
2	0	2	0	0	28331	2
2	0	2	0	0	28332	2
2	0	2	0	0	28333	2
2	0	2	0	0	28334	2
2	0	2	0	0	28335	2
2	0	2	0	0	28336	2
2	0	2	0	0	28337	2
2	0	2	0	0	28338	2
2	0	2	0	0	28339	2
2	0	2	0	0	28340	2
2	0	2	0	0	28341	2
2	0	2	0	0	28342	2
2	0	2	0	0	28343	2
2	0	2	0	0	28344	2
2	0	2	0	0	28345	2
2	0	2	0	0	28346	2
2	0	2	0	0	28347	2
2	0	2	0	0	28348	2
2	0	2	0	0	28349	2
2	0	2	0	0	28350	2
2	0	2	0	0	28351	2
2	0	2	0	0	28352	2
2	0	2	0	0	28353	2
2	0	2	0	0	28354	2
2	0	2	0	0	28355	2
2	0	2	0	0	28356	2
2	0	2	0	0	28357	2
2	0	2	0	0	28358	2
2	0	2	0	0	28359	2
2	0	2	0	0	28360	2
2	0	2	0	0	28361	2
2	0	2	0	0	28362	2
2	0	2	0	0	28363	2
2	0	2	0	0	28364	2
2	0	2	0	0	28365	2
2	0	2	0	0	28366	2
2	0	2	0	0	28367	2
2	0	2	5	5	28368	2
2	0	2	0	0	28369	2
2	0	2	0	0	28370	2
2	1	2	0	1	28371	1
2	0	2	2	2	28372	2
2	0	2	0	0	28373	2
2	0	2	1	1	28374	2
2	0	2	0	0	28375	2
2	0	2	0	0	28376	2
2	0	2	0	0	28377	2
2	0	2	0	0	28378	2
2	0	2	0	0	28379	2
2	0	2	1	1	28380	2
2	0	2	0	0	28381	2
2	0	2	0	0	28382	2
2	0	2	0	0	28383	2
2	0	2	0	0	28384	2
2	0	2	0	0	28385	2
2	0	2	0	0	28386	2
2	0	2	0	0	28387	2
2	0	2	0	0	28388	2
2	0	2	0	0	28389	2
2	0	2	0	0	28390	2
2	0	2	0	0	28391	2
2	0	2	0	0	28392	2
2	0	2	0	0	28393	2
2	0	2	0	0	28394	2
2	0	2	0	0	28395	2
2	0	2	0	0	28396	2
2	0	2	0	0	28397	2
2	0	2	0	0	28398	2
2	0	2	0	0	28399	2
2	0	2	0	0	28400	2
2	0	2	0	0	28401	2
2	0	2	0	0	28402	2
2	0	2	0	0	28403	2
2	0	2	0	0	28404	2
2	0	2	0	0	28405	2
2	0	2	0	0	28406	2
2	0	2	0	0	28407	2
2	0	2	0	0	28408	2
2	0	2	0	0	28409	2
2	0	2	0	0	28410	2
2	0	2	0	0	28411	2
2	0	2	0	0	28412	2
2	0	2	0	0	28413	2
2	0	2	0	0	28414	2
2	0	2	0	0	28415	2
2	0	2	0	0	28416	2
2	1	2	0	1	28417	0
2	0	2	0	0	28418	2
2	0	2	1	1	28419	2
2	0	2	0	0	28420	2
2	0	2	1	1	28421	2
2	0	2	0	0	28422	2
2	0	2	0	0	28423	2
2	0	2	5	5	28424	2
2	0	2	0	0	28425	2
2	0	2	0	0	28426	2
2	0	2	0	0	28427	2
2	0	2	3	3	28428	2
2	0	2	0	0	28429	2
2	0	2	0	0	28430	2
2	0	2	0	0	28431	2
2	0	2	0	0	28432	2
2	0	2	0	0	28433	2
2	0	2	0	0	28434	2
2	0	2	0	0	28435	2
2	0	2	0	0	28436	2
2	0	2	0	0	28437	2
2	0	2	0	0	28438	2
2	0	2	0	0	28439	2
2	0	2	0	0	28440	2
2	0	2	0	0	28441	2
2	0	2	0	0	28442	2
2	0	2	0	0	28443	2
2	0	2	0	0	28444	2
2	3	2	0	3	28445	0
2	0	2	0	0	28446	2
2	0	2	0	0	28447	2
2	0	2	0	0	28448	2
2	0	2	0	0	28449	2
2	0	2	0	0	28450	2
2	0	2	0	0	28451	2
2	0	2	79	79	28452	2
2	0	2	0	0	28453	2
2	0	2	0	0	28454	2
2	0	2	0	0	28455	2
2	0	2	8	8	28456	2
2	0	2	0	0	28457	2
2	0	2	0	0	28458	2
2	0	2	0	0	28459	2
2	0	2	0	0	28460	2
2	0	2	0	0	28461	2
2	0	2	0	0	28462	2
2	0	2	0	0	28463	2
2	1	4	1725	1726	28464	1
2	0	2	0	0	28465	2
2	0	2	0	0	28466	2
2	1	4	695	696	28467	1
2	0	2	0	0	28468	2
2	0	2	0	0	28469	2
2	0	2	0	0	28470	2
2	0	2	0	0	28471	2
2	0	2	0	0	28472	2
2	0	2	0	0	28473	2
2	0	2	0	0	28474	2
2	0	2	0	0	28475	2
2	0	2	0	0	28476	2
2	0	2	0	0	28477	2
2	0	2	0	0	28478	2
2	0	2	0	0	28479	2
2	0	2	0	0	28480	2
2	0	2	0	0	28481	2
2	0	2	0	0	28482	2
2	0	2	0	0	28483	2
2	0	2	0	0	28484	2
2	0	2	0	0	28485	2
2	0	2	0	0	28486	2
2	0	2	0	0	28487	2
2	0	2	0	0	28488	2
2	0	2	0	0	28489	2
2	0	2	0	0	28490	2
2	0	2	0	0	28491	2
2	0	2	0	0	28492	2
2	0	2	0	0	28493	2
2	0	2	0	0	28494	2
2	0	2	0	0	28495	2
2	0	2	0	0	28496	2
2	1	2	4	5	28497	1
2	0	2	0	0	28498	2
2	0	2	0	0	28499	2
2	1	2	0	1	28500	1
2	0	2	1	1	28501	2
2	6	2	0	6	28502	1
2	0	2	0	0	28503	2
2	0	2	0	0	28504	2
2	0	2	0	0	28505	2
2	0	2	0	0	28506	2
2	0	2	0	0	28507	2
2	0	2	0	0	28508	2
2	0	2	0	0	28509	2
2	0	2	0	0	28510	2
2	0	2	0	0	28511	2
2	0	2	0	0	28512	2
2	0	2	0	0	28513	2
2	0	2	0	0	28514	2
2	0	2	0	0	28515	2
2	1	2	0	1	28516	0
2	0	2	11	11	28517	2
2	0	2	0	0	28518	2
2	0	2	0	0	28519	2
2	0	2	0	0	28520	2
2	0	2	0	0	28521	2
2	0	2	0	0	28522	2
2	0	2	0	0	28523	2
2	0	2	0	0	28524	2
2	0	2	0	0	28525	2
2	0	2	0	0	28526	2
2	0	2	0	0	28527	2
2	0	2	0	0	28528	2
2	0	2	0	0	28529	2
2	0	2	0	0	28530	2
2	0	2	0	0	28531	2
2	0	2	0	0	28532	2
2	0	2	0	0	28533	2
2	0	2	0	0	28534	2
2	0	2	0	0	28535	2
2	0	2	0	0	28536	2
2	0	2	0	0	28537	2
2	0	2	0	0	28538	2
2	0	2	0	0	28539	2
2	0	2	0	0	28540	2
2	0	2	0	0	28541	2
2	0	2	0	0	28542	2
2	0	2	0	0	28543	2
2	0	2	0	0	28544	2
2	0	2	0	0	28545	2
2	0	2	0	0	28546	2
2	0	2	0	0	28547	2
2	0	2	0	0	28548	2
2	0	2	0	0	28549	2
2	0	2	0	0	28550	2
2	0	2	0	0	28551	2
2	0	2	0	0	28552	2
2	1	2	5	6	28553	1
2	0	2	1	1	28554	2
2	0	2	0	0	28555	2
2	0	2	2	2	28556	2
2	0	2	0	0	28557	2
2	0	2	0	0	28558	2
2	0	2	0	0	28559	2
2	0	2	0	0	28560	2
2	0	2	0	0	28561	2
2	0	2	0	0	28562	2
2	0	2	0	0	28563	2
2	0	2	0	0	28564	2
2	0	2	0	0	28565	2
2	0	2	0	0	28566	2
2	0	2	0	0	28567	2
2	0	2	0	0	28568	2
2	0	2	0	0	28569	2
2	0	2	0	0	28570	2
2	0	2	0	0	28571	2
2	0	2	0	0	28572	2
2	0	2	0	0	28573	2
2	0	2	0	0	28574	2
2	0	2	0	0	28575	2
2	0	2	0	0	28576	2
2	0	2	0	0	28577	2
2	0	2	0	0	28578	2
2	0	2	0	0	28579	2
2	0	2	0	0	28580	2
2	0	2	0	0	28581	2
2	0	2	0	0	28582	2
2	0	2	0	0	28583	2
2	0	2	0	0	28584	2
2	0	2	0	0	28585	2
2	1	2	0	1	28586	1
2	0	2	0	0	28587	2
2	0	2	0	0	28588	2
2	0	2	0	0	28589	2
2	0	2	3	3	28590	2
2	0	2	0	0	28591	2
2	1	2	0	1	28592	0
2	0	2	0	0	28593	2
2	0	2	0	0	28594	2
2	0	2	5	5	28595	2
2	0	2	0	0	28596	2
2	0	2	0	0	28597	2
2	0	2	0	0	28598	2
2	1	2	0	1	28599	1
2	0	2	0	0	28600	2
2	0	2	0	0	28601	2
2	0	2	0	0	28602	2
2	0	2	0	0	28603	2
2	0	2	0	0	28604	2
2	0	2	0	0	28605	2
2	0	2	0	0	28606	2
2	0	2	0	0	28607	2
2	0	2	0	0	28608	2
2	0	2	0	0	28609	2
2	0	2	0	0	28610	2
2	0	2	0	0	28611	2
2	0	2	0	0	28612	2
2	0	2	0	0	28613	2
2	0	2	0	0	28614	2
2	0	2	0	0	28615	2
2	0	2	0	0	28616	2
2	0	2	0	0	28617	2
2	0	2	0	0	28618	2
2	0	2	0	0	28619	2
2	0	2	0	0	28620	2
2	2	2	8	10	28621	1
2	0	2	0	0	28622	2
2	0	2	0	0	28623	2
2	1	2	3	4	28624	0
2	0	2	0	0	28625	2
2	20	2	0	20	28626	0
2	44	2	280	324	28627	1
2	0	2	1	1	28628	2
2	0	2	0	0	28629	2
2	6	2	2	8	28630	1
2	0	2	7	7	28631	2
2	0	2	0	0	28632	2
2	0	2	0	0	28633	2
2	0	2	0	0	28634	2
2	0	2	0	0	28635	2
2	0	2	0	0	28636	2
2	0	2	0	0	28637	2
2	0	2	0	0	28638	2
2	0	2	0	0	28639	2
2	0	2	0	0	28640	2
2	0	2	0	0	28641	2
2	0	2	0	0	28642	2
2	0	2	0	0	28643	2
2	0	2	0	0	28644	2
2	0	2	0	0	28645	2
2	0	2	0	0	28646	2
2	0	2	0	0	28647	2
2	2	2	2	4	28648	1
2	0	2	0	0	28649	2
2	0	2	0	0	28650	2
2	0	2	0	0	28651	2
2	0	2	1	1	28652	2
2	0	2	0	0	28653	2
2	0	2	0	0	28654	2
2	0	2	0	0	28655	2
2	0	2	0	0	28656	2
2	0	2	0	0	28657	2
2	0	2	0	0	28658	2
2	0	2	0	0	28659	2
2	0	2	0	0	28660	2
2	0	2	0	0	28661	2
2	0	2	0	0	28662	2
2	0	2	0	0	28663	2
2	0	2	0	0	28664	2
2	0	2	0	0	28665	2
2	0	2	0	0	28666	2
2	0	2	0	0	28667	2
2	0	2	0	0	28668	2
2	0	2	0	0	28669	2
2	0	2	0	0	28670	2
2	0	2	0	0	28671	2
2	0	2	0	0	28672	2
2	0	2	0	0	28673	2
2	0	2	0	0	28674	2
2	0	2	0	0	28675	2
2	0	2	0	0	28676	2
2	0	2	0	0	28677	2
2	0	2	0	0	28678	2
2	0	2	0	0	28679	2
2	0	2	0	0	28680	2
2	0	2	0	0	28681	2
2	0	2	0	0	28682	2
2	0	2	0	0	28683	2
2	0	2	0	0	28684	2
2	0	2	0	0	28685	2
2	0	2	0	0	28686	2
2	0	2	0	0	28687	2
2	0	2	0	0	28688	2
2	0	2	0	0	28689	2
2	0	2	0	0	28690	2
2	0	2	0	0	28691	2
2	0	2	0	0	28692	2
2	0	2	0	0	28693	2
2	0	2	0	0	28694	2
2	0	2	0	0	28695	2
2	0	2	0	0	28696	2
2	0	2	0	0	28697	2
2	0	2	0	0	28698	2
2	0	2	0	0	28699	2
2	0	2	0	0	28700	2
2	0	2	0	0	28701	2
2	0	2	0	0	28702	2
2	0	2	0	0	28703	2
2	0	2	0	0	28704	2
2	0	2	0	0	28705	2
2	0	2	0	0	28706	2
2	0	2	0	0	28707	2
2	0	2	0	0	28708	2
2	0	2	0	0	28709	2
2	28	2	0	28	28710	0
2	0	2	2	2	28711	2
2	0	2	0	0	28712	2
2	0	2	0	0	28713	2
2	0	2	0	0	28714	2
2	0	2	0	0	28715	2
2	0	2	0	0	28716	2
2	0	2	0	0	28717	2
2	0	2	0	0	28718	2
2	0	2	0	0	28719	2
2	0	2	0	0	28720	2
2	0	2	0	0	28721	2
2	0	2	0	0	28722	2
2	0	2	0	0	28723	2
2	0	2	0	0	28724	2
2	0	2	0	0	28725	2
2	0	2	1	1	28726	2
2	0	2	0	0	28727	2
2	0	2	0	0	28728	2
2	0	2	1	1	28729	2
2	0	2	0	0	28730	2
2	0	2	0	0	28731	2
2	0	2	0	0	28732	2
2	0	2	0	0	28733	2
2	0	2	0	0	28734	2
2	0	2	0	0	28735	2
2	0	2	0	0	28736	2
2	0	2	0	0	28737	2
2	0	2	0	0	28738	2
2	0	2	0	0	28739	2
2	0	2	0	0	28740	2
2	0	2	0	0	28741	2
2	0	2	0	0	28742	2
2	0	2	0	0	28743	2
2	0	2	0	0	28744	2
2	0	2	0	0	28745	2
2	0	2	0	0	28746	2
2	0	2	0	0	28747	2
2	0	2	0	0	28748	2
2	0	2	0	0	28749	2
2	0	2	0	0	28750	2
2	0	2	0	0	28751	2
2	0	2	0	0	28752	2
2	0	2	0	0	28753	2
2	0	2	0	0	28754	2
2	0	2	2	2	28755	2
2	0	2	0	0	28756	2
2	0	2	0	0	28757	2
2	0	2	0	0	28758	2
2	0	2	0	0	28759	2
2	0	2	0	0	28760	2
2	0	2	0	0	28761	2
2	0	2	0	0	28762	2
2	0	2	0	0	28763	2
2	7	2	1	8	28764	1
2	0	2	0	0	28765	2
2	0	2	0	0	28766	2
2	0	2	0	0	28767	2
2	0	2	1	1	28768	2
2	0	2	0	0	28769	2
2	0	2	0	0	28770	2
2	0	2	0	0	28771	2
2	0	2	0	0	28772	2
2	0	2	0	0	28773	2
2	0	2	0	0	28774	2
2	0	2	0	0	28775	2
2	0	2	0	0	28776	2
2	0	2	0	0	28777	2
2	0	2	0	0	28778	2
2	0	2	0	0	28779	2
2	0	2	0	0	28780	2
2	0	2	0	0	28781	2
2	0	2	0	0	28782	2
2	0	2	0	0	28783	2
2	0	2	0	0	28784	2
2	0	2	0	0	28785	2
2	0	2	0	0	28786	2
2	0	2	0	0	28787	2
2	0	2	1	1	28788	2
2	0	2	0	0	28789	2
2	0	2	0	0	28790	2
2	0	2	0	0	28791	2
2	0	2	0	0	28792	2
2	0	2	0	0	28793	2
2	0	2	0	0	28794	2
2	0	2	0	0	28795	2
2	0	2	0	0	28796	2
2	0	2	0	0	28797	2
2	0	2	0	0	28798	2
2	0	2	0	0	28799	2
2	0	2	0	0	28800	2
2	0	2	0	0	28801	2
2	0	2	0	0	28802	2
2	0	2	0	0	28803	2
2	0	2	0	0	28804	2
2	0	2	0	0	28805	2
2	0	2	0	0	28806	2
2	4	2	0	4	28807	0
2	1	2	31	32	28808	1
2	0	2	0	0	28809	2
2	0	2	0	0	28810	2
2	0	2	0	0	28811	2
2	0	2	0	0	28812	2
2	0	2	0	0	28813	2
2	0	2	0	0	28814	2
2	0	2	0	0	28815	2
2	0	2	0	0	28816	2
2	0	2	0	0	28817	2
2	0	2	0	0	28818	2
2	0	2	0	0	28819	2
2	0	2	0	0	28820	2
2	0	2	0	0	28821	2
2	0	2	0	0	28822	2
2	0	2	0	0	28823	2
2	0	2	0	0	28824	2
2	0	2	0	0	28825	2
2	0	2	0	0	28826	2
2	0	2	0	0	28827	2
2	0	2	0	0	28828	2
2	0	2	0	0	28829	2
2	0	2	0	0	28830	2
2	0	2	0	0	28831	2
2	0	2	0	0	28832	2
2	0	2	0	0	28833	2
2	0	2	0	0	28834	2
2	0	2	0	0	28835	2
2	0	2	0	0	28836	2
4	0	2	0	0	28837	2
4	1	2	0	1	28838	1
2	0	2	0	0	28839	2
2	0	2	0	0	28840	2
2	0	2	0	0	28841	2
2	0	2	0	0	28842	2
2	0	2	0	0	28843	2
2	0	2	0	0	28844	2
2	0	2	0	0	28845	2
2	0	2	0	0	28846	2
2	0	2	0	0	28847	2
2	0	2	0	0	28848	2
2	0	2	0	0	28849	2
2	0	2	1	1	28850	2
2	0	2	0	0	28851	2
2	0	2	0	0	28852	2
2	0	2	0	0	28853	2
2	0	2	0	0	28854	2
2	0	2	0	0	28855	2
2	0	2	0	0	28856	2
2	0	2	0	0	28857	2
2	0	2	0	0	28858	2
2	0	2	0	0	28859	2
2	0	2	0	0	28860	2
2	0	2	0	0	28861	2
2	0	2	0	0	28862	2
2	0	2	0	0	28863	2
2	0	2	0	0	28864	2
2	0	2	0	0	28865	2
2	0	2	0	0	28866	2
2	0	2	0	0	28867	2
2	0	2	0	0	28868	2
2	0	2	0	0	28869	2
2	0	2	0	0	28870	2
2	0	2	0	0	28871	2
2	0	2	0	0	28872	2
2	0	2	0	0	28873	2
2	0	2	2	2	28874	2
2	0	2	0	0	28875	2
2	0	2	0	0	28876	2
2	0	2	0	0	28877	2
2	0	2	0	0	28878	2
2	0	2	0	0	28879	2
2	0	2	0	0	28880	2
2	0	2	0	0	28881	2
2	0	2	0	0	28882	2
2	0	2	0	0	28883	2
2	0	2	0	0	28884	2
2	0	2	0	0	28885	2
2	0	2	0	0	28886	2
2	0	2	0	0	28887	2
2	0	2	0	0	28888	2
2	0	2	0	0	28889	2
2	0	2	0	0	28890	2
2	0	2	0	0	28891	2
2	0	2	0	0	28892	2
2	0	2	0	0	28893	2
2	0	2	0	0	28894	2
2	0	2	0	0	28895	2
2	0	2	0	0	28896	2
2	0	2	0	0	28897	2
2	0	2	0	0	28898	2
2	0	2	0	0	28899	2
2	0	2	0	0	28900	2
2	0	2	0	0	28901	2
2	0	2	0	0	28902	2
2	0	2	0	0	28903	2
2	0	2	0	0	28904	2
2	0	2	0	0	28905	2
2	0	2	0	0	28906	2
2	1	2	0	1	28907	1
2	0	2	0	0	28908	2
2	0	2	0	0	28909	2
2	0	2	0	0	28910	2
2	0	2	0	0	28911	2
2	0	2	0	0	28912	2
2	0	2	0	0	28913	2
2	0	2	0	0	28914	2
2	0	2	0	0	28915	2
2	0	2	0	0	28916	2
2	0	2	0	0	28917	2
2	0	2	0	0	28918	2
2	0	2	0	0	28919	2
2	0	2	0	0	28920	2
2	0	2	0	0	28921	2
2	0	2	0	0	28922	2
2	0	2	0	0	28923	2
2	0	2	0	0	28924	2
2	0	2	0	0	28925	2
2	0	2	0	0	28926	2
2	0	2	0	0	28927	2
2	0	2	0	0	28928	2
2	0	2	0	0	28929	2
2	0	2	0	0	28930	2
2	0	2	0	0	28931	2
2	0	2	0	0	28932	2
2	0	2	0	0	28933	2
2	0	2	0	0	28934	2
2	0	2	0	0	28935	2
2	0	2	0	0	28936	2
2	0	2	0	0	28937	2
2	0	2	0	0	28938	2
2	0	2	0	0	28939	2
2	0	2	0	0	28940	2
2	0	2	0	0	28941	2
2	0	2	5	5	28942	2
2	0	2	0	0	28943	2
2	0	2	0	0	28944	2
2	0	2	0	0	28945	2
2	0	2	0	0	28946	2
2	0	2	0	0	28947	2
2	0	2	0	0	28948	2
2	0	2	0	0	28949	2
2	0	2	0	0	28950	2
2	0	2	0	0	28951	2
2	0	2	0	0	28952	2
2	0	2	0	0	28953	2
2	0	2	0	0	28954	2
2	0	2	0	0	28955	2
2	0	2	0	0	28956	2
2	0	2	0	0	28957	2
2	0	2	0	0	28958	2
2	35	2	2	37	28959	0
2	0	2	0	0	28960	2
2	0	2	0	0	28961	2
2	0	2	0	0	28962	2
2	106	4	721	827	28963	1
2	0	2	11	11	28964	2
2	0	2	1	1	28965	2
2	33	4	37	70	28966	0
2	0	2	91	91	28967	2
2	0	2	0	0	28968	2
2	0	2	0	0	28969	2
2	0	2	0	0	28970	2
2	0	2	0	0	28971	2
2	0	2	0	0	28972	2
2	0	2	0	0	28973	2
2	0	2	0	0	28974	2
2	0	2	0	0	28975	2
2	0	2	0	0	28976	2
2	0	2	0	0	28977	2
2	0	2	0	0	28978	2
2	0	2	0	0	28979	2
2	0	2	0	0	28980	2
2	0	2	0	0	28981	2
2	0	2	0	0	28982	2
2	0	2	0	0	28983	2
2	0	2	0	0	28984	2
2	0	2	0	0	28985	2
2	0	2	0	0	28986	2
2	0	2	0	0	28987	2
2	0	2	0	0	28988	2
2	0	2	0	0	28989	2
2	0	2	0	0	28990	2
2	0	2	0	0	28991	2
2	0	2	0	0	28992	2
2	0	2	0	0	28993	2
2	0	2	0	0	28994	2
2	0	2	0	0	28995	2
2	0	2	0	0	28996	2
2	0	2	0	0	28997	2
2	0	2	0	0	28998	2
2	0	2	0	0	28999	2
2	0	2	0	0	29000	2
2	0	2	0	0	29001	2
2	0	2	0	0	29002	2
2	0	2	0	0	29003	2
2	0	2	0	0	29004	2
2	1	2	3	4	29005	1
2	0	2	0	0	29006	2
2	0	2	1	1	29007	2
2	0	2	0	0	29008	2
2	0	2	0	0	29009	2
2	0	2	0	0	29010	2
2	0	2	0	0	29011	2
2	0	2	0	0	29012	2
2	0	2	0	0	29013	2
2	0	2	0	0	29014	2
2	0	2	0	0	29015	2
2	0	2	0	0	29016	2
2	0	2	0	0	29017	2
2	0	2	0	0	29018	2
2	0	2	0	0	29019	2
2	0	2	0	0	29020	2
2	0	2	0	0	29021	2
2	0	2	0	0	29022	2
2	0	2	0	0	29023	2
2	0	2	0	0	29024	2
2	0	2	0	0	29025	2
2	0	2	0	0	29026	2
2	0	2	0	0	29027	2
2	0	2	0	0	29028	2
2	0	2	0	0	29029	2
2	0	2	0	0	29030	2
2	0	2	0	0	29031	2
2	0	2	0	0	29032	2
2	0	2	0	0	29033	2
2	0	2	0	0	29034	2
2	0	2	0	0	29035	2
2	0	2	0	0	29036	2
2	0	2	0	0	29037	2
2	0	2	0	0	29038	2
2	0	2	0	0	29039	2
2	0	2	0	0	29040	2
2	0	2	0	0	29041	2
2	0	2	0	0	29042	2
2	0	2	0	0	29043	2
2	0	2	0	0	29044	2
2	0	2	0	0	29045	2
2	0	2	0	0	29046	2
2	0	2	0	0	29047	2
2	0	2	0	0	29048	2
2	0	2	0	0	29049	2
2	0	2	0	0	29050	2
2	0	2	0	0	29051	2
2	0	2	0	0	29052	2
2	0	2	0	0	29053	2
2	0	2	0	0	29054	2
2	0	2	0	0	29055	2
2	0	2	0	0	29056	2
2	0	2	0	0	29057	2
2	0	2	0	0	29058	2
2	0	2	0	0	29059	2
2	0	2	0	0	29060	2
2	0	2	0	0	29061	2
2	0	2	0	0	29062	2
2	0	2	0	0	29063	2
2	0	2	0	0	29064	2
2	0	2	0	0	29065	2
2	0	2	0	0	29066	2
2	0	2	0	0	29067	2
2	0	2	0	0	29068	2
2	0	2	0	0	29069	2
2	7	2	0	7	29070	0
2	0	2	3	3	29071	2
2	0	2	6	6	29072	2
2	0	2	74	74	29073	2
2	0	2	10	10	29074	2
2	0	2	0	0	29075	2
2	0	2	0	0	29076	2
2	0	2	0	0	29077	2
2	0	2	0	0	29078	2
2	0	2	0	0	29079	2
2	0	2	0	0	29080	2
2	0	2	0	0	29081	2
2	21	2	0	21	29082	0
2	5	2	20	25	29083	1
2	0	2	1	1	29084	2
2	0	2	0	0	29085	2
2	8	2	0	8	29086	0
2	0	2	18	18	29087	2
2	0	2	0	0	29088	2
2	0	2	0	0	29089	2
2	0	2	0	0	29090	2
2	0	2	0	0	29091	2
2	0	2	0	0	29092	2
2	0	2	0	0	29093	2
2	0	2	0	0	29094	2
2	0	6	0	0	29095	2
2	0	2	0	0	29096	2
2	0	2	0	0	29097	2
2	0	2	0	0	29098	2
2	0	2	0	0	29099	2
2	0	2	0	0	29100	2
2	0	2	1	1	29101	2
2	0	2	0	0	29102	2
2	0	2	0	0	29103	2
2	0	2	0	0	29104	2
2	0	2	0	0	29105	2
2	0	2	0	0	29106	2
2	0	2	0	0	29107	2
2	0	2	0	0	29108	2
2	0	2	0	0	29109	2
2	0	2	0	0	29110	2
2	0	2	0	0	29111	2
2	0	2	0	0	29112	2
2	0	2	0	0	29113	2
2	1	2	0	1	29114	1
2	0	2	0	0	29115	2
2	0	2	0	0	29116	2
2	0	2	0	0	29117	2
2	0	2	0	0	29118	2
2	0	2	0	0	29119	2
2	0	2	0	0	29120	2
2	0	2	0	0	29121	2
2	0	2	0	0	29122	2
2	3	2	0	3	29123	0
2	0	2	8	8	29124	2
2	0	2	0	0	29125	2
2	0	2	0	0	29126	2
2	0	2	2	2	29127	2
2	0	2	2	2	29128	2
2	0	2	0	0	29129	2
2	0	2	0	0	29130	2
2	0	2	0	0	29131	2
2	0	2	0	0	29132	2
2	0	2	0	0	29133	2
2	0	2	0	0	29134	2
2	0	2	0	0	29135	2
2	0	2	0	0	29136	2
2	0	2	0	0	29137	2
2	0	2	0	0	29138	2
2	0	2	0	0	29139	2
2	0	2	0	0	29140	2
2	0	2	0	0	29141	2
2	0	2	0	0	29142	2
2	0	2	0	0	29143	2
2	0	2	0	0	29144	2
2	0	2	0	0	29145	2
2	0	2	0	0	29146	2
2	0	2	0	0	29147	2
2	0	2	0	0	29148	2
2	0	2	0	0	29149	2
2	0	2	0	0	29150	2
2	0	2	0	0	29151	2
2	0	2	0	0	29152	2
2	0	2	0	0	29153	2
2	0	2	0	0	29154	2
2	0	2	3	3	29155	2
2	0	2	0	0	29156	2
2	0	2	0	0	29157	2
2	0	2	0	0	29158	2
2	0	2	1	1	29159	2
2	0	2	0	0	29160	2
2	0	2	0	0	29161	2
2	0	2	0	0	29162	2
2	0	2	0	0	29163	2
2	0	2	0	0	29164	2
2	0	2	0	0	29165	2
2	0	2	0	0	29166	2
2	0	2	0	0	29167	2
2	0	2	0	0	29168	2
2	0	2	0	0	29169	2
2	0	2	0	0	29170	2
2	0	2	0	0	29171	2
2	0	2	0	0	29172	2
2	0	2	0	0	29173	2
2	0	2	0	0	29174	2
2	0	2	0	0	29175	2
2	0	2	0	0	29176	2
2	0	2	0	0	29177	2
2	1	2	0	1	29178	0
2	0	2	3	3	29179	2
2	0	2	0	0	29180	2
2	0	2	0	0	29181	2
2	0	2	1	1	29182	2
2	0	2	0	0	29183	2
2	0	2	0	0	29184	2
2	0	2	0	0	29185	2
2	0	2	0	0	29186	2
2	0	2	0	0	29187	2
2	0	2	0	0	29188	2
2	0	2	0	0	29189	2
2	0	2	0	0	29190	2
2	0	4	1	1	29191	2
2	0	2	0	0	29192	2
2	0	2	0	0	29193	2
2	0	4	0	0	29194	2
2	0	2	1	1	29195	2
2	0	2	0	0	29196	2
2	0	2	0	0	29197	2
2	0	2	0	0	29198	2
2	0	2	0	0	29199	2
2	0	2	0	0	29200	2
2	0	2	0	0	29201	2
2	0	2	0	0	29202	2
2	0	2	0	0	29203	2
2	0	2	0	0	29204	2
2	0	2	0	0	29205	2
2	0	2	0	0	29206	2
2	0	2	0	0	29207	2
2	0	2	0	0	29208	2
2	0	2	0	0	29209	2
2	0	2	0	0	29210	2
2	0	2	0	0	29211	2
2	0	2	0	0	29212	2
2	0	2	0	0	29213	2
2	0	2	0	0	29214	2
2	0	2	0	0	29215	2
2	0	2	0	0	29216	2
2	0	2	0	0	29217	2
2	0	2	0	0	29218	2
2	0	2	0	0	29219	2
2	0	2	0	0	29220	2
2	0	2	0	0	29221	2
2	0	2	0	0	29222	2
2	0	2	0	0	29223	2
2	0	2	0	0	29224	2
2	0	2	0	0	29225	2
2	0	2	0	0	29226	2
2	0	2	0	0	29227	2
2	0	2	0	0	29228	2
2	0	2	0	0	29229	2
2	0	2	0	0	29230	2
2	0	2	0	0	29231	2
2	0	2	0	0	29232	2
2	0	2	0	0	29233	2
2	18	2	0	18	29234	0
2	0	2	0	0	29235	2
2	0	2	0	0	29236	2
2	0	2	0	0	29237	2
2	0	2	0	0	29238	2
2	0	2	0	0	29239	2
2	0	2	0	0	29240	2
2	17	2	22	39	29241	1
2	0	2	13	13	29242	2
2	0	2	0	0	29243	2
2	20	2	2	22	29244	0
2	0	2	83	83	29245	2
2	0	2	0	0	29246	2
2	0	2	0	0	29247	2
2	0	2	0	0	29248	2
2	0	2	0	0	29249	2
2	0	2	0	0	29250	2
2	0	2	0	0	29251	2
2	0	2	0	0	29252	2
2	0	2	0	0	29253	2
2	0	2	0	0	29254	2
2	0	2	0	0	29255	2
2	0	2	0	0	29256	2
2	0	2	0	0	29257	2
2	0	2	0	0	29258	2
2	0	2	0	0	29259	2
2	0	2	0	0	29260	2
2	0	2	0	0	29261	2
2	0	2	0	0	29262	2
2	0	2	0	0	29263	2
2	0	2	0	0	29264	2
2	0	2	0	0	29265	2
2	0	2	0	0	29266	2
2	0	2	0	0	29267	2
2	0	2	0	0	29268	2
2	0	2	0	0	29269	2
2	4	2	0	4	29270	0
2	0	2	25	25	29271	2
2	0	2	2	2	29272	2
2	0	2	0	0	29273	2
2	0	2	0	0	29274	2
2	0	2	4	4	29275	2
2	0	2	0	0	29276	2
2	0	2	0	0	29277	2
2	0	2	0	0	29278	2
2	0	2	0	0	29279	2
2	0	2	0	0	29280	2
2	10	4	14528	14538	29281	0
2	0	2	0	0	29282	2
2	0	2	0	0	29283	2
2	0	2	0	0	29284	2
2	0	2	0	0	29285	2
2	0	2	0	0	29286	2
2	0	2	0	0	29287	2
2	0	2	0	0	29288	2
2	0	2	0	0	29289	2
2	0	2	0	0	29290	2
2	0	2	0	0	29291	2
2	0	2	0	0	29292	2
2	0	2	0	0	29293	2
2	0	2	0	0	29294	2
2	0	2	0	0	29295	2
2	0	2	0	0	29296	2
2	0	2	0	0	29297	2
2	0	2	0	0	29298	2
2	35	2	4	39	29299	0
2	0	2	397	397	29300	2
2	0	2	0	0	29301	2
2	0	2	0	0	29302	2
2	0	2	0	0	29303	2
2	0	2	0	0	29304	2
2	0	2	0	0	29305	2
2	0	2	0	0	29306	2
2	0	2	0	0	29307	2
2	0	2	0	0	29308	2
2	2	2	0	2	29309	0
2	0	2	0	0	29310	2
2	0	2	0	0	29311	2
2	0	2	0	0	29312	2
2	0	0	0	0	29313	2
2	0	2	0	0	29314	2
2	0	2	0	0	29315	2
2	0	0	0	0	29316	2
2	0	2	0	0	29317	2
2	9	2	0	9	29318	0
2	0	2	0	0	29319	2
2	0	2	0	0	29320	2
2	0	2	0	0	29321	2
2	0	2	0	0	29322	2
2	0	2	0	0	29323	2
2	0	2	0	0	29324	2
2	4	2	44	48	29325	1
2	0	2	8	8	29326	2
2	0	2	3	3	29327	2
2	8	2	1	9	29328	0
2	0	2	15	15	29329	2
2	0	2	0	0	29330	2
2	0	2	4	4	29331	2
2	0	2	0	0	29332	2
2	0	2	0	0	29333	2
2	0	2	1	1	29334	2
2	0	2	0	0	29335	2
2	0	2	0	0	29336	2
2	0	4	0	0	29337	2
2	0	2	0	0	29338	2
2	0	2	0	0	29339	2
2	0	4	0	0	29340	2
2	0	2	0	0	29341	2
2	0	2	0	0	29342	2
2	0	2	0	0	29343	2
2	0	2	5	5	29344	2
2	0	2	0	0	29345	2
2	0	2	0	0	29346	2
2	0	2	0	0	29347	2
2	0	2	0	0	29348	2
2	0	2	0	0	29349	2
2	0	2	0	0	29350	2
2	0	2	0	0	29351	2
2	0	2	0	0	29352	2
2	0	2	0	0	29353	2
2	0	2	0	0	29354	2
2	0	2	0	0	29355	2
2	0	2	0	0	29356	2
2	0	2	0	0	29357	2
2	0	2	0	0	29358	2
2	0	2	0	0	29359	2
2	0	2	0	0	29360	2
2	0	2	0	0	29361	2
2	0	2	0	0	29362	2
2	0	2	0	0	29363	2
2	0	2	0	0	29364	2
2	0	2	0	0	29365	2
2	0	2	0	0	29366	2
2	0	2	0	0	29367	2
2	0	2	0	0	29368	2
2	0	2	0	0	29369	2
2	0	2	0	0	29370	2
2	1	2	0	1	29371	0
2	0	2	1	1	29372	2
2	0	2	0	0	29373	2
2	0	2	0	0	29374	2
2	0	2	1	1	29375	2
2	0	2	0	0	29376	2
2	1	2	0	1	29377	0
2	0	2	0	0	29378	2
2	0	2	0	0	29379	2
2	0	2	0	0	29380	2
2	0	2	0	0	29381	2
2	0	2	0	0	29382	2
2	0	2	0	0	29383	2
2	0	2	0	0	29384	2
2	0	2	0	0	29385	2
2	0	2	0	0	29386	2
2	0	2	0	0	29387	2
2	0	2	0	0	29388	2
2	0	2	0	0	29389	2
2	0	2	12	12	29390	2
2	0	2	0	0	29391	2
2	0	2	0	0	29392	2
2	1	2	0	1	29393	1
2	0	2	3	3	29394	2
2	0	2	0	0	29395	2
2	0	2	0	0	29396	2
2	0	2	0	0	29397	2
2	0	2	0	0	29398	2
2	0	2	0	0	29399	2
2	0	2	0	0	29400	2
2	0	2	0	0	29401	2
2	0	2	0	0	29402	2
2	0	2	0	0	29403	2
2	0	2	0	0	29404	2
2	1	2	1	2	29405	1
2	0	2	0	0	29406	2
2	0	2	0	0	29407	2
2	0	2	0	0	29408	2
2	0	2	0	0	29409	2
2	5	2	0	5	29410	0
2	0	2	0	0	29411	2
2	0	2	0	0	29412	2
2	0	2	0	0	29413	2
2	0	2	0	0	29414	2
2	0	2	0	0	29415	2
2	0	2	0	0	29416	2
2	0	2	0	0	29417	2
2	0	2	0	0	29418	2
2	0	2	0	0	29419	2
2	0	2	0	0	29420	2
2	0	2	0	0	29421	2
2	0	2	0	0	29422	2
2	0	2	0	0	29423	2
2	0	2	0	0	29424	2
2	0	2	0	0	29425	2
2	0	2	0	0	29426	2
2	0	2	0	0	29427	2
2	0	2	0	0	29428	2
2	0	2	0	0	29429	2
2	0	2	2	2	29430	2
2	0	2	0	0	29431	2
2	0	2	0	0	29432	2
2	0	2	1	1	29433	2
2	0	2	0	0	29434	2
2	0	2	0	0	29435	2
2	0	2	0	0	29436	2
2	0	2	0	0	29437	2
2	0	2	0	0	29438	2
2	0	2	0	0	29439	2
2	0	2	0	0	29440	2
2	0	2	0	0	29441	2
2	0	2	0	0	29442	2
2	0	2	0	0	29443	2
2	0	2	0	0	29444	2
2	0	2	0	0	29445	2
2	0	2	0	0	29446	2
2	0	2	0	0	29447	2
2	0	2	0	0	29448	2
2	0	2	1	1	29449	2
2	0	2	0	0	29450	2
2	0	2	0	0	29451	2
2	0	2	0	0	29452	2
2	0	2	0	0	29453	2
2	0	2	0	0	29454	2
2	0	2	0	0	29455	2
2	0	2	0	0	29456	2
2	0	2	0	0	29457	2
2	0	2	0	0	29458	2
2	0	2	0	0	29459	2
2	0	2	0	0	29460	2
2	0	2	0	0	29461	2
2	0	2	0	0	29462	2
2	0	2	0	0	29463	2
2	0	2	0	0	29464	2
2	0	2	0	0	29465	2
2	0	2	0	0	29466	2
2	0	2	0	0	29467	2
2	0	2	0	0	29468	2
2	0	2	0	0	29469	2
2	0	2	0	0	29470	2
2	0	2	0	0	29471	2
2	0	2	0	0	29472	2
2	0	2	0	0	29473	2
2	0	2	0	0	29474	2
2	0	2	0	0	29475	2
2	0	2	0	0	29476	2
2	0	2	0	0	29477	2
2	0	2	0	0	29478	2
2	0	2	0	0	29479	2
2	1	2	0	1	29480	1
2	0	2	0	0	29481	2
2	0	2	0	0	29482	2
2	0	2	0	0	29483	2
2	0	2	0	0	29484	2
2	595	2	7	602	29485	0
2	0	2	0	0	29486	2
2	0	2	0	0	29487	2
2	0	2	0	0	29488	2
2	0	2	0	0	29489	2
2	0	2	0	0	29490	2
2	0	2	0	0	29491	2
2	0	2	5	5	29492	2
2	0	2	0	0	29493	2
2	0	2	0	0	29494	2
2	0	2	0	0	29495	2
2	0	2	0	0	29496	2
2	0	2	0	0	29497	2
2	0	2	0	0	29498	2
2	0	2	0	0	29499	2
2	0	2	0	0	29500	2
2	0	2	0	0	29501	2
2	0	2	0	0	29502	2
2	1	2	3	4	29503	1
2	0	2	0	0	29504	2
2	0	2	0	0	29505	2
2	0	2	1	1	29506	2
2	0	2	1	1	29507	2
2	0	2	1	1	29508	2
2	0	2	0	0	29509	2
2	0	2	0	0	29510	2
2	0	2	0	0	29511	2
2	0	2	0	0	29512	2
2	0	2	0	0	29513	2
2	0	2	0	0	29514	2
2	0	2	0	0	29515	2
2	0	2	0	0	29516	2
2	0	2	0	0	29517	2
2	0	4	0	0	29518	2
2	0	2	0	0	29519	2
2	0	4	0	0	29520	2
2	0	2	0	0	29521	2
2	0	2	0	0	29522	2
2	0	2	0	0	29523	2
2	0	2	0	0	29524	2
2	0	2	0	0	29525	2
2	0	2	0	0	29526	2
2	0	2	0	0	29527	2
2	0	2	0	0	29528	2
2	0	2	0	0	29529	2
2	0	2	0	0	29530	2
2	0	2	0	0	29531	2
2	0	2	0	0	29532	2
2	0	2	0	0	29533	2
2	0	2	0	0	29534	2
2	0	2	0	0	29535	2
2	0	2	0	0	29536	2
2	0	2	0	0	29537	2
2	0	2	0	0	29538	2
2	0	2	0	0	29539	2
2	0	2	0	0	29540	2
2	0	2	0	0	29541	2
2	0	2	0	0	29542	2
2	0	2	0	0	29543	2
2	0	2	0	0	29544	2
2	0	2	0	0	29545	2
2	0	2	0	0	29546	2
2	0	2	0	0	29547	2
2	0	2	0	0	29548	2
2	0	2	0	0	29549	2
2	0	2	0	0	29550	2
2	0	2	0	0	29551	2
2	0	2	0	0	29552	2
2	0	2	0	0	29553	2
2	0	2	3	3	29554	2
2	0	2	0	0	29555	2
2	0	2	0	0	29556	2
2	0	2	0	0	29557	2
2	0	2	1	1	29558	2
2	0	2	0	0	29559	2
2	0	2	0	0	29560	2
2	0	2	0	0	29561	2
2	0	2	0	0	29562	2
2	0	2	0	0	29563	2
2	0	2	0	0	29564	2
2	0	2	0	0	29565	2
2	0	2	1	1	29566	2
2	0	2	0	0	29567	2
2	0	2	0	0	29568	2
2	0	2	0	0	29569	2
2	0	2	0	0	29570	2
2	0	2	0	0	29571	2
2	0	2	0	0	29572	2
2	0	2	0	0	29573	2
2	0	2	0	0	29574	2
2	0	2	0	0	29575	2
2	0	2	0	0	29576	2
2	0	2	0	0	29577	2
2	0	2	0	0	29578	2
2	0	2	0	0	29579	2
2	0	2	0	0	29580	2
2	0	2	0	0	29581	2
2	0	2	0	0	29582	2
2	0	2	0	0	29583	2
2	0	2	0	0	29584	2
2	0	2	0	0	29585	2
2	0	2	0	0	29586	2
2	0	2	0	0	29587	2
2	0	2	0	0	29588	2
2	0	2	0	0	29589	2
2	11	2	0	11	29590	0
2	0	2	0	0	29591	2
2	0	2	0	0	29592	2
2	0	2	0	0	29593	2
2	0	2	0	0	29594	2
2	0	2	0	0	29595	2
2	0	2	0	0	29596	2
2	0	2	0	0	29597	2
2	0	2	0	0	29598	2
2	0	2	0	0	29599	2
2	0	2	0	0	29600	2
2	0	2	0	0	29601	2
2	0	2	0	0	29602	2
2	11	4	85	96	29603	0
2	0	2	19	19	29604	2
2	14	4	503	517	29605	1
2	0	2	5	5	29606	2
2	0	2	3	3	29607	2
2	0	2	0	0	29608	2
2	0	2	3	3	29609	2
2	1	2	0	1	29610	0
2	1	2	13	14	29611	1
2	0	2	0	0	29612	2
2	0	2	0	0	29613	2
2	0	2	0	0	29614	2
2	0	2	0	0	29615	2
2	0	2	0	0	29616	2
2	0	2	0	0	29617	2
2	0	2	0	0	29618	2
2	0	2	0	0	29619	2
2	0	2	0	0	29620	2
2	0	2	0	0	29621	2
2	0	2	0	0	29622	2
2	0	2	0	0	29623	2
2	0	2	0	0	29624	2
2	0	2	0	0	29625	2
2	0	2	0	0	29626	2
2	0	2	0	0	29627	2
2	0	2	0	0	29628	2
2	0	2	6	6	29629	2
2	0	2	0	0	29630	2
2	0	2	0	0	29631	2
2	0	2	0	0	29632	2
2	0	2	1	1	29633	2
2	0	2	0	0	29634	2
2	0	2	0	0	29635	2
2	0	2	0	0	29636	2
2	0	2	0	0	29637	2
2	0	2	0	0	29638	2
2	0	2	0	0	29639	2
2	0	2	0	0	29640	2
2	0	2	0	0	29641	2
2	0	2	0	0	29642	2
2	0	2	0	0	29643	2
2	0	2	0	0	29644	2
2	0	2	0	0	29645	2
2	0	2	0	0	29646	2
2	0	2	0	0	29647	2
2	0	2	0	0	29648	2
2	0	2	0	0	29649	2
2	0	2	0	0	29650	2
2	0	2	0	0	29651	2
2	0	2	0	0	29652	2
2	0	2	0	0	29653	2
2	0	2	0	0	29654	2
2	0	2	1	1	29655	2
2	0	2	0	0	29656	2
2	0	2	0	0	29657	2
2	0	2	0	0	29658	2
2	0	2	0	0	29659	2
2	0	2	62	62	29660	2
2	1	2	0	1	29661	0
2	0	2	10	10	29662	2
2	0	2	0	0	29663	2
2	0	2	0	0	29664	2
2	0	2	0	0	29665	2
2	0	2	0	0	29666	2
2	0	2	0	0	29667	2
2	0	2	0	0	29668	2
2	2	2	1	3	29669	0
2	0	2	0	0	29670	2
2	0	2	0	0	29671	2
2	0	2	0	0	29672	2
2	0	2	0	0	29673	2
2	0	2	0	0	29674	2
2	0	2	0	0	29675	2
2	0	2	0	0	29676	2
2	0	2	0	0	29677	2
2	0	2	0	0	29678	2
2	0	2	0	0	29679	2
2	0	2	0	0	29680	2
2	0	2	0	0	29681	2
2	27	2	122	149	29682	1
2	0	2	4	4	29683	2
2	0	2	0	0	29684	2
2	6	2	3	9	29685	0
2	0	2	3	3	29686	2
2	0	2	0	0	29687	2
2	1	2	0	1	29688	1
2	0	2	0	0	29689	2
2	0	2	0	0	29690	2
2	0	2	0	0	29691	2
2	0	2	0	0	29692	2
2	0	2	0	0	29693	2
2	0	2	0	0	29694	2
2	0	2	0	0	29695	2
2	0	2	0	0	29696	2
2	0	2	0	0	29697	2
2	0	2	0	0	29698	2
2	0	2	0	0	29699	2
2	0	2	0	0	29700	2
2	0	4	2	2	29701	2
2	0	2	0	0	29702	2
2	0	2	0	0	29703	2
2	0	4	0	0	29704	2
2	0	2	0	0	29705	2
2	0	2	0	0	29706	2
2	0	2	0	0	29707	2
2	0	2	0	0	29708	2
2	0	2	0	0	29709	2
2	0	2	0	0	29710	2
2	0	2	0	0	29711	2
2	0	2	0	0	29712	2
2	0	2	0	0	29713	2
2	0	2	0	0	29714	2
2	0	2	0	0	29715	2
2	0	2	0	0	29716	2
2	0	2	0	0	29717	2
2	0	2	0	0	29718	2
2	0	2	0	0	29719	2
2	0	2	0	0	29720	2
2	0	2	0	0	29721	2
2	0	2	0	0	29722	2
2	0	2	0	0	29723	2
2	0	2	0	0	29724	2
2	0	2	0	0	29725	2
2	0	2	0	0	29726	2
2	0	2	0	0	29727	2
2	0	2	0	0	29728	2
2	0	2	0	0	29729	2
2	0	2	0	0	29730	2
2	0	2	0	0	29731	2
2	0	2	0	0	29732	2
2	0	2	0	0	29733	2
2	0	2	0	0	29734	2
2	0	2	0	0	29735	2
2	0	2	0	0	29736	2
2	0	2	0	0	29737	2
2	0	2	0	0	29738	2
2	0	2	0	0	29739	2
2	0	2	0	0	29740	2
2	0	2	0	0	29741	2
2	0	2	0	0	29742	2
4	25	4	4	29	29743	0
4	1	4	1	2	29744	0
2	0	2	0	0	29745	2
2	0	2	0	0	29746	2
2	0	2	0	0	29747	2
2	0	2	0	0	29748	2
2	0	2	0	0	29749	2
2	0	2	0	0	29750	2
2	0	2	0	0	29751	2
2	0	2	0	0	29752	2
2	0	2	0	0	29753	2
2	0	2	0	0	29754	2
2	0	2	0	0	29755	2
2	0	2	0	0	29756	2
2	0	2	0	0	29757	2
2	0	2	0	0	29758	2
2	0	2	0	0	29759	2
2	0	2	0	0	29760	2
2	0	4	1	1	29761	2
2	0	2	0	0	29762	2
2	0	2	0	0	29763	2
2	0	4	0	0	29764	2
2	0	2	0	0	29765	2
2	0	2	1	1	29766	2
2	10	2	2	12	29767	0
2	0	2	0	0	29768	2
2	0	2	7	7	29769	2
2	0	2	0	0	29770	2
2	0	2	0	0	29771	2
2	0	2	0	0	29772	2
2	0	2	0	0	29773	2
2	0	2	0	0	29774	2
2	0	2	0	0	29775	2
2	0	2	0	0	29776	2
2	0	2	0	0	29777	2
2	0	2	0	0	29778	2
2	0	2	0	0	29779	2
2	0	2	0	0	29780	2
2	0	2	0	0	29781	2
2	0	2	0	0	29782	2
2	0	2	0	0	29783	2
2	0	2	0	0	29784	2
2	0	2	0	0	29785	2
2	0	2	0	0	29786	2
2	0	2	0	0	29787	2
2	0	2	0	0	29788	2
2	0	2	0	0	29789	2
2	0	2	111	111	29790	2
2	0	2	0	0	29791	2
2	0	2	0	0	29792	2
2	0	2	0	0	29793	2
2	4	2	0	4	29794	0
2	16	2	1540	1556	29795	1
2	0	2	0	0	29796	2
2	0	2	0	0	29797	2
2	5	2	575	580	29798	0
2	1	2	5	6	29799	1
2	0	2	0	0	29800	2
2	0	2	1	1	29801	2
2	0	2	0	0	29802	2
2	0	2	1	1	29803	2
2	0	2	0	0	29804	2
2	0	2	7	7	29805	2
2	0	2	0	0	29806	2
2	0	2	0	0	29807	2
2	0	2	0	0	29808	2
2	0	2	0	0	29809	2
2	0	2	0	0	29810	2
2	0	2	0	0	29811	2
2	0	2	0	0	29812	2
2	0	2	0	0	29813	2
2	0	2	0	0	29814	2
2	0	2	0	0	29815	2
2	0	2	0	0	29816	2
2	0	2	0	0	29817	2
2	0	2	0	0	29818	2
2	2	2	0	2	29819	0
2	0	2	0	0	29820	2
2	0	2	0	0	29821	2
2	0	2	0	0	29822	2
2	0	2	0	0	29823	2
2	0	2	0	0	29824	2
2	0	2	0	0	29825	2
2	0	2	0	0	29826	2
2	0	2	0	0	29827	2
2	0	2	0	0	29828	2
2	0	2	0	0	29829	2
2	0	2	0	0	29830	2
2	0	2	0	0	29831	2
2	0	2	0	0	29832	2
2	0	2	0	0	29833	2
2	0	2	0	0	29834	2
2	0	2	12	12	29835	2
2	0	2	0	0	29836	2
2	0	2	0	0	29837	2
2	0	2	0	0	29838	2
2	2	2	2	4	29839	1
2	0	2	0	0	29840	2
2	0	2	0	0	29841	2
2	0	2	0	0	29842	2
2	0	2	0	0	29843	2
2	0	2	0	0	29844	2
2	0	2	0	0	29845	2
2	0	2	0	0	29846	2
2	0	2	0	0	29847	2
2	0	2	0	0	29848	2
2	0	2	0	0	29849	2
2	0	2	0	0	29850	2
2	0	2	2	2	29851	2
2	0	2	0	0	29852	2
2	0	2	0	0	29853	2
2	0	2	0	0	29854	2
2	0	2	0	0	29855	2
4	0	2	0	0	29856	2
2	0	2	0	0	29857	2
2	0	2	0	0	29858	2
2	0	2	0	0	29859	2
2	0	2	0	0	29860	2
2	0	2	0	0	29861	2
2	0	2	0	0	29862	2
2	0	2	0	0	29863	2
2	0	2	0	0	29864	2
2	0	2	0	0	29865	2
2	0	2	0	0	29866	2
2	0	2	0	0	29867	2
2	0	2	0	0	29868	2
2	353	2	2419	2772	29869	1
2	1	2	87	88	29870	1
2	1	2	11	12	29871	1
2	0	2	1300	1300	29872	2
2	295	2	59	354	29873	1
2	0	2	1170	1170	29874	2
7	0	2	69	69	29875	2
2	0	2	0	0	29876	2
2	0	2	1	1	29877	2
2	0	2	0	0	29878	2
2	0	2	0	0	29879	2
2	0	2	0	0	29880	2
2	0	2	0	0	29881	2
2	0	2	0	0	29882	2
2	0	2	0	0	29883	2
2	0	2	0	0	29884	2
2	0	2	0	0	29885	2
2	0	2	0	0	29886	2
2	0	2	0	0	29887	2
2	0	2	0	0	29888	2
2	0	2	0	0	29889	2
2	0	2	0	0	29890	2
2	0	2	0	0	29891	2
2	0	2	0	0	29892	2
2	0	2	0	0	29893	2
2	0	2	0	0	29894	2
2	0	2	0	0	29895	2
2	0	2	0	0	29896	2
2	0	2	0	0	29897	2
2	0	2	0	0	29898	2
2	0	2	0	0	29899	2
2	0	2	0	0	29900	2
2	0	2	0	0	29901	2
2	0	2	0	0	29902	2
2	0	2	0	0	29903	2
2	0	2	0	0	29904	2
2	0	2	0	0	29905	2
2	0	2	0	0	29906	2
2	0	2	0	0	29907	2
2	0	2	0	0	29908	2
2	3	2	0	3	29909	0
2	2	2	49	51	29910	1
2	0	2	1	1	29911	2
2	0	2	0	0	29912	2
2	0	2	9	9	29913	2
2	0	2	6	6	29914	2
2	0	2	0	0	29915	2
2	0	2	0	0	29916	2
2	0	2	0	0	29917	2
2	0	2	0	0	29918	2
2	0	2	0	0	29919	2
2	0	2	0	0	29920	2
2	4	2	0	4	29921	0
2	3	2	304	307	29922	1
2	0	2	4	4	29923	2
2	0	2	0	0	29924	2
2	3	2	0	3	29925	1
2	0	2	17	17	29926	2
2	1	2	0	1	29927	0
2	2	2	60	62	29928	1
2	0	2	0	0	29929	2
2	0	2	0	0	29930	2
2	2	2	0	2	29931	1
2	0	2	0	0	29932	2
2	0	2	1	1	29933	2
2	0	2	1	1	29934	2
2	0	2	0	0	29935	2
2	1	2	6	7	29936	1
2	0	2	0	0	29937	2
2	0	2	0	0	29938	2
0	68	4	1	69	29939	0
2	0	2	0	0	29940	2
2	0	2	0	0	29941	2
2	0	2	0	0	29942	2
2	0	2	0	0	29943	2
2	0	2	0	0	29944	2
2	0	2	0	0	29945	2
2	0	2	0	0	29946	2
2	0	2	0	0	29947	2
2	0	2	0	0	29948	2
2	0	2	0	0	29949	2
2	0	2	0	0	29950	2
2	0	2	0	0	29951	2
2	0	2	0	0	29952	2
2	0	2	4	4	29953	2
2	0	2	0	0	29954	2
2	0	2	0	0	29955	2
2	0	2	0	0	29956	2
2	0	2	2	2	29957	2
2	0	2	2	2	29958	2
2	0	2	0	0	29959	2
0	0	4	6	6	29960	2
0	0	4	6	6	29961	2
2	0	2	4	4	29962	2
2	1	2	0	1	29963	0
2	0	4	154	154	29964	2
2	0	2	1	1	29965	2
2	0	2	0	0	29966	2
2	0	2	0	0	29967	2
2	3	2	0	3	29968	0
2	0	2	0	0	29969	2
2	0	2	0	0	29970	2
2	0	2	0	0	29971	2
2	0	2	0	0	29972	2
2	0	2	0	0	29973	2
2	0	2	0	0	29974	2
2	0	2	1	1	29975	2
2	0	2	0	0	29976	2
2	0	2	0	0	29977	2
2	0	2	0	0	29978	2
2	0	2	0	0	29979	2
2	0	2	0	0	29980	2
2	0	2	0	0	29981	2
2	0	2	0	0	29982	2
2	0	2	0	0	29983	2
2	0	2	0	0	29984	2
2	0	2	0	0	29985	2
2	0	2	0	0	29986	2
2	0	2	0	0	29987	2
2	0	2	0	0	29988	2
2	0	2	0	0	29989	2
2	0	2	0	0	29990	2
2	0	2	0	0	29991	2
2	0	2	0	0	29992	2
2	0	2	0	0	29993	2
2	0	2	0	0	29994	2
2	0	2	0	0	29995	2
2	0	2	0	0	29996	2
2	0	2	0	0	29997	2
2	0	2	0	0	29998	2
2	0	2	0	0	29999	2
2	0	2	0	0	30000	2
2	0	2	0	0	30001	2
2	0	2	0	0	30002	2
2	0	2	0	0	30003	2
2	7	2	0	7	30004	0
2	0	2	0	0	30005	2
2	0	2	0	0	30006	2
2	0	2	0	0	30007	2
2	0	2	0	0	30008	2
2	0	2	0	0	30009	2
2	0	2	0	0	30010	2
2	2	2	27	29	30011	1
2	0	2	0	0	30012	2
2	0	2	0	0	30013	2
2	6	2	0	6	30014	0
2	0	2	4	4	30015	2
2	1	2	0	1	30016	0
2	0	2	0	0	30017	2
2	0	2	0	0	30018	2
2	0	2	0	0	30019	2
2	0	2	0	0	30020	2
2	0	2	0	0	30021	2
2	0	2	0	0	30022	2
2	0	2	0	0	30023	2
2	0	2	0	0	30024	2
2	0	2	0	0	30025	2
2	1	2	0	1	30026	1
2	0	2	0	0	30027	2
2	0	2	0	0	30028	2
2	0	2	0	0	30029	2
2	0	2	0	0	30030	2
2	0	2	0	0	30031	2
2	0	2	0	0	30032	2
2	0	2	0	0	30033	2
2	0	2	0	0	30034	2
2	0	2	0	0	30035	2
2	0	2	0	0	30036	2
2	0	2	0	0	30037	2
2	0	2	0	0	30038	2
2	0	2	0	0	30039	2
2	0	2	0	0	30040	2
2	0	2	0	0	30041	2
2	0	2	0	0	30042	2
2	0	2	0	0	30043	2
2	0	2	0	0	30044	2
2	0	2	0	0	30045	2
2	0	2	0	0	30046	2
2	0	2	0	0	30047	2
2	0	2	0	0	30048	2
2	0	2	0	0	30049	2
2	0	2	0	0	30050	2
2	0	2	0	0	30051	2
2	0	2	0	0	30052	2
2	0	2	0	0	30053	2
2	0	2	0	0	30054	2
2	0	2	0	0	30055	2
2	0	2	0	0	30056	2
2	0	2	0	0	30057	2
2	0	2	0	0	30058	2
2	0	2	0	0	30059	2
2	0	2	0	0	30060	2
2	534	2	5	539	30061	0
2	0	2	0	0	30062	2
2	0	2	0	0	30063	2
2	0	2	0	0	30064	2
2	0	2	0	0	30065	2
2	0	2	0	0	30066	2
2	0	2	0	0	30067	2
2	0	2	0	0	30068	2
2	0	2	0	0	30069	2
2	0	2	0	0	30070	2
2	0	2	0	0	30071	2
2	0	2	0	0	30072	2
2	0	2	0	0	30073	2
2	0	2	0	0	30074	2
2	0	2	0	0	30075	2
2	0	2	0	0	30076	2
2	0	2	0	0	30077	2
2	0	2	0	0	30078	2
2	0	2	0	0	30079	2
2	0	2	0	0	30080	2
2	0	2	0	0	30081	2
2	0	2	2	2	30082	2
2	0	2	0	0	30083	2
2	0	2	0	0	30084	2
2	0	2	0	0	30085	2
2	0	2	0	0	30086	2
2	0	2	0	0	30087	2
2	0	2	0	0	30088	2
2	0	2	0	0	30089	2
2	0	2	0	0	30090	2
2	0	2	0	0	30091	2
2	0	2	0	0	30092	2
2	0	2	0	0	30093	2
2	0	2	0	0	30094	2
2	0	2	0	0	30095	2
2	0	2	0	0	30096	2
2	0	2	0	0	30097	2
2	0	2	0	0	30098	2
2	0	2	0	0	30099	2
2	0	2	0	0	30100	2
2	0	2	0	0	30101	2
2	0	2	0	0	30102	2
2	0	2	0	0	30103	2
2	0	2	0	0	30104	2
2	0	2	0	0	30105	2
2	0	2	0	0	30106	2
2	0	2	0	0	30107	2
2	0	2	0	0	30108	2
2	0	2	1	1	30109	2
2	0	2	0	0	30110	2
2	0	2	0	0	30111	2
2	0	2	0	0	30112	2
2	0	2	0	0	30113	2
2	0	2	0	0	30114	2
2	0	2	0	0	30115	2
2	0	2	0	0	30116	2
2	0	2	0	0	30117	2
2	0	2	0	0	30118	2
2	0	2	0	0	30119	2
2	0	2	0	0	30120	2
2	0	2	0	0	30121	2
2	0	2	0	0	30122	2
2	0	2	0	0	30123	2
2	0	2	0	0	30124	2
2	0	2	0	0	30125	2
2	0	2	0	0	30126	2
2	0	2	0	0	30127	2
2	0	2	0	0	30128	2
2	0	2	0	0	30129	2
2	0	2	0	0	30130	2
2	0	2	0	0	30131	2
2	0	2	0	0	30132	2
2	0	2	0	0	30133	2
2	0	2	0	0	30134	2
2	0	2	0	0	30135	2
2	0	2	0	0	30136	2
2	0	2	0	0	30137	2
2	0	2	0	0	30138	2
2	0	2	0	0	30139	2
2	0	2	0	0	30140	2
2	0	2	0	0	30141	2
2	0	2	0	0	30142	2
2	0	2	0	0	30143	2
2	0	2	0	0	30144	2
2	1	2	0	1	30145	1
2	0	2	0	0	30146	2
2	0	2	0	0	30147	2
2	0	2	1	1	30148	2
2	0	2	0	0	30149	2
2	443	2	2775	3218	30150	1
2	0	2	145	145	30151	2
2	0	2	8	8	30152	2
2	183	2	29	212	30153	0
2	5	2	8	13	30154	0
2	0	2	0	0	30155	2
2	9	2	0	9	30156	0
2	7	0	936	943	30157	1
2	0	2	2	2	30158	2
2	0	2	0	0	30159	2
2	3	0	0	3	30160	1
2	0	2	6	6	30161	2
2	0	2	0	0	30162	2
2	0	2	0	0	30163	2
2	0	2	0	0	30164	2
2	0	2	0	0	30165	2
2	0	2	0	0	30166	2
2	0	2	0	0	30167	2
2	2	2	1	3	30168	1
2	0	2	0	0	30169	2
2	0	2	0	0	30170	2
2	0	2	0	0	30171	2
2	0	2	0	0	30172	2
2	3	2	1	4	30173	0
2	1	2	15	16	30174	1
2	0	2	10	10	30175	2
2	0	2	0	0	30176	2
2	1	2	0	1	30177	1
2	0	2	11	11	30178	2
2	0	2	0	0	30179	2
2	0	2	0	0	30180	2
2	0	2	0	0	30181	2
2	0	2	0	0	30182	2
2	0	2	0	0	30183	2
2	0	2	0	0	30184	2
2	0	2	0	0	30185	2
2	0	2	0	0	30186	2
2	0	2	0	0	30187	2
2	0	2	0	0	30188	2
2	0	2	0	0	30189	2
2	0	2	0	0	30190	2
2	0	2	0	0	30191	2
2	0	2	0	0	30192	2
2	0	2	0	0	30193	2
2	0	2	0	0	30194	2
2	0	2	0	0	30195	2
2	0	2	0	0	30196	2
2	0	2	0	0	30197	2
2	0	2	0	0	30198	2
2	0	2	0	0	30199	2
2	0	2	0	0	30200	2
2	0	2	0	0	30201	2
2	0	2	0	0	30202	2
2	0	2	0	0	30203	2
2	0	2	0	0	30204	2
2	0	2	0	0	30205	2
2	0	2	0	0	30206	2
2	0	2	0	0	30207	2
2	0	2	0	0	30208	2
2	0	2	0	0	30209	2
2	0	2	0	0	30210	2
2	0	2	0	0	30211	2
2	0	2	0	0	30212	2
2	0	2	0	0	30213	2
2	0	2	0	0	30214	2
2	0	2	0	0	30215	2
2	0	2	0	0	30216	2
2	0	2	0	0	30217	2
2	0	2	0	0	30218	2
2	0	2	0	0	30219	2
2	0	2	0	0	30220	2
2	0	2	0	0	30221	2
2	0	2	0	0	30222	2
2	0	2	0	0	30223	2
2	0	2	0	0	30224	2
2	0	2	0	0	30225	2
2	0	2	0	0	30226	2
2	0	2	0	0	30227	2
2	0	2	0	0	30228	2
2	0	2	0	0	30229	2
2	1	2	0	1	30230	0
2	1	2	14	15	30231	1
2	0	2	2	2	30232	2
2	0	2	0	0	30233	2
2	1	2	7	8	30234	0
2	0	2	1	1	30235	2
0	0	0	1996	1996	30236	2
0	0	0	1866	1866	30237	2
2	0	2	0	0	30238	2
2	0	2	0	0	30239	2
2	0	2	0	0	30240	2
2	0	2	0	0	30241	2
2	0	2	0	0	30242	2
2	0	2	0	0	30243	2
2	0	2	0	0	30244	2
2	0	2	0	0	30245	2
2	0	2	0	0	30246	2
2	0	2	0	0	30247	2
2	0	2	0	0	30248	2
2	0	2	0	0	30249	2
2	0	2	0	0	30250	2
2	0	2	0	0	30251	2
2	0	2	0	0	30252	2
2	0	2	0	0	30253	2
2	0	2	0	0	30254	2
2	0	2	0	0	30255	2
2	0	2	0	0	30256	2
2	0	2	0	0	30257	2
2	0	2	0	0	30258	2
2	0	2	0	0	30259	2
2	0	2	0	0	30260	2
2	0	2	0	0	30261	2
2	0	2	0	0	30262	2
2	0	2	0	0	30263	2
2	0	2	0	0	30264	2
2	0	2	0	0	30265	2
2	0	2	0	0	30266	2
2	0	2	0	0	30267	2
0	0	4	0	0	30268	2
0	0	4	0	0	30269	2
4	0	4	0	0	30270	2
4	0	4	0	0	30271	2
4	0	4	0	0	30272	2
4	0	4	0	0	30273	2
2	0	2	0	0	30274	2
2	0	2	13	13	30275	2
2	0	2	0	0	30276	2
2	0	2	0	0	30277	2
2	0	2	0	0	30278	2
2	0	2	0	0	30279	2
2	0	2	0	0	30280	2
2	0	2	0	0	30281	2
2	0	2	0	0	30282	2
2	0	2	0	0	30283	2
2	0	2	0	0	30284	2
2	0	2	0	0	30285	2
2	4	2	0	4	30286	0
2	0	2	54	54	30287	2
2	0	2	0	0	30288	2
2	0	2	0	0	30289	2
2	3	2	1	4	30290	0
2	0	2	8041	8041	30291	2
2	2	2	0	2	30292	0
2	0	2	23	23	30293	2
2	0	2	0	0	30294	2
2	0	2	0	0	30295	2
2	0	2	0	0	30296	2
2	2	2	0	2	30297	1
2	0	2	21	21	30298	2
2	0	2	0	0	30299	2
2	0	2	0	0	30300	2
2	0	2	0	0	30301	2
2	0	2	0	0	30302	2
2	0	2	0	0	30303	2
2	0	2	0	0	30304	2
2	2	2	18	20	30305	1
2	0	2	4	4	30306	2
2	0	2	0	0	30307	2
2	53	2	0	53	30308	0
2	0	2	8	8	30309	2
2	0	2	0	0	30310	2
2	1	2	0	1	30311	0
2	0	2	20	20	30312	2
2	3	2	0	3	30313	0
2	2	2	241	243	30314	1
2	1	2	3	4	30315	1
2	0	2	0	0	30316	2
2	8	2	52	60	30317	0
2	0	2	49	49	30318	2
0	69	4	1	70	30319	1
0	27	2	241	268	30320	1
0	66	4	0	66	30321	0
0	18	2	52	70	30322	0
2	0	2	0	0	30323	2
2	0	2	0	0	30324	2
2	0	2	0	0	30325	2
2	0	2	0	0	30326	2
2	0	2	0	0	30327	2
2	0	2	0	0	30328	2
2	0	2	0	0	30329	2
2	0	4	0	0	30330	2
2	0	2	0	0	30331	2
2	0	2	0	0	30332	2
2	0	4	0	0	30333	2
2	0	2	0	0	30334	2
2	0	2	0	0	30335	2
2	0	2	0	0	30336	2
2	0	2	0	0	30337	2
2	0	2	0	0	30338	2
2	0	2	0	0	30339	2
2	0	2	0	0	30340	2
2	0	2	0	0	30341	2
2	0	2	0	0	30342	2
2	2	2	0	2	30343	0
2	0	2	2	2	30344	2
2	0	2	0	0	30345	2
2	0	2	0	0	30346	2
2	0	2	0	0	30347	2
2	0	2	0	0	30348	2
2	0	2	0	0	30349	2
2	0	2	0	0	30350	2
2	0	2	0	0	30351	2
2	0	2	0	0	30352	2
2	0	2	0	0	30353	2
2	0	2	0	0	30354	2
2	0	2	0	0	30355	2
2	0	2	0	0	30356	2
2	0	0	17	17	30357	2
2	0	2	0	0	30358	2
2	0	2	0	0	30359	2
2	0	0	22	22	30360	2
2	0	2	0	0	30361	2
2	0	2	0	0	30362	2
2	0	2	0	0	30363	2
2	0	2	0	0	30364	2
2	0	2	0	0	30365	2
2	0	2	0	0	30366	2
2	0	2	0	0	30367	2
2	0	2	0	0	30368	2
2	0	4	0	0	30369	2
2	0	2	0	0	30370	2
2	0	2	0	0	30371	2
2	0	4	5	5	30372	2
2	0	2	0	0	30373	2
2	4	2	0	4	30374	0
2	6	2	41	47	30375	1
2	0	2	1	1	30376	2
2	0	2	0	0	30377	2
2	0	2	0	0	30378	2
2	0	2	9	9	30379	2
2	0	2	0	0	30380	2
2	0	2	0	0	30381	2
2	0	2	0	0	30382	2
2	0	2	0	0	30383	2
2	0	2	0	0	30384	2
2	0	2	0	0	30385	2
2	7	2	0	7	30386	0
2	1	2	5	6	30387	1
2	0	2	4	4	30388	2
2	0	2	0	0	30389	2
2	2	2	0	2	30390	0
2	0	2	15	15	30391	2
2	0	2	0	0	30392	2
2	1	4	30	31	30393	1
2	0	2	1	1	30394	2
2	0	2	1	1	30395	2
2	4	4	7	11	30396	1
2	0	2	1	1	30397	2
2	0	2	0	0	30398	2
2	0	2	1	1	30399	2
2	0	2	0	0	30400	2
2	0	2	0	0	30401	2
2	0	2	1	1	30402	2
2	0	2	0	0	30403	2
2	0	2	0	0	30404	2
2	1	2	2	3	30405	1
2	0	2	0	0	30406	2
2	0	2	0	0	30407	2
2	1	2	0	1	30408	1
2	0	2	0	0	30409	2
2	0	2	0	0	30410	2
2	0	2	0	0	30411	2
2	0	2	0	0	30412	2
2	0	2	0	0	30413	2
2	0	2	0	0	30414	2
2	0	2	0	0	30415	2
2	0	2	0	0	30416	2
2	0	2	0	0	30417	2
2	0	2	0	0	30418	2
2	0	2	0	0	30419	2
2	0	2	0	0	30420	2
2	0	2	0	0	30421	2
2	0	2	0	0	30422	2
2	0	2	0	0	30423	2
2	0	2	0	0	30424	2
2	0	2	0	0	30425	2
2	0	2	0	0	30426	2
2	0	2	0	0	30427	2
2	0	2	0	0	30428	2
2	0	2	0	0	30429	2
2	0	2	0	0	30430	2
2	0	2	0	0	30431	2
2	0	2	0	0	30432	2
2	0	2	0	0	30433	2
2	0	2	0	0	30434	2
2	0	2	0	0	30435	2
2	0	2	0	0	30436	2
2	0	2	0	0	30437	2
2	0	2	0	0	30438	2
2	0	2	0	0	30439	2
2	0	2	0	0	30440	2
2	0	2	0	0	30441	2
2	0	2	0	0	30442	2
2	0	2	0	0	30443	2
2	0	2	0	0	30444	2
2	0	2	0	0	30445	2
2	0	2	0	0	30446	2
2	0	2	0	0	30447	2
2	0	2	0	0	30448	2
2	0	2	0	0	30449	2
2	0	2	0	0	30450	2
2	0	2	0	0	30451	2
2	0	2	0	0	30452	2
2	0	2	0	0	30453	2
2	0	2	0	0	30454	2
2	0	2	0	0	30455	2
2	0	2	0	0	30456	2
2	0	2	0	0	30457	2
2	0	2	0	0	30458	2
2	0	2	0	0	30459	2
2	0	2	0	0	30460	2
2	0	2	0	0	30461	2
2	0	2	0	0	30462	2
2	0	2	0	0	30463	2
2	0	2	0	0	30464	2
2	0	2	0	0	30465	2
2	0	2	0	0	30466	2
2	0	2	0	0	30467	2
2	0	2	0	0	30468	2
2	0	2	0	0	30469	2
2	0	2	0	0	30470	2
2	0	2	0	0	30471	2
2	0	2	0	0	30472	2
2	0	2	0	0	30473	2
2	0	2	0	0	30474	2
2	0	2	0	0	30475	2
2	0	2	0	0	30476	2
2	0	2	0	0	30477	2
2	0	2	0	0	30478	2
2	0	2	0	0	30479	2
2	0	2	0	0	30480	2
2	0	2	0	0	30481	2
2	0	2	0	0	30482	2
2	0	2	0	0	30483	2
2	0	2	0	0	30484	2
2	0	2	0	0	30485	2
2	0	2	0	0	30486	2
2	0	2	0	0	30487	2
2	0	2	0	0	30488	2
2	0	2	0	0	30489	2
2	0	2	0	0	30490	2
2	0	2	0	0	30491	2
2	0	2	0	0	30492	2
2	0	2	0	0	30493	2
2	0	2	0	0	30494	2
2	0	2	0	0	30495	2
2	0	2	0	0	30496	2
2	0	2	0	0	30497	2
2	0	2	0	0	30498	2
2	0	2	0	0	30499	2
2	0	2	0	0	30500	2
2	0	2	0	0	30501	2
2	0	2	0	0	30502	2
2	0	2	0	0	30503	2
2	0	2	0	0	30504	2
2	0	2	0	0	30505	2
2	0	2	0	0	30506	2
2	0	2	0	0	30507	2
2	0	2	0	0	30508	2
2	0	2	0	0	30509	2
2	0	2	0	0	30510	2
2	0	2	0	0	30511	2
2	0	2	0	0	30512	2
2	0	2	0	0	30513	2
2	0	2	0	0	30514	2
2	0	2	0	0	30515	2
2	0	2	0	0	30516	2
2	0	2	0	0	30517	2
2	0	2	0	0	30518	2
2	0	2	0	0	30519	2
2	0	2	0	0	30520	2
2	0	2	0	0	30521	2
2	0	2	0	0	30522	2
2	0	2	0	0	30523	2
2	0	2	0	0	30524	2
2	0	2	0	0	30525	2
0	0	4	2	2	30526	2
2	0	2	0	0	30527	2
2	0	2	0	0	30528	2
2	0	2	0	0	30529	2
2	0	2	0	0	30530	2
2	0	2	0	0	30531	2
2	0	2	0	0	30532	2
2	0	2	0	0	30533	2
2	0	2	0	0	30534	2
2	0	2	0	0	30535	2
2	0	2	0	0	30536	2
2	0	2	0	0	30537	2
2	0	2	0	0	30538	2
2	0	2	0	0	30539	2
2	0	2	0	0	30540	2
2	0	2	0	0	30541	2
2	0	2	0	0	30542	2
2	0	2	0	0	30543	2
2	0	2	0	0	30544	2
2	0	2	0	0	30545	2
2	0	2	0	0	30546	2
2	0	2	0	0	30547	2
2	0	2	0	0	30548	2
2	0	2	0	0	30549	2
2	0	2	0	0	30550	2
2	0	2	0	0	30551	2
2	0	2	0	0	30552	2
2	0	2	0	0	30553	2
2	0	2	0	0	30554	2
2	0	2	0	0	30555	2
2	0	2	0	0	30556	2
2	0	2	0	0	30557	2
2	0	2	0	0	30558	2
2	0	2	0	0	30559	2
2	0	2	0	0	30560	2
2	0	2	0	0	30561	2
2	0	2	0	0	30562	2
2	0	2	0	0	30563	2
2	0	2	0	0	30564	2
2	0	2	0	0	30565	2
2	0	2	0	0	30566	2
2	0	2	0	0	30567	2
2	0	2	0	0	30568	2
2	0	2	0	0	30569	2
4	1	2	0	1	30570	0
2	0	2	0	0	30571	2
2	0	2	0	0	30572	2
2	0	2	0	0	30573	2
2	0	2	0	0	30574	2
2	0	2	0	0	30575	2
2	0	2	0	0	30576	2
2	0	2	0	0	30577	2
2	0	2	0	0	30578	2
2	0	2	0	0	30579	2
2	0	2	0	0	30580	2
2	0	2	0	0	30581	2
2	0	2	0	0	30582	2
2	0	2	0	0	30583	2
2	0	2	0	0	30584	2
2	0	2	0	0	30585	2
2	0	2	0	0	30586	2
2	0	2	0	0	30587	2
2	0	2	0	0	30588	2
2	0	2	0	0	30589	2
2	0	2	0	0	30590	2
2	0	2	0	0	30591	2
2	0	4	3	3	30592	2
2	0	2	0	0	30593	2
2	0	2	0	0	30594	2
2	0	4	1	1	30595	2
2	0	2	0	0	30596	2
2	0	2	0	0	30597	2
2	0	2	0	0	30598	2
2	0	2	0	0	30599	2
2	0	2	0	0	30600	2
2	0	2	0	0	30601	2
2	0	2	0	0	30602	2
2	0	2	0	0	30603	2
2	0	2	12	12	30604	2
2	0	2	0	0	30605	2
2	0	2	0	0	30606	2
2	0	2	0	0	30607	2
2	0	2	1	1	30608	2
2	0	2	0	0	30609	2
2	0	2	0	0	30610	2
2	0	2	0	0	30611	2
2	0	2	0	0	30612	2
2	0	2	0	0	30613	2
2	0	2	0	0	30614	2
2	0	2	0	0	30615	2
2	0	2	0	0	30616	2
2	0	2	0	0	30617	2
2	0	2	0	0	30618	2
2	0	2	0	0	30619	2
2	0	2	0	0	30620	2
4	0	2	0	0	30621	2
2	0	2	0	0	30622	2
2	0	2	0	0	30623	2
2	0	2	0	0	30624	2
2	0	2	0	0	30625	2
2	0	2	0	0	30626	2
2	0	2	0	0	30627	2
2	0	2	0	0	30628	2
2	0	2	0	0	30629	2
2	0	2	0	0	30630	2
2	0	2	0	0	30631	2
2	0	2	0	0	30632	2
2	0	2	0	0	30633	2
2	0	2	0	0	30634	2
2	0	2	0	0	30635	2
2	0	2	0	0	30636	2
2	0	2	0	0	30637	2
2	0	2	0	0	30638	2
2	0	2	0	0	30639	2
2	0	2	0	0	30640	2
2	0	2	0	0	30641	2
2	0	2	0	0	30642	2
2	0	2	0	0	30643	2
2	0	2	2	2	30644	2
2	0	2	0	0	30645	2
2	0	2	0	0	30646	2
2	0	2	0	0	30647	2
2	0	2	0	0	30648	2
2	0	2	0	0	30649	2
2	0	2	0	0	30650	2
2	0	2	0	0	30651	2
2	0	2	0	0	30652	2
2	0	2	0	0	30653	2
2	0	2	0	0	30654	2
2	0	2	0	0	30655	2
2	0	2	0	0	30656	2
2	0	2	0	0	30657	2
2	0	2	0	0	30658	2
2	0	2	0	0	30659	2
2	0	2	0	0	30660	2
2	0	2	0	0	30661	2
2	0	2	0	0	30662	2
2	0	2	0	0	30663	2
2	0	2	0	0	30664	2
2	0	2	0	0	30665	2
2	0	2	0	0	30666	2
2	0	2	0	0	30667	2
2	0	2	0	0	30668	2
2	0	2	0	0	30669	2
2	0	2	0	0	30670	2
2	0	2	0	0	30671	2
2	0	2	0	0	30672	2
2	0	2	0	0	30673	2
2	0	2	0	0	30674	2
2	0	2	0	0	30675	2
2	0	2	0	0	30676	2
2	0	2	0	0	30677	2
2	0	2	0	0	30678	2
2	0	2	0	0	30679	2
2	0	2	0	0	30680	2
2	0	2	0	0	30681	2
2	0	2	0	0	30682	2
2	0	2	0	0	30683	2
2	0	2	0	0	30684	2
2	0	2	0	0	30685	2
2	0	2	0	0	30686	2
2	0	2	0	0	30687	2
2	0	2	0	0	30688	2
2	0	2	0	0	30689	2
2	0	2	0	0	30690	2
2	0	2	0	0	30691	2
2	0	2	0	0	30692	2
2	0	2	0	0	30693	2
2	0	2	0	0	30694	2
2	0	2	0	0	30695	2
2	0	2	0	0	30696	2
2	0	2	0	0	30697	2
2	0	2	0	0	30698	2
2	0	2	0	0	30699	2
2	0	2	0	0	30700	2
2	0	2	0	0	30701	2
2	0	2	0	0	30702	2
2	0	2	0	0	30703	2
2	0	2	0	0	30704	2
2	0	2	0	0	30705	2
2	0	2	0	0	30706	2
2	0	2	0	0	30707	2
2	0	2	0	0	30708	2
2	0	2	0	0	30709	2
2	0	2	0	0	30710	2
2	0	2	0	0	30711	2
2	0	2	0	0	30712	2
2	0	2	0	0	30713	2
2	118	2	0	118	30714	0
2	0	2	0	0	30715	2
2	0	2	0	0	30716	2
2	0	2	0	0	30717	2
2	0	2	0	0	30718	2
2	0	2	0	0	30719	2
2	0	2	0	0	30720	2
2	0	2	0	0	30721	2
2	0	2	4	4	30722	2
2	0	2	0	0	30723	2
2	0	2	0	0	30724	2
2	0	2	0	0	30725	2
2	0	2	0	0	30726	2
2	2	2	762	764	30727	1
2	0	2	1	1	30728	2
2	0	2	7	7	30729	2
2	11	2	5	16	30730	0
2	0	2	34	34	30731	2
2	0	2	0	0	30732	2
2	0	2	0	0	30733	2
2	0	2	0	0	30734	2
2	0	2	0	0	30735	2
2	0	2	0	0	30736	2
2	0	2	0	0	30737	2
2	2	2	0	2	30738	0
2	10	2	75	85	30739	1
2	0	2	2	2	30740	2
2	0	2	0	0	30741	2
2	3	2	0	3	30742	0
2	0	2	25	25	30743	2
2	0	2	0	0	30744	2
2	0	2	0	0	30745	2
2	0	2	0	0	30746	2
2	0	2	0	0	30747	2
2	0	2	0	0	30748	2
2	0	2	0	0	30749	2
2	0	2	0	0	30750	2
2	0	2	2	2	30751	2
2	0	2	0	0	30752	2
2	0	2	0	0	30753	2
2	0	2	0	0	30754	2
2	0	2	1	1	30755	2
2	0	2	0	0	30756	2
2	0	2	0	0	30757	2
2	0	2	0	0	30758	2
2	0	2	0	0	30759	2
2	0	2	0	0	30760	2
2	0	2	0	0	30761	2
2	0	2	0	0	30762	2
2	0	2	0	0	30763	2
2	0	2	0	0	30764	2
2	0	2	0	0	30765	2
2	0	2	0	0	30766	2
2	0	2	0	0	30767	2
2	0	2	0	0	30768	2
2	0	2	0	0	30769	2
2	0	2	0	0	30770	2
2	0	2	0	0	30771	2
2	0	2	0	0	30772	2
2	0	2	0	0	30773	2
2	0	2	0	0	30774	2
2	0	2	0	0	30775	2
2	0	2	0	0	30776	2
2	0	2	0	0	30777	2
2	0	2	0	0	30778	2
2	0	2	0	0	30779	2
2	0	2	0	0	30780	2
2	0	2	0	0	30781	2
2	0	2	0	0	30782	2
2	0	2	0	0	30783	2
2	0	2	0	0	30784	2
2	0	2	0	0	30785	2
2	0	2	0	0	30786	2
2	0	2	0	0	30787	2
2	0	2	0	0	30788	2
2	0	2	0	0	30789	2
2	0	2	0	0	30790	2
2	0	2	0	0	30791	2
2	0	2	0	0	30792	2
2	0	2	0	0	30793	2
2	3	2	0	3	30794	0
2	1	2	37	38	30795	1
2	0	2	30	30	30796	2
2	0	2	1	1	30797	2
2	5	2	2	7	30798	1
2	0	2	33	33	30799	2
2	0	2	0	0	30800	2
2	0	2	0	0	30801	2
2	0	2	0	0	30802	2
2	0	2	0	0	30803	2
2	0	2	0	0	30804	2
2	0	2	0	0	30805	2
2	0	2	0	0	30806	2
2	0	2	0	0	30807	2
2	0	2	0	0	30808	2
2	0	2	0	0	30809	2
2	0	2	0	0	30810	2
2	0	2	0	0	30811	2
2	0	2	0	0	30812	2
2	0	2	0	0	30813	2
2	0	2	0	0	30814	2
2	0	2	0	0	30815	2
2	0	2	0	0	30816	2
2	0	2	0	0	30817	2
2	0	2	0	0	30818	2
2	0	2	0	0	30819	2
2	0	2	0	0	30820	2
2	0	2	0	0	30821	2
2	0	2	0	0	30822	2
2	0	2	2	2	30823	2
2	0	2	0	0	30824	2
2	0	2	0	0	30825	2
2	0	2	0	0	30826	2
2	0	2	1	1	30827	2
2	0	2	0	0	30828	2
2	0	2	0	0	30829	2
2	0	2	0	0	30830	2
2	0	2	0	0	30831	2
2	0	2	0	0	30832	2
2	0	2	0	0	30833	2
2	0	2	0	0	30834	2
2	0	2	0	0	30835	2
2	0	2	0	0	30836	2
2	0	2	1	1	30837	2
2	0	2	0	0	30838	2
2	0	2	0	0	30839	2
2	0	2	0	0	30840	2
2	0	2	0	0	30841	2
2	0	2	0	0	30842	2
2	0	2	0	0	30843	2
2	0	2	0	0	30844	2
2	0	2	0	0	30845	2
2	0	2	0	0	30846	2
2	0	2	0	0	30847	2
2	0	2	0	0	30848	2
2	0	2	0	0	30849	2
2	0	2	0	0	30850	2
2	0	2	0	0	30851	2
2	0	2	0	0	30852	2
2	0	2	0	0	30853	2
2	0	2	0	0	30854	2
2	0	2	0	0	30855	2
2	0	2	0	0	30856	2
2	0	2	0	0	30857	2
2	0	2	0	0	30858	2
2	0	2	0	0	30859	2
2	0	2	0	0	30860	2
2	0	2	0	0	30861	2
2	0	2	0	0	30862	2
2	0	2	0	0	30863	2
2	0	2	0	0	30864	2
2	0	2	0	0	30865	2
2	0	2	0	0	30866	2
2	0	2	1	1	30867	2
2	0	2	0	0	30868	2
2	0	2	0	0	30869	2
2	0	2	0	0	30870	2
2	0	2	0	0	30871	2
2	0	2	1	1	30872	2
2	0	2	0	0	30873	2
2	0	2	0	0	30874	2
2	0	2	0	0	30875	2
2	0	2	0	0	30876	2
2	0	2	0	0	30877	2
2	0	2	0	0	30878	2
2	0	2	4	4	30879	2
2	0	2	0	0	30880	2
2	0	2	0	0	30881	2
2	0	2	0	0	30882	2
2	0	2	0	0	30883	2
2	0	2	0	0	30884	2
2	0	2	0	0	30885	2
2	0	2	0	0	30886	2
2	0	2	0	0	30887	2
2	0	2	0	0	30888	2
2	0	2	0	0	30889	2
2	0	2	0	0	30890	2
2	0	2	0	0	30891	2
2	0	2	0	0	30892	2
2	0	2	0	0	30893	2
2	0	2	0	0	30894	2
2	0	2	0	0	30895	2
2	0	2	0	0	30896	2
2	0	2	0	0	30897	2
2	0	2	0	0	30898	2
2	0	2	0	0	30899	2
2	0	2	0	0	30900	2
2	0	2	0	0	30901	2
2	0	2	0	0	30902	2
2	0	2	0	0	30903	2
2	0	2	0	0	30904	2
2	0	2	0	0	30905	2
2	0	2	0	0	30906	2
2	0	2	0	0	30907	2
2	0	2	0	0	30908	2
2	0	2	0	0	30909	2
2	0	2	0	0	30910	2
2	0	2	0	0	30911	2
2	0	2	0	0	30912	2
2	0	2	0	0	30913	2
2	0	2	0	0	30914	2
2	0	2	0	0	30915	2
2	0	2	0	0	30916	2
2	0	2	0	0	30917	2
2	0	2	0	0	30918	2
2	0	2	0	0	30919	2
2	0	2	0	0	30920	2
2	0	2	0	0	30921	2
2	0	2	0	0	30922	2
2	0	2	0	0	30923	2
2	0	2	0	0	30924	2
2	0	2	0	0	30925	2
2	0	2	0	0	30926	2
2	0	2	0	0	30927	2
2	0	2	0	0	30928	2
2	0	2	0	0	30929	2
2	0	2	0	0	30930	2
2	0	2	0	0	30931	2
2	0	2	0	0	30932	2
2	0	2	0	0	30933	2
2	0	2	0	0	30934	2
2	0	2	0	0	30935	2
2	0	2	0	0	30936	2
2	0	2	0	0	30937	2
2	0	2	0	0	30938	2
2	0	2	0	0	30939	2
2	0	2	0	0	30940	2
2	0	2	0	0	30941	2
2	0	2	0	0	30942	2
2	0	2	0	0	30943	2
4	0	2	0	0	30944	2
2	0	2	0	0	30945	2
2	0	2	0	0	30946	2
2	0	2	0	0	30947	2
2	0	2	0	0	30948	2
2	0	2	0	0	30949	2
2	0	2	0	0	30950	2
2	0	2	0	0	30951	2
2	0	2	0	0	30952	2
2	0	2	0	0	30953	2
2	0	2	0	0	30954	2
2	0	2	0	0	30955	2
2	0	2	0	0	30956	2
2	0	2	0	0	30957	2
2	0	2	0	0	30958	2
2	0	2	0	0	30959	2
2	0	2	0	0	30960	2
2	0	2	0	0	30961	2
2	0	2	0	0	30962	2
2	0	2	0	0	30963	2
2	0	2	0	0	30964	2
2	0	2	0	0	30965	2
2	0	2	0	0	30966	2
2	0	2	0	0	30967	2
2	0	2	0	0	30968	2
2	0	2	0	0	30969	2
2	0	2	0	0	30970	2
2	0	2	0	0	30971	2
2	0	2	0	0	30972	2
2	0	2	0	0	30973	2
2	0	2	0	0	30974	2
2	0	2	0	0	30975	2
2	0	2	0	0	30976	2
2	0	2	0	0	30977	2
2	0	2	0	0	30978	2
2	0	2	0	0	30979	2
2	0	2	0	0	30980	2
2	0	2	0	0	30981	2
2	0	2	0	0	30982	2
2	0	2	0	0	30983	2
2	0	2	0	0	30984	2
2	0	2	0	0	30985	2
2	0	2	0	0	30986	2
2	0	2	0	0	30987	2
2	0	2	0	0	30988	2
2	0	2	0	0	30989	2
2	0	2	0	0	30990	2
2	0	2	0	0	30991	2
2	0	2	0	0	30992	2
2	0	2	0	0	30993	2
2	0	2	0	0	30994	2
2	0	2	0	0	30995	2
2	0	2	0	0	30996	2
2	0	2	0	0	30997	2
2	0	2	0	0	30998	2
2	0	2	0	0	30999	2
4	0	2	0	0	31000	2
2	0	2	0	0	31001	2
2	0	2	0	0	31002	2
2	0	2	0	0	31003	2
2	0	2	0	0	31004	2
2	0	2	0	0	31005	2
2	0	2	0	0	31006	2
2	1	2	0	1	31007	0
2	0	2	62	62	31008	2
2	0	2	0	0	31009	2
2	0	2	0	0	31010	2
2	0	2	0	0	31011	2
2	0	2	0	0	31012	2
2	0	2	0	0	31013	2
2	0	2	0	0	31014	2
2	0	2	0	0	31015	2
2	0	2	9	9	31016	2
2	0	2	0	0	31017	2
2	0	2	0	0	31018	2
2	0	2	8	8	31019	2
2	0	2	0	0	31020	2
2	0	2	0	0	31021	2
2	0	2	0	0	31022	2
2	0	2	0	0	31023	2
2	0	2	0	0	31024	2
2	0	2	0	0	31025	2
2	0	2	0	0	31026	2
2	0	2	0	0	31027	2
2	0	2	2	2	31028	2
2	0	2	0	0	31029	2
2	0	2	0	0	31030	2
2	0	2	0	0	31031	2
2	0	2	0	0	31032	2
2	0	2	0	0	31033	2
2	0	2	0	0	31034	2
2	0	2	0	0	31035	2
2	0	2	0	0	31036	2
2	0	2	0	0	31037	2
2	0	2	0	0	31038	2
2	34	2	0	34	31039	0
2	0	2	0	0	31040	2
2	0	2	0	0	31041	2
2	0	2	0	0	31042	2
2	0	2	0	0	31043	2
2	0	2	0	0	31044	2
2	0	2	0	0	31045	2
4	0	2	0	0	31046	2
2	0	2	0	0	31047	2
2	0	2	0	0	31048	2
2	0	2	0	0	31049	2
2	0	2	0	0	31050	2
2	0	2	0	0	31051	2
2	0	2	0	0	31052	2
2	0	2	0	0	31053	2
2	0	2	0	0	31054	2
2	0	2	0	0	31055	2
2	0	2	0	0	31056	2
2	0	2	0	0	31057	2
2	0	2	0	0	31058	2
2	0	2	0	0	31059	2
2	0	4	44	44	31060	2
2	0	2	0	0	31061	2
2	0	2	0	0	31062	2
2	0	4	4	4	31063	2
2	0	2	0	0	31064	2
4	0	2	0	0	31065	2
4	0	4	0	0	31066	2
4	0	4	0	0	31067	2
2	2	2	0	2	31068	0
2	0	2	0	0	31069	2
2	0	2	0	0	31070	2
2	2	2	150	152	31071	1
2	0	2	2	2	31072	2
2	0	2	0	0	31073	2
2	4	2	6	10	31074	0
2	0	2	23	23	31075	2
2	0	2	0	0	31076	2
2	0	2	0	0	31077	2
2	0	2	0	0	31078	2
2	0	2	0	0	31079	2
2	0	2	0	0	31080	2
2	0	2	0	0	31081	2
2	0	2	0	0	31082	2
2	0	2	0	0	31083	2
2	0	2	0	0	31084	2
2	0	2	0	0	31085	2
2	0	2	0	0	31086	2
2	0	2	0	0	31087	2
2	1	2	0	1	31088	0
2	0	4	9	9	31089	2
2	0	2	0	0	31090	2
2	0	2	0	0	31091	2
2	0	2	0	0	31092	2
2	0	2	2	2	31093	2
2	0	2	0	0	31094	2
2	0	4	3	3	31095	2
2	0	2	0	0	31096	2
2	0	2	0	0	31097	2
2	0	4	0	0	31098	2
2	0	2	0	0	31099	2
2	6	4	15928	15934	31100	1
2	0	2	0	0	31101	2
2	0	2	0	0	31102	2
0	8	2	3	11	31103	0
0	0	2	3	3	31104	2
2	1	4	1011	1012	31105	1
2	0	2	12	12	31106	2
4	12	2	1	13	31107	0
2	0	2	0	0	31108	2
2	22	2	0	22	31109	0
2	0	2	0	0	31110	2
2	0	2	0	0	31111	2
2	0	2	0	0	31112	2
2	0	2	0	0	31113	2
2	0	2	0	0	31114	2
2	0	2	0	0	31115	2
2	0	2	0	0	31116	2
2	0	2	0	0	31117	2
2	0	2	0	0	31118	2
2	0	2	0	0	31119	2
2	0	2	0	0	31120	2
2	0	2	0	0	31121	2
2	0	2	0	0	31122	2
2	0	2	0	0	31123	2
2	0	2	0	0	31124	2
2	0	2	0	0	31125	2
2	0	2	0	0	31126	2
2	0	2	0	0	31127	2
2	0	2	0	0	31128	2
2	0	2	0	0	31129	2
2	0	2	0	0	31130	2
2	0	2	0	0	31131	2
2	0	2	0	0	31132	2
2	0	2	0	0	31133	2
2	0	2	0	0	31134	2
2	0	2	0	0	31135	2
2	0	2	0	0	31136	2
2	0	2	7	7	31137	2
2	0	2	0	0	31138	2
2	0	2	0	0	31139	2
2	0	2	0	0	31140	2
2	0	2	0	0	31141	2
2	0	2	0	0	31142	2
2	0	2	0	0	31143	2
2	0	2	0	0	31144	2
2	0	2	0	0	31145	2
2	0	2	0	0	31146	2
2	0	2	0	0	31147	2
2	0	2	0	0	31148	2
2	0	2	0	0	31149	2
2	0	2	0	0	31150	2
2	4	2	1	5	31151	0
2	11	2	52	63	31152	1
2	0	2	4	4	31153	2
2	0	2	0	0	31154	2
2	6	2	1	7	31155	0
2	0	2	13	13	31156	2
2	0	4	5	5	31157	2
2	0	2	0	0	31158	2
2	0	2	0	0	31159	2
2	0	4	28	28	31160	2
2	0	2	0	0	31161	2
2	0	2	0	0	31162	2
2	0	2	0	0	31163	2
2	1	2	31	32	31164	1
2	0	2	0	0	31165	2
2	0	2	0	0	31166	2
2	1	2	0	1	31167	0
2	0	2	1	1	31168	2
2	0	2	0	0	31169	2
2	0	2	0	0	31170	2
2	0	2	0	0	31171	2
2	0	2	0	0	31172	2
2	0	2	0	0	31173	2
2	0	2	0	0	31174	2
2	0	2	0	0	31175	2
2	0	4	15	15	31176	2
2	0	2	0	0	31177	2
2	0	2	0	0	31178	2
2	0	4	0	0	31179	2
2	0	2	0	0	31180	2
2	0	2	8	8	31181	2
2	9	2	0	9	31182	0
2	1	2	125	126	31183	1
2	0	2	0	0	31184	2
2	0	2	0	0	31185	2
2	0	2	0	0	31186	2
2	0	2	0	0	31187	2
2	0	2	1	1	31188	2
2	0	2	0	0	31189	2
2	0	2	0	0	31190	2
2	0	2	0	0	31191	2
2	0	2	0	0	31192	2
2	0	2	0	0	31193	2
2	0	2	0	0	31194	2
2	0	2	0	0	31195	2
2	0	2	0	0	31196	2
2	0	2	0	0	31197	2
2	0	2	0	0	31198	2
2	0	2	0	0	31199	2
2	0	2	0	0	31200	2
2	0	2	0	0	31201	2
2	0	2	0	0	31202	2
2	0	2	0	0	31203	2
2	0	2	0	0	31204	2
2	0	2	0	0	31205	2
2	0	2	0	0	31206	2
2	0	2	0	0	31207	2
2	0	2	0	0	31208	2
2	0	2	0	0	31209	2
2	3	2	0	3	31210	0
2	0	2	0	0	31211	2
2	0	2	0	0	31212	2
2	0	2	0	0	31213	2
2	0	2	0	0	31214	2
2	0	2	0	0	31215	2
2	0	2	0	0	31216	2
2	0	2	0	0	31217	2
2	0	2	0	0	31218	2
2	0	2	0	0	31219	2
2	0	2	0	0	31220	2
2	0	2	0	0	31221	2
2	0	2	0	0	31222	2
2	0	2	0	0	31223	2
2	0	2	0	0	31224	2
2	0	2	0	0	31225	2
2	0	2	0	0	31226	2
2	0	2	0	0	31227	2
2	0	2	0	0	31228	2
2	0	2	0	0	31229	2
2	0	2	0	0	31230	2
2	0	2	0	0	31231	2
2	0	2	20	20	31232	2
2	0	2	0	0	31233	2
2	0	2	0	0	31234	2
2	2	2	0	2	31235	0
2	0	2	3	3	31236	2
4	0	2	0	0	31237	2
2	0	2	0	0	31238	2
2	0	2	0	0	31239	2
2	0	2	0	0	31240	2
2	0	2	0	0	31241	2
2	0	2	0	0	31242	2
2	0	2	0	0	31243	2
2	25	2	4	29	31244	0
2	0	4	0	0	31245	2
2	0	2	1	1	31246	2
2	0	2	0	0	31247	2
2	0	2	0	0	31248	2
2	0	2	0	0	31249	2
2	0	2	0	0	31250	2
2	0	2	0	0	31251	2
2	0	2	0	0	31252	2
2	0	2	0	0	31253	2
2	0	2	0	0	31254	2
2	0	2	0	0	31255	2
2	0	2	0	0	31256	2
2	0	2	0	0	31257	2
2	0	2	0	0	31258	2
2	2	2	2	4	31259	1
2	0	2	1	1	31260	2
2	0	2	0	0	31261	2
2	0	2	0	0	31262	2
4	0	2	0	0	31263	2
2	49	2	418	467	31264	1
2	0	2	10	10	31265	2
2	0	2	4	4	31266	2
2	6	2	0	6	31267	0
2	0	4	182	182	31268	2
2	0	2	0	0	31269	2
2	0	2	0	0	31270	2
2	31	2	5	36	31271	1
2	0	2	65	65	31272	2
2	0	2	0	0	31273	2
2	0	2	0	0	31274	2
2	0	2	0	0	31275	2
2	0	2	0	0	31276	2
2	0	2	0	0	31277	2
2	0	2	0	0	31278	2
2	0	2	0	0	31279	2
2	0	4	73	73	31280	2
2	0	2	0	0	31281	2
2	0	2	0	0	31282	2
2	0	4	108	108	31283	2
2	0	2	0	0	31284	2
2	0	2	0	0	31285	2
2	0	2	0	0	31286	2
2	0	2	0	0	31287	2
2	0	2	0	0	31288	2
2	0	2	0	0	31289	2
2	0	2	0	0	31290	2
2	0	2	0	0	31291	2
2	0	2	0	0	31292	2
2	0	2	2	2	31293	2
2	0	2	0	0	31294	2
2	0	2	0	0	31295	2
2	0	2	1	1	31296	2
2	0	2	0	0	31297	2
2	0	2	0	0	31298	2
2	0	2	0	0	31299	2
2	0	2	0	0	31300	2
2	0	2	0	0	31301	2
2	0	2	0	0	31302	2
2	0	2	0	0	31303	2
2	0	2	0	0	31304	2
2	0	2	0	0	31305	2
2	0	2	0	0	31306	2
2	0	2	0	0	31307	2
2	0	2	0	0	31308	2
2	0	2	0	0	31309	2
2	0	2	0	0	31310	2
2	0	2	0	0	31311	2
2	0	4	0	0	31312	2
2	0	2	0	0	31313	2
2	0	2	0	0	31314	2
2	0	2	0	0	31315	2
2	0	2	0	0	31316	2
2	0	2	0	0	31317	2
2	0	2	0	0	31318	2
2	0	2	0	0	31319	2
2	0	2	0	0	31320	2
2	0	2	0	0	31321	2
2	0	2	0	0	31322	2
4	0	2	0	0	31323	2
2	0	2	0	0	31324	2
2	0	2	0	0	31325	2
2	0	2	0	0	31326	2
2	0	2	0	0	31327	2
2	0	2	0	0	31328	2
2	0	2	0	0	31329	2
2	0	2	0	0	31330	2
2	0	2	0	0	31331	2
2	0	2	0	0	31332	2
2	0	2	0	0	31333	2
2	0	2	0	0	31334	2
2	0	2	0	0	31335	2
2	0	2	0	0	31336	2
2	0	2	0	0	31337	2
2	0	2	0	0	31338	2
2	0	2	0	0	31339	2
2	0	2	0	0	31340	2
2	0	2	0	0	31341	2
2	0	2	0	0	31342	2
2	0	2	0	0	31343	2
2	0	2	0	0	31344	2
2	0	2	0	0	31345	2
2	0	2	0	0	31346	2
2	0	2	0	0	31347	2
2	0	2	0	0	31348	2
2	0	2	0	0	31349	2
2	0	2	0	0	31350	2
2	0	2	0	0	31351	2
2	0	2	0	0	31352	2
2	0	2	0	0	31353	2
2	0	2	0	0	31354	2
2	0	2	0	0	31355	2
2	0	4	4	4	31356	2
2	0	2	0	0	31357	2
2	0	2	0	0	31358	2
2	0	4	1	1	31359	2
2	0	2	0	0	31360	2
2	0	2	1	1	31361	2
2	0	2	0	0	31362	2
2	0	2	0	0	31363	2
2	0	2	0	0	31364	2
2	0	2	0	0	31365	2
2	0	2	0	0	31366	2
2	0	2	0	0	31367	2
2	0	2	0	0	31368	2
2	0	2	0	0	31369	2
2	0	2	0	0	31370	2
2	0	2	0	0	31371	2
2	0	2	0	0	31372	2
2	0	2	0	0	31373	2
2	0	2	0	0	31374	2
2	0	2	0	0	31375	2
2	0	2	0	0	31376	2
2	0	2	0	0	31377	2
2	0	2	0	0	31378	2
2	0	2	0	0	31379	2
2	0	2	0	0	31380	2
2	0	2	0	0	31381	2
2	0	2	0	0	31382	2
2	0	2	0	0	31383	2
2	0	2	0	0	31384	2
2	0	2	0	0	31385	2
2	0	2	0	0	31386	2
2	0	2	0	0	31387	2
2	0	2	0	0	31388	2
2	0	2	0	0	31389	2
2	0	2	0	0	31390	2
2	0	2	0	0	31391	2
2	0	2	0	0	31392	2
2	0	2	0	0	31393	2
2	0	2	0	0	31394	2
2	0	2	0	0	31395	2
2	0	2	0	0	31396	2
2	0	2	0	0	31397	2
2	0	2	0	0	31398	2
2	0	2	0	0	31399	2
2	0	2	0	0	31400	2
2	0	2	0	0	31401	2
2	0	2	0	0	31402	2
2	0	2	0	0	31403	2
2	1	2	0	1	31404	1
2	0	2	0	0	31405	2
2	0	2	0	0	31406	2
2	0	2	0	0	31407	2
2	0	2	0	0	31408	2
4	0	2	2	2	31409	2
2	0	2	0	0	31410	2
2	0	2	0	0	31411	2
2	0	2	0	0	31412	2
2	0	2	0	0	31413	2
2	0	2	0	0	31414	2
2	0	2	0	0	31415	2
2	0	2	0	0	31416	2
2	0	2	0	0	31417	2
2	0	2	0	0	31418	2
2	0	2	0	0	31419	2
2	0	2	0	0	31420	2
2	0	2	0	0	31421	2
2	0	2	0	0	31422	2
2	0	2	0	0	31423	2
2	0	2	0	0	31424	2
2	0	2	0	0	31425	2
2	0	2	0	0	31426	2
2	0	2	0	0	31427	2
2	0	2	0	0	31428	2
2	0	2	0	0	31429	2
2	0	2	0	0	31430	2
2	0	2	1	1	31431	2
2	0	2	0	0	31432	2
2	0	2	0	0	31433	2
2	0	2	0	0	31434	2
2	0	2	0	0	31435	2
2	0	2	0	0	31436	2
2	0	2	0	0	31437	2
2	0	2	0	0	31438	2
2	0	2	0	0	31439	2
2	0	2	0	0	31440	2
2	0	2	0	0	31441	2
2	0	2	0	0	31442	2
2	0	2	0	0	31443	2
2	0	2	0	0	31444	2
2	0	2	0	0	31445	2
2	0	2	0	0	31446	2
2	0	2	0	0	31447	2
2	0	2	0	0	31448	2
2	0	4	0	0	31449	2
2	0	2	0	0	31450	2
2	0	2	0	0	31451	2
2	0	4	0	0	31452	2
2	0	2	0	0	31453	2
2	0	2	0	0	31454	2
2	0	2	0	0	31455	2
2	0	2	0	0	31456	2
2	0	2	0	0	31457	2
2	0	2	0	0	31458	2
2	0	2	4	4	31459	2
2	0	2	0	0	31460	2
2	0	2	0	0	31461	2
2	0	2	0	0	31462	2
2	0	2	1	1	31463	2
2	0	2	0	0	31464	2
2	0	2	0	0	31465	2
2	0	2	3	3	31466	2
2	2	2	0	2	31467	0
2	0	2	45	45	31468	2
2	0	2	0	0	31469	2
2	0	2	0	0	31470	2
2	0	2	0	0	31471	2
2	0	2	0	0	31472	2
2	0	2	0	0	31473	2
2	0	2	0	0	31474	2
2	0	2	0	0	31475	2
2	0	2	0	0	31476	2
2	0	2	0	0	31477	2
2	0	2	0	0	31478	2
2	0	2	0	0	31479	2
2	0	2	0	0	31480	2
2	0	2	0	0	31481	2
2	0	2	1	1	31482	2
2	0	2	0	0	31483	2
2	0	2	0	0	31484	2
2	0	2	0	0	31485	2
2	0	2	0	0	31486	2
2	0	2	0	0	31487	2
2	0	2	0	0	31488	2
2	0	2	0	0	31489	2
2	45	2	0	45	31490	0
2	0	2	0	0	31491	2
2	0	2	0	0	31492	2
2	0	2	0	0	31493	2
2	0	2	0	0	31494	2
2	0	2	0	0	31495	2
2	0	2	0	0	31496	2
2	0	2	20	20	31497	2
2	0	2	26	26	31498	2
2	0	2	0	0	31499	2
2	1	2	0	1	31500	1
2	0	2	14	14	31501	2
2	0	2	0	0	31502	2
2	0	2	0	0	31503	2
2	0	2	0	0	31504	2
2	0	2	0	0	31505	2
2	0	2	0	0	31506	2
2	0	2	0	0	31507	2
2	0	2	0	0	31508	2
2	0	2	0	0	31509	2
2	0	2	0	0	31510	2
2	0	2	0	0	31511	2
2	0	2	0	0	31512	2
2	0	2	0	0	31513	2
2	0	2	0	0	31514	2
2	0	4	13	13	31515	2
2	0	2	0	0	31516	2
2	0	2	0	0	31517	2
2	0	4	204	204	31518	2
2	0	2	0	0	31519	2
2	0	2	0	0	31520	2
2	0	2	0	0	31521	2
2	0	2	0	0	31522	2
2	0	2	11	11	31523	2
2	0	2	0	0	31524	2
2	0	2	0	0	31525	2
2	0	2	0	0	31526	2
2	0	2	0	0	31527	2
2	0	2	0	0	31528	2
2	0	2	0	0	31529	2
2	0	2	0	0	31530	2
2	0	2	0	0	31531	2
2	0	2	0	0	31532	2
2	0	2	0	0	31533	2
2	0	2	0	0	31534	2
2	0	2	0	0	31535	2
2	0	2	0	0	31536	2
2	1	2	4	5	31537	1
2	0	2	0	0	31538	2
2	0	2	0	0	31539	2
2	0	2	0	0	31540	2
2	0	2	0	0	31541	2
2	1	2	0	1	31542	0
2	0	2	0	0	31543	2
2	0	2	0	0	31544	2
2	0	2	0	0	31545	2
2	0	2	0	0	31546	2
2	0	2	0	0	31547	2
2	0	2	0	0	31548	2
2	0	2	0	0	31549	2
2	0	2	0	0	31550	2
2	1	2	0	1	31551	0
2	0	2	0	0	31552	2
2	0	2	0	0	31553	2
2	0	2	0	0	31554	2
2	0	2	0	0	31555	2
2	0	2	0	0	31556	2
2	0	2	0	0	31557	2
2	0	2	0	0	31558	2
2	0	2	0	0	31559	2
2	0	2	0	0	31560	2
2	0	2	0	0	31561	2
2	0	2	0	0	31562	2
2	0	2	0	0	31563	2
2	0	2	0	0	31564	2
2	0	2	0	0	31565	2
2	0	2	0	0	31566	2
2	0	2	0	0	31567	2
2	0	2	0	0	31568	2
2	0	2	0	0	31569	2
2	0	2	0	0	31570	2
2	2	2	14	16	31571	1
2	0	2	2	2	31572	2
2	0	2	0	0	31573	2
2	0	2	0	0	31574	2
2	0	2	0	0	31575	2
2	4	2	0	4	31576	1
2	1	2	2	3	31577	1
2	0	2	0	0	31578	2
2	0	2	0	0	31579	2
2	0	2	0	0	31580	2
2	0	2	0	0	31581	2
2	0	2	0	0	31582	2
2	0	2	0	0	31583	2
2	0	2	0	0	31584	2
2	0	2	0	0	31585	2
2	0	2	0	0	31586	2
2	3	2	0	3	31587	0
2	0	2	0	0	31588	2
2	0	2	0	0	31589	2
2	0	2	0	0	31590	2
2	0	2	0	0	31591	2
2	0	2	0	0	31592	2
2	0	2	0	0	31593	2
2	0	2	0	0	31594	2
2	0	2	0	0	31595	2
2	0	2	0	0	31596	2
2	0	2	0	0	31597	2
2	25	2	1	26	31598	0
2	87	2	99	186	31599	1
2	0	2	0	0	31600	2
2	0	2	0	0	31601	2
2	51	2	0	51	31602	1
2	0	2	47	47	31603	2
4	0	2	0	0	31604	2
2	1	2	0	1	31605	1
2	1	2	5	6	31606	1
2	0	2	1	1	31607	2
2	0	2	0	0	31608	2
2	0	2	0	0	31609	2
2	0	2	1	1	31610	2
2	0	2	0	0	31611	2
2	0	2	0	0	31612	2
2	0	2	0	0	31613	2
2	0	2	0	0	31614	2
2	0	2	0	0	31615	2
2	0	2	0	0	31616	2
2	0	2	0	0	31617	2
2	0	4	0	0	31618	2
2	0	2	0	0	31619	2
2	0	2	0	0	31620	2
2	0	4	0	0	31621	2
2	0	2	0	0	31622	2
2	0	2	0	0	31623	2
2	0	2	0	0	31624	2
2	0	2	0	0	31625	2
2	0	2	0	0	31626	2
2	0	2	0	0	31627	2
2	0	2	232	232	31628	2
2	0	2	0	0	31629	2
2	0	2	0	0	31630	2
2	0	2	0	0	31631	2
2	0	2	0	0	31632	2
2	0	2	0	0	31633	2
2	0	2	0	0	31634	2
2	0	2	0	0	31635	2
2	0	4	0	0	31636	2
2	0	2	0	0	31637	2
2	0	2	0	0	31638	2
2	0	4	0	0	31639	2
2	0	2	0	0	31640	2
2	0	2	0	0	31641	2
2	0	2	0	0	31642	2
2	0	2	0	0	31643	2
2	0	2	0	0	31644	2
2	0	2	0	0	31645	2
2	0	2	0	0	31646	2
2	0	2	0	0	31647	2
2	0	2	0	0	31648	2
2	0	2	0	0	31649	2
2	0	2	0	0	31650	2
2	0	2	0	0	31651	2
2	0	2	0	0	31652	2
2	0	2	0	0	31653	2
2	0	2	0	0	31654	2
2	0	2	0	0	31655	2
2	0	2	0	0	31656	2
2	0	2	0	0	31657	2
2	0	2	0	0	31658	2
2	0	2	0	0	31659	2
2	0	2	0	0	31660	2
2	0	2	0	0	31661	2
2	0	2	0	0	31662	2
2	0	2	0	0	31663	2
2	0	2	0	0	31664	2
2	0	2	0	0	31665	2
2	0	2	0	0	31666	2
2	0	2	0	0	31667	2
2	0	2	0	0	31668	2
2	0	2	0	0	31669	2
2	0	2	0	0	31670	2
2	0	2	0	0	31671	2
2	0	2	0	0	31672	2
2	0	2	0	0	31673	2
2	0	2	3	3	31674	2
2	0	2	0	0	31675	2
2	0	2	0	0	31676	2
2	0	2	0	0	31677	2
2	0	2	1	1	31678	2
2	0	4	2	2	31679	2
2	0	2	0	0	31680	2
2	0	2	0	0	31681	2
2	0	4	0	0	31682	2
2	0	2	0	0	31683	2
2	0	2	0	0	31684	2
2	0	2	0	0	31685	2
2	0	2	0	0	31686	2
2	0	2	0	0	31687	2
2	0	2	0	0	31688	2
2	0	2	0	0	31689	2
2	0	2	0	0	31690	2
2	0	2	1	1	31691	2
2	0	2	0	0	31692	2
2	0	2	0	0	31693	2
2	0	2	0	0	31694	2
2	0	2	0	0	31695	2
2	1	2	0	1	31696	0
2	0	2	0	0	31697	2
2	0	2	0	0	31698	2
2	0	2	0	0	31699	2
2	0	2	0	0	31700	2
2	0	2	0	0	31701	2
2	0	2	0	0	31702	2
2	0	2	0	0	31703	2
2	0	2	0	0	31704	2
2	0	2	0	0	31705	2
2	0	2	0	0	31706	2
2	0	2	0	0	31707	2
2	0	2	0	0	31708	2
2	0	2	0	0	31709	2
2	19	2	0	19	31710	0
2	0	2	1	1	31711	2
2	0	2	0	0	31712	2
2	0	2	0	0	31713	2
2	0	2	0	0	31714	2
2	75	2	4	79	31715	1
2	0	2	5	5	31716	2
2	0	2	4	4	31717	2
2	20	2	1	21	31718	1
2	105	2	0	105	31719	0
2	16	0	2022	2038	31720	1
2	0	2	80	80	31721	2
2	0	2	12	12	31722	2
2	57	0	318	375	31723	0
2	0	2	531	531	31724	2
2	0	2	0	0	31725	2
2	0	2	0	0	31726	2
2	0	4	4794	4794	31727	2
2	0	2	11	11	31728	2
2	1	2	0	1	31729	0
2	0	2	0	0	31730	2
2	0	2	0	0	31731	2
2	0	2	0	0	31732	2
2	0	2	0	0	31733	2
2	0	2	0	0	31734	2
2	0	2	0	0	31735	2
2	3	4	79	82	31736	0
2	0	2	0	0	31737	2
2	0	2	0	0	31738	2
2	4	4	20	24	31739	0
2	0	2	5	5	31740	2
2	0	2	0	0	31741	2
2	0	2	0	0	31742	2
2	0	2	0	0	31743	2
2	0	2	0	0	31744	2
2	0	2	0	0	31745	2
2	0	2	0	0	31746	2
2	1	2	336	337	31747	1
2	5	2	0	5	31748	0
2	0	2	14	14	31749	2
2	0	2	0	0	31750	2
2	0	2	0	0	31751	2
2	0	2	0	0	31752	2
2	0	2	0	0	31753	2
2	0	2	0	0	31754	2
2	0	2	0	0	31755	2
2	0	2	0	0	31756	2
2	0	2	0	0	31757	2
2	0	2	0	0	31758	2
2	0	2	0	0	31759	2
2	0	2	0	0	31760	2
2	0	2	0	0	31761	2
2	0	2	0	0	31762	2
2	0	2	0	0	31763	2
2	0	2	0	0	31764	2
2	0	2	0	0	31765	2
2	0	2	0	0	31766	2
2	0	2	0	0	31767	2
2	0	2	0	0	31768	2
2	0	2	0	0	31769	2
2	0	4	3	3	31770	2
2	0	2	0	0	31771	2
2	0	2	0	0	31772	2
2	0	4	9	9	31773	2
2	0	2	0	0	31774	2
2	0	4	1	1	31775	2
2	0	2	0	0	31776	2
2	0	2	0	0	31777	2
2	0	4	0	0	31778	2
2	0	2	0	0	31779	2
2	1	2	0	1	31780	0
2	0	2	0	0	31781	2
2	0	2	0	0	31782	2
2	0	2	0	0	31783	2
2	0	2	0	0	31784	2
2	1	2	3	4	31785	1
2	0	2	0	0	31786	2
2	0	2	0	0	31787	2
2	3	2	0	3	31788	1
2	0	2	1	1	31789	2
2	0	4	25	25	31790	2
2	0	2	0	0	31791	2
2	0	2	0	0	31792	2
2	0	2	0	0	31793	2
2	0	2	0	0	31794	2
2	0	2	0	0	31795	2
2	0	2	0	0	31796	2
2	0	2	0	0	31797	2
2	0	2	0	0	31798	2
2	0	2	0	0	31799	2
2	0	2	0	0	31800	2
2	0	2	0	0	31801	2
2	0	2	0	0	31802	2
2	0	2	0	0	31803	2
2	0	2	0	0	31804	2
2	0	2	0	0	31805	2
2	0	2	0	0	31806	2
2	0	2	0	0	31807	2
2	0	2	0	0	31808	2
2	0	2	0	0	31809	2
2	0	2	0	0	31810	2
2	0	2	0	0	31811	2
2	0	2	0	0	31812	2
2	0	2	0	0	31813	2
2	0	2	0	0	31814	2
2	0	2	0	0	31815	2
2	0	2	0	0	31816	2
2	0	2	0	0	31817	2
2	0	2	0	0	31818	2
2	0	2	0	0	31819	2
2	0	2	0	0	31820	2
2	0	2	0	0	31821	2
2	0	2	0	0	31822	2
2	0	2	0	0	31823	2
2	0	2	0	0	31824	2
2	0	2	0	0	31825	2
2	0	2	0	0	31826	2
2	0	2	0	0	31827	2
2	0	2	0	0	31828	2
2	0	2	0	0	31829	2
2	0	2	0	0	31830	2
2	0	2	0	0	31831	2
2	0	2	0	0	31832	2
2	0	2	0	0	31833	2
2	0	2	0	0	31834	2
2	0	2	0	0	31835	2
2	0	2	0	0	31836	2
2	0	2	0	0	31837	2
2	0	2	0	0	31838	2
2	0	2	0	0	31839	2
2	0	2	0	0	31840	2
2	2	2	0	2	31841	0
2	6	4	258	264	31842	1
2	0	2	2	2	31843	2
2	0	2	0	0	31844	2
2	0	4	65	65	31845	2
2	0	2	0	0	31846	2
2	1	2	0	1	31847	0
2	0	4	3	3	31848	2
2	0	2	0	0	31849	2
2	0	2	0	0	31850	2
2	0	4	0	0	31851	2
2	0	2	0	0	31852	2
2	2	4	5	7	31853	1
2	0	2	0	0	31854	2
2	0	2	0	0	31855	2
2	0	2	0	0	31856	2
2	0	4	576	576	31857	2
2	0	2	0	0	31858	2
2	0	2	0	0	31859	2
2	0	4	0	0	31860	2
2	0	2	4	4	31861	2
2	0	2	0	0	31862	2
2	0	2	0	0	31863	2
2	0	2	0	0	31864	2
2	0	2	0	0	31865	2
2	0	2	0	0	31866	2
2	0	2	0	0	31867	2
2	0	2	0	0	31868	2
2	0	2	0	0	31869	2
2	0	2	0	0	31870	2
2	0	2	0	0	31871	2
2	0	2	0	0	31872	2
2	0	2	0	0	31873	2
2	0	2	0	0	31874	2
2	0	2	0	0	31875	2
2	0	2	0	0	31876	2
2	0	2	0	0	31877	2
2	0	2	0	0	31878	2
2	0	2	0	0	31879	2
2	0	2	0	0	31880	2
2	0	2	0	0	31881	2
2	0	2	0	0	31882	2
2	0	2	0	0	31883	2
2	0	2	0	0	31884	2
2	0	2	0	0	31885	2
2	0	2	0	0	31886	2
2	0	4	3	3	31887	2
2	0	2	0	0	31888	2
2	0	2	0	0	31889	2
2	0	4	1	1	31890	2
2	0	2	0	0	31891	2
2	0	2	0	0	31892	2
2	0	2	0	0	31893	2
2	0	2	0	0	31894	2
2	0	2	0	0	31895	2
2	0	2	0	0	31896	2
2	0	2	0	0	31897	2
2	0	2	0	0	31898	2
2	0	2	0	0	31899	2
2	0	2	0	0	31900	2
2	0	2	0	0	31901	2
2	0	2	0	0	31902	2
2	0	2	0	0	31903	2
2	0	2	0	0	31904	2
2	0	2	0	0	31905	2
2	0	2	0	0	31906	2
2	0	2	0	0	31907	2
2	0	2	0	0	31908	2
2	0	2	0	0	31909	2
2	0	2	5	5	31910	2
2	0	2	0	0	31911	2
2	0	2	0	0	31912	2
2	0	2	0	0	31913	2
2	0	2	0	0	31914	2
2	0	2	0	0	31915	2
2	0	2	0	0	31916	2
2	0	2	0	0	31917	2
2	0	2	1	1	31918	2
2	0	2	0	0	31919	2
2	0	2	0	0	31920	2
2	0	2	0	0	31921	2
2	40	4	1	41	31922	0
2	1	2	178	179	31923	1
2	0	2	0	0	31924	2
2	0	4	2958	2958	31925	2
2	0	2	0	0	31926	2
2	0	2	0	0	31927	2
0	0	2	0	0	31928	2
0	0	2	0	0	31929	2
2	0	4	381	381	31930	2
2	0	2	0	0	31931	2
2	48	2	12581	12629	31932	1
2	0	2	0	0	31933	2
2	0	2	0	0	31934	2
2	0	2	0	0	31935	2
2	0	2	0	0	31936	2
2	0	2	0	0	31937	2
2	0	2	0	0	31938	2
2	0	2	0	0	31939	2
2	0	2	0	0	31940	2
2	0	2	0	0	31941	2
2	0	2	0	0	31942	2
2	0	2	0	0	31943	2
2	0	2	0	0	31944	2
2	0	2	0	0	31945	2
2	0	2	0	0	31946	2
2	0	2	0	0	31947	2
2	0	2	0	0	31948	2
2	0	2	0	0	31949	2
2	0	2	0	0	31950	2
2	0	2	0	0	31951	2
2	0	2	0	0	31952	2
2	0	2	0	0	31953	2
2	0	2	0	0	31954	2
2	0	2	0	0	31955	2
2	0	2	0	0	31956	2
2	0	2	0	0	31957	2
2	0	2	0	0	31958	2
2	0	2	0	0	31959	2
2	0	2	0	0	31960	2
2	0	2	0	0	31961	2
2	0	2	0	0	31962	2
2	1	2	0	1	31963	0
2	0	2	0	0	31964	2
2	0	2	1	1	31965	2
2	0	2	0	0	31966	2
2	0	2	0	0	31967	2
2	0	2	0	0	31968	2
2	0	2	0	0	31969	2
2	0	2	0	0	31970	2
2	0	2	0	0	31971	2
2	0	2	0	0	31972	2
2	0	2	0	0	31973	2
2	0	2	0	0	31974	2
2	0	2	0	0	31975	2
2	0	2	0	0	31976	2
2	0	2	0	0	31977	2
2	0	2	0	0	31978	2
2	0	2	0	0	31979	2
2	0	2	0	0	31980	2
2	0	2	0	0	31981	2
2	0	2	0	0	31982	2
2	0	2	0	0	31983	2
2	0	2	0	0	31984	2
2	0	2	0	0	31985	2
2	0	2	0	0	31986	2
2	0	2	0	0	31987	2
2	0	4	14	14	31988	2
2	0	2	0	0	31989	2
2	0	2	0	0	31990	2
2	0	4	4	4	31991	2
2	0	2	0	0	31992	2
2	0	2	19	19	31993	2
2	0	2	0	0	31994	2
2	0	2	0	0	31995	2
2	1	2	0	1	31996	0
2	0	2	7	7	31997	2
2	0	2	0	0	31998	2
2	0	2	0	0	31999	2
2	0	2	0	0	32000	2
2	0	2	0	0	32001	2
2	0	2	0	0	32002	2
2	0	2	0	0	32003	2
2	0	2	0	0	32004	2
2	0	2	0	0	32005	2
2	0	2	0	0	32006	2
2	0	2	0	0	32007	2
2	0	2	0	0	32008	2
2	0	2	0	0	32009	2
2	0	2	0	0	32010	2
2	0	2	0	0	32011	2
2	0	2	0	0	32012	2
2	0	2	0	0	32013	2
2	0	2	0	0	32014	2
2	0	2	0	0	32015	2
2	0	2	0	0	32016	2
2	0	2	0	0	32017	2
2	0	2	0	0	32018	2
2	0	2	0	0	32019	2
2	0	2	0	0	32020	2
2	1	2	0	1	32021	0
2	0	2	37	37	32022	2
2	0	2	0	0	32023	2
2	0	2	0	0	32024	2
2	0	2	0	0	32025	2
2	0	2	0	0	32026	2
2	0	4	902	902	32027	2
2	0	2	0	0	32028	2
2	0	2	0	0	32029	2
2	0	4	659	659	32030	2
2	0	2	0	0	32031	2
2	0	2	0	0	32032	2
2	0	2	0	0	32033	2
2	0	2	0	0	32034	2
2	0	2	0	0	32035	2
2	0	2	0	0	32036	2
2	0	2	0	0	32037	2
2	0	2	0	0	32038	2
2	0	2	0	0	32039	2
2	0	2	0	0	32040	2
2	0	2	0	0	32041	2
2	0	2	0	0	32042	2
2	0	2	0	0	32043	2
2	0	4	165	165	32044	2
2	0	2	0	0	32045	2
2	0	2	0	0	32046	2
2	0	4	36	36	32047	2
2	0	2	0	0	32048	2
2	0	2	0	0	32049	2
2	0	2	0	0	32050	2
2	0	2	0	0	32051	2
2	0	2	0	0	32052	2
2	0	2	0	0	32053	2
2	0	2	0	0	32054	2
2	0	2	0	0	32055	2
2	0	2	0	0	32056	2
2	0	2	0	0	32057	2
2	2	2	1	3	32058	0
2	0	2	4	4	32059	2
2	0	2	3	3	32060	2
2	0	2	0	0	32061	2
2	0	2	0	0	32062	2
2	9	2	0	9	32063	0
2	4	2	67	71	32064	1
2	0	2	2	2	32065	2
2	0	2	0	0	32066	2
4	67	2	1	68	32067	0
2	0	2	0	0	32068	2
2	0	2	0	0	32069	2
4	0	2	0	0	32070	2
2	0	2	0	0	32071	2
2	0	2	0	0	32072	2
2	0	2	0	0	32073	2
2	0	2	0	0	32074	2
2	0	2	0	0	32075	2
2	0	2	0	0	32076	2
2	0	4	0	0	32077	2
2	0	2	0	0	32078	2
2	0	2	0	0	32079	2
2	0	4	0	0	32080	2
2	0	4	19	19	32081	2
4	0	2	2	2	32082	2
0	3	2	0	3	32083	0
0	0	2	0	0	32084	2
0	0	2	0	0	32085	2
2	0	2	0	0	32086	2
2	0	2	0	0	32087	2
4	1	2	0	1	32088	0
4	0	2	0	0	32089	2
4	0	2	0	0	32090	2
4	0	2	0	0	32091	2
2	0	4	0	0	32092	2
4	728	2	3	731	32093	0
4	11	2	0	11	32094	0
4	0	2	0	0	32095	2
2	0	2	0	0	32096	2
2	0	2	0	0	32097	2
2	0	2	0	0	32098	2
2	0	2	0	0	32099	2
2	0	2	0	0	32100	2
2	0	2	0	0	32101	2
2	0	2	0	0	32102	2
2	0	2	0	0	32103	2
2	0	2	0	0	32104	2
2	0	2	0	0	32105	2
2	0	2	0	0	32106	2
2	0	2	0	0	32107	2
2	0	2	0	0	32108	2
2	0	2	0	0	32109	2
2	0	2	0	0	32110	2
2	0	2	0	0	32111	2
2	0	2	0	0	32112	2
2	0	2	0	0	32113	2
2	0	2	0	0	32114	2
2	0	2	0	0	32115	2
2	0	2	0	0	32116	2
2	2	2	0	2	32117	1
2	1	2	42	43	32118	1
2	91	2	2	93	32119	0
2	1	2	111	112	32120	1
2	0	2	0	0	32121	2
2	0	2	0	0	32122	2
2	0	2	0	0	32123	2
2	0	2	0	0	32124	2
2	0	2	0	0	32125	2
2	0	2	0	0	32126	2
2	0	2	0	0	32127	2
2	0	2	0	0	32128	2
2	0	2	0	0	32129	2
2	0	2	0	0	32130	2
2	0	2	0	0	32131	2
2	0	2	0	0	32132	2
2	0	2	0	0	32133	2
2	0	2	0	0	32134	2
2	0	2	0	0	32135	2
2	0	2	0	0	32136	2
2	0	2	0	0	32137	2
2	0	2	0	0	32138	2
2	0	2	0	0	32139	2
2	0	2	0	0	32140	2
4	0	4	0	0	32141	2
4	0	4	0	0	32142	2
2	0	2	0	0	32143	2
2	0	2	0	0	32144	2
2	0	2	0	0	32145	2
2	0	2	0	0	32146	2
2	0	2	0	0	32147	2
2	0	2	0	0	32148	2
2	0	2	0	0	32149	2
2	0	2	0	0	32150	2
2	0	2	0	0	32151	2
2	0	2	0	0	32152	2
2	0	2	0	0	32153	2
2	0	2	0	0	32154	2
2	0	2	0	0	32155	2
2	0	2	0	0	32156	2
2	0	2	0	0	32157	2
2	0	2	0	0	32158	2
2	0	2	0	0	32159	2
2	0	2	0	0	32160	2
2	0	2	0	0	32161	2
2	0	2	0	0	32162	2
2	0	2	0	0	32163	2
2	0	2	0	0	32164	2
2	0	2	0	0	32165	2
2	0	2	0	0	32166	2
2	0	2	0	0	32167	2
2	0	2	0	0	32168	2
2	0	2	0	0	32169	2
2	0	2	0	0	32170	2
2	0	2	0	0	32171	2
2	0	2	0	0	32172	2
2	0	2	0	0	32173	2
2	0	2	0	0	32174	2
2	0	2	0	0	32175	2
2	0	2	0	0	32176	2
2	0	2	0	0	32177	2
2	0	2	0	0	32178	2
2	0	2	0	0	32179	2
2	0	2	0	0	32180	2
2	0	2	0	0	32181	2
2	0	2	0	0	32182	2
2	0	2	0	0	32183	2
2	0	2	0	0	32184	2
2	0	2	0	0	32185	2
2	0	2	0	0	32186	2
2	0	2	0	0	32187	2
2	0	2	0	0	32188	2
2	16	2	0	16	32189	0
2	6	2	34	40	32190	1
2	0	2	2	2	32191	2
2	0	2	0	0	32192	2
2	6	2	0	6	32193	0
2	0	2	14	14	32194	2
2	16	2	5	21	32195	0
2	2	2	129	131	32196	1
2	117	2	0	117	32197	0
2	10	2	266	276	32198	1
2	0	2	87	87	32199	2
2	0	2	0	0	32200	2
2	0	2	0	0	32201	2
2	0	2	0	0	32202	2
2	0	2	0	0	32203	2
2	0	2	0	0	32204	2
2	0	2	0	0	32205	2
2	0	2	0	0	32206	2
2	0	2	0	0	32207	2
2	0	2	0	0	32208	2
2	0	2	0	0	32209	2
2	0	2	0	0	32210	2
2	0	2	0	0	32211	2
2	0	2	0	0	32212	2
2	6	2	0	6	32213	0
2	3	2	9	12	32214	1
2	0	2	0	0	32215	2
2	0	2	0	0	32216	2
2	1	2	0	1	32217	0
2	0	2	2	2	32218	2
4	0	2	0	0	32219	2
2	0	2	0	0	32220	2
2	0	2	0	0	32221	2
2	0	2	0	0	32222	2
2	0	2	0	0	32223	2
2	0	2	0	0	32224	2
2	0	2	0	0	32225	2
2	0	2	0	0	32226	2
2	0	2	0	0	32227	2
2	0	2	0	0	32228	2
2	0	2	0	0	32229	2
2	0	2	0	0	32230	2
2	0	2	0	0	32231	2
2	0	2	0	0	32232	2
2	0	2	0	0	32233	2
2	0	2	0	0	32234	2
2	0	2	0	0	32235	2
2	0	2	0	0	32236	2
2	0	2	0	0	32237	2
2	0	2	0	0	32238	2
2	0	2	0	0	32239	2
2	0	2	0	0	32240	2
2	0	2	0	0	32241	2
2	0	2	0	0	32242	2
2	0	2	0	0	32243	2
2	0	2	0	0	32244	2
2	0	2	0	0	32245	2
2	0	2	0	0	32246	2
2	0	2	0	0	32247	2
2	0	2	0	0	32248	2
2	0	2	0	0	32249	2
2	0	2	0	0	32250	2
2	0	2	0	0	32251	2
2	0	2	0	0	32252	2
2	0	2	0	0	32253	2
2	0	2	0	0	32254	2
2	0	2	0	0	32255	2
2	0	2	0	0	32256	2
2	0	2	0	0	32257	2
2	0	2	0	0	32258	2
2	0	2	0	0	32259	2
2	0	2	0	0	32260	2
2	0	2	0	0	32261	2
2	0	2	0	0	32262	2
2	0	2	0	0	32263	2
2	0	2	0	0	32264	2
2	0	2	0	0	32265	2
2	0	2	0	0	32266	2
2	0	2	0	0	32267	2
2	0	2	0	0	32268	2
2	0	2	0	0	32269	2
2	0	2	0	0	32270	2
2	0	2	0	0	32271	2
2	0	2	0	0	32272	2
2	0	2	0	0	32273	2
2	0	2	0	0	32274	2
2	0	2	0	0	32275	2
2	0	2	0	0	32276	2
2	0	2	0	0	32277	2
2	0	2	0	0	32278	2
2	0	2	0	0	32279	2
2	0	2	0	0	32280	2
2	0	2	0	0	32281	2
2	0	2	0	0	32282	2
2	0	2	0	0	32283	2
2	0	2	0	0	32284	2
2	0	2	0	0	32285	2
2	0	2	10	10	32286	2
2	0	2	0	0	32287	2
2	0	2	0	0	32288	2
2	0	2	1	1	32289	2
2	0	2	0	0	32290	2
2	1	2	0	1	32291	0
2	0	2	0	0	32292	2
2	0	2	0	0	32293	2
2	0	2	2	2	32294	2
2	0	2	0	0	32295	2
2	0	2	0	0	32296	2
2	0	2	0	0	32297	2
2	0	2	0	0	32298	2
2	0	2	0	0	32299	2
2	0	2	0	0	32300	2
2	0	2	0	0	32301	2
2	0	2	0	0	32302	2
2	0	2	0	0	32303	2
2	0	2	0	0	32304	2
2	0	2	0	0	32305	2
2	0	2	0	0	32306	2
2	0	2	0	0	32307	2
2	0	2	0	0	32308	2
2	0	2	0	0	32309	2
2	0	2	0	0	32310	2
2	0	2	1	1	32311	2
2	0	2	0	0	32312	2
2	0	2	0	0	32313	2
2	1	2	0	1	32314	0
2	0	2	0	0	32315	2
2	0	2	0	0	32316	2
2	0	2	0	0	32317	2
2	0	2	0	0	32318	2
2	0	2	0	0	32319	2
2	0	2	0	0	32320	2
2	0	2	0	0	32321	2
2	0	2	1	1	32322	2
2	0	2	0	0	32323	2
2	0	2	0	0	32324	2
2	0	2	0	0	32325	2
2	0	2	0	0	32326	2
4	0	2	0	0	32327	2
2	0	2	0	0	32328	2
2	0	2	0	0	32329	2
2	0	2	0	0	32330	2
2	0	2	0	0	32331	2
2	0	2	0	0	32332	2
2	0	2	0	0	32333	2
2	0	2	0	0	32334	2
2	0	2	0	0	32335	2
2	0	2	0	0	32336	2
2	0	2	0	0	32337	2
2	0	2	0	0	32338	2
2	0	2	0	0	32339	2
2	0	2	0	0	32340	2
2	0	2	2	2	32341	2
2	0	2	0	0	32342	2
2	0	2	0	0	32343	2
2	0	2	0	0	32344	2
2	0	2	0	0	32345	2
2	0	2	0	0	32346	2
2	0	2	0	0	32347	2
2	0	2	2	2	32348	2
2	0	2	0	0	32349	2
2	0	2	0	0	32350	2
2	0	2	0	0	32351	2
2	0	2	0	0	32352	2
2	0	2	2	2	32353	2
2	0	2	0	0	32354	2
2	0	2	0	0	32355	2
2	0	2	0	0	32356	2
2	0	2	0	0	32357	2
2	0	4	22	22	32358	2
2	0	2	0	0	32359	2
2	0	2	0	0	32360	2
2	0	2	0	0	32361	2
2	0	2	0	0	32362	2
2	0	2	0	0	32363	2
2	0	2	0	0	32364	2
2	0	2	0	0	32365	2
2	0	2	0	0	32366	2
2	0	2	0	0	32367	2
2	0	2	0	0	32368	2
2	0	2	0	0	32369	2
2	0	2	0	0	32370	2
2	14	2	0	14	32371	0
2	0	2	0	0	32372	2
2	0	2	0	0	32373	2
2	0	2	0	0	32374	2
2	0	2	0	0	32375	2
2	0	2	0	0	32376	2
2	0	2	0	0	32377	2
2	8	2	112	120	32378	1
2	0	2	6	6	32379	2
2	0	2	0	0	32380	2
2	7	2	0	7	32381	0
2	0	2	41	41	32382	2
2	0	2	0	0	32383	2
2	0	2	0	0	32384	2
2	0	2	0	0	32385	2
2	0	2	0	0	32386	2
2	0	2	0	0	32387	2
2	0	2	0	0	32388	2
2	0	2	0	0	32389	2
2	0	2	0	0	32390	2
2	0	2	0	0	32391	2
2	0	2	0	0	32392	2
2	0	2	0	0	32393	2
2	0	2	0	0	32394	2
2	0	2	0	0	32395	2
2	0	4	0	0	32396	2
2	0	2	0	0	32397	2
2	0	2	0	0	32398	2
2	0	2	0	0	32399	2
2	0	4	0	0	32400	2
2	0	2	0	0	32401	2
2	0	2	0	0	32402	2
2	0	2	0	0	32403	2
2	0	2	0	0	32404	2
2	0	2	0	0	32405	2
2	0	2	0	0	32406	2
2	0	2	0	0	32407	2
2	0	2	0	0	32408	2
2	0	2	0	0	32409	2
2	0	2	0	0	32410	2
2	0	2	0	0	32411	2
2	0	2	0	0	32412	2
2	0	2	0	0	32413	2
2	0	2	0	0	32414	2
2	0	2	0	0	32415	2
2	0	2	0	0	32416	2
2	0	2	0	0	32417	2
2	0	2	0	0	32418	2
2	0	2	0	0	32419	2
2	0	2	0	0	32420	2
2	0	2	0	0	32421	2
2	0	2	0	0	32422	2
2	0	2	0	0	32423	2
2	0	2	0	0	32424	2
2	0	2	0	0	32425	2
2	0	2	0	0	32426	2
2	0	2	0	0	32427	2
2	0	2	0	0	32428	2
2	0	2	0	0	32429	2
2	0	2	0	0	32430	2
2	0	2	0	0	32431	2
2	0	2	0	0	32432	2
2	0	2	0	0	32433	2
2	0	2	0	0	32434	2
2	0	2	0	0	32435	2
2	0	2	0	0	32436	2
2	0	2	0	0	32437	2
2	1	2	0	1	32438	0
2	0	2	0	0	32439	2
2	0	2	0	0	32440	2
2	0	2	0	0	32441	2
2	0	2	0	0	32442	2
2	0	2	0	0	32443	2
2	0	2	0	0	32444	2
2	0	2	0	0	32445	2
2	0	2	0	0	32446	2
2	0	2	0	0	32447	2
2	0	2	0	0	32448	2
2	0	2	0	0	32449	2
2	0	2	0	0	32450	2
2	0	2	0	0	32451	2
2	0	2	0	0	32452	2
2	0	2	0	0	32453	2
2	0	2	0	0	32454	2
2	0	2	0	0	32455	2
2	0	2	0	0	32456	2
2	0	2	0	0	32457	2
2	0	2	0	0	32458	2
2	0	2	0	0	32459	2
2	0	2	0	0	32460	2
2	0	2	0	0	32461	2
2	0	2	0	0	32462	2
2	0	2	0	0	32463	2
2	0	2	0	0	32464	2
2	0	2	0	0	32465	2
2	0	2	0	0	32466	2
2	0	2	0	0	32467	2
2	0	2	0	0	32468	2
2	0	2	0	0	32469	2
2	0	2	0	0	32470	2
2	0	2	0	0	32471	2
2	0	2	0	0	32472	2
2	0	2	1	1	32473	2
2	0	2	0	0	32474	2
2	0	2	0	0	32475	2
2	0	2	0	0	32476	2
2	0	2	0	0	32477	2
2	0	2	0	0	32478	2
2	0	2	1	1	32479	2
2	0	2	0	0	32480	2
2	0	2	0	0	32481	2
2	0	2	0	0	32482	2
2	0	2	0	0	32483	2
2	0	2	0	0	32484	2
2	0	2	0	0	32485	2
2	0	2	0	0	32486	2
2	0	2	0	0	32487	2
2	0	2	0	0	32488	2
2	0	2	0	0	32489	2
4	0	2	0	0	32490	2
2	2	2	0	2	32491	0
2	1	2	0	1	32492	1
2	0	2	0	0	32493	2
2	0	2	0	0	32494	2
2	1	2	1	2	32495	0
2	0	2	1	1	32496	2
2	0	2	0	0	32497	2
2	0	2	0	0	32498	2
2	0	2	0	0	32499	2
2	0	2	0	0	32500	2
2	0	2	0	0	32501	2
2	0	2	0	0	32502	2
2	0	2	0	0	32503	2
2	0	2	0	0	32504	2
2	0	2	0	0	32505	2
2	0	2	0	0	32506	2
2	0	2	0	0	32507	2
2	0	2	0	0	32508	2
2	0	2	0	0	32509	2
2	0	2	0	0	32510	2
2	0	2	0	0	32511	2
2	0	2	0	0	32512	2
2	0	2	0	0	32513	2
2	0	2	0	0	32514	2
2	0	2	0	0	32515	2
2	0	2	0	0	32516	2
2	0	2	0	0	32517	2
2	0	2	0	0	32518	2
2	0	2	0	0	32519	2
2	0	2	0	0	32520	2
4	0	2	0	0	32521	2
2	0	2	0	0	32522	2
2	0	2	0	0	32523	2
2	0	2	0	0	32524	2
2	0	2	0	0	32525	2
2	0	2	0	0	32526	2
2	0	2	0	0	32527	2
2	0	2	0	0	32528	2
2	0	4	0	0	32529	2
2	0	2	0	0	32530	2
2	0	4	0	0	32531	2
2	0	2	0	0	32532	2
2	0	2	0	0	32533	2
2	0	2	0	0	32534	2
2	0	2	0	0	32535	2
2	0	2	0	0	32536	2
2	0	2	0	0	32537	2
2	0	2	0	0	32538	2
2	0	2	0	0	32539	2
2	0	2	0	0	32540	2
2	0	2	0	0	32541	2
2	0	2	0	0	32542	2
2	0	2	0	0	32543	2
2	0	2	0	0	32544	2
2	0	2	0	0	32545	2
2	0	2	0	0	32546	2
2	0	2	0	0	32547	2
2	0	2	0	0	32548	2
2	0	2	0	0	32549	2
2	0	2	0	0	32550	2
2	0	2	0	0	32551	2
2	0	2	0	0	32552	2
2	0	2	0	0	32553	2
2	0	2	0	0	32554	2
2	0	2	0	0	32555	2
2	0	2	0	0	32556	2
2	0	2	0	0	32557	2
2	0	2	0	0	32558	2
2	0	2	0	0	32559	2
2	0	2	0	0	32560	2
2	0	2	0	0	32561	2
2	0	2	0	0	32562	2
2	0	2	0	0	32563	2
2	0	2	0	0	32564	2
2	0	2	0	0	32565	2
2	0	2	0	0	32566	2
2	0	2	0	0	32567	2
2	0	2	0	0	32568	2
2	0	2	0	0	32569	2
2	0	2	0	0	32570	2
2	0	2	0	0	32571	2
2	0	2	0	0	32572	2
2	0	2	0	0	32573	2
2	0	2	0	0	32574	2
2	0	2	0	0	32575	2
2	0	2	0	0	32576	2
2	0	2	0	0	32577	2
2	0	2	0	0	32578	2
2	0	2	0	0	32579	2
2	1	2	0	1	32580	1
2	0	2	0	0	32581	2
2	0	2	0	0	32582	2
2	0	2	0	0	32583	2
2	0	2	0	0	32584	2
2	0	2	0	0	32585	2
2	0	2	0	0	32586	2
2	0	2	0	0	32587	2
2	0	2	0	0	32588	2
2	0	2	0	0	32589	2
2	0	2	0	0	32590	2
2	0	2	0	0	32591	2
2	0	2	0	0	32592	2
2	0	2	0	0	32593	2
2	0	2	0	0	32594	2
2	0	2	0	0	32595	2
2	0	2	0	0	32596	2
2	0	2	0	0	32597	2
2	0	2	0	0	32598	2
2	0	2	0	0	32599	2
2	0	2	0	0	32600	2
2	0	2	0	0	32601	2
2	0	2	0	0	32602	2
2	0	2	0	0	32603	2
2	0	2	0	0	32604	2
2	0	2	0	0	32605	2
2	0	2	0	0	32606	2
2	0	2	0	0	32607	2
2	0	2	0	0	32608	2
2	0	2	0	0	32609	2
2	0	2	0	0	32610	2
2	0	2	0	0	32611	2
2	0	2	0	0	32612	2
2	0	2	0	0	32613	2
2	0	2	0	0	32614	2
2	0	2	0	0	32615	2
2	0	2	0	0	32616	2
2	0	2	0	0	32617	2
2	0	2	1	1	32618	2
2	0	2	0	0	32619	2
2	0	2	0	0	32620	2
2	0	2	0	0	32621	2
2	0	2	0	0	32622	2
2	0	2	0	0	32623	2
2	0	2	0	0	32624	2
2	12	2	0	12	32625	0
2	25	2	1	26	32626	0
2	17	2	2784	2801	32627	1
2	0	2	11	11	32628	2
2	0	2	1	1	32629	2
2	56	2	1	57	32630	0
2	0	2	318	318	32631	2
2	0	2	0	0	32632	2
2	0	2	0	0	32633	2
2	0	2	0	0	32634	2
2	0	2	0	0	32635	2
2	0	2	0	0	32636	2
2	0	2	0	0	32637	2
2	7	4	21465	21472	32638	1
2	0	2	3	3	32639	2
2	0	2	0	0	32640	2
2	9	4	26520	26529	32641	0
2	0	2	63	63	32642	2
2	0	2	2	2	32643	2
2	0	2	0	0	32644	2
2	0	2	0	0	32645	2
2	0	2	0	0	32646	2
2	0	2	0	0	32647	2
2	0	2	0	0	32648	2
2	0	2	0	0	32649	2
2	0	2	0	0	32650	2
2	0	2	0	0	32651	2
2	0	2	0	0	32652	2
2	0	2	0	0	32653	2
2	0	2	0	0	32654	2
2	0	2	0	0	32655	2
2	0	2	0	0	32656	2
2	0	2	0	0	32657	2
2	0	2	0	0	32658	2
2	0	2	0	0	32659	2
2	0	2	0	0	32660	2
2	0	2	0	0	32661	2
2	0	2	0	0	32662	2
2	0	2	0	0	32663	2
2	1	2	0	1	32664	1
2	0	2	0	0	32665	2
2	0	2	0	0	32666	2
2	0	2	0	0	32667	2
2	0	2	0	0	32668	2
2	1	2	6	7	32669	1
2	0	2	0	0	32670	2
2	0	2	0	0	32671	2
2	0	2	0	0	32672	2
2	0	2	2	2	32673	2
2	0	2	0	0	32674	2
2	0	2	0	0	32675	2
2	0	2	0	0	32676	2
2	0	2	0	0	32677	2
2	0	2	0	0	32678	2
2	0	2	0	0	32679	2
2	0	2	0	0	32680	2
2	0	2	0	0	32681	2
2	0	2	0	0	32682	2
2	0	2	0	0	32683	2
2	0	2	0	0	32684	2
2	0	2	0	0	32685	2
2	0	2	0	0	32686	2
2	0	2	0	0	32687	2
2	0	2	0	0	32688	2
2	0	2	0	0	32689	2
2	0	2	0	0	32690	2
2	0	2	0	0	32691	2
2	0	2	0	0	32692	2
2	0	2	0	0	32693	2
2	0	2	0	0	32694	2
2	0	2	0	0	32695	2
2	0	2	0	0	32696	2
2	0	2	0	0	32697	2
2	0	2	0	0	32698	2
2	0	2	0	0	32699	2
2	0	2	0	0	32700	2
2	0	2	0	0	32701	2
2	0	2	2	2	32702	2
2	0	2	0	0	32703	2
2	0	2	0	0	32704	2
2	0	2	1	1	32705	2
2	0	2	0	0	32706	2
2	0	2	0	0	32707	2
2	0	2	0	0	32708	2
2	0	2	0	0	32709	2
2	0	2	0	0	32710	2
2	0	2	0	0	32711	2
2	0	2	0	0	32712	2
2	0	2	0	0	32713	2
2	0	2	0	0	32714	2
2	0	2	0	0	32715	2
2	0	2	0	0	32716	2
2	0	2	0	0	32717	2
2	0	2	0	0	32718	2
2	0	2	0	0	32719	2
2	0	2	0	0	32720	2
2	0	2	0	0	32721	2
2	0	2	0	0	32722	2
2	0	2	0	0	32723	2
2	0	2	0	0	32724	2
2	0	2	0	0	32725	2
2	0	2	0	0	32726	2
2	0	2	0	0	32727	2
2	0	2	0	0	32728	2
2	0	2	0	0	32729	2
2	0	2	0	0	32730	2
2	0	2	0	0	32731	2
2	0	2	0	0	32732	2
2	0	2	0	0	32733	2
2	0	2	0	0	32734	2
2	0	2	0	0	32735	2
2	0	2	0	0	32736	2
2	0	2	0	0	32737	2
2	0	2	0	0	32738	2
2	0	2	0	0	32739	2
2	0	2	0	0	32740	2
2	0	2	0	0	32741	2
2	0	2	0	0	32742	2
2	0	2	0	0	32743	2
2	1	2	0	1	32744	0
2	2	2	5	7	32745	1
2	0	2	3	3	32746	2
2	0	2	0	0	32747	2
2	0	2	1	1	32748	2
2	0	2	0	0	32749	2
2	0	2	0	0	32750	2
2	0	2	0	0	32751	2
2	0	2	0	0	32752	2
2	0	2	0	0	32753	2
2	0	2	0	0	32754	2
2	0	2	0	0	32755	2
2	1	2	0	1	32756	0
2	2	2	1	3	32757	1
2	0	2	0	0	32758	2
2	0	2	0	0	32759	2
2	1	2	0	1	32760	0
2	0	2	0	0	32761	2
2	0	2	1	1	32762	2
2	0	2	0	0	32763	2
2	0	2	0	0	32764	2
2	1	2	0	1	32765	0
2	0	2	0	0	32766	2
2	0	4	11	11	32767	2
2	0	2	0	0	32768	2
2	0	2	0	0	32769	2
2	0	2	0	0	32770	2
2	0	4	0	0	32771	2
2	0	2	0	0	32772	2
2	0	2	0	0	32773	2
2	0	2	0	0	32774	2
2	0	2	0	0	32775	2
2	0	2	0	0	32776	2
2	0	2	0	0	32777	2
2	0	2	0	0	32778	2
2	0	2	0	0	32779	2
2	0	2	2	2	32780	2
2	0	2	0	0	32781	2
2	0	2	0	0	32782	2
2	0	2	0	0	32783	2
2	0	2	0	0	32784	2
2	0	2	0	0	32785	2
2	0	2	0	0	32786	2
2	0	2	0	0	32787	2
2	0	2	0	0	32788	2
2	0	2	0	0	32789	2
2	0	2	0	0	32790	2
2	0	2	0	0	32791	2
2	0	2	0	0	32792	2
2	0	4	5	5	32793	2
2	0	2	0	0	32794	2
2	0	2	0	0	32795	2
2	0	4	0	0	32796	2
2	0	2	0	0	32797	2
2	0	2	0	0	32798	2
2	0	2	0	0	32799	2
2	0	2	0	0	32800	2
2	0	2	0	0	32801	2
4	0	2	0	0	32802	2
2	0	2	0	0	32803	2
2	0	2	0	0	32804	2
2	0	2	0	0	32805	2
2	0	2	0	0	32806	2
2	0	2	0	0	32807	2
2	0	2	0	0	32808	2
2	2	2	0	2	32809	0
2	0	2	5	5	32810	2
2	0	2	0	0	32811	2
2	0	2	0	0	32812	2
2	0	2	0	0	32813	2
2	0	2	0	0	32814	2
2	0	2	0	0	32815	2
2	0	2	0	0	32816	2
2	0	2	0	0	32817	2
2	0	2	0	0	32818	2
2	0	2	0	0	32819	2
2	0	2	0	0	32820	2
2	0	4	0	0	32821	2
2	0	2	0	0	32822	2
2	0	2	0	0	32823	2
2	0	4	0	0	32824	2
2	0	2	0	0	32825	2
2	0	2	0	0	32826	2
2	0	2	0	0	32827	2
2	0	2	0	0	32828	2
2	0	2	0	0	32829	2
2	0	2	0	0	32830	2
2	0	2	0	0	32831	2
2	0	2	0	0	32832	2
2	0	2	0	0	32833	2
2	0	2	0	0	32834	2
2	0	2	0	0	32835	2
2	0	2	0	0	32836	2
2	0	2	0	0	32837	2
2	9	2	0	9	32838	0
2	2	2	158	160	32839	1
2	0	2	1	1	32840	2
2	0	2	3	3	32841	2
2	4	2	17	21	32842	0
2	0	2	23	23	32843	2
2	0	2	0	0	32844	2
2	0	2	0	0	32845	2
2	0	2	0	0	32846	2
2	0	2	0	0	32847	2
2	0	2	0	0	32848	2
2	0	2	0	0	32849	2
2	0	2	0	0	32850	2
2	0	4	8717	8717	32851	2
2	0	2	0	0	32852	2
2	0	2	0	0	32853	2
2	0	4	12	12	32854	2
2	0	2	0	0	32855	2
2	0	2	0	0	32856	2
2	0	2	0	0	32857	2
2	0	2	0	0	32858	2
2	0	2	0	0	32859	2
2	0	2	0	0	32860	2
2	0	2	0	0	32861	2
2	0	2	0	0	32862	2
2	0	2	0	0	32863	2
2	0	2	0	0	32864	2
2	0	2	0	0	32865	2
2	0	2	0	0	32866	2
2	0	2	0	0	32867	2
2	0	2	0	0	32868	2
2	0	2	0	0	32869	2
2	0	2	0	0	32870	2
2	0	2	0	0	32871	2
2	0	2	0	0	32872	2
2	0	2	0	0	32873	2
2	0	2	0	0	32874	2
2	0	2	0	0	32875	2
2	0	2	0	0	32876	2
2	0	2	0	0	32877	2
2	0	2	0	0	32878	2
2	0	2	0	0	32879	2
2	0	2	0	0	32880	2
2	0	2	0	0	32881	2
2	0	2	0	0	32882	2
2	0	2	0	0	32883	2
2	0	2	0	0	32884	2
2	0	2	0	0	32885	2
2	0	2	0	0	32886	2
2	67	4	230	297	32887	0
2	0	2	0	0	32888	2
2	0	2	0	0	32889	2
2	0	2	0	0	32890	2
2	0	2	0	0	32891	2
2	0	2	0	0	32892	2
2	0	2	0	0	32893	2
2	0	2	0	0	32894	2
2	0	2	0	0	32895	2
2	0	2	0	0	32896	2
2	0	2	0	0	32897	2
2	0	2	0	0	32898	2
2	0	2	0	0	32899	2
2	0	2	0	0	32900	2
2	0	2	0	0	32901	2
2	0	2	0	0	32902	2
2	0	2	29	29	32903	2
2	0	2	0	0	32904	2
2	0	2	0	0	32905	2
2	0	2	4	4	32906	2
2	0	2	0	0	32907	2
2	0	2	0	0	32908	2
2	0	2	2	2	32909	2
2	0	2	0	0	32910	2
2	0	4	1203	1203	32911	2
2	0	2	0	0	32912	2
2	0	2	0	0	32913	2
2	0	4	438	438	32914	2
2	18	2	0	18	32915	0
2	0	2	0	0	32916	2
2	0	2	0	0	32917	2
2	0	2	0	0	32918	2
2	0	2	0	0	32919	2
2	0	2	0	0	32920	2
2	0	2	0	0	32921	2
2	0	2	0	0	32922	2
2	0	2	0	0	32923	2
2	0	2	0	0	32924	2
2	0	2	0	0	32925	2
2	0	2	0	0	32926	2
2	0	2	0	0	32927	2
2	0	2	0	0	32928	2
2	0	2	0	0	32929	2
2	0	2	0	0	32930	2
2	0	2	0	0	32931	2
2	0	2	0	0	32932	2
2	0	2	0	0	32933	2
2	0	2	0	0	32934	2
2	1	2	0	1	32935	0
2	0	2	0	0	32936	2
2	0	2	0	0	32937	2
2	0	2	0	0	32938	2
2	0	2	0	0	32939	2
2	0	2	0	0	32940	2
2	0	2	0	0	32941	2
2	0	4	477	477	32942	2
2	0	2	1	1	32943	2
2	0	2	0	0	32944	2
2	3	4	371	374	32945	0
2	0	2	9	9	32946	2
4	0	2	1	1	32947	2
2	0	4	2	2	32948	2
2	0	2	0	0	32949	2
2	0	2	0	0	32950	2
2	0	4	1	1	32951	2
2	0	2	0	0	32952	2
4	0	2	0	0	32953	2
2	0	2	0	0	32954	2
2	0	2	0	0	32955	2
2	0	2	0	0	32956	2
2	0	2	0	0	32957	2
2	0	2	0	0	32958	2
2	0	2	0	0	32959	2
2	5	2	0	5	32960	0
2	0	2	14	14	32961	2
2	0	2	3	3	32962	2
2	0	2	0	0	32963	2
2	0	2	2	2	32964	2
2	0	2	0	0	32965	2
2	0	4	19094	19094	32966	2
2	0	2	0	0	32967	2
2	0	2	0	0	32968	2
2	0	2	0	0	32969	2
2	0	2	0	0	32970	2
2	0	4	3852	3852	32971	2
2	0	2	0	0	32972	2
2	0	2	0	0	32973	2
2	0	2	0	0	32974	2
2	0	2	0	0	32975	2
2	0	2	0	0	32976	2
2	0	2	0	0	32977	2
2	1	2	1	2	32978	0
2	40	2	100	140	32979	1
2	0	2	0	0	32980	2
2	0	2	0	0	32981	2
2	1	2	1	2	32982	0
2	0	2	2	2	32983	2
2	0	2	0	0	32984	2
2	35	2	2	37	32985	0
2	3	2	2042	2045	32986	1
2	0	2	4	4	32987	2
2	0	2	4	4	32988	2
2	17	2	8	25	32989	0
2	0	2	164	164	32990	2
2	0	2	4	4	32991	2
2	0	2	0	0	32992	2
2	0	2	0	0	32993	2
2	0	2	10	10	32994	2
2	0	2	0	0	32995	2
2	0	2	0	0	32996	2
2	15	2	146	161	32997	1
2	0	2	3	3	32998	2
2	0	2	0	0	32999	2
2	1	2	0	1	33000	1
2	0	2	5	5	33001	2
0	4001	2	7	4008	33002	0
0	3955	2	2042	5997	33003	0
0	4953	2	8	4961	33004	0
2	0	2	0	0	33005	2
2	0	2	0	0	33006	2
2	0	2	0	0	33007	2
2	0	2	0	0	33008	2
2	0	2	0	0	33009	2
2	0	2	0	0	33010	2
2	0	2	0	0	33011	2
2	0	2	0	0	33012	2
2	0	2	0	0	33013	2
2	0	2	0	0	33014	2
2	0	2	0	0	33015	2
2	0	2	0	0	33016	2
2	0	2	0	0	33017	2
2	0	2	0	0	33018	2
2	0	2	0	0	33019	2
2	0	2	0	0	33020	2
2	0	2	0	0	33021	2
2	0	2	0	0	33022	2
2	0	2	0	0	33023	2
2	0	2	0	0	33024	2
2	0	2	0	0	33025	2
2	0	2	0	0	33026	2
2	0	2	0	0	33027	2
2	0	2	0	0	33028	2
2	0	2	0	0	33029	2
2	0	2	0	0	33030	2
2	0	2	0	0	33031	2
2	0	2	0	0	33032	2
2	0	2	0	0	33033	2
2	0	2	0	0	33034	2
2	0	2	0	0	33035	2
2	0	2	0	0	33036	2
2	0	2	0	0	33037	2
2	0	2	0	0	33038	2
2	0	2	0	0	33039	2
2	0	2	0	0	33040	2
2	0	2	0	0	33041	2
2	0	2	0	0	33042	2
2	0	2	0	0	33043	2
2	0	2	0	0	33044	2
2	0	2	0	0	33045	2
2	0	2	0	0	33046	2
2	0	2	0	0	33047	2
2	0	2	0	0	33048	2
2	0	2	0	0	33049	2
2	0	2	0	0	33050	2
2	0	2	0	0	33051	2
2	0	2	0	0	33052	2
2	0	2	0	0	33053	2
2	0	2	0	0	33054	2
2	0	2	0	0	33055	2
2	0	2	0	0	33056	2
2	0	2	0	0	33057	2
2	0	2	0	0	33058	2
2	0	2	0	0	33059	2
2	0	2	0	0	33060	2
2	0	2	0	0	33061	2
2	0	2	0	0	33062	2
2	0	2	0	0	33063	2
2	0	2	0	0	33064	2
2	0	2	0	0	33065	2
2	0	2	1	1	33066	2
2	0	2	0	0	33067	2
2	0	2	0	0	33068	2
2	0	2	0	0	33069	2
2	0	2	0	0	33070	2
2	0	2	0	0	33071	2
2	0	2	0	0	33072	2
2	0	2	0	0	33073	2
2	0	2	0	0	33074	2
2	0	2	0	0	33075	2
2	0	2	0	0	33076	2
2	0	2	0	0	33077	2
2	0	2	0	0	33078	2
2	0	2	0	0	33079	2
2	0	2	1	1	33080	2
2	0	2	0	0	33081	2
2	0	2	0	0	33082	2
2	0	2	0	0	33083	2
2	0	2	0	0	33084	2
2	0	2	0	0	33085	2
2	0	2	0	0	33086	2
2	0	2	0	0	33087	2
2	0	2	0	0	33088	2
2	0	2	0	0	33089	2
2	0	2	0	0	33090	2
2	0	2	1	1	33091	2
2	0	2	0	0	33092	2
2	0	2	0	0	33093	2
2	0	2	0	0	33094	2
2	0	2	1	1	33095	2
2	0	2	0	0	33096	2
2	0	2	0	0	33097	2
2	0	2	1	1	33098	2
2	0	2	0	0	33099	2
2	0	2	0	0	33100	2
2	0	2	0	0	33101	2
2	0	2	0	0	33102	2
2	0	2	0	0	33103	2
2	0	2	0	0	33104	2
2	0	2	0	0	33105	2
2	0	2	0	0	33106	2
2	0	2	0	0	33107	2
2	0	2	0	0	33108	2
2	0	2	0	0	33109	2
2	0	2	0	0	33110	2
2	0	2	0	0	33111	2
2	0	2	0	0	33112	2
2	0	2	0	0	33113	2
2	0	2	0	0	33114	2
2	0	2	0	0	33115	2
2	0	2	0	0	33116	2
2	0	2	0	0	33117	2
2	0	2	0	0	33118	2
2	0	2	0	0	33119	2
2	0	2	0	0	33120	2
2	0	2	0	0	33121	2
2	0	2	0	0	33122	2
2	0	2	0	0	33123	2
2	0	2	0	0	33124	2
2	0	2	0	0	33125	2
2	0	4	9	9	33126	2
2	0	2	0	0	33127	2
2	0	2	0	0	33128	2
2	0	4	1	1	33129	2
2	0	2	0	0	33130	2
4	0	2	0	0	33131	2
2	0	2	0	0	33132	2
2	0	2	0	0	33133	2
2	0	2	0	0	33134	2
2	0	2	0	0	33135	2
2	0	2	0	0	33136	2
2	0	2	0	0	33137	2
2	0	2	0	0	33138	2
2	0	2	0	0	33139	2
2	0	2	0	0	33140	2
2	0	2	0	0	33141	2
4	0	2	0	0	33142	2
2	0	4	2002	2002	33143	2
2	0	2	0	0	33144	2
2	0	2	0	0	33145	2
2	0	4	5607	5607	33146	2
2	0	2	0	0	33147	2
2	0	2	0	0	33148	2
2	127	2	2	129	33149	0
2	0	2	0	0	33150	2
2	0	2	0	0	33151	2
2	0	2	0	0	33152	2
2	0	2	0	0	33153	2
2	0	2	0	0	33154	2
2	0	2	0	0	33155	2
2	0	2	0	0	33156	2
2	0	2	0	0	33157	2
2	0	2	0	0	33158	2
2	0	2	0	0	33159	2
2	0	2	0	0	33160	2
2	0	2	0	0	33161	2
2	0	2	0	0	33162	2
2	0	2	1	1	33163	2
2	0	2	0	0	33164	2
2	0	2	0	0	33165	2
2	0	2	0	0	33166	2
2	0	2	0	0	33167	2
2	0	2	0	0	33168	2
2	0	2	0	0	33169	2
2	0	2	0	0	33170	2
2	0	2	0	0	33171	2
2	0	2	0	0	33172	2
2	0	2	0	0	33173	2
2	0	2	0	0	33174	2
2	0	2	0	0	33175	2
2	0	2	0	0	33176	2
2	0	2	0	0	33177	2
2	0	2	0	0	33178	2
2	0	2	0	0	33179	2
2	0	2	0	0	33180	2
2	0	2	0	0	33181	2
2	0	2	0	0	33182	2
2	0	2	0	0	33183	2
2	0	2	0	0	33184	2
2	0	2	0	0	33185	2
2	0	2	0	0	33186	2
2	0	2	5	5	33187	2
2	0	2	0	0	33188	2
2	0	2	0	0	33189	2
2	1	2	0	1	33190	1
2	0	2	1	1	33191	2
2	0	2	0	0	33192	2
2	0	2	0	0	33193	2
2	0	2	0	0	33194	2
2	0	2	0	0	33195	2
2	0	2	0	0	33196	2
2	0	2	0	0	33197	2
2	13	4	7936	7949	33198	1
2	1	2	146	147	33199	1
2	0	2	3	3	33200	2
2	0	4	137	137	33201	2
2	49	4	137	186	33202	0
2	0	2	312	312	33203	2
4	139	2	22242	22381	33204	0
2	0	2	0	0	33205	2
2	0	2	0	0	33206	2
2	0	2	0	0	33207	2
2	0	2	0	0	33208	2
2	0	2	0	0	33209	2
2	0	2	0	0	33210	2
2	0	2	0	0	33211	2
2	0	2	0	0	33212	2
2	0	2	0	0	33213	2
2	0	2	0	0	33214	2
2	0	2	0	0	33215	2
2	0	2	0	0	33216	2
2	0	2	0	0	33217	2
2	0	2	0	0	33218	2
2	0	2	0	0	33219	2
2	0	2	0	0	33220	2
2	0	2	0	0	33221	2
2	0	2	0	0	33222	2
2	0	2	0	0	33223	2
2	0	2	0	0	33224	2
2	0	2	1	1	33225	2
2	0	2	0	0	33226	2
2	0	2	0	0	33227	2
2	0	2	0	0	33228	2
2	0	2	0	0	33229	2
2	0	2	0	0	33230	2
2	0	2	2	2	33231	2
2	0	2	0	0	33232	2
2	0	2	0	0	33233	2
2	0	2	0	0	33234	2
2	0	2	0	0	33235	2
2	0	2	0	0	33236	2
2	0	2	0	0	33237	2
2	0	2	0	0	33238	2
2	0	2	0	0	33239	2
2	1	2	0	1	33240	0
2	0	2	0	0	33241	2
2	0	2	0	0	33242	2
2	0	2	0	0	33243	2
2	0	2	0	0	33244	2
2	0	2	0	0	33245	2
2	0	2	0	0	33246	2
2	0	2	0	0	33247	2
2	0	2	0	0	33248	2
2	0	2	0	0	33249	2
2	0	2	0	0	33250	2
2	0	2	0	0	33251	2
2	0	2	0	0	33252	2
2	0	2	0	0	33253	2
2	0	2	0	0	33254	2
2	0	2	0	0	33255	2
2	0	2	0	0	33256	2
2	0	2	1	1	33257	2
2	0	2	0	0	33258	2
2	0	2	0	0	33259	2
2	0	2	0	0	33260	2
2	0	2	0	0	33261	2
2	0	2	0	0	33262	2
2	0	2	0	0	33263	2
2	0	2	0	0	33264	2
2	0	2	0	0	33265	2
2	0	2	0	0	33266	2
2	0	2	5	5	33267	2
2	0	2	0	0	33268	2
2	0	2	0	0	33269	2
2	0	2	0	0	33270	2
2	0	2	0	0	33271	2
2	0	2	0	0	33272	2
2	0	2	0	0	33273	2
2	0	2	0	0	33274	2
2	0	2	0	0	33275	2
2	0	2	0	0	33276	2
2	0	2	0	0	33277	2
2	0	4	29	29	33278	2
2	0	2	0	0	33279	2
2	0	4	55	55	33280	2
2	0	2	0	0	33281	2
2	0	2	0	0	33282	2
2	0	2	0	0	33283	2
2	0	2	0	0	33284	2
2	0	2	0	0	33285	2
2	0	2	0	0	33286	2
2	0	2	0	0	33287	2
2	0	2	0	0	33288	2
2	0	2	0	0	33289	2
2	0	2	0	0	33290	2
2	0	2	0	0	33291	2
2	0	2	0	0	33292	2
2	0	2	0	0	33293	2
2	0	2	0	0	33294	2
2	0	2	0	0	33295	2
2	0	2	0	0	33296	2
2	0	2	0	0	33297	2
2	0	2	0	0	33298	2
2	0	2	0	0	33299	2
2	0	2	0	0	33300	2
2	0	2	0	0	33301	2
2	0	2	0	0	33302	2
2	0	2	0	0	33303	2
2	0	2	0	0	33304	2
2	0	2	0	0	33305	2
2	0	2	0	0	33306	2
2	0	2	0	0	33307	2
2	0	2	0	0	33308	2
2	0	2	0	0	33309	2
2	0	2	0	0	33310	2
2	0	2	0	0	33311	2
2	0	2	0	0	33312	2
2	0	2	0	0	33313	2
2	0	2	0	0	33314	2
2	0	2	0	0	33315	2
2	0	2	0	0	33316	2
2	0	2	0	0	33317	2
2	0	2	0	0	33318	2
2	0	2	0	0	33319	2
2	0	2	0	0	33320	2
2	0	2	0	0	33321	2
2	0	2	0	0	33322	2
2	0	2	0	0	33323	2
2	0	2	0	0	33324	2
2	0	2	0	0	33325	2
2	0	2	0	0	33326	2
2	0	2	0	0	33327	2
2	0	2	0	0	33328	2
2	0	2	0	0	33329	2
2	0	2	0	0	33330	2
2	0	2	0	0	33331	2
2	0	2	0	0	33332	2
2	0	2	0	0	33333	2
2	0	4	197	197	33334	2
2	0	2	0	0	33335	2
2	0	2	0	0	33336	2
2	0	2	0	0	33337	2
2	0	2	0	0	33338	2
2	0	2	0	0	33339	2
2	0	2	0	0	33340	2
2	0	4	238	238	33341	2
2	0	2	0	0	33342	2
2	0	2	0	0	33343	2
2	0	2	0	0	33344	2
2	0	2	0	0	33345	2
2	0	2	0	0	33346	2
2	0	2	0	0	33347	2
2	0	2	0	0	33348	2
2	0	2	0	0	33349	2
2	0	2	0	0	33350	2
2	0	2	0	0	33351	2
2	0	2	0	0	33352	2
2	0	2	0	0	33353	2
2	0	2	0	0	33354	2
2	0	2	0	0	33355	2
2	0	2	0	0	33356	2
2	0	2	0	0	33357	2
2	0	2	0	0	33358	2
2	0	2	0	0	33359	2
2	0	2	0	0	33360	2
2	0	2	0	0	33361	2
2	0	2	0	0	33362	2
2	0	2	0	0	33363	2
2	0	2	0	0	33364	2
2	0	2	0	0	33365	2
2	0	2	0	0	33366	2
2	0	2	0	0	33367	2
2	0	2	0	0	33368	2
2	0	2	0	0	33369	2
2	0	4	8	8	33370	2
2	0	2	0	0	33371	2
4	0	4	0	0	33372	2
2	0	2	0	0	33373	2
2	0	2	0	0	33374	2
2	0	2	0	0	33375	2
2	0	2	0	0	33376	2
2	0	2	0	0	33377	2
2	0	2	0	0	33378	2
2	0	2	0	0	33379	2
2	0	2	0	0	33380	2
2	0	2	0	0	33381	2
2	0	2	0	0	33382	2
2	0	2	0	0	33383	2
2	0	2	0	0	33384	2
2	0	2	0	0	33385	2
2	0	2	0	0	33386	2
2	0	4	10	10	33387	2
2	0	2	0	0	33388	2
2	0	2	0	0	33389	2
2	0	4	37	37	33390	2
2	0	2	0	0	33391	2
2	0	2	0	0	33392	2
2	0	2	0	0	33393	2
2	0	2	0	0	33394	2
2	0	4	0	0	33395	2
2	0	2	0	0	33396	2
2	0	2	0	0	33397	2
2	0	2	0	0	33398	2
2	0	2	0	0	33399	2
2	0	2	0	0	33400	2
2	0	2	0	0	33401	2
2	0	2	0	0	33402	2
2	0	2	0	0	33403	2
2	0	2	0	0	33404	2
2	0	2	0	0	33405	2
2	0	2	0	0	33406	2
2	0	2	0	0	33407	2
2	0	2	0	0	33408	2
2	0	2	0	0	33409	2
2	0	2	0	0	33410	2
2	0	2	0	0	33411	2
2	0	2	0	0	33412	2
2	0	2	0	0	33413	2
2	0	2	0	0	33414	2
2	0	2	0	0	33415	2
2	0	2	0	0	33416	2
2	0	2	0	0	33417	2
2	0	2	0	0	33418	2
2	0	2	0	0	33419	2
2	0	2	0	0	33420	2
2	0	4	268	268	33421	2
2	0	2	0	0	33422	2
2	0	2	0	0	33423	2
2	2	4	224	226	33424	1
2	0	2	0	0	33425	2
4	0	2	1	1	33426	2
2	1	2	0	1	33427	0
2	0	2	5	5	33428	2
2	0	2	0	0	33429	2
2	0	2	0	0	33430	2
2	1	2	0	1	33431	0
2	0	2	0	0	33432	2
2	0	4	0	0	33433	2
2	0	2	0	0	33434	2
2	0	2	0	0	33435	2
2	0	4	0	0	33436	2
2	0	2	0	0	33437	2
2	0	2	0	0	33438	2
2	0	2	0	0	33439	2
2	0	2	0	0	33440	2
2	0	2	0	0	33441	2
2	0	2	0	0	33442	2
2	0	2	0	0	33443	2
2	0	4	44	44	33444	2
2	0	2	0	0	33445	2
2	0	2	0	0	33446	2
2	0	2	0	0	33447	2
2	0	2	0	0	33448	2
2	0	2	0	0	33449	2
2	0	2	0	0	33450	2
2	0	2	0	0	33451	2
2	0	2	0	0	33452	2
2	0	2	0	0	33453	2
2	0	2	0	0	33454	2
2	0	2	0	0	33455	2
2	0	2	0	0	33456	2
2	0	2	0	0	33457	2
2	0	2	0	0	33458	2
2	0	2	0	0	33459	2
2	0	2	0	0	33460	2
2	0	2	0	0	33461	2
2	0	2	0	0	33462	2
2	0	2	0	0	33463	2
2	0	2	0	0	33464	2
2	0	4	22	22	33465	2
2	1	2	0	1	33466	0
2	0	4	8	8	33467	2
2	0	2	0	0	33468	2
2	0	2	0	0	33469	2
2	0	2	0	0	33470	2
2	0	2	0	0	33471	2
2	0	2	0	0	33472	2
2	0	2	0	0	33473	2
2	0	2	0	0	33474	2
2	0	2	0	0	33475	2
2	0	2	0	0	33476	2
2	0	2	0	0	33477	2
2	0	2	0	0	33478	2
2	0	2	0	0	33479	2
2	0	2	0	0	33480	2
2	0	2	0	0	33481	2
2	0	2	0	0	33482	2
2	0	2	0	0	33483	2
2	0	2	0	0	33484	2
2	0	2	0	0	33485	2
2	0	2	0	0	33486	2
2	0	2	0	0	33487	2
2	0	2	0	0	33488	2
2	0	2	0	0	33489	2
2	0	2	0	0	33490	2
2	0	2	0	0	33491	2
2	0	2	0	0	33492	2
2	0	2	0	0	33493	2
2	0	2	0	0	33494	2
2	0	4	2	2	33495	2
2	0	2	0	0	33496	2
2	0	2	0	0	33497	2
2	0	2	0	0	33498	2
2	0	2	0	0	33499	2
2	0	2	0	0	33500	2
2	0	2	0	0	33501	2
2	0	2	9	9	33502	2
2	0	2	0	0	33503	2
2	0	2	0	0	33504	2
2	0	2	0	0	33505	2
2	0	2	0	0	33506	2
4	0	2	0	0	33507	2
2	0	2	0	0	33508	2
2	0	2	0	0	33509	2
2	0	2	0	0	33510	2
2	0	2	0	0	33511	2
2	0	2	0	0	33512	2
2	0	2	0	0	33513	2
2	0	2	0	0	33514	2
2	0	2	0	0	33515	2
2	0	2	0	0	33516	2
2	0	2	0	0	33517	2
4	0	4	36	36	33518	2
2	0	2	0	0	33519	2
2	0	2	0	0	33520	2
2	0	2	0	0	33521	2
2	0	2	0	0	33522	2
2	0	2	0	0	33523	2
2	0	2	0	0	33524	2
2	0	4	66	66	33525	2
2	0	2	0	0	33526	2
2	0	2	0	0	33527	2
2	0	4	58	58	33528	2
2	0	2	0	0	33529	2
2	0	2	0	0	33530	2
2	0	2	0	0	33531	2
2	0	2	2	2	33532	2
2	0	2	0	0	33533	2
2	0	2	0	0	33534	2
2	0	2	0	0	33535	2
2	0	2	0	0	33536	2
2	0	2	0	0	33537	2
2	0	2	0	0	33538	2
2	0	2	0	0	33539	2
2	0	2	0	0	33540	2
2	0	2	0	0	33541	2
2	0	2	0	0	33542	2
2	0	2	0	0	33543	2
2	0	2	0	0	33544	2
2	0	2	0	0	33545	2
2	0	2	0	0	33546	2
2	0	2	0	0	33547	2
2	0	2	0	0	33548	2
2	0	2	0	0	33549	2
2	0	4	0	0	33550	2
2	0	2	0	0	33551	2
2	0	4	1	1	33552	2
2	0	2	0	0	33553	2
2	0	2	0	0	33554	2
2	0	2	0	0	33555	2
2	0	2	0	0	33556	2
2	0	2	0	0	33557	2
2	0	2	0	0	33558	2
2	0	2	0	0	33559	2
2	0	2	0	0	33560	2
2	0	2	0	0	33561	2
2	0	2	0	0	33562	2
2	0	2	0	0	33563	2
2	0	2	0	0	33564	2
2	0	2	0	0	33565	2
2	0	2	0	0	33566	2
2	0	2	0	0	33567	2
2	0	2	0	0	33568	2
2	0	2	0	0	33569	2
2	0	2	0	0	33570	2
2	0	2	0	0	33571	2
2	0	2	0	0	33572	2
2	0	2	0	0	33573	2
2	0	2	0	0	33574	2
2	0	2	0	0	33575	2
2	0	2	0	0	33576	2
2	0	2	1	1	33577	2
2	0	2	0	0	33578	2
2	0	2	0	0	33579	2
2	0	2	0	0	33580	2
2	0	2	0	0	33581	2
2	0	2	0	0	33582	2
2	2	2	2609	2611	33583	1
2	0	2	0	0	33584	2
2	0	2	0	0	33585	2
2	0	2	319	319	33586	2
2	0	2	0	0	33587	2
2	0	2	0	0	33588	2
2	0	2	0	0	33589	2
2	0	2	0	0	33590	2
2	0	2	0	0	33591	2
2	0	2	0	0	33592	2
2	0	2	0	0	33593	2
2	1	2	0	1	33594	0
2	0	2	1	1	33595	2
2	0	2	0	0	33596	2
2	0	2	0	0	33597	2
2	0	2	3	3	33598	2
2	0	2	0	0	33599	2
2	0	2	0	0	33600	2
2	0	2	0	0	33601	2
2	0	2	0	0	33602	2
2	0	2	0	0	33603	2
2	0	2	0	0	33604	2
2	0	2	0	0	33605	2
2	0	2	0	0	33606	2
2	0	2	0	0	33607	2
2	0	2	0	0	33608	2
2	0	2	0	0	33609	2
2	0	2	0	0	33610	2
2	0	2	0	0	33611	2
2	0	2	0	0	33612	2
2	0	2	0	0	33613	2
2	0	2	0	0	33614	2
2	0	2	0	0	33615	2
2	0	2	0	0	33616	2
2	0	2	0	0	33617	2
2	0	2	0	0	33618	2
2	0	2	0	0	33619	2
2	0	2	0	0	33620	2
2	0	2	0	0	33621	2
2	0	2	0	0	33622	2
2	0	2	0	0	33623	2
2	0	2	1	1	33624	2
2	0	2	0	0	33625	2
2	0	2	0	0	33626	2
2	0	4	4	4	33627	2
2	0	2	0	0	33628	2
2	0	2	0	0	33629	2
2	0	4	1	1	33630	2
2	0	2	0	0	33631	2
2	0	2	0	0	33632	2
2	0	2	0	0	33633	2
2	0	2	0	0	33634	2
2	0	2	0	0	33635	2
2	0	2	0	0	33636	2
2	0	2	0	0	33637	2
2	0	2	0	0	33638	2
2	0	2	0	0	33639	2
2	0	2	0	0	33640	2
2	0	2	0	0	33641	2
2	0	2	0	0	33642	2
2	0	2	0	0	33643	2
4	0	2	0	0	33644	2
2	0	2	0	0	33645	2
2	0	2	0	0	33646	2
2	0	4	1	1	33647	2
2	0	2	0	0	33648	2
2	0	2	0	0	33649	2
2	0	2	0	0	33650	2
2	0	2	0	0	33651	2
2	0	2	0	0	33652	2
2	0	2	0	0	33653	2
2	0	2	0	0	33654	2
2	0	2	0	0	33655	2
2	0	2	0	0	33656	2
2	0	2	0	0	33657	2
2	0	2	0	0	33658	2
2	0	2	1	1	33659	2
2	0	2	0	0	33660	2
2	0	2	0	0	33661	2
2	0	4	127	127	33662	2
2	0	2	0	0	33663	2
2	0	2	0	0	33664	2
2	0	4	77	77	33665	2
2	0	2	0	0	33666	2
2	0	2	0	0	33667	2
2	0	2	0	0	33668	2
2	0	2	0	0	33669	2
2	0	2	0	0	33670	2
2	0	2	0	0	33671	2
2	0	2	0	0	33672	2
2	0	2	0	0	33673	2
2	0	2	0	0	33674	2
2	0	2	0	0	33675	2
2	0	2	0	0	33676	2
2	0	2	0	0	33677	2
2	0	2	0	0	33678	2
2	0	2	0	0	33679	2
2	0	2	0	0	33680	2
4	56	2	4	60	33681	0
4	6952	2	11	6963	33682	0
4	9076	2	10	9086	33683	0
4	5	2	0	5	33684	0
4	0	2	1	1	33685	2
4	0	2	0	0	33686	2
2	0	2	0	0	33687	2
2	0	2	0	0	33688	2
2	0	2	0	0	33689	2
2	0	2	0	0	33690	2
2	0	2	0	0	33691	2
2	0	2	0	0	33692	2
2	0	2	0	0	33693	2
2	0	2	2	2	33694	2
2	0	2	2	2	33695	2
2	0	2	0	0	33696	2
2	0	2	0	0	33697	2
2	0	2	0	0	33698	2
2	0	2	0	0	33699	2
2	0	2	0	0	33700	2
2	0	2	0	0	33701	2
2	0	2	0	0	33702	2
2	0	2	0	0	33703	2
2	0	2	0	0	33704	2
2	0	2	0	0	33705	2
2	0	2	1	1	33706	2
2	0	2	0	0	33707	2
2	0	2	0	0	33708	2
2	0	2	0	0	33709	2
2	0	2	0	0	33710	2
2	0	2	0	0	33711	2
2	0	2	0	0	33712	2
2	0	2	0	0	33713	2
2	0	2	0	0	33714	2
2	0	2	0	0	33715	2
2	0	2	0	0	33716	2
2	0	2	0	0	33717	2
2	0	2	0	0	33718	2
2	0	2	0	0	33719	2
2	0	2	0	0	33720	2
2	0	2	0	0	33721	2
2	0	2	0	0	33722	2
2	0	2	0	0	33723	2
2	0	2	0	0	33724	2
2	0	2	0	0	33725	2
2	0	2	0	0	33726	2
2	0	2	0	0	33727	2
2	0	2	0	0	33728	2
2	0	2	0	0	33729	2
2	0	4	10	10	33730	2
2	0	2	0	0	33731	2
2	0	2	0	0	33732	2
2	0	4	2	2	33733	2
2	0	2	0	0	33734	2
2	0	2	0	0	33735	2
2	0	2	2	2	33736	2
2	0	2	0	0	33737	2
2	0	2	0	0	33738	2
2	0	2	0	0	33739	2
2	0	2	0	0	33740	2
2	0	2	0	0	33741	2
2	0	4	1414	1414	33742	2
2	0	2	0	0	33743	2
2	0	2	0	0	33744	2
2	0	4	34	34	33745	2
2	0	2	0	0	33746	2
2	0	2	0	0	33747	2
2	2	2	0	2	33748	0
2	0	2	0	0	33749	2
2	0	2	0	0	33750	2
2	0	2	0	0	33751	2
2	0	2	0	0	33752	2
2	0	2	0	0	33753	2
2	0	2	0	0	33754	2
2	0	2	0	0	33755	2
2	0	2	0	0	33756	2
2	0	2	0	0	33757	2
2	0	2	0	0	33758	2
2	0	2	0	0	33759	2
2	0	2	0	0	33760	2
2	0	2	0	0	33761	2
2	0	2	0	0	33762	2
2	0	2	0	0	33763	2
2	0	2	0	0	33764	2
2	0	2	0	0	33765	2
2	0	2	0	0	33766	2
2	2	4	151	153	33767	1
2	0	2	0	0	33768	2
2	0	2	0	0	33769	2
2	0	4	173	173	33770	2
2	0	2	3	3	33771	2
2	0	2	0	0	33772	2
2	0	2	0	0	33773	2
2	0	2	0	0	33774	2
2	0	2	0	0	33775	2
2	0	0	583	583	33776	2
2	0	2	0	0	33777	2
2	0	2	3	3	33778	2
2	0	2	0	0	33779	2
2	0	2	0	0	33780	2
2	0	2	0	0	33781	2
2	0	2	0	0	33782	2
2	0	2	0	0	33783	2
2	0	2	0	0	33784	2
2	0	2	0	0	33785	2
2	0	2	0	0	33786	2
2	0	2	0	0	33787	2
2	0	4	8	8	33788	2
2	0	2	0	0	33789	2
2	0	2	0	0	33790	2
2	2	2	0	2	33791	1
2	9	2	0	9	33792	1
2	0	2	0	0	33793	2
2	0	2	3	3	33794	2
2	3	2	0	3	33795	0
2	1	2	6	7	33796	1
2	0	2	0	0	33797	2
2	0	2	0	0	33798	2
2	0	2	0	0	33799	2
2	0	2	0	0	33800	2
2	0	2	0	0	33801	2
2	0	2	0	0	33802	2
2	0	2	0	0	33803	2
2	0	2	0	0	33804	2
0	2	4	34	36	33805	0
2	0	2	0	0	33806	2
2	0	2	0	0	33807	2
2	0	2	0	0	33808	2
2	0	2	0	0	33809	2
2	0	2	0	0	33810	2
2	0	2	0	0	33811	2
2	0	2	0	0	33812	2
2	0	2	0	0	33813	2
2	0	2	0	0	33814	2
2	0	2	0	0	33815	2
2	0	2	0	0	33816	2
2	0	2	0	0	33817	2
2	0	2	0	0	33818	2
2	0	2	0	0	33819	2
2	1	2	19	20	33820	1
2	0	2	0	0	33821	2
2	0	2	0	0	33822	2
2	1	2	0	1	33823	1
2	0	2	1	1	33824	2
4	0	2	0	0	33825	2
2	0	2	1	1	33826	2
2	0	2	0	0	33827	2
2	0	2	0	0	33828	2
2	0	2	0	0	33829	2
2	0	2	0	0	33830	2
2	2	2	0	2	33831	0
2	1	4	25	26	33832	1
2	0	2	0	0	33833	2
2	0	2	0	0	33834	2
2	2	0	2	4	33835	1
2	0	2	2	2	33836	2
2	0	2	12	12	33837	2
2	0	2	0	0	33838	2
2	0	2	0	0	33839	2
2	0	2	0	0	33840	2
2	0	2	0	0	33841	2
2	0	2	0	0	33842	2
2	0	4	0	0	33843	2
2	527	2	3	530	33844	0
2	14	2	0	14	33845	0
2	5	2	62	67	33846	1
2	0	2	0	0	33847	2
2	0	2	0	0	33848	2
2	5	2	0	5	33849	0
2	0	2	37	37	33850	2
2	0	2	0	0	33851	2
2	605	2	1	606	33852	0
2	0	4	0	0	33853	2
2	0	2	0	0	33854	2
2	0	2	0	0	33855	2
2	0	4	1112	1112	33856	2
2	476	2	2	478	33857	0
2	0	2	79	79	33858	2
2	0	2	8	8	33859	2
2	253	2	2	255	33860	0
2	0	2	0	0	33861	2
2	0	2	0	0	33862	2
2	0	2	0	0	33863	2
2	0	2	0	0	33864	2
2	0	2	1	1	33865	2
2	0	2	0	0	33866	2
2	0	2	0	0	33867	2
2	0	2	0	0	33868	2
2	0	2	0	0	33869	2
2	0	2	0	0	33870	2
2	1	2	0	1	33871	0
2	4	2	5	9	33872	1
2	0	2	0	0	33873	2
2	0	2	0	0	33874	2
0	63	2	1	64	33875	0
0	33	2	0	33	33876	0
2	0	2	1	1	33877	2
2	0	2	0	0	33878	2
2	0	4	57	57	33879	2
2	0	2	0	0	33880	2
2	0	2	0	0	33881	2
2	0	2	0	0	33882	2
2	0	2	0	0	33883	2
2	0	2	0	0	33884	2
2	0	2	0	0	33885	2
2	0	2	0	0	33886	2
2	0	2	0	0	33887	2
2	2	2	0	2	33888	0
0	0	4	0	0	33889	2
2	0	4	139	139	33890	2
2	0	2	1	1	33891	2
2	0	2	0	0	33892	2
2	1	4	82	83	33893	1
2	0	2	21	21	33894	2
2	0	2	0	0	33895	2
2	0	2	0	0	33896	2
2	0	2	0	0	33897	2
2	0	2	0	0	33898	2
2	0	2	0	0	33899	2
2	0	2	0	0	33900	2
2	0	2	0	0	33901	2
2	0	2	0	0	33902	2
2	0	2	0	0	33903	2
2	0	2	0	0	33904	2
2	0	2	0	0	33905	2
2	77	2	0	77	33906	0
2	1	2	181	182	33907	1
2	0	2	32	32	33908	2
2	0	2	9	9	33909	2
2	5	2	7	12	33910	0
2	0	2	0	0	33911	2
2	0	2	0	0	33912	2
2	0	2	0	0	33913	2
2	0	2	0	0	33914	2
2	0	2	0	0	33915	2
2	0	2	0	0	33916	2
2	0	2	0	0	33917	2
2	0	2	0	0	33918	2
2	0	2	0	0	33919	2
2	0	2	0	0	33920	2
2	0	2	0	0	33921	2
2	0	2	0	0	33922	2
2	0	2	0	0	33923	2
2	0	2	0	0	33924	2
2	0	2	0	0	33925	2
2	0	2	0	0	33926	2
2	0	2	0	0	33927	2
2	0	2	0	0	33928	2
2	0	4	2	2	33929	2
2	0	2	0	0	33930	2
2	0	2	0	0	33931	2
2	0	4	0	0	33932	2
2	0	2	0	0	33933	2
2	0	2	0	0	33934	2
0	0	2	0	0	33935	2
2	1	4	28	29	33936	1
2	0	2	0	0	33937	2
2	0	2	0	0	33938	2
2	1	4	30	31	33939	1
2	0	2	1	1	33940	2
2	0	2	0	0	33941	2
2	0	2	0	0	33942	2
2	0	2	0	0	33943	2
2	3	2	0	3	33944	0
2	4	0	25	29	33945	1
2	0	2	2	2	33946	2
2	0	2	0	0	33947	2
2	0	2	0	0	33948	2
2	1	2	8	9	33949	1
2	0	2	0	0	33950	2
2	0	2	0	0	33951	2
2	0	2	0	0	33952	2
2	0	2	0	0	33953	2
2	1	0	12	13	33954	0
2	0	2	0	0	33955	2
2	0	2	0	0	33956	2
2	0	2	0	0	33957	2
2	0	2	0	0	33958	2
2	0	2	0	0	33959	2
2	0	2	0	0	33960	2
2	0	2	0	0	33961	2
2	0	2	0	0	33962	2
2	0	4	1	1	33963	2
2	0	2	0	0	33964	2
2	0	2	0	0	33965	2
2	0	4	0	0	33966	2
2	0	2	0	0	33967	2
2	0	2	0	0	33968	2
2	0	4	2	2	33969	2
2	0	2	0	0	33970	2
2	0	2	0	0	33971	2
2	0	2	0	0	33972	2
2	0	2	0	0	33973	2
2	0	4	43	43	33974	2
2	0	2	0	0	33975	2
2	0	2	0	0	33976	2
2	0	2	1	1	33977	2
2	0	2	0	0	33978	2
2	0	2	0	0	33979	2
2	0	2	0	0	33980	2
2	0	2	1	1	33981	2
2	0	2	0	0	33982	2
2	0	2	0	0	33983	2
2	0	2	0	0	33984	2
2	0	2	0	0	33985	2
2	0	2	0	0	33986	2
2	0	2	0	0	33987	2
2	0	2	0	0	33988	2
2	0	2	0	0	33989	2
2	0	2	0	0	33990	2
2	0	2	0	0	33991	2
2	0	2	0	0	33992	2
2	0	2	0	0	33993	2
2	0	4	18	18	33994	2
2	0	2	0	0	33995	2
2	0	2	0	0	33996	2
2	0	2	0	0	33997	2
2	0	2	0	0	33998	2
2	0	2	0	0	33999	2
2	0	2	0	0	34000	2
2	0	2	0	0	34001	2
2	0	2	0	0	34002	2
2	0	4	1	1	34003	2
2	0	2	0	0	34004	2
2	0	2	0	0	34005	2
2	0	2	0	0	34006	2
2	0	2	0	0	34007	2
2	2	2	0	2	34008	0
2	31	2	33	64	34009	1
2	0	2	2	2	34010	2
2	0	2	0	0	34011	2
2	11	2	5	16	34012	0
2	0	2	10	10	34013	2
2	0	4	8	8	34014	2
0	1	4	32	33	34015	0
2	0	2	0	0	34016	2
2	1	4	44	45	34017	1
2	0	2	0	0	34018	2
2	0	2	0	0	34019	2
2	0	2	0	0	34020	2
2	0	2	0	0	34021	2
2	0	2	0	0	34022	2
2	0	2	0	0	34023	2
2	0	2	0	0	34024	2
2	0	2	3	3	34025	2
2	0	2	0	0	34026	2
2	70	2	2954	3024	34027	0
2	82	2	0	82	34028	0
2	0	2	336	336	34029	2
2	0	2	0	0	34030	2
2	0	4	4	4	34031	2
2	0	2	0	0	34032	2
2	0	2	0	0	34033	2
2	0	4	0	0	34034	2
2	0	2	0	0	34035	2
2	0	2	0	0	34036	2
2	0	2	0	0	34037	2
2	0	2	0	0	34038	2
2	0	2	0	0	34039	2
2	0	2	0	0	34040	2
2	0	2	0	0	34041	2
2	0	2	0	0	34042	2
2	0	2	0	0	34043	2
2	0	2	0	0	34044	2
2	0	2	0	0	34045	2
2	0	2	0	0	34046	2
2	0	2	0	0	34047	2
2	0	2	0	0	34048	2
2	0	2	1	1	34049	2
2	0	2	0	0	34050	2
2	0	2	0	0	34051	2
2	0	2	0	0	34052	2
2	0	2	0	0	34053	2
2	0	2	0	0	34054	2
2	0	2	0	0	34055	2
2	0	2	0	0	34056	2
2	0	2	0	0	34057	2
2	0	2	0	0	34058	2
2	0	2	0	0	34059	2
2	0	2	0	0	34060	2
2	0	2	0	0	34061	2
2	0	2	0	0	34062	2
2	0	2	0	0	34063	2
2	1	2	3	4	34064	1
2	0	2	0	0	34065	2
2	0	2	0	0	34066	2
2	0	2	0	0	34067	2
2	0	2	0	0	34068	2
2	0	2	0	0	34069	2
2	0	2	0	0	34070	2
2	0	2	0	0	34071	2
2	0	2	0	0	34072	2
2	0	2	0	0	34073	2
2	0	2	0	0	34074	2
2	0	2	0	0	34075	2
2	0	2	10	10	34076	2
2	0	2	0	0	34077	2
2	0	2	0	0	34078	2
2	0	2	0	0	34079	2
2	0	2	0	0	34080	2
2	0	2	0	0	34081	2
2	0	2	0	0	34082	2
2	0	2	0	0	34083	2
2	0	2	0	0	34084	2
2	0	2	0	0	34085	2
2	0	2	0	0	34086	2
2	0	2	0	0	34087	2
2	0	2	0	0	34088	2
2	0	2	0	0	34089	2
2	0	2	0	0	34090	2
2	0	2	0	0	34091	2
2	0	2	0	0	34092	2
2	0	2	0	0	34093	2
2	0	2	0	0	34094	2
2	0	2	0	0	34095	2
2	0	2	0	0	34096	2
2	0	2	0	0	34097	2
2	0	2	0	0	34098	2
2	0	2	0	0	34099	2
2	0	2	680	680	34100	2
2	0	2	0	0	34101	2
2	0	2	0	0	34102	2
2	0	2	206	206	34103	2
2	0	2	0	0	34104	2
2	0	2	0	0	34105	2
2	0	2	0	0	34106	2
2	0	2	0	0	34107	2
2	0	2	0	0	34108	2
2	0	2	0	0	34109	2
2	0	2	0	0	34110	2
2	0	2	0	0	34111	2
2	0	4	5	5	34112	2
2	0	2	0	0	34113	2
2	0	2	0	0	34114	2
2	0	4	23	23	34115	2
2	0	2	0	0	34116	2
2	0	2	0	0	34117	2
2	0	4	12	12	34118	2
2	0	2	0	0	34119	2
2	0	2	0	0	34120	2
2	0	4	0	0	34121	2
2	0	2	0	0	34122	2
2	0	2	0	0	34123	2
2	0	2	0	0	34124	2
2	0	2	0	0	34125	2
2	0	2	0	0	34126	2
2	0	2	0	0	34127	2
2	0	2	0	0	34128	2
2	3	2	0	3	34129	0
2	0	2	12	12	34130	2
2	0	2	0	0	34131	2
2	0	2	0	0	34132	2
2	0	2	0	0	34133	2
2	0	2	4	4	34134	2
2	1409	2	132	1541	34135	0
2	0	2	9299	9299	34136	2
2	0	2	0	0	34137	2
2	0	2	0	0	34138	2
2	0	2	6	6	34139	2
2	0	2	0	0	34140	2
2	0	2	0	0	34141	2
2	0	2	0	0	34142	2
2	0	2	0	0	34143	2
2	0	2	1	1	34144	2
2	0	2	0	0	34145	2
2	0	2	0	0	34146	2
2	0	2	1	1	34147	2
2	0	2	0	0	34148	2
2	19	2	2	21	34149	0
2	0	2	0	0	34150	2
2	0	2	1	1	34151	2
2	0	2	1	1	34152	2
2	0	2	0	0	34153	2
2	1	2	0	1	34154	0
2	0	2	1	1	34155	2
2	129	2	0	129	34156	0
2	6	2	269	275	34157	1
2	0	2	10	10	34158	2
2	0	2	0	0	34159	2
2	16	2	0	16	34160	0
2	0	2	114	114	34161	2
2	72	4	2925	2997	34162	1
2	0	2	4	4	34163	2
2	0	2	2	2	34164	2
2	22	4	172	194	34165	0
2	0	2	123	123	34166	2
2	0	2	0	0	34167	2
2	0	2	1	1	34168	2
2	0	2	0	0	34169	2
2	0	2	0	0	34170	2
2	0	2	0	0	34171	2
2	0	2	0	0	34172	2
2	0	2	0	0	34173	2
2	0	2	0	0	34174	2
2	0	2	0	0	34175	2
2	0	2	0	0	34176	2
4	1	2	0	1	34177	1
4	0	2	0	0	34178	2
2	0	2	0	0	34179	2
2	0	2	0	0	34180	2
2	2	2	0	2	34181	0
2	5	2	666	671	34182	1
2	0	2	0	0	34183	2
2	0	2	0	0	34184	2
2	9	2	0	9	34185	0
2	0	2	34	34	34186	2
2	0	2	0	0	34187	2
2	0	2	0	0	34188	2
2	0	2	0	0	34189	2
2	0	2	0	0	34190	2
2	0	2	0	0	34191	2
2	0	2	0	0	34192	2
2	7	2	1	8	34193	0
2	0	2	0	0	34194	2
2	0	2	0	0	34195	2
2	0	2	0	0	34196	2
2	0	2	0	0	34197	2
2	0	2	0	0	34198	2
2	0	2	0	0	34199	2
2	0	2	0	0	34200	2
2	0	2	0	0	34201	2
2	0	2	0	0	34202	2
2	0	2	0	0	34203	2
2	0	2	0	0	34204	2
2	0	2	0	0	34205	2
4	0	2	0	0	34206	2
2	1	4	176	177	34207	1
2	0	2	1	1	34208	2
2	0	2	0	0	34209	2
4	8	2	0	8	34210	0
4	0	2	0	0	34211	2
2	2	4	8	10	34212	0
2	0	2	8	8	34213	2
4	0	2	5	5	34214	2
2	0	2	0	0	34215	2
2	0	2	0	0	34216	2
2	0	2	0	0	34217	2
2	0	2	0	0	34218	2
2	0	2	10	10	34219	2
2	0	2	0	0	34220	2
2	0	2	0	0	34221	2
2	0	2	0	0	34222	2
2	0	2	0	0	34223	2
2	0	2	0	0	34224	2
2	0	2	0	0	34225	2
2	0	2	0	0	34226	2
2	0	2	0	0	34227	2
2	0	2	0	0	34228	2
2	0	2	0	0	34229	2
2	0	2	0	0	34230	2
2	0	2	0	0	34231	2
2	0	2	0	0	34232	2
2	0	2	0	0	34233	2
2	0	2	2	2	34234	2
2	0	2	0	0	34235	2
2	0	2	0	0	34236	2
2	0	2	0	0	34237	2
2	0	2	1	1	34238	2
2	0	2	0	0	34239	2
2	0	4	4	4	34240	2
2	0	2	0	0	34241	2
2	0	2	0	0	34242	2
2	0	4	0	0	34243	2
2	0	2	0	0	34244	2
2	0	2	0	0	34245	2
2	0	2	4	4	34246	2
2	0	2	0	0	34247	2
2	0	2	0	0	34248	2
2	1	2	0	1	34249	1
2	0	2	5	5	34250	2
2	0	2	0	0	34251	2
2	0	2	0	0	34252	2
2	0	2	0	0	34253	2
2	0	2	0	0	34254	2
2	0	2	0	0	34255	2
2	0	2	0	0	34256	2
2	0	2	0	0	34257	2
2	0	2	0	0	34258	2
2	0	2	0	0	34259	2
2	0	2	0	0	34260	2
2	0	2	0	0	34261	2
2	0	2	0	0	34262	2
2	0	2	0	0	34263	2
2	0	2	0	0	34264	2
2	0	2	0	0	34265	2
2	0	2	0	0	34266	2
2	0	2	0	0	34267	2
2	0	2	0	0	34268	2
2	0	2	0	0	34269	2
2	0	2	0	0	34270	2
2	0	2	0	0	34271	2
2	0	2	0	0	34272	2
2	0	2	0	0	34273	2
2	0	2	0	0	34274	2
2	0	2	0	0	34275	2
2	0	2	0	0	34276	2
2	0	2	0	0	34277	2
2	0	2	0	0	34278	2
2	0	2	0	0	34279	2
2	0	2	0	0	34280	2
2	0	2	0	0	34281	2
2	0	2	0	0	34282	2
2	0	2	0	0	34283	2
2	0	2	0	0	34284	2
2	0	2	0	0	34285	2
2	0	2	0	0	34286	2
2	0	2	0	0	34287	2
2	0	2	0	0	34288	2
2	0	2	0	0	34289	2
2	0	2	0	0	34290	2
2	0	2	0	0	34291	2
2	0	2	0	0	34292	2
2	0	2	0	0	34293	2
2	0	4	56	56	34294	2
2	0	2	0	0	34295	2
2	0	2	0	0	34296	2
2	0	4	53	53	34297	2
2	0	2	0	0	34298	2
2	0	2	0	0	34299	2
2	0	2	0	0	34300	2
2	0	2	0	0	34301	2
2	0	2	1	1	34302	2
2	0	2	1	1	34303	2
2	0	2	0	0	34304	2
2	0	2	0	0	34305	2
2	0	2	0	0	34306	2
2	0	2	0	0	34307	2
2	0	2	0	0	34308	2
2	0	2	0	0	34309	2
2	0	2	0	0	34310	2
2	0	2	0	0	34311	2
2	0	2	0	0	34312	2
2	0	2	0	0	34313	2
2	0	2	0	0	34314	2
2	0	2	0	0	34315	2
2	0	2	0	0	34316	2
2	0	2	0	0	34317	2
2	0	2	0	0	34318	2
2	0	2	0	0	34319	2
2	0	2	0	0	34320	2
2	0	2	0	0	34321	2
2	0	2	0	0	34322	2
2	0	2	0	0	34323	2
2	0	2	0	0	34324	2
2	0	2	0	0	34325	2
2	0	2	0	0	34326	2
2	0	2	0	0	34327	2
2	0	2	0	0	34328	2
2	0	2	0	0	34329	2
2	0	2	0	0	34330	2
2	0	2	0	0	34331	2
2	0	2	0	0	34332	2
2	0	2	0	0	34333	2
2	0	2	0	0	34334	2
2	0	2	0	0	34335	2
2	0	2	0	0	34336	2
2	0	2	0	0	34337	2
2	0	2	4	4	34338	2
2	0	2	0	0	34339	2
2	0	2	0	0	34340	2
2	2	2	0	2	34341	0
2	0	2	2	2	34342	2
2	0	2	0	0	34343	2
2	0	2	0	0	34344	2
2	0	2	0	0	34345	2
2	0	2	0	0	34346	2
2	0	2	0	0	34347	2
2	0	2	0	0	34348	2
2	0	2	0	0	34349	2
2	0	2	0	0	34350	2
2	0	2	0	0	34351	2
2	0	2	0	0	34352	2
2	0	2	0	0	34353	2
2	0	2	0	0	34354	2
2	0	2	0	0	34355	2
2	0	2	0	0	34356	2
2	0	2	0	0	34357	2
2	0	2	0	0	34358	2
2	0	2	0	0	34359	2
2	0	2	0	0	34360	2
2	0	2	0	0	34361	2
2	0	2	0	0	34362	2
2	0	2	0	0	34363	2
2	0	2	0	0	34364	2
2	0	2	0	0	34365	2
2	0	2	0	0	34366	2
2	0	2	0	0	34367	2
2	0	2	0	0	34368	2
2	1	2	3	4	34369	1
2	0	2	0	0	34370	2
2	0	2	0	0	34371	2
2	1	2	0	1	34372	1
2	0	2	0	0	34373	2
2	14	2	0	14	34374	0
2	0	0	998	998	34375	2
2	0	2	0	0	34376	2
2	0	2	0	0	34377	2
2	0	0	328	328	34378	2
2	0	2	11	11	34379	2
2	0	2	0	0	34380	2
2	0	2	1	1	34381	2
2	0	2	0	0	34382	2
2	0	2	0	0	34383	2
2	0	2	0	0	34384	2
2	0	2	0	0	34385	2
2	0	2	0	0	34386	2
2	0	2	3	3	34387	2
2	0	2	0	0	34388	2
2	0	2	0	0	34389	2
2	0	2	0	0	34390	2
2	0	2	0	0	34391	2
2	0	2	0	0	34392	2
2	0	4	149	149	34393	2
2	0	2	0	0	34394	2
2	0	2	0	0	34395	2
2	0	4	7	7	34396	2
2	0	2	0	0	34397	2
2	0	2	0	0	34398	2
2	0	2	0	0	34399	2
2	0	2	0	0	34400	2
2	11	2	1	12	34401	0
2	10	2	1	11	34402	0
2	0	2	2	2	34403	2
2	0	2	0	0	34404	2
2	1	2	1	2	34405	0
2	0	2	21	21	34406	2
2	203	4	1093	1296	34407	1
2	0	2	0	0	34408	2
2	0	2	0	0	34409	2
2	13	4	105	118	34410	0
2	0	2	1	1	34411	2
2	0	2	0	0	34412	2
2	0	2	0	0	34413	2
2	0	2	0	0	34414	2
2	0	2	0	0	34415	2
2	0	2	0	0	34416	2
2	0	2	0	0	34417	2
2	0	2	0	0	34418	2
2	0	2	1	1	34419	2
2	0	2	0	0	34420	2
2	0	2	0	0	34421	2
2	0	2	0	0	34422	2
2	0	2	0	0	34423	2
2	0	2	0	0	34424	2
2	0	2	0	0	34425	2
2	0	2	0	0	34426	2
2	0	2	0	0	34427	2
2	0	2	0	0	34428	2
2	0	2	0	0	34429	2
2	2	2	0	2	34430	1
2	0	2	0	0	34431	2
2	0	2	0	0	34432	2
2	0	2	0	0	34433	2
2	0	2	0	0	34434	2
2	0	2	0	0	34435	2
2	0	2	0	0	34436	2
2	0	2	0	0	34437	2
2	0	2	0	0	34438	2
2	0	2	0	0	34439	2
2	0	2	0	0	34440	2
2	0	2	2	2	34441	2
2	0	2	0	0	34442	2
2	0	2	0	0	34443	2
2	0	2	0	0	34444	2
2	0	2	0	0	34445	2
2	0	2	0	0	34446	2
2	0	2	0	0	34447	2
2	0	2	0	0	34448	2
2	0	2	0	0	34449	2
2	0	2	0	0	34450	2
2	0	2	0	0	34451	2
2	0	2	0	0	34452	2
2	0	2	0	0	34453	2
2	0	2	0	0	34454	2
2	0	2	0	0	34455	2
2	0	2	0	0	34456	2
2	0	2	0	0	34457	2
2	0	2	0	0	34458	2
2	0	2	0	0	34459	2
2	0	2	0	0	34460	2
2	0	2	0	0	34461	2
2	0	2	0	0	34462	2
2	3	2	14	17	34463	1
2	0	2	0	0	34464	2
2	0	2	0	0	34465	2
2	1	2	0	1	34466	0
2	0	2	1	1	34467	2
2	0	2	0	0	34468	2
2	0	2	0	0	34469	2
2	0	2	0	0	34470	2
2	0	2	0	0	34471	2
2	0	2	0	0	34472	2
2	0	2	0	0	34473	2
2	0	2	0	0	34474	2
2	0	2	0	0	34475	2
2	0	4	8	8	34476	2
2	0	2	0	0	34477	2
2	0	2	0	0	34478	2
2	0	4	27	27	34479	2
2	0	2	0	0	34480	2
2	0	2	0	0	34481	2
2	0	2	0	0	34482	2
2	0	2	0	0	34483	2
2	0	2	0	0	34484	2
2	0	2	0	0	34485	2
2	0	2	0	0	34486	2
2	0	2	0	0	34487	2
2	1	2	0	1	34488	1
2	0	2	0	0	34489	2
2	0	2	0	0	34490	2
2	0	2	0	0	34491	2
2	0	2	0	0	34492	2
2	0	2	0	0	34493	2
2	0	2	0	0	34494	2
2	0	2	0	0	34495	2
2	0	2	0	0	34496	2
2	0	2	0	0	34497	2
2	0	2	0	0	34498	2
2	0	2	0	0	34499	2
2	0	2	0	0	34500	2
2	0	2	0	0	34501	2
2	0	2	0	0	34502	2
2	0	2	0	0	34503	2
2	0	2	0	0	34504	2
2	0	2	0	0	34505	2
2	0	2	0	0	34506	2
2	0	2	0	0	34507	2
2	0	2	0	0	34508	2
2	0	2	0	0	34509	2
2	0	2	0	0	34510	2
2	0	2	0	0	34511	2
2	0	2	0	0	34512	2
2	0	2	0	0	34513	2
2	0	2	0	0	34514	2
2	0	2	0	0	34515	2
2	0	2	0	0	34516	2
2	8	2	0	8	34517	0
2	1	4	9956	9957	34518	1
2	0	2	2	2	34519	2
2	0	2	0	0	34520	2
2	1	4	5860	5861	34521	1
2	0	2	12	12	34522	2
2	728	4	12	740	34523	0
4	20	4	12	32	34524	0
4	0	2	0	0	34525	2
2	0	2	0	0	34526	2
2	0	4	0	0	34527	2
2	0	2	0	0	34528	2
2	0	2	0	0	34529	2
2	0	4	0	0	34530	2
2	0	2	0	0	34531	2
2	0	2	0	0	34532	2
2	0	2	0	0	34533	2
2	0	2	0	0	34534	2
2	0	2	0	0	34535	2
2	261	2	2	263	34536	0
2	773	2	516	1289	34537	1
2	1	2	198	199	34538	1
2	0	2	0	0	34539	2
2	115	2	16	131	34540	1
2	0	2	0	0	34541	2
2	0	2	0	0	34542	2
2	0	2	0	0	34543	2
2	0	2	0	0	34544	2
2	0	2	0	0	34545	2
2	0	2	0	0	34546	2
2	0	2	0	0	34547	2
2	0	2	0	0	34548	2
2	0	2	0	0	34549	2
2	0	4	27	27	34550	2
2	0	2	0	0	34551	2
2	0	2	0	0	34552	2
2	0	4	24	24	34553	2
2	0	2	0	0	34554	2
2	0	2	0	0	34555	2
2	0	2	0	0	34556	2
2	0	2	0	0	34557	2
2	0	2	0	0	34558	2
2	0	2	0	0	34559	2
2	0	2	0	0	34560	2
2	0	2	0	0	34561	2
2	0	2	0	0	34562	2
2	0	2	0	0	34563	2
2	0	2	0	0	34564	2
2	0	2	0	0	34565	2
2	0	2	0	0	34566	2
2	0	2	0	0	34567	2
2	0	2	0	0	34568	2
2	0	2	0	0	34569	2
2	0	2	0	0	34570	2
2	0	2	0	0	34571	2
2	134747	3	541	135288	34572	0
0	18	2	181	199	34573	0
0	9	2	7	16	34574	1
4	0	4	0	0	34575	2
4	0	4	0	0	34576	2
4	0	2	343	343	34577	2
4	0	2	0	0	34578	2
2	973	3	113	1086	34579	0
2	28	3	113	141	34580	0
4	1108	2	0	1108	34581	0
4	0	2	666	666	34582	2
4	12	2	0	12	34583	0
2	0	3	45	45	34584	2
4	317	4	19	336	34585	0
4	21	4	0	21	34586	0
2	0	2	0	0	34587	2
2	0	2	0	0	34588	2
2	0	2	1	1	34589	2
2	0	2	0	0	34590	2
2	0	2	0	0	34591	2
2	0	2	0	0	34592	2
2	0	2	0	0	34593	2
2	0	2	0	0	34594	2
2	0	2	0	0	34595	2
2	0	2	0	0	34596	2
2	0	2	1	1	34597	2
2	0	2	0	0	34598	2
2	0	2	0	0	34599	2
2	0	2	0	0	34600	2
2	0	2	0	0	34601	2
4	0	2	0	0	34602	2
2	0	2	0	0	34603	2
2	0	2	0	0	34604	2
2	0	2	0	0	34605	2
2	0	2	0	0	34606	2
2	0	2	0	0	34607	2
2	0	2	0	0	34608	2
2	0	2	0	0	34609	2
2	0	2	0	0	34610	2
2	0	2	0	0	34611	2
2	0	2	0	0	34612	2
2	0	2	0	0	34613	2
2	0	2	0	0	34614	2
2	0	2	0	0	34615	2
2	0	2	0	0	34616	2
2	0	2	0	0	34617	2
2	0	2	0	0	34618	2
2	0	2	0	0	34619	2
2	0	2	0	0	34620	2
2	0	2	0	0	34621	2
2	0	2	0	0	34622	2
2	0	2	0	0	34623	2
2	0	2	0	0	34624	2
2	0	2	0	0	34625	2
2	0	2	0	0	34626	2
2	0	2	0	0	34627	2
2	0	2	0	0	34628	2
2	0	2	0	0	34629	2
2	0	2	0	0	34630	2
2	0	2	0	0	34631	2
2	0	2	0	0	34632	2
2	0	2	0	0	34633	2
2	0	2	0	0	34634	2
2	0	2	0	0	34635	2
2	0	2	0	0	34636	2
2	0	2	0	0	34637	2
2	0	2	0	0	34638	2
2	0	2	0	0	34639	2
2	0	2	0	0	34640	2
2	0	2	0	0	34641	2
2	0	2	1	1	34642	2
2	0	2	0	0	34643	2
2	0	2	0	0	34644	2
2	0	2	0	0	34645	2
2	0	2	3	3	34646	2
2	0	2	0	0	34647	2
2	0	2	0	0	34648	2
2	0	2	0	0	34649	2
2	0	2	0	0	34650	2
2	0	2	0	0	34651	2
2	0	2	0	0	34652	2
2	0	2	0	0	34653	2
2	0	2	0	0	34654	2
2	0	2	0	0	34655	2
2	0	2	0	0	34656	2
2	0	2	0	0	34657	2
2	0	2	0	0	34658	2
2	0	2	0	0	34659	2
2	0	2	0	0	34660	2
2	0	2	0	0	34661	2
2	0	2	0	0	34662	2
2	0	2	0	0	34663	2
2	0	2	0	0	34664	2
2	0	2	0	0	34665	2
2	0	2	0	0	34666	2
2	0	2	0	0	34667	2
2	0	2	0	0	34668	2
2	0	2	0	0	34669	2
2	0	2	0	0	34670	2
2	0	2	0	0	34671	2
2	0	2	0	0	34672	2
2	0	2	0	0	34673	2
2	0	2	0	0	34674	2
2	0	2	0	0	34675	2
2	0	2	0	0	34676	2
2	0	2	0	0	34677	2
2	0	2	0	0	34678	2
2	0	2	0	0	34679	2
2	0	2	0	0	34680	2
2	0	2	0	0	34681	2
2	0	2	0	0	34682	2
2	0	2	0	0	34683	2
2	0	2	0	0	34684	2
2	0	2	0	0	34685	2
2	0	2	0	0	34686	2
2	0	2	0	0	34687	2
2	0	2	0	0	34688	2
2	0	2	0	0	34689	2
2	0	2	0	0	34690	2
2	0	2	0	0	34691	2
2	0	2	0	0	34692	2
2	0	2	0	0	34693	2
2	0	2	0	0	34694	2
2	2	2	0	2	34695	0
2	0	2	5	5	34696	2
2	0	2	0	0	34697	2
2	0	2	0	0	34698	2
2	0	2	0	0	34699	2
2	0	2	3	3	34700	2
2	0	2	0	0	34701	2
2	0	2	0	0	34702	2
2	0	2	0	0	34703	2
2	0	2	0	0	34704	2
4	45	2	0	45	34705	0
4	0	2	0	0	34706	2
2	0	2	0	0	34707	2
2	0	2	0	0	34708	2
2	0	2	0	0	34709	2
2	0	2	0	0	34710	2
2	0	2	0	0	34711	2
2	0	2	0	0	34712	2
2	0	2	0	0	34713	2
2	0	2	0	0	34714	2
2	8	2	0	8	34715	0
2	5	4	5382	5387	34716	1
2	0	2	0	0	34717	2
2	0	2	0	0	34718	2
2	1	4	4171	4172	34719	0
2	0	2	12	12	34720	2
2	0	2	0	0	34721	2
2	1	2	1	2	34722	1
2	0	2	0	0	34723	2
2	0	2	0	0	34724	2
2	0	2	0	0	34725	2
2	0	2	0	0	34726	2
4	34	4	427	461	34727	0
2	0	2	0	0	34728	2
2	0	2	0	0	34729	2
2	0	2	0	0	34730	2
2	0	2	0	0	34731	2
2	0	2	0	0	34732	2
2	0	2	0	0	34733	2
2	0	2	0	0	34734	2
2	0	2	0	0	34735	2
2	0	2	0	0	34736	2
2	0	2	0	0	34737	2
2	0	2	0	0	34738	2
2	0	2	0	0	34739	2
2	0	2	0	0	34740	2
2	8	2	7	15	34741	1
2	0	2	0	0	34742	2
2	0	2	0	0	34743	2
2	6	2	0	6	34744	0
2	0	2	0	0	34745	2
2	0	2	0	0	34746	2
2	0	2	0	0	34747	2
2	0	2	0	0	34748	2
2	0	2	0	0	34749	2
2	0	2	0	0	34750	2
2	0	2	0	0	34751	2
2	0	2	0	0	34752	2
2	0	2	0	0	34753	2
2	0	2	0	0	34754	2
2	2	2	0	2	34755	1
2	0	2	0	0	34756	2
2	0	2	0	0	34757	2
2	0	2	0	0	34758	2
2	0	2	0	0	34759	2
2	3	2	0	3	34760	0
2	0	2	43	43	34761	2
2	0	2	0	0	34762	2
2	0	2	0	0	34763	2
2	2	2	0	2	34764	0
2	0	2	15	15	34765	2
2	3	2	0	3	34766	0
2	2	2	200	202	34767	1
2	0	2	0	0	34768	2
2	0	2	0	0	34769	2
2	2	2	14	16	34770	0
2	0	2	0	0	34771	2
4	2186	2	200	2386	34772	0
4	593	2	14	607	34773	0
2	0	2	0	0	34774	2
2	0	2	0	0	34775	2
2	0	2	0	0	34776	2
2	0	2	0	0	34777	2
2	0	2	0	0	34778	2
2	0	2	0	0	34779	2
2	249	2	2	251	34780	0
2	27	2	971	998	34781	1
2	0	2	72	72	34782	2
2	0	2	9	9	34783	2
2	51	2	3	54	34784	1
2	0	2	355	355	34785	2
2	0	2	0	0	34786	2
2	3	2	136	139	34787	1
2	0	2	0	0	34788	2
2	0	2	0	0	34789	2
2	45	2	0	45	34790	0
2	65	2	209	274	34791	1
2	0	2	3	3	34792	2
2	0	2	0	0	34793	2
2	14	2	0	14	34794	1
2	0	2	85	85	34795	2
2	2	2	0	2	34796	1
2	0	2	3	3	34797	2
2	9	2	0	9	34798	0
2	3	2	32	35	34799	1
2	0	2	2	2	34800	2
2	0	2	0	0	34801	2
2	0	2	0	0	34802	2
2	0	2	3	3	34803	2
2	1	2	0	1	34804	0
2	1	2	44	45	34805	1
2	0	2	1	1	34806	2
2	0	2	0	0	34807	2
2	2	2	0	2	34808	0
2	0	2	6	6	34809	2
2	0	2	0	0	34810	2
2	0	2	0	0	34811	2
2	1	2	0	1	34812	0
2	2	2	15	17	34813	1
2	0	2	0	0	34814	2
2	0	2	0	0	34815	2
2	0	2	0	0	34816	2
2	0	2	1	1	34817	2
2	0	2	0	0	34818	2
2	0	2	4	4	34819	2
2	0	2	0	0	34820	2
2	0	2	0	0	34821	2
2	465	2	1	466	34822	0
2	27	2	507	534	34823	1
2	0	2	374	374	34824	2
2	0	2	0	0	34825	2
2	118	2	2	120	34826	1
2	0	2	609	609	34827	2
2	0	2	0	0	34828	2
2	1	2	5	6	34829	1
2	0	2	0	0	34830	2
2	0	2	0	0	34831	2
2	0	2	0	0	34832	2
2	0	2	0	0	34833	2
2	0	2	0	0	34834	2
2	0	2	0	0	34835	2
2	0	2	0	0	34836	2
2	0	2	0	0	34837	2
2	0	2	0	0	34838	2
2	0	2	0	0	34839	2
2	0	2	0	0	34840	2
2	0	2	0	0	34841	2
2	0	2	0	0	34842	2
2	0	2	0	0	34843	2
2	0	2	0	0	34844	2
2	0	2	0	0	34845	2
2	0	2	0	0	34846	2
2	0	2	0	0	34847	2
2	0	2	0	0	34848	2
2	0	2	0	0	34849	2
2	7	2	19	26	34850	1
2	0	2	0	0	34851	2
2	0	2	0	0	34852	2
2	2	2	0	2	34853	0
2	0	2	2	2	34854	2
2	17	2	0	17	34855	0
2	0	2	3	3	34856	2
2	0	2	0	0	34857	2
2	0	2	0	0	34858	2
2	0	2	0	0	34859	2
2	0	2	0	0	34860	2
2	0	2	0	0	34861	2
2	0	2	15	15	34862	2
2	0	2	0	0	34863	2
2	0	2	0	0	34864	2
2	0	2	0	0	34865	2
2	1	2	0	1	34866	0
2	0	2	24	24	34867	2
2	0	2	1	1	34868	2
2	0	2	0	0	34869	2
2	0	2	2	2	34870	2
2	0	2	3	3	34871	2
4	5	2	2	7	34872	0
2	0	2	0	0	34873	2
2	13	2	18	31	34874	1
2	0	2	0	0	34875	2
2	0	2	0	0	34876	2
2	4	2	0	4	34877	0
2	0	2	0	0	34878	2
2	0	2	0	0	34879	2
2	0	2	0	0	34880	2
2	0	2	0	0	34881	2
2	0	2	0	0	34882	2
2	0	2	0	0	34883	2
2	0	2	0	0	34884	2
2	28	2	0	28	34885	0
2	0	2	175	175	34886	2
2	1	2	1432	1433	34887	1
2	0	2	0	0	34888	2
2	0	2	0	0	34889	2
2	0	2	0	0	34890	2
2	0	2	0	0	34891	2
2	0	2	0	0	34892	2
2	0	2	0	0	34893	2
2	0	2	0	0	34894	2
2	9	2	4	13	34895	1
2	0	2	0	0	34896	2
2	0	2	0	0	34897	2
2	1	2	0	1	34898	1
2	0	2	1	1	34899	2
2	0	2	0	0	34900	2
2	0	2	0	0	34901	2
2	0	2	0	0	34902	2
2	0	2	0	0	34903	2
2	0	2	0	0	34904	2
2	0	2	0	0	34905	2
2	0	2	0	0	34906	2
2	0	2	0	0	34907	2
2	0	2	0	0	34908	2
2	0	2	0	0	34909	2
2	0	2	0	0	34910	2
2	0	2	0	0	34911	2
2	0	2	0	0	34912	2
2	0	2	0	0	34913	2
2	0	2	0	0	34914	2
2	0	2	0	0	34915	2
2	0	2	0	0	34916	2
2	0	2	0	0	34917	2
2	0	2	0	0	34918	2
2	0	4	17	17	34919	2
2	0	2	0	0	34920	2
2	0	2	0	0	34921	2
2	0	4	3	3	34922	2
2	0	2	0	0	34923	2
2	0	2	0	0	34924	2
2	0	2	3	3	34925	2
2	0	2	0	0	34926	2
2	0	2	0	0	34927	2
2	0	2	0	0	34928	2
2	0	2	0	0	34929	2
2	1	2	0	1	34930	0
2	2	4	1100	1102	34931	1
2	0	2	0	0	34932	2
2	0	2	0	0	34933	2
2	1	4	312	313	34934	0
2	0	2	17	17	34935	2
2	0	2	0	0	34936	2
2	0	2	0	0	34937	2
2	0	2	0	0	34938	2
2	0	2	0	0	34939	2
2	0	2	0	0	34940	2
2	0	2	0	0	34941	2
2	354	2	0	354	34942	0
2	26	2	1879	1905	34943	1
2	0	2	6	6	34944	2
2	0	2	0	0	34945	2
2	31	2	2	33	34946	0
2	0	2	281	281	34947	2
2	1	2	0	1	34948	0
2	0	2	72	72	34949	2
2	0	2	0	0	34950	2
2	0	2	0	0	34951	2
2	0	2	0	0	34952	2
2	0	2	0	0	34953	2
2	0	2	0	0	34954	2
2	0	0	161	161	34955	2
2	0	2	0	0	34956	2
2	0	2	0	0	34957	2
2	0	0	166	166	34958	2
2	0	2	0	0	34959	2
2	550	2	1	551	34960	0
2	1	2	0	1	34961	0
2	1	2	11	12	34962	1
2	0	2	0	0	34963	2
2	0	2	0	0	34964	2
2	0	2	0	0	34965	2
2	0	2	5	5	34966	2
2	0	2	41	41	34967	2
2	0	2	0	0	34968	2
2	0	2	0	0	34969	2
2	0	2	3	3	34970	2
2	0	2	0	0	34971	2
2	0	2	0	0	34972	2
2	0	2	0	0	34973	2
2	0	2	0	0	34974	2
2	1	2	0	1	34975	0
2	0	2	6	6	34976	2
2	0	2	0	0	34977	2
2	0	2	0	0	34978	2
2	0	2	1	1	34979	2
2	0	2	2	2	34980	2
2	1	2	0	1	34981	1
2	0	2	0	0	34982	2
2	0	2	0	0	34983	2
2	10	2	0	10	34984	0
2	0	2	1	1	34985	2
2	0	2	0	0	34986	2
2	4	2	0	4	34987	0
2	2	2	103	105	34988	1
2	0	2	1	1	34989	2
2	0	2	0	0	34990	2
2	2	2	0	2	34991	0
2	0	2	5	5	34992	2
2	0	2	0	0	34993	2
2	0	2	1	1	34994	2
2	0	2	0	0	34995	2
2	0	2	0	0	34996	2
2	0	2	0	0	34997	2
2	0	2	0	0	34998	2
2	437	2	0	437	34999	0
2	0	2	51	51	35000	2
2	0	2	1	1	35001	2
2	0	2	0	0	35002	2
2	29	2	7	36	35003	1
2	0	2	1	1	35004	2
2	0	2	1	1	35005	2
2	4	2	0	4	35006	0
2	0	2	0	0	35007	2
2	8	2	0	8	35008	0
2	2	0	1	3	35009	1
2	0	2	2	2	35010	2
2	0	2	0	0	35011	2
2	5	0	1	6	35012	0
2	0	2	0	0	35013	2
2	0	2	0	0	35014	2
2	0	2	0	0	35015	2
2	0	2	0	0	35016	2
2	0	2	0	0	35017	2
2	0	2	0	0	35018	2
2	298	2	4	302	35019	0
2	0	2	0	0	35020	2
2	0	2	0	0	35021	2
2	1	2	0	1	35022	0
2	6	2	17	23	35023	1
2	0	2	0	0	35024	2
2	0	2	0	0	35025	2
2	1	2	0	1	35026	1
2	0	2	6	6	35027	2
2	0	2	0	0	35028	2
2	0	2	0	0	35029	2
2	0	2	0	0	35030	2
2	0	2	0	0	35031	2
2	0	2	0	0	35032	2
2	0	2	0	0	35033	2
2	0	2	0	0	35034	2
2	0	2	0	0	35035	2
2	0	2	0	0	35036	2
2	0	2	0	0	35037	2
2	0	2	0	0	35038	2
2	0	2	0	0	35039	2
2	0	2	0	0	35040	2
2	0	2	0	0	35041	2
2	0	2	0	0	35042	2
2	0	2	0	0	35043	2
2	0	2	0	0	35044	2
2	0	2	0	0	35045	2
2	36	2	0	36	35046	0
2	0	2	1	1	35047	2
2	0	2	0	0	35048	2
2	0	2	0	0	35049	2
2	0	2	0	0	35050	2
2	0	2	0	0	35051	2
2	0	2	0	0	35052	2
2	0	2	0	0	35053	2
2	0	2	0	0	35054	2
2	0	2	0	0	35055	2
2	0	2	0	0	35056	2
2	0	2	0	0	35057	2
2	0	2	0	0	35058	2
2	0	2	0	0	35059	2
2	0	2	0	0	35060	2
2	0	2	0	0	35061	2
2	0	2	0	0	35062	2
2	0	2	0	0	35063	2
2	0	2	0	0	35064	2
2	0	2	0	0	35065	2
2	0	2	0	0	35066	2
2	0	2	0	0	35067	2
2	0	2	0	0	35068	2
2	0	2	0	0	35069	2
2	0	2	0	0	35070	2
2	0	2	0	0	35071	2
2	0	2	0	0	35072	2
2	0	2	0	0	35073	2
2	0	2	0	0	35074	2
2	0	2	0	0	35075	2
2	0	2	0	0	35076	2
2	0	2	0	0	35077	2
2	0	2	1	1	35078	2
2	9	2	0	9	35079	0
2	0	2	0	0	35080	2
2	0	2	0	0	35081	2
2	0	2	0	0	35082	2
2	0	2	0	0	35083	2
2	0	2	0	0	35084	2
2	0	2	3	3	35085	2
2	0	2	0	0	35086	2
2	0	2	0	0	35087	2
2	71	2	1	72	35088	0
2	56	2	395	451	35089	1
2	0	2	23	23	35090	2
2	0	2	4	4	35091	2
2	10	2	3	13	35092	1
2	0	2	51	51	35093	2
2	0	2	0	0	35094	2
2	0	2	0	0	35095	2
2	0	2	0	0	35096	2
2	0	2	0	0	35097	2
2	0	2	0	0	35098	2
2	0	2	0	0	35099	2
2	0	2	0	0	35100	2
2	56	2	1	57	35101	0
2	6	2	181	187	35102	1
2	0	2	0	0	35103	2
2	0	2	0	0	35104	2
2	27	2	0	27	35105	1
2	0	2	98	98	35106	2
2	0	2	1	1	35107	2
2	0	2	0	0	35108	2
2	0	2	0	0	35109	2
2	0	2	0	0	35110	2
2	0	2	0	0	35111	2
2	0	2	0	0	35112	2
2	0	2	0	0	35113	2
2	0	2	0	0	35114	2
2	0	2	0	0	35115	2
2	0	2	0	0	35116	2
2	0	2	0	0	35117	2
2	0	2	0	0	35118	2
2	0	2	0	0	35119	2
2	0	2	0	0	35120	2
2	0	2	0	0	35121	2
2	0	2	0	0	35122	2
2	0	2	0	0	35123	2
2	135	2	3	138	35124	0
2	2	2	0	2	35125	0
2	0	2	39	39	35126	2
2	0	2	0	0	35127	2
2	0	2	0	0	35128	2
2	0	2	0	0	35129	2
2	0	2	7	7	35130	2
2	0	2	0	0	35131	2
2	0	2	0	0	35132	2
2	0	2	0	0	35133	2
2	0	2	0	0	35134	2
2	0	2	0	0	35135	2
2	0	2	0	0	35136	2
2	91	2	2839	2930	35137	1
2	1	2	53	54	35138	1
2	0	2	2	2	35139	2
2	215	2	58	273	35140	1
2	0	2	493	493	35141	2
2	20	2	0	20	35142	0
2	35	2	423	458	35143	1
2	0	2	9	9	35144	2
2	0	2	0	0	35145	2
2	10	2	1	11	35146	0
2	0	2	36	36	35147	2
2	0	2	0	0	35148	2
2	0	2	2	2	35149	2
2	0	2	0	0	35150	2
2	0	2	0	0	35151	2
2	0	2	0	0	35152	2
2	0	2	0	0	35153	2
2	37	2	1	38	35154	0
2	21	2	197	218	35155	1
2	0	2	6	6	35156	2
2	0	2	0	0	35157	2
2	15	2	0	15	35158	1
2	0	2	56	56	35159	2
0	431	2	8	439	35160	0
0	881	2	39	920	35161	0
0	158	2	0	158	35162	0
2	50	2	0	50	35163	0
2	6	2	1672	1678	35164	1
2	0	2	5	5	35165	2
2	0	2	0	0	35166	2
2	0	4	1	1	35167	2
2	3	2	1	4	35168	0
2	0	2	42	42	35169	2
2	84	2	0	84	35170	0
2	38	2	876	914	35171	1
2	0	2	19	19	35172	2
2	0	2	0	0	35173	2
2	36	2	4	40	35174	0
2	0	2	204	204	35175	2
2	62	2	1	63	35176	0
2	84	4	2110	2194	35177	0
2	0	2	22	22	35178	2
2	0	2	0	0	35179	2
2	90	4	29	119	35180	1
2	0	2	445	445	35181	2
2	0	2	0	0	35182	2
2	0	2	0	0	35183	2
2	0	2	0	0	35184	2
2	0	2	0	0	35185	2
2	2	2	5	7	35186	1
2	0	2	0	0	35187	2
2	0	2	0	0	35188	2
2	0	2	0	0	35189	2
2	0	2	0	0	35190	2
2	0	2	0	0	35191	2
2	0	2	0	0	35192	2
2	0	2	0	0	35193	2
2	0	2	0	0	35194	2
2	0	2	0	0	35195	2
2	0	2	0	0	35196	2
2	13	2	1	14	35197	0
2	34	2	170	204	35198	1
2	0	2	1	1	35199	2
2	0	2	0	0	35200	2
2	25	2	0	25	35201	0
2	0	2	25	25	35202	2
2	0	2	0	0	35203	2
2	0	2	0	0	35204	2
2	0	2	0	0	35205	2
2	0	2	0	0	35206	2
2	0	2	0	0	35207	2
2	0	2	0	0	35208	2
2	0	2	0	0	35209	2
2	0	2	0	0	35210	2
2	0	2	0	0	35211	2
2	0	2	0	0	35212	2
2	0	2	0	0	35213	2
2	0	2	0	0	35214	2
2	0	2	0	0	35215	2
2	0	2	0	0	35216	2
2	0	2	0	0	35217	2
2	0	2	0	0	35218	2
2	0	2	0	0	35219	2
2	0	2	0	0	35220	2
2	0	2	0	0	35221	2
2	0	2	0	0	35222	2
2	0	2	0	0	35223	2
2	0	2	0	0	35224	2
2	0	2	0	0	35225	2
2	0	2	0	0	35226	2
2	0	2	0	0	35227	2
2	0	2	0	0	35228	2
2	1	2	0	1	35229	0
2	0	2	1	1	35230	2
2	0	2	0	0	35231	2
2	0	2	0	0	35232	2
2	0	2	0	0	35233	2
2	0	2	0	0	35234	2
2	0	2	0	0	35235	2
2	0	2	1	1	35236	2
2	0	2	0	0	35237	2
2	0	2	0	0	35238	2
2	0	2	0	0	35239	2
2	0	2	0	0	35240	2
2	0	2	0	0	35241	2
2	0	2	0	0	35242	2
2	0	2	0	0	35243	2
2	0	2	0	0	35244	2
2	0	2	0	0	35245	2
2	0	2	0	0	35246	2
2	0	2	1	1	35247	2
2	0	2	0	0	35248	2
2	0	2	0	0	35249	2
2	1	2	0	1	35250	1
2	0	2	1	1	35251	2
2	0	2	0	0	35252	2
2	3	2	7	10	35253	1
2	0	2	1	1	35254	2
2	0	2	0	0	35255	2
2	3	2	0	3	35256	1
2	0	2	235	235	35257	2
2	0	2	0	0	35258	2
2	0	2	4	4	35259	2
2	0	2	0	0	35260	2
2	0	2	0	0	35261	2
2	0	2	0	0	35262	2
2	0	2	0	0	35263	2
2	8	2	0	8	35264	0
2	0	2	0	0	35265	2
2	0	2	0	0	35266	2
2	1	2	0	1	35267	0
2	0	2	7	7	35268	2
2	0	2	0	0	35269	2
2	0	2	0	0	35270	2
2	0	2	0	0	35271	2
2	0	2	4	4	35272	2
2	0	2	0	0	35273	2
2	0	2	0	0	35274	2
2	0	2	0	0	35275	2
2	0	2	0	0	35276	2
2	0	2	2	2	35277	2
2	0	2	0	0	35278	2
2	0	2	0	0	35279	2
2	0	2	0	0	35280	2
2	0	2	0	0	35281	2
2	0	2	0	0	35282	2
2	0	2	0	0	35283	2
2	0	2	0	0	35284	2
2	0	2	0	0	35285	2
2	0	2	242	242	35286	2
2	0	2	0	0	35287	2
2	2	2	0	2	35288	0
2	0	2	1	1	35289	2
2	0	2	0	0	35290	2
2	7	2	0	7	35291	0
2	0	2	0	0	35292	2
2	1	2	0	1	35293	0
2	0	2	3	3	35294	2
2	0	2	0	0	35295	2
2	0	2	0	0	35296	2
2	1	2	0	1	35297	0
2	0	2	2	2	35298	2
2	0	2	0	0	35299	2
2	1	2	16	17	35300	1
2	0	2	1	1	35301	2
2	0	2	0	0	35302	2
2	1	2	0	1	35303	0
2	0	2	1	1	35304	2
2	4	2	97	101	35305	0
2	0	2	0	0	35306	2
2	0	2	0	0	35307	2
2	0	2	0	0	35308	2
2	0	2	0	0	35309	2
2	0	2	0	0	35310	2
2	0	2	0	0	35311	2
2	0	2	0	0	35312	2
2	0	2	0	0	35313	2
2	0	2	0	0	35314	2
2	0	2	0	0	35315	2
2	0	2	0	0	35316	2
2	0	2	0	0	35317	2
2	0	2	0	0	35318	2
2	0	2	0	0	35319	2
2	0	2	0	0	35320	2
2	0	2	0	0	35321	2
2	0	2	0	0	35322	2
2	0	2	0	0	35323	2
2	1	2	0	1	35324	0
2	0	2	2	2	35325	2
2	0	2	0	0	35326	2
2	0	2	0	0	35327	2
2	1	2	0	1	35328	0
2	0	2	0	0	35329	2
2	0	2	0	0	35330	2
2	0	2	0	0	35331	2
2	0	2	0	0	35332	2
2	0	2	0	0	35333	2
2	0	2	0	0	35334	2
2	0	2	0	0	35335	2
2	0	2	0	0	35336	2
4	11	2	0	11	35337	0
2	0	0	1999	1999	35338	2
2	0	2	0	0	35339	2
2	0	2	0	0	35340	2
2	0	0	480	480	35341	2
2	0	2	4	4	35342	2
2	0	2	0	0	35343	2
2	0	2	0	0	35344	2
2	0	2	0	0	35345	2
2	0	2	0	0	35346	2
2	0	2	0	0	35347	2
2	0	2	0	0	35348	2
2	0	2	0	0	35349	2
2	0	2	0	0	35350	2
2	0	2	0	0	35351	2
2	0	2	0	0	35352	2
2	0	2	0	0	35353	2
2	0	2	0	0	35354	2
2	0	2	0	0	35355	2
2	0	2	0	0	35356	2
2	0	2	0	0	35357	2
2	0	2	0	0	35358	2
2	0	2	0	0	35359	2
2	0	2	0	0	35360	2
2	0	2	0	0	35361	2
2	0	2	0	0	35362	2
2	0	2	0	0	35363	2
4	14895	2	1955	16850	35364	0
4	1601	2	48	1649	35365	0
0	0	2	13	13	35366	2
0	0	2	0	0	35367	2
4	11	4	37	48	35368	0
2	10	2	0	10	35369	0
2	11	2	292	303	35370	1
2	1	2	2	3	35371	1
2	0	2	0	0	35372	2
2	4	2	9	13	35373	0
2	0	2	26	26	35374	2
2	0	2	0	0	35375	2
2	0	2	0	0	35376	2
2	0	2	0	0	35377	2
2	0	2	0	0	35378	2
2	0	2	1	1	35379	2
2	0	2	0	0	35380	2
2	0	2	0	0	35381	2
2	0	4	212	212	35382	2
2	0	2	0	0	35383	2
2	0	2	0	0	35384	2
2	0	4	239	239	35385	2
2	0	2	0	0	35386	2
2	680	2	0	680	35387	0
2	22	2	936	958	35388	1
2	0	2	32	32	35389	2
2	0	2	1	1	35390	2
0	0	2	261	261	35391	2
0	0	2	0	0	35392	2
2	74	2	1	75	35393	1
2	0	2	571	571	35394	2
2	1	2	0	1	35395	0
2	0	2	5	5	35396	2
2	0	2	0	0	35397	2
2	0	2	0	0	35398	2
2	0	2	0	0	35399	2
2	0	2	0	0	35400	2
2	3	2	0	3	35401	0
2	0	4	1029	1029	35402	2
2	0	2	2	2	35403	2
2	0	2	0	0	35404	2
2	1	4	687	688	35405	1
2	0	2	4	4	35406	2
2	1	2	0	1	35407	0
2	0	2	32	32	35408	2
2	0	2	0	0	35409	2
2	0	2	0	0	35410	2
2	2	2	0	2	35411	1
2	0	2	9	9	35412	2
2	0	2	0	0	35413	2
2	0	2	0	0	35414	2
2	0	2	0	0	35415	2
2	0	2	0	0	35416	2
2	0	2	0	0	35417	2
2	0	2	0	0	35418	2
2	0	2	0	0	35419	2
2	0	2	0	0	35420	2
2	0	4	0	0	35421	2
2	0	2	0	0	35422	2
2	0	4	2	2	35423	2
2	0	2	0	0	35424	2
2	0	2	0	0	35425	2
2	0	2	0	0	35426	2
2	0	2	0	0	35427	2
2	0	2	0	0	35428	2
2	0	2	0	0	35429	2
2	0	2	0	0	35430	2
2	0	2	0	0	35431	2
2	0	4	107	107	35432	2
2	0	2	0	0	35433	2
2	0	2	0	0	35434	2
2	0	4	282	282	35435	2
2	0	2	2	2	35436	2
2	0	2	0	0	35437	2
2	0	2	0	0	35438	2
2	0	2	0	0	35439	2
2	0	2	0	0	35440	2
2	0	2	0	0	35441	2
2	0	2	0	0	35442	2
2	0	2	0	0	35443	2
2	0	2	0	0	35444	2
2	0	2	0	0	35445	2
2	0	2	0	0	35446	2
2	0	2	0	0	35447	2
2	0	2	0	0	35448	2
2	0	2	0	0	35449	2
2	1	2	1	2	35450	1
2	0	2	0	0	35451	2
2	0	2	0	0	35452	2
0	1	2	0	1	35453	0
0	1	2	0	1	35454	0
2	0	2	0	0	35455	2
2	0	2	0	0	35456	2
4	19	2	0	19	35457	0
2	0	2	0	0	35458	2
2	0	4	48	48	35459	2
2	0	2	0	0	35460	2
2	0	2	0	0	35461	2
2	0	4	12	12	35462	2
2	5	2	0	5	35463	0
4	1	2	0	1	35464	1
2	0	2	0	0	35465	2
2	0	2	0	0	35466	2
2	0	2	0	0	35467	2
2	0	2	0	0	35468	2
2	0	2	0	0	35469	2
2	0	2	0	0	35470	2
2	0	2	0	0	35471	2
2	0	4	55	55	35472	2
2	0	2	0	0	35473	2
2	0	2	0	0	35474	2
2	0	2	0	0	35475	2
2	0	2	0	0	35476	2
2	0	2	0	0	35477	2
2	0	2	0	0	35478	2
2	0	2	0	0	35479	2
2	0	2	0	0	35480	2
2	43	2	0	43	35481	0
2	0	2	0	0	35482	2
2	20	4	710	730	35483	1
2	0	2	4	4	35484	2
2	0	2	1	1	35485	2
2	33	4	186	219	35486	0
2	0	2	76	76	35487	2
2	0	2	0	0	35488	2
2	0	2	0	0	35489	2
2	0	2	5	5	35490	2
2	4	4	19	23	35491	1
2	0	2	0	0	35492	2
2	0	2	0	0	35493	2
2	0	2	0	0	35494	2
2	0	2	4	4	35495	2
2	1	2	0	1	35496	0
2	0	2	25	25	35497	2
2	0	2	0	0	35498	2
2	0	2	0	0	35499	2
2	0	2	0	0	35500	2
2	2	2	8	10	35501	1
2	0	2	0	0	35502	2
2	0	2	0	0	35503	2
2	0	2	0	0	35504	2
2	0	2	1	1	35505	2
2	0	0	965	965	35506	2
2	0	2	0	0	35507	2
2	0	2	0	0	35508	2
0	1	2	0	1	35509	0
0	1	2	0	1	35510	0
2	0	0	796	796	35511	2
2	0	2	1	1	35512	2
2	58	2	2	60	35513	0
2	2	4	16630	16632	35514	1
2	0	2	4	4	35515	2
2	0	2	0	0	35516	2
2	17	4	219	236	35517	1
2	0	2	77	77	35518	2
2	0	2	0	0	35519	2
2	0	2	0	0	35520	2
2	0	2	0	0	35521	2
2	0	2	0	0	35522	2
2	0	2	0	0	35523	2
2	0	2	0	0	35524	2
2	1	2	0	1	35525	0
2	6	2	3	9	35526	1
2	0	2	1	1	35527	2
2	0	2	0	0	35528	2
2	1	2	0	1	35529	0
2	0	2	13	13	35530	2
2	0	2	0	0	35531	2
2	0	2	1	1	35532	2
2	0	2	0	0	35533	2
2	0	2	0	0	35534	2
2	0	2	0	0	35535	2
2	0	2	0	0	35536	2
2	0	2	1	1	35537	2
2	0	2	0	0	35538	2
2	0	2	0	0	35539	2
2	0	2	3	3	35540	2
2	0	2	0	0	35541	2
2	0	2	0	0	35542	2
2	0	2	0	0	35543	2
2	0	2	0	0	35544	2
2	0	2	0	0	35545	2
2	0	2	0	0	35546	2
2	0	2	0	0	35547	2
2	0	2	0	0	35548	2
2	0	2	0	0	35549	2
2	0	2	0	0	35550	2
2	0	2	0	0	35551	2
2	0	2	0	0	35552	2
2	0	2	0	0	35553	2
2	0	2	0	0	35554	2
2	0	2	0	0	35555	2
2	0	4	1	1	35556	2
2	0	2	0	0	35557	2
2	0	4	8	8	35558	2
2	0	2	0	0	35559	2
2	0	2	0	0	35560	2
2	0	2	0	0	35561	2
2	0	2	0	0	35562	2
2	0	2	1	1	35563	2
2	0	2	0	0	35564	2
2	1	2	3	4	35565	1
2	0	2	0	0	35566	2
2	0	2	0	0	35567	2
2	0	4	637	637	35568	2
2	0	2	2	2	35569	2
2	0	2	0	0	35570	2
2	1	4	133	134	35571	1
2	0	2	0	0	35572	2
2	0	2	0	0	35573	2
2	0	2	0	0	35574	2
2	0	2	0	0	35575	2
2	0	2	0	0	35576	2
2	0	2	0	0	35577	2
2	0	2	0	0	35578	2
2	0	2	0	0	35579	2
2	0	2	0	0	35580	2
2	0	2	0	0	35581	2
2	0	2	0	0	35582	2
2	0	2	0	0	35583	2
2	0	2	0	0	35584	2
2	1	2	0	1	35585	0
2	0	2	0	0	35586	2
2	0	2	0	0	35587	2
2	0	2	0	0	35588	2
2	0	2	0	0	35589	2
2	0	2	0	0	35590	2
2	0	2	0	0	35591	2
2	0	2	0	0	35592	2
2	0	2	0	0	35593	2
2	0	2	0	0	35594	2
2	0	4	5	5	35595	2
2	0	2	0	0	35596	2
2	0	4	20	20	35597	2
2	0	2	0	0	35598	2
2	0	2	0	0	35599	2
2	0	2	0	0	35600	2
2	0	2	0	0	35601	2
2	0	2	0	0	35602	2
2	0	2	0	0	35603	2
2	0	2	0	0	35604	2
2	0	2	0	0	35605	2
2	0	2	0	0	35606	2
2	0	2	0	0	35607	2
2	0	2	0	0	35608	2
2	0	2	0	0	35609	2
2	0	2	0	0	35610	2
2	0	2	0	0	35611	2
2	0	4	84	84	35612	2
2	0	2	0	0	35613	2
2	0	2	0	0	35614	2
2	0	2	0	0	35615	2
2	0	2	0	0	35616	2
2	0	2	0	0	35617	2
4	0	2	0	0	35618	2
2	0	2	0	0	35619	2
2	0	2	0	0	35620	2
2	0	2	0	0	35621	2
2	0	2	0	0	35622	2
2	0	2	0	0	35623	2
2	0	2	0	0	35624	2
2	0	2	0	0	35625	2
2	0	0	67	67	35626	2
2	0	2	1	1	35627	2
2	0	2	0	0	35628	2
2	0	0	8	8	35629	2
2	0	2	0	0	35630	2
0	0	2	0	0	35631	2
4	0	2	0	0	35632	2
4	2	4	28	30	35633	0
2	1	2	0	1	35634	0
2	1	2	35	36	35635	1
2	0	2	0	0	35636	2
2	0	2	0	0	35637	2
2	0	2	1	1	35638	2
2	0	2	0	0	35639	2
2	0	2	0	0	35640	2
2	0	2	0	0	35641	2
2	0	2	0	0	35642	2
2	1	2	1	2	35643	1
2	0	2	0	0	35644	2
2	0	2	0	0	35645	2
0	0	4	0	0	35646	2
2	0	2	0	0	35647	2
2	0	4	6	6	35648	2
2	0	2	1	1	35649	2
2	0	4	235	235	35650	2
2	0	2	0	0	35651	2
2	0	2	0	0	35652	2
2	0	2	0	0	35653	2
2	0	2	0	0	35654	2
2	0	2	0	0	35655	2
2	0	2	0	0	35656	2
2	0	2	0	0	35657	2
2	0	2	0	0	35658	2
2	0	2	0	0	35659	2
2	0	2	0	0	35660	2
2	0	2	0	0	35661	2
2	0	2	0	0	35662	2
2	0	2	0	0	35663	2
2	0	2	0	0	35664	2
2	0	2	0	0	35665	2
2	0	4	2	2	35666	2
2	0	2	0	0	35667	2
2	0	2	0	0	35668	2
2	0	4	1	1	35669	2
2	0	2	0	0	35670	2
2	0	2	0	0	35671	2
2	0	2	0	0	35672	2
2	0	2	0	0	35673	2
2	0	2	0	0	35674	2
2	0	2	0	0	35675	2
2	0	2	0	0	35676	2
2	0	2	0	0	35677	2
2	0	2	0	0	35678	2
2	0	2	0	0	35679	2
2	0	2	0	0	35680	2
2	0	2	0	0	35681	2
2	0	2	0	0	35682	2
2	0	2	0	0	35683	2
2	0	2	0	0	35684	2
2	0	2	0	0	35685	2
2	0	2	3	3	35686	2
2	0	2	0	0	35687	2
2	0	2	0	0	35688	2
2	0	2	0	0	35689	2
2	0	2	0	0	35690	2
2	0	2	0	0	35691	2
2	0	2	0	0	35692	2
2	0	2	0	0	35693	2
2	0	2	0	0	35694	2
2	0	2	0	0	35695	2
2	0	0	26	26	35696	2
2	0	2	0	0	35697	2
2	0	2	0	0	35698	2
2	0	0	10	10	35699	2
2	0	2	0	0	35700	2
2	0	2	0	0	35701	2
2	0	2	0	0	35702	2
2	0	2	0	0	35703	2
2	0	2	0	0	35704	2
2	0	2	0	0	35705	2
2	0	2	0	0	35706	2
2	0	2	0	0	35707	2
2	1	2	0	1	35708	1
2	0	2	0	0	35709	2
2	0	2	0	0	35710	2
2	0	2	0	0	35711	2
2	0	2	1	1	35712	2
2	0	2	0	0	35713	2
2	0	2	0	0	35714	2
2	0	2	0	0	35715	2
2	0	2	0	0	35716	2
2	0	2	0	0	35717	2
2	0	2	0	0	35718	2
2	0	2	0	0	35719	2
2	0	2	0	0	35720	2
2	0	2	0	0	35721	2
2	0	2	0	0	35722	2
2	0	2	0	0	35723	2
2	0	2	0	0	35724	2
2	0	2	0	0	35725	2
2	0	4	1	1	35726	2
2	0	2	0	0	35727	2
2	0	2	0	0	35728	2
2	0	4	14	14	35729	2
2	0	2	0	0	35730	2
2	5	2	0	5	35731	0
2	9	2	265	274	35732	1
2	0	2	3	3	35733	2
2	0	2	0	0	35734	2
2	9	2	3	12	35735	0
2	0	2	114	114	35736	2
0	0	4	0	0	35737	2
2	0	2	0	0	35738	2
2	0	2	0	0	35739	2
2	0	2	0	0	35740	2
2	0	2	0	0	35741	2
2	0	2	0	0	35742	2
2	0	2	0	0	35743	2
2	0	2	0	0	35744	2
2	0	2	0	0	35745	2
2	0	2	3	3	35746	2
2	0	2	0	0	35747	2
2	0	2	0	0	35748	2
2	0	2	0	0	35749	2
2	0	2	0	0	35750	2
2	0	2	0	0	35751	2
2	0	4	58	58	35752	2
2	0	2	0	0	35753	2
2	0	2	0	0	35754	2
2	0	4	12	12	35755	2
2	0	2	0	0	35756	2
2	0	2	13	13	35757	2
2	0	2	0	0	35758	2
2	0	2	0	0	35759	2
2	0	2	0	0	35760	2
2	0	2	11	11	35761	2
2	0	2	0	0	35762	2
2	0	2	0	0	35763	2
2	0	4	2	2	35764	2
2	0	2	0	0	35765	2
2	0	2	0	0	35766	2
2	0	4	0	0	35767	2
2	0	2	0	0	35768	2
2	0	2	0	0	35769	2
2	0	2	0	0	35770	2
2	0	2	0	0	35771	2
2	0	2	0	0	35772	2
2	0	2	0	0	35773	2
2	0	2	0	0	35774	2
2	0	2	0	0	35775	2
4	25	2	2	27	35776	0
2	0	2	0	0	35777	2
2	0	2	0	0	35778	2
2	0	2	0	0	35779	2
2	0	2	0	0	35780	2
2	0	2	0	0	35781	2
2	0	2	0	0	35782	2
2	0	2	0	0	35783	2
2	0	2	0	0	35784	2
2	0	2	0	0	35785	2
2	0	2	0	0	35786	2
2	0	2	0	0	35787	2
2	0	2	0	0	35788	2
2	0	2	0	0	35789	2
2	0	2	0	0	35790	2
2	0	2	0	0	35791	2
2	0	2	0	0	35792	2
2	0	2	0	0	35793	2
2	2	2	0	2	35794	0
2	0	2	0	0	35795	2
2	0	2	0	0	35796	2
2	0	2	11	11	35797	2
2	0	2	0	0	35798	2
2	0	2	0	0	35799	2
2	0	2	0	0	35800	2
2	0	2	3	3	35801	2
2	2	0	2818	2820	35802	0
2	0	2	0	0	35803	2
2	0	2	0	0	35804	2
2	1	0	555	556	35805	1
2	0	4	170	170	35806	2
0	0	2	0	0	35807	2
0	0	2	0	0	35808	2
2	0	4	2	2	35809	2
2	0	2	0	0	35810	2
2	0	2	0	0	35811	2
2	0	2	0	0	35812	2
2	0	2	0	0	35813	2
2	0	2	0	0	35814	2
2	0	2	0	0	35815	2
2	0	2	0	0	35816	2
2	0	2	0	0	35817	2
2	0	2	0	0	35818	2
2	0	2	0	0	35819	2
2	0	2	0	0	35820	2
2	0	2	0	0	35821	2
2	0	2	0	0	35822	2
2	0	2	0	0	35823	2
2	0	2	0	0	35824	2
2	0	2	0	0	35825	2
2	0	2	0	0	35826	2
2	0	2	0	0	35827	2
2	0	2	0	0	35828	2
2	1	4	1	2	35829	1
2	0	4	276	276	35830	2
0	22	4	22	44	35831	0
2	1	2	0	1	35832	0
2	0	2	8	8	35833	2
2	0	2	0	0	35834	2
2	0	2	0	0	35835	2
2	0	2	0	0	35836	2
2	0	2	0	0	35837	2
2	0	2	0	0	35838	2
2	0	2	0	0	35839	2
2	0	2	0	0	35840	2
2	0	2	0	0	35841	2
2	0	2	0	0	35842	2
2	0	2	0	0	35843	2
2	10	2	0	10	35844	0
2	0	2	1	1	35845	2
2	0	2	0	0	35846	2
2	5	2	0	5	35847	0
2	0	2	1	1	35848	2
2	0	2	1	1	35849	2
2	2	2	0	2	35850	0
2	0	2	8	8	35851	2
2	0	2	0	0	35852	2
2	0	2	0	0	35853	2
2	0	2	0	0	35854	2
2	0	0	35	35	35855	2
2	0	2	0	0	35856	2
2	0	2	0	0	35857	2
2	0	0	34	34	35858	2
2	0	2	0	0	35859	2
2	0	2	0	0	35860	2
2	0	2	0	0	35861	2
2	0	2	0	0	35862	2
2	0	2	0	0	35863	2
2	0	2	0	0	35864	2
2	0	2	0	0	35865	2
2	0	2	0	0	35866	2
2	0	2	0	0	35867	2
2	0	2	0	0	35868	2
2	0	2	0	0	35869	2
2	0	2	0	0	35870	2
2	0	2	0	0	35871	2
2	0	2	0	0	35872	2
2	1	2	0	1	35873	1
2	0	2	0	0	35874	2
2	0	2	0	0	35875	2
2	0	2	0	0	35876	2
2	0	2	0	0	35877	2
2	0	4	25	25	35878	2
2	0	2	0	0	35879	2
2	0	2	0	0	35880	2
2	0	4	176	176	35881	2
2	0	2	0	0	35882	2
2	0	2	0	0	35883	2
2	2	2	0	2	35884	0
2	0	2	0	0	35885	2
2	0	2	0	0	35886	2
2	0	2	0	0	35887	2
2	0	2	0	0	35888	2
2	0	2	0	0	35889	2
2	0	2	0	0	35890	2
2	0	2	0	0	35891	2
2	0	4	0	0	35892	2
2	0	2	0	0	35893	2
2	0	2	0	0	35894	2
2	0	4	0	0	35895	2
2	0	2	0	0	35896	2
4	29	2	0	29	35897	0
2	0	2	0	0	35898	2
2	0	2	21	21	35899	2
2	0	2	0	0	35900	2
2	0	2	0	0	35901	2
2	0	2	21	21	35902	2
2	0	2	65	65	35903	2
2	25	2	0	25	35904	0
2	0	2	0	0	35905	2
2	0	2	0	0	35906	2
2	0	2	0	0	35907	2
2	0	2	0	0	35908	2
2	0	2	2	2	35909	2
2	0	2	0	0	35910	2
2	4	2	154	158	35911	1
2	0	2	11	11	35912	2
2	0	2	0	0	35913	2
2	0	2	0	0	35914	2
2	0	2	0	0	35915	2
2	0	2	0	0	35916	2
2	0	2	0	0	35917	2
2	0	2	0	0	35918	2
2	0	2	0	0	35919	2
2	0	2	0	0	35920	2
2	0	2	0	0	35921	2
2	0	2	0	0	35922	2
0	0	4	8	8	35923	2
2	84	2	0	84	35924	0
2	4	4	4501	4505	35925	1
2	0	2	0	0	35926	2
2	0	2	0	0	35927	2
2	42	4	2008	2050	35928	1
2	0	2	228	228	35929	2
2	0	2	0	0	35930	2
2	0	2	0	0	35931	2
2	0	2	0	0	35932	2
2	0	2	0	0	35933	2
2	0	2	0	0	35934	2
2	0	2	0	0	35935	2
2	0	2	0	0	35936	2
2	0	2	0	0	35937	2
2	0	2	0	0	35938	2
2	0	4	20	20	35939	2
2	0	2	0	0	35940	2
2	0	2	0	0	35941	2
2	0	4	8	8	35942	2
2	0	2	0	0	35943	2
2	0	2	2	2	35944	2
2	0	2	0	0	35945	2
2	0	2	0	0	35946	2
2	0	2	2	2	35947	2
2	0	2	1	1	35948	2
2	0	2	0	0	35949	2
2	0	2	0	0	35950	2
2	0	2	0	0	35951	2
2	0	2	0	0	35952	2
2	0	2	0	0	35953	2
2	0	2	0	0	35954	2
2	0	2	0	0	35955	2
2	0	4	5	5	35956	2
2	0	2	0	0	35957	2
2	0	2	0	0	35958	2
2	0	4	1	1	35959	2
2	0	2	0	0	35960	2
2	0	2	0	0	35961	2
2	8	2	17	25	35962	1
2	0	2	1	1	35963	2
2	0	2	0	0	35964	2
2	2	2	1	3	35965	1
2	0	2	3	3	35966	2
2	0	2	0	0	35967	2
2	0	2	2	2	35968	2
2	0	2	0	0	35969	2
2	0	2	0	0	35970	2
2	0	2	0	0	35971	2
2	0	2	0	0	35972	2
2	11	2	0	11	35973	0
2	6	2	440	446	35974	1
2	0	2	0	0	35975	2
2	0	2	0	0	35976	2
2	9	2	1803	1812	35977	0
2	0	2	17	17	35978	2
2	0	2	0	0	35979	2
2	0	2	0	0	35980	2
2	0	2	0	0	35981	2
2	0	2	0	0	35982	2
2	0	2	0	0	35983	2
2	0	2	0	0	35984	2
2	0	4	2239	2239	35985	2
2	0	2	0	0	35986	2
2	0	2	0	0	35987	2
4	0	2	0	0	35988	2
4	4	2	0	4	35989	0
2	0	4	1980	1980	35990	2
2	2	2	3	5	35991	1
4	792	2	2	794	35992	0
4	44	2	2	46	35993	0
4	1	2	0	1	35994	0
2	0	2	0	0	35995	2
2	0	2	0	0	35996	2
2	0	2	0	0	35997	2
2	0	2	0	0	35998	2
2	0	2	0	0	35999	2
2	0	2	0	0	36000	2
2	0	2	0	0	36001	2
2	0	2	0	0	36002	2
2	0	2	0	0	36003	2
2	0	2	0	0	36004	2
2	0	2	0	0	36005	2
2	0	2	0	0	36006	2
2	132	2	0	132	36007	0
2	137	2	571	708	36008	1
2	0	2	10	10	36009	2
2	0	2	3	3	36010	2
2	86	2	4	90	36011	1
2	0	2	548	548	36012	2
2	0	2	0	0	36013	2
2	0	2	0	0	36014	2
2	0	2	0	0	36015	2
2	0	2	0	0	36016	2
2	0	2	0	0	36017	2
2	0	2	0	0	36018	2
2	24	4	2860	2884	36019	0
2	0	2	161	161	36020	2
2	141	2	0	141	36021	0
2	19	4	465	484	36022	1
2	0	2	31	31	36023	2
2	0	2	0	0	36024	2
2	0	2	0	0	36025	2
2	0	2	0	0	36026	2
2	0	2	0	0	36027	2
2	0	2	0	0	36028	2
2	0	2	0	0	36029	2
2	0	2	0	0	36030	2
2	0	2	0	0	36031	2
2	0	2	0	0	36032	2
2	0	2	0	0	36033	2
2	0	2	0	0	36034	2
2	0	2	0	0	36035	2
2	0	2	0	0	36036	2
2	0	2	0	0	36037	2
2	1	2	0	1	36038	0
2	0	2	1	1	36039	2
2	0	2	0	0	36040	2
2	0	2	0	0	36041	2
2	0	2	0	0	36042	2
2	0	2	0	0	36043	2
2	0	2	0	0	36044	2
2	0	4	2	2	36045	2
2	0	2	0	0	36046	2
2	0	4	525	525	36047	2
2	0	2	0	0	36048	2
2	0	2	0	0	36049	2
0	307	4	254	561	36050	0
2	3	4	254	257	36051	0
2	3	2	47	50	36052	1
2	0	2	0	0	36053	2
2	0	2	0	0	36054	2
2	0	2	9	9	36055	2
2	13	2	34	47	36056	0
2	0	2	42	42	36057	2
2	0	2	0	0	36058	2
2	3	2	0	3	36059	0
2	19	4	319	338	36060	1
2	0	2	0	0	36061	2
2	0	2	0	0	36062	2
2	1	4	67	68	36063	1
2	1	2	6	7	36064	1
2	0	4	466	466	36065	2
2	0	2	0	0	36066	2
2	0	2	0	0	36067	2
2	0	4	140	140	36068	2
2	0	2	0	0	36069	2
2	1	2	0	1	36070	0
2	0	2	4	4	36071	2
2	0	2	0	0	36072	2
2	0	2	0	0	36073	2
2	1	2	0	1	36074	1
2	0	2	2	2	36075	2
2	0	2	0	0	36076	2
2	0	2	1	1	36077	2
2	0	2	0	0	36078	2
2	0	2	0	0	36079	2
2	0	2	0	0	36080	2
2	0	2	0	0	36081	2
2	0	2	0	0	36082	2
2	0	2	0	0	36083	2
2	0	2	0	0	36084	2
2	0	2	0	0	36085	2
2	0	2	0	0	36086	2
2	0	2	0	0	36087	2
2	0	2	0	0	36088	2
2	0	2	0	0	36089	2
2	0	2	0	0	36090	2
2	0	2	0	0	36091	2
2	0	2	0	0	36092	2
2	0	2	0	0	36093	2
2	1	2	0	1	36094	0
2	0	2	0	0	36095	2
2	0	4	0	0	36096	2
2	0	2	0	0	36097	2
2	0	2	0	0	36098	2
2	0	4	0	0	36099	2
2	0	2	0	0	36100	2
2	26	2	0	26	36101	0
2	48	4	418	466	36102	1
2	0	2	1	1	36103	2
2	0	2	0	0	36104	2
2	3	4	399	402	36105	0
2	0	2	12	12	36106	2
2	0	4	930	930	36107	2
2	0	2	0	0	36108	2
2	0	2	0	0	36109	2
2	0	0	308	308	36110	2
2	0	2	1	1	36111	2
2	85	2	1	86	36112	0
2	25	0	1527	1552	36113	1
2	1	2	23	24	36114	1
2	0	2	0	0	36115	2
2	72	0	376	448	36116	0
2	0	2	285	285	36117	2
2	0	2	60	60	36118	2
2	0	2	1	1	36119	2
2	0	2	0	0	36120	2
2	1	2	16	17	36121	0
2	0	2	10	10	36122	2
2	0	2	0	0	36123	2
2	0	2	1	1	36124	2
2	0	2	0	0	36125	2
2	0	2	0	0	36126	2
2	0	2	0	0	36127	2
2	0	2	0	0	36128	2
2	0	2	0	0	36129	2
2	0	2	0	0	36130	2
2	0	2	0	0	36131	2
2	0	2	0	0	36132	2
2	0	2	0	0	36133	2
2	0	2	0	0	36134	2
2	0	2	0	0	36135	2
2	0	2	0	0	36136	2
2	0	2	0	0	36137	2
2	0	2	0	0	36138	2
2	0	2	0	0	36139	2
2	0	2	0	0	36140	2
2	0	2	0	0	36141	2
2	0	2	0	0	36142	2
2	0	2	0	0	36143	2
2	0	2	0	0	36144	2
2	0	2	2	2	36145	2
2	0	2	0	0	36146	2
2	0	2	0	0	36147	2
2	0	2	0	0	36148	2
2	0	2	0	0	36149	2
2	0	2	0	0	36150	2
2	0	2	0	0	36151	2
2	0	2	0	0	36152	2
2	0	2	0	0	36153	2
2	0	2	0	0	36154	2
2	0	2	0	0	36155	2
2	0	2	0	0	36156	2
2	0	2	0	0	36157	2
2	0	2	0	0	36158	2
2	0	2	0	0	36159	2
2	0	2	0	0	36160	2
2	0	2	0	0	36161	2
2	0	2	0	0	36162	2
2	0	2	0	0	36163	2
2	0	2	0	0	36164	2
2	0	2	0	0	36165	2
2	0	2	0	0	36166	2
2	0	2	0	0	36167	2
2	0	2	0	0	36168	2
2	0	2	0	0	36169	2
2	0	2	0	0	36170	2
2	0	2	0	0	36171	2
2	0	4	363	363	36172	2
2	0	2	0	0	36173	2
2	0	2	0	0	36174	2
2	0	4	470	470	36175	2
2	1	2	0	1	36176	1
2	0	2	0	0	36177	2
2	0	2	1	1	36178	2
2	0	2	0	0	36179	2
2	1	2	6	7	36180	1
2	0	2	0	0	36181	2
2	0	2	0	0	36182	2
2	0	2	0	0	36183	2
2	0	2	4	4	36184	2
2	2	2	0	2	36185	0
2	0	2	11	11	36186	2
2	0	2	2	2	36187	2
2	0	2	0	0	36188	2
2	0	2	0	0	36189	2
2	0	2	0	0	36190	2
2	0	2	0	0	36191	2
2	0	2	0	0	36192	2
2	0	2	0	0	36193	2
2	0	2	0	0	36194	2
2	0	2	0	0	36195	2
2	0	2	0	0	36196	2
2	0	2	0	0	36197	2
2	0	2	0	0	36198	2
2	0	2	0	0	36199	2
2	0	2	0	0	36200	2
2	0	2	0	0	36201	2
2	0	2	0	0	36202	2
2	0	2	0	0	36203	2
2	0	2	0	0	36204	2
2	0	2	0	0	36205	2
2	0	2	0	0	36206	2
2	0	2	0	0	36207	2
2	0	2	0	0	36208	2
2	0	2	0	0	36209	2
2	0	2	0	0	36210	2
2	0	2	0	0	36211	2
2	0	4	0	0	36212	2
2	0	2	0	0	36213	2
2	0	2	0	0	36214	2
2	0	4	0	0	36215	2
2	0	2	0	0	36216	2
2	3	2	0	3	36217	0
2	0	2	11	11	36218	2
2	0	2	0	0	36219	2
2	0	2	0	0	36220	2
2	0	2	0	0	36221	2
2	0	2	9	9	36222	2
2	1	2	0	1	36223	1
2	0	2	10	10	36224	2
2	0	2	0	0	36225	2
2	0	2	0	0	36226	2
2	0	2	0	0	36227	2
2	0	2	2	2	36228	2
2	0	2	0	0	36229	2
2	0	2	0	0	36230	2
2	0	2	0	0	36231	2
2	0	2	0	0	36232	2
2	0	2	0	0	36233	2
2	0	2	0	0	36234	2
2	0	2	0	0	36235	2
2	0	2	0	0	36236	2
2	0	2	0	0	36237	2
2	0	2	0	0	36238	2
2	0	2	0	0	36239	2
2	0	2	0	0	36240	2
2	0	2	0	0	36241	2
2	0	2	0	0	36242	2
2	0	2	0	0	36243	2
2	0	2	0	0	36244	2
2	0	2	0	0	36245	2
2	0	2	0	0	36246	2
2	1	2	0	1	36247	1
2	0	2	0	0	36248	2
2	0	2	0	0	36249	2
2	0	2	0	0	36250	2
2	0	2	0	0	36251	2
2	0	2	0	0	36252	2
2	0	2	0	0	36253	2
2	0	2	1	1	36254	2
2	0	2	0	0	36255	2
2	0	2	0	0	36256	2
2	0	2	11	11	36257	2
2	0	2	0	0	36258	2
2	0	2	0	0	36259	2
2	0	2	0	0	36260	2
2	0	2	0	0	36261	2
2	0	2	0	0	36262	2
2	0	2	0	0	36263	2
2	0	2	0	0	36264	2
2	0	2	0	0	36265	2
2	0	2	0	0	36266	2
2	0	2	0	0	36267	2
2	0	2	0	0	36268	2
2	0	2	0	0	36269	2
2	0	2	0	0	36270	2
2	0	2	0	0	36271	2
2	0	2	0	0	36272	2
2	0	2	0	0	36273	2
2	0	2	0	0	36274	2
2	0	2	0	0	36275	2
2	0	2	0	0	36276	2
2	0	2	0	0	36277	2
2	0	2	0	0	36278	2
2	0	2	0	0	36279	2
2	0	2	0	0	36280	2
2	0	2	0	0	36281	2
2	0	2	0	0	36282	2
2	0	2	0	0	36283	2
2	0	4	3	3	36284	2
2	0	2	0	0	36285	2
2	0	2	0	0	36286	2
2	0	2	0	0	36287	2
2	0	2	0	0	36288	2
2	0	2	0	0	36289	2
2	0	2	0	0	36290	2
2	0	2	0	0	36291	2
2	0	2	0	0	36292	2
0	0	2	0	0	36293	2
0	0	2	0	0	36294	2
0	0	2	0	0	36295	2
2	0	2	0	0	36296	2
2	0	2	0	0	36297	2
2	0	2	0	0	36298	2
2	0	2	0	0	36299	2
2	0	2	0	0	36300	2
2	0	2	0	0	36301	2
2	0	4	0	0	36302	2
2	0	2	0	0	36303	2
2	0	2	0	0	36304	2
2	0	2	0	0	36305	2
2	0	2	0	0	36306	2
2	0	2	0	0	36307	2
2	0	2	0	0	36308	2
2	0	2	0	0	36309	2
2	8	2	0	8	36310	0
2	0	2	0	0	36311	2
2	0	2	0	0	36312	2
2	3	4	19	22	36313	0
2	3	2	0	3	36314	0
2	0	4	3938	3938	36315	2
2	0	2	0	0	36316	2
2	0	2	0	0	36317	2
2	2	4	1007	1009	36318	0
2	0	2	1	1	36319	2
4	0	2	1	1	36320	2
2	7	2	0	7	36321	0
2	2	2	39	41	36322	1
2	0	2	0	0	36323	2
2	0	2	0	0	36324	2
2	0	2	0	0	36325	2
2	0	2	0	0	36326	2
2	0	2	0	0	36327	2
2	0	2	0	0	36328	2
2	0	2	1	1	36329	2
2	0	2	0	0	36330	2
2	0	2	0	0	36331	2
2	0	2	0	0	36332	2
2	0	2	0	0	36333	2
2	0	2	0	0	36334	2
2	0	2	0	0	36335	2
4	0	2	0	0	36336	2
4	0	2	0	0	36337	2
2	0	2	0	0	36338	2
2	0	2	0	0	36339	2
2	0	2	0	0	36340	2
2	0	2	0	0	36341	2
2	0	2	0	0	36342	2
2	0	2	0	0	36343	2
2	0	2	0	0	36344	2
2	0	2	0	0	36345	2
2	0	2	0	0	36346	2
2	0	2	0	0	36347	2
2	0	2	0	0	36348	2
2	0	2	0	0	36349	2
2	0	2	0	0	36350	2
2	0	2	0	0	36351	2
2	0	2	0	0	36352	2
2	0	2	0	0	36353	2
4	0	2	0	0	36354	2
0	1	4	1910	1911	36355	1
6	0	6	0	0	36356	2
0	0	4	8	8	36357	2
2	0	2	0	0	36358	2
2	1	2	24	25	36359	1
2	0	2	0	0	36360	2
2	0	2	0	0	36361	2
2	1	2	0	1	36362	0
2	0	2	4	4	36363	2
4	0	0	0	0	36364	2
4	0	0	0	0	36365	2
2	0	2	0	0	36366	2
2	0	2	0	0	36367	2
2	0	2	0	0	36368	2
2	0	2	0	0	36369	2
2	0	2	0	0	36370	2
2	0	2	0	0	36371	2
2	0	2	0	0	36372	2
2	0	2	0	0	36373	2
2	0	2	0	0	36374	2
2	0	2	0	0	36375	2
2	0	2	0	0	36376	2
2	0	2	0	0	36377	2
2	0	2	0	0	36378	2
2	0	4	0	0	36379	2
2	0	2	0	0	36380	2
2	0	2	0	0	36381	2
2	0	2	0	0	36382	2
2	0	2	0	0	36383	2
2	0	2	0	0	36384	2
2	0	2	0	0	36385	2
2	0	2	0	0	36386	2
2	0	2	0	0	36387	2
2	0	2	0	0	36388	2
2	0	2	0	0	36389	2
2	0	2	0	0	36390	2
2	0	2	0	0	36391	2
2	0	2	0	0	36392	2
2	0	2	0	0	36393	2
2	0	2	0	0	36394	2
2	0	2	0	0	36395	2
2	0	2	0	0	36396	2
2	0	2	0	0	36397	2
2	0	2	0	0	36398	2
2	0	2	2	2	36399	2
2	0	2	0	0	36400	2
2	0	2	0	0	36401	2
4	19	2	28	47	36402	0
2	0	2	0	0	36403	2
2	0	4	0	0	36404	2
2	0	2	0	0	36405	2
2	0	4	0	0	36406	2
2	0	2	0	0	36407	2
2	0	2	0	0	36408	2
2	0	2	0	0	36409	2
2	0	4	4	4	36410	2
2	0	2	0	0	36411	2
2	0	2	0	0	36412	2
2	0	4	10	10	36413	2
2	0	2	0	0	36414	2
2	0	2	0	0	36415	2
2	0	2	0	0	36416	2
2	0	2	0	0	36417	2
2	0	2	0	0	36418	2
2	0	2	0	0	36419	2
2	0	2	0	0	36420	2
2	0	2	1	1	36421	2
2	0	2	0	0	36422	2
2	0	2	0	0	36423	2
2	0	2	0	0	36424	2
2	0	2	0	0	36425	2
2	0	2	0	0	36426	2
2	0	2	0	0	36427	2
2	0	0	20	20	36428	2
2	0	2	3	3	36429	2
2	0	2	0	0	36430	2
2	1	0	26	27	36431	1
2	0	2	3	3	36432	2
2	0	2	0	0	36433	2
2	0	2	1	1	36434	2
2	0	2	0	0	36435	2
2	0	2	0	0	36436	2
2	0	2	11	11	36437	2
2	0	2	0	0	36438	2
2	248	2	0	248	36439	0
2	8	2	762	770	36440	1
2	0	2	28	28	36441	2
2	0	2	0	0	36442	2
2	27	2	0	27	36443	0
2	0	2	407	407	36444	2
2	5	2	0	5	36445	0
2	1	2	361	362	36446	1
2	0	2	0	0	36447	2
2	0	2	0	0	36448	2
2	6	2	0	6	36449	0
2	0	2	56	56	36450	2
2	0	2	0	0	36451	2
2	1	2	0	1	36452	1
2	0	2	0	0	36453	2
2	0	2	0	0	36454	2
2	0	2	0	0	36455	2
2	0	2	0	0	36456	2
2	0	2	0	0	36457	2
2	5	2	178	183	36458	0
2	0	2	0	0	36459	2
2	0	2	0	0	36460	2
2	0	2	0	0	36461	2
2	0	2	0	0	36462	2
2	0	2	0	0	36463	2
2	0	2	0	0	36464	2
2	5	2	0	5	36465	0
2	0	2	32	32	36466	2
2	0	2	0	0	36467	2
2	0	2	0	0	36468	2
2	0	2	0	0	36469	2
2	0	2	0	0	36470	2
2	0	2	0	0	36471	2
2	0	2	0	0	36472	2
2	0	2	0	0	36473	2
2	0	2	0	0	36474	2
2	0	2	0	0	36475	2
2	0	2	0	0	36476	2
2	0	2	0	0	36477	2
2	0	2	0	0	36478	2
2	0	4	10	10	36479	2
2	0	2	0	0	36480	2
2	0	2	0	0	36481	2
2	0	4	9	9	36482	2
2	0	2	5	5	36483	2
4	6	2	4	10	36484	0
2	0	2	0	0	36485	2
2	0	4	9	9	36486	2
2	0	2	0	0	36487	2
2	0	2	0	0	36488	2
2	0	4	0	0	36489	2
2	0	2	0	0	36490	2
2	0	2	0	0	36491	2
2	2	2	2	4	36492	1
2	0	2	0	0	36493	2
2	0	2	0	0	36494	2
2	1	2	0	1	36495	1
2	0	2	0	0	36496	2
2	0	2	0	0	36497	2
2	0	2	0	0	36498	2
2	0	2	0	0	36499	2
2	0	2	0	0	36500	2
2	0	2	0	0	36501	2
2	0	2	0	0	36502	2
2	0	2	0	0	36503	2
2	0	2	0	0	36504	2
2	0	2	0	0	36505	2
2	0	2	0	0	36506	2
2	0	2	0	0	36507	2
2	0	2	0	0	36508	2
2	0	2	0	0	36509	2
2	0	2	0	0	36510	2
2	0	2	0	0	36511	2
0	0	4	0	0	36512	2
2	0	2	0	0	36513	2
2	0	2	0	0	36514	2
2	0	2	0	0	36515	2
2	0	2	0	0	36516	2
2	0	2	1	1	36517	2
2	0	2	0	0	36518	2
2	0	2	0	0	36519	2
2	0	4	146	146	36520	2
2	0	2	0	0	36521	2
2	0	2	0	0	36522	2
2	9	4	15294	15303	36523	0
2	0	2	37	37	36524	2
4	0	2	0	0	36525	2
2	0	2	0	0	36526	2
2	0	2	0	0	36527	2
2	0	2	0	0	36528	2
2	0	2	0	0	36529	2
2	0	2	0	0	36530	2
2	0	2	0	0	36531	2
2	0	2	0	0	36532	2
2	0	2	0	0	36533	2
2	0	2	0	0	36534	2
2	0	2	0	0	36535	2
2	0	2	0	0	36536	2
2	0	2	0	0	36537	2
2	0	2	0	0	36538	2
2	0	2	0	0	36539	2
2	0	2	0	0	36540	2
2	0	2	0	0	36541	2
2	0	2	0	0	36542	2
2	0	2	0	0	36543	2
2	1	4	31	32	36544	0
2	0	2	9	9	36545	2
2	6	2	0	6	36546	0
2	9	4	129	138	36547	1
2	0	2	2	2	36548	2
2	0	2	0	0	36549	2
2	6	2	0	6	36550	0
2	8	2	18	26	36551	1
2	0	2	3	3	36552	2
2	0	2	0	0	36553	2
2	5	2	0	5	36554	0
2	0	2	24	24	36555	2
2	233	2	0	233	36556	0
2	11	2	0	11	36557	0
2	0	4	93	93	36558	2
2	0	2	0	0	36559	2
2	0	2	0	0	36560	2
2	0	2	0	0	36561	2
2	0	2	0	0	36562	2
2	0	2	0	0	36563	2
2	0	2	242	242	36564	2
2	0	2	0	0	36565	2
2	0	2	0	0	36566	2
2	0	2	0	0	36567	2
2	0	2	2	2	36568	2
2	0	2	0	0	36569	2
2	0	2	0	0	36570	2
2	0	2	0	0	36571	2
2	0	2	0	0	36572	2
2	0	2	0	0	36573	2
2	0	2	0	0	36574	2
2	0	2	1	1	36575	2
2	0	2	0	0	36576	2
2	0	2	0	0	36577	2
2	0	2	0	0	36578	2
2	0	2	0	0	36579	2
2	0	2	0	0	36580	2
2	0	2	0	0	36581	2
2	0	4	389	389	36582	2
2	0	2	0	0	36583	2
2	0	4	103	103	36584	2
2	0	2	0	0	36585	2
2	0	2	0	0	36586	2
4	418	2	0	418	36587	0
2	60	2	0	60	36588	0
2	25	2	508	533	36589	1
2	0	2	39	39	36590	2
2	0	2	0	0	36591	2
0	1	2	12	13	36592	0
0	1	2	0	1	36593	0
2	68	2	9	77	36594	1
2	0	2	245	245	36595	2
2	463	4	47268	47731	36596	1
2	0	2	16	16	36597	2
2	0	2	2	2	36598	2
2	110	4	9182	9292	36599	0
2	1	2	358	359	36600	0
4	0	2	109	109	36601	2
2	0	2	0	0	36602	2
2	0	2	0	0	36603	2
2	0	2	0	0	36604	2
2	0	2	8	8	36605	2
2	0	2	0	0	36606	2
2	0	2	0	0	36607	2
2	0	2	0	0	36608	2
2	0	2	3	3	36609	2
2	0	2	0	0	36610	2
2	0	2	0	0	36611	2
0	0	2	0	0	36612	2
0	0	2	0	0	36613	2
2	0	2	0	0	36614	2
2	0	2	0	0	36615	2
2	0	2	0	0	36616	2
2	0	2	0	0	36617	2
2	0	2	0	0	36618	2
2	0	2	0	0	36619	2
2	0	2	0	0	36620	2
2	0	2	0	0	36621	2
2	0	2	0	0	36622	2
2	0	2	0	0	36623	2
2	0	2	0	0	36624	2
2	0	2	0	0	36625	2
2	0	2	0	0	36626	2
2	0	2	0	0	36627	2
2	0	2	0	0	36628	2
2	0	2	0	0	36629	2
2	0	2	0	0	36630	2
2	0	4	24	24	36631	2
2	0	2	0	0	36632	2
2	0	2	0	0	36633	2
2	0	4	2	2	36634	2
2	0	2	0	0	36635	2
2	0	2	0	0	36636	2
2	0	4	4	4	36637	2
2	0	2	0	0	36638	2
2	0	2	0	0	36639	2
2	7	2	1	8	36640	1
2	0	2	0	0	36641	2
2	0	2	0	0	36642	2
2	3	2	0	3	36643	0
2	0	2	0	0	36644	2
0	12	6	16728	16740	36645	1
2	48	2	0	48	36646	0
2	71	3	16820	16891	36647	1
2	0	2	3	3	36648	2
2	0	2	0	0	36649	2
2	0	2	0	0	36650	2
2	0	2	0	0	36651	2
2	0	2	0	0	36652	2
2	0	2	0	0	36653	2
2	0	2	0	0	36654	2
2	0	2	0	0	36655	2
2	0	2	0	0	36656	2
2	0	2	0	0	36657	2
2	0	2	0	0	36658	2
2	0	2	0	0	36659	2
2	0	2	0	0	36660	2
2	0	2	0	0	36661	2
2	0	2	0	0	36662	2
2	0	2	0	0	36663	2
2	0	2	7	7	36664	2
2	0	2	0	0	36665	2
2	0	2	0	0	36666	2
2	0	2	0	0	36667	2
2	0	2	0	0	36668	2
2	0	2	0	0	36669	2
2	0	2	0	0	36670	2
2	0	2	0	0	36671	2
2	0	2	0	0	36672	2
2	0	2	0	0	36673	2
2	0	2	0	0	36674	2
2	0	2	0	0	36675	2
2	0	2	0	0	36676	2
2	0	2	0	0	36677	2
2	0	2	0	0	36678	2
2	0	2	0	0	36679	2
2	0	2	0	0	36680	2
2	0	2	1	1	36681	2
2	0	2	0	0	36682	2
2	0	2	1	1	36683	2
2	0	2	0	0	36684	2
2	0	2	0	0	36685	2
2	0	2	0	0	36686	2
2	0	2	0	0	36687	2
2	0	2	0	0	36688	2
2	0	2	0	0	36689	2
2	0	2	0	0	36690	2
2	0	2	0	0	36691	2
2	0	2	0	0	36692	2
2	0	4	305	305	36693	2
2	0	2	0	0	36694	2
2	0	2	0	0	36695	2
2	0	4	223	223	36696	2
2	0	2	8	8	36697	2
2	0	2	0	0	36698	2
2	0	2	0	0	36699	2
2	0	2	0	0	36700	2
2	0	2	0	0	36701	2
2	0	2	0	0	36702	2
2	0	2	0	0	36703	2
2	0	4	5	5	36704	2
2	0	2	0	0	36705	2
2	0	2	0	0	36706	2
2	0	2	0	0	36707	2
2	0	2	0	0	36708	2
2	0	2	0	0	36709	2
2	0	2	0	0	36710	2
2	0	2	0	0	36711	2
2	0	2	0	0	36712	2
2	0	4	2	2	36713	2
2	0	2	0	0	36714	2
2	0	2	0	0	36715	2
2	0	2	0	0	36716	2
2	0	2	0	0	36717	2
2	0	2	0	0	36718	2
2	0	2	0	0	36719	2
2	0	2	1	1	36720	2
2	0	2	0	0	36721	2
2	0	2	0	0	36722	2
2	0	2	0	0	36723	2
2	0	2	0	0	36724	2
4	35	2	1	36	36725	1
4	25	2	0	25	36726	0
2	1	2	0	1	36727	0
2	5	4	2400	2405	36728	1
2	0	2	0	0	36729	2
2	0	2	0	0	36730	2
2	2	4	2246	2248	36731	1
2	0	2	0	0	36732	2
2	0	2	0	0	36733	2
2	0	2	0	0	36734	2
2	0	2	0	0	36735	2
2	0	2	0	0	36736	2
2	0	2	0	0	36737	2
2	0	2	0	0	36738	2
2	0	2	0	0	36739	2
2	0	4	14	14	36740	2
2	0	2	0	0	36741	2
2	0	2	0	0	36742	2
2	0	4	0	0	36743	2
2	0	2	0	0	36744	2
2	0	2	0	0	36745	2
2	0	2	0	0	36746	2
2	0	2	0	0	36747	2
2	0	2	0	0	36748	2
2	0	2	0	0	36749	2
2	0	2	0	0	36750	2
2	0	2	0	0	36751	2
2	0	2	0	0	36752	2
2	0	2	0	0	36753	2
2	0	2	0	0	36754	2
2	0	2	0	0	36755	2
2	0	2	0	0	36756	2
2	29	7	157	186	36757	0
2	3	2	0	3	36758	0
4	129	4	1948	2077	36759	0
2	64	2	0	64	36760	0
2	103	2	159	262	36761	1
2	0	2	29	29	36762	2
2	0	2	7	7	36763	2
2	52	2	1	53	36764	1
2	0	2	85	85	36765	2
2	1	2	0	1	36766	0
2	0	2	3	3	36767	2
2	0	2	0	0	36768	2
2	0	2	0	0	36769	2
0	22	2	1	23	36770	0
0	9	2	0	9	36771	0
2	0	2	0	0	36772	2
2	0	2	0	0	36773	2
2	1	2	0	1	36774	0
2	2	4	270	272	36775	1
2	0	2	0	0	36776	2
2	0	2	0	0	36777	2
2	1	4	128	129	36778	0
2	0	2	0	0	36779	2
2	2	2	0	2	36780	0
2	5	2	25	30	36781	1
2	0	2	0	0	36782	2
2	0	2	0	0	36783	2
0	70	2	4	74	36784	0
0	59	2	0	59	36785	0
2	1	2	0	1	36786	0
2	0	2	13	13	36787	2
2	0	2	0	0	36788	2
2	0	2	0	0	36789	2
2	0	2	0	0	36790	2
2	0	2	0	0	36791	2
2	0	2	0	0	36792	2
2	0	2	0	0	36793	2
0	137	4	36	173	36794	0
2	0	4	394	394	36795	2
2	0	2	0	0	36796	2
2	0	2	0	0	36797	2
2	0	4	1057	1057	36798	2
2	0	2	0	0	36799	2
2	0	2	0	0	36800	2
2	2	2	0	2	36801	1
2	0	2	1	1	36802	2
2	2	2	0	2	36803	0
2	0	2	2	2	36804	2
2	0	2	2	2	36805	2
2	0	2	0	0	36806	2
2	0	2	0	0	36807	2
2	0	2	0	0	36808	2
2	0	2	0	0	36809	2
2	0	2	0	0	36810	2
2	0	2	0	0	36811	2
2	0	2	0	0	36812	2
2	0	2	0	0	36813	2
2	0	2	1	1	36814	2
2	0	2	0	0	36815	2
2	0	2	0	0	36816	2
2	0	2	0	0	36817	2
2	0	2	0	0	36818	2
2	0	2	0	0	36819	2
2	0	2	0	0	36820	2
2	0	2	0	0	36821	2
2	0	2	0	0	36822	2
2	0	2	0	0	36823	2
2	0	2	0	0	36824	2
2	0	2	0	0	36825	2
2	0	2	0	0	36826	2
2	0	2	0	0	36827	2
2	0	2	0	0	36828	2
2	0	2	0	0	36829	2
2	0	2	0	0	36830	2
2	5	2	0	5	36831	0
2	0	2	0	0	36832	2
2	0	2	0	0	36833	2
2	0	2	0	0	36834	2
2	0	2	0	0	36835	2
2	0	2	0	0	36836	2
2	0	2	0	0	36837	2
2	0	2	0	0	36838	2
2	0	4	12	12	36839	2
2	0	2	0	0	36840	2
2	0	4	65	65	36841	2
2	0	2	0	0	36842	2
2	0	2	0	0	36843	2
2	0	2	1	1	36844	2
2	0	2	0	0	36845	2
4	0	2	2	2	36846	2
0	0	4	0	0	36847	2
2	0	2	0	0	36848	2
2	0	2	0	0	36849	2
2	0	2	0	0	36850	2
2	29	2	0	29	36851	0
2	3	2	112	115	36852	1
2	0	2	2	2	36853	2
2	0	2	0	0	36854	2
2	7	2	2	9	36855	0
2	0	2	56	56	36856	2
2	0	2	0	0	36857	2
2	6	2	15	21	36858	1
2	0	2	0	0	36859	2
2	0	2	0	0	36860	2
2	0	2	0	0	36861	2
2	0	2	0	0	36862	2
2	0	2	0	0	36863	2
0	0	0	441	441	36864	2
2	0	2	0	0	36865	2
2	0	2	0	0	36866	2
2	0	2	0	0	36867	2
2	0	2	2	2	36868	2
2	0	2	0	0	36869	2
2	0	2	0	0	36870	2
2	0	2	0	0	36871	2
2	0	2	0	0	36872	2
2	0	2	0	0	36873	2
2	0	2	0	0	36874	2
2	0	2	0	0	36875	2
2	0	2	0	0	36876	2
2	0	2	0	0	36877	2
2	0	4	10	10	36878	2
2	0	2	0	0	36879	2
2	0	2	0	0	36880	2
2	0	4	0	0	36881	2
2	0	2	0	0	36882	2
2	0	4	49	49	36883	2
2	0	2	0	0	36884	2
2	0	2	0	0	36885	2
2	0	4	9	9	36886	2
2	0	2	40	40	36887	2
2	0	2	0	0	36888	2
2	0	2	0	0	36889	2
2	0	2	0	0	36890	2
2	0	2	0	0	36891	2
2	0	2	0	0	36892	2
2	0	2	0	0	36893	2
2	0	2	0	0	36894	2
2	0	4	0	0	36895	2
2	0	2	0	0	36896	2
2	0	2	0	0	36897	2
2	0	4	0	0	36898	2
2	0	2	0	0	36899	2
2	0	2	0	0	36900	2
2	0	2	0	0	36901	2
2	0	2	0	0	36902	2
2	0	2	0	0	36903	2
2	0	2	0	0	36904	2
2	0	2	0	0	36905	2
2	0	2	0	0	36906	2
2	0	2	0	0	36907	2
2	0	2	0	0	36908	2
2	0	2	0	0	36909	2
2	0	2	0	0	36910	2
2	0	2	0	0	36911	2
2	0	2	0	0	36912	2
2	0	2	0	0	36913	2
2	0	2	0	0	36914	2
2	0	2	0	0	36915	2
2	0	2	0	0	36916	2
2	0	2	0	0	36917	2
2	0	2	0	0	36918	2
2	0	2	2	2	36919	2
2	0	2	0	0	36920	2
2	0	2	0	0	36921	2
2	0	2	0	0	36922	2
2	0	2	7	7	36923	2
0	101	2	5	106	36924	0
0	9	4	27	36	36925	0
2	0	2	0	0	36926	2
2	0	2	0	0	36927	2
2	0	2	0	0	36928	2
2	0	2	0	0	36929	2
2	0	2	0	0	36930	2
2	0	2	0	0	36931	2
2	0	2	0	0	36932	2
2	0	2	0	0	36933	2
2	0	2	0	0	36934	2
2	0	2	1	1	36935	2
2	0	2	0	0	36936	2
2	0	2	0	0	36937	2
2	0	2	0	0	36938	2
2	1	2	3	4	36939	1
2	0	2	0	0	36940	2
2	0	2	0	0	36941	2
2	1	2	0	1	36942	1
2	0	2	5	5	36943	2
0	0	2	0	0	36944	2
2	0	2	0	0	36945	2
2	0	4	1072	1072	36946	2
2	0	2	0	0	36947	2
2	0	2	0	0	36948	2
2	0	4	971	971	36949	2
2	0	2	0	0	36950	2
2	0	2	0	0	36951	2
2	0	2	0	0	36952	2
2	0	2	0	0	36953	2
2	8	2	0	8	36954	0
2	5	2	34	39	36955	1
2	0	2	0	0	36956	2
2	0	2	0	0	36957	2
2	1	2	0	1	36958	1
2	0	2	10	10	36959	2
2	0	2	0	0	36960	2
2	0	2	0	0	36961	2
4	0	4	566	566	36962	2
2	0	2	0	0	36963	2
2	0	2	1	1	36964	2
2	0	2	0	0	36965	2
2	0	2	4	4	36966	2
2	0	2	0	0	36967	2
2	0	2	0	0	36968	2
2	0	2	0	0	36969	2
2	7	2	0	7	36970	0
2	0	4	54	54	36971	2
2	0	2	0	0	36972	2
2	2	4	257	259	36973	1
2	0	2	1	1	36974	2
2	0	2	0	0	36975	2
2	65	2	29	94	36976	1
2	0	2	1	1	36977	2
2	0	2	1	1	36978	2
2	22	2	4	26	36979	1
2	0	2	0	0	36980	2
2	0	2	0	0	36981	2
2	0	2	0	0	36982	2
2	0	2	0	0	36983	2
2	0	2	0	0	36984	2
2	0	2	0	0	36985	2
2	0	2	0	0	36986	2
2	0	2	0	0	36987	2
2	0	2	7	7	36988	2
2	0	2	0	0	36989	2
2	0	2	0	0	36990	2
2	0	2	0	0	36991	2
2	0	2	0	0	36992	2
2	0	2	0	0	36993	2
2	0	2	0	0	36994	2
2	0	2	0	0	36995	2
2	0	2	0	0	36996	2
2	0	2	1	1	36997	2
2	0	2	0	0	36998	2
2	0	2	9	9	36999	2
2	0	2	0	0	37000	2
2	0	2	0	0	37001	2
2	0	2	0	0	37002	2
2	0	2	0	0	37003	2
2	0	4	1651	1651	37004	2
2	0	2	0	0	37005	2
2	0	2	0	0	37006	2
2	0	2	1	1	37007	2
2	0	2	0	0	37008	2
2	0	2	0	0	37009	2
2	2	2	0	2	37010	1
2	0	2	0	0	37011	2
0	0	0	1	1	37012	2
2	3	2	0	3	37013	0
2	0	2	0	0	37014	2
2	0	2	0	0	37015	2
2	0	2	0	0	37016	2
2	0	2	1	1	37017	2
2	0	2	0	0	37018	2
2	0	2	0	0	37019	2
2	0	0	4	4	37020	2
2	0	2	0	0	37021	2
2	0	2	0	0	37022	2
2	0	2	0	0	37023	2
2	0	2	1	1	37024	2
2	0	2	0	0	37025	2
2	0	2	0	0	37026	2
2	0	2	90	90	37027	2
2	0	2	1	1	37028	2
2	0	2	0	0	37029	2
4	0	2	3	3	37030	2
4	0	2	2	2	37031	2
2	0	2	4	4	37032	2
2	0	2	0	0	37033	2
2	0	2	0	0	37034	2
2	2	2	14	16	37035	1
2	0	2	26	26	37036	2
2	0	2	0	0	37037	2
2	0	2	0	0	37038	2
2	0	2	0	0	37039	2
2	0	2	0	0	37040	2
2	0	2	0	0	37041	2
2	0	2	0	0	37042	2
2	788	2	4	792	37043	0
2	26	2	4812	4838	37044	1
2	0	2	2	2	37045	2
2	0	2	0	0	37046	2
4	45	2	149	194	37047	0
4	24	2	0	24	37048	1
2	133	2	8	141	37049	1
2	0	2	1925	1925	37050	2
2	4	2	1	5	37051	0
2	361	4	197	558	37052	1
2	0	2	1	1	37053	2
2	0	2	0	0	37054	2
2	11	4	23	34	37055	0
2	0	2	8	8	37056	2
2	0	2	0	0	37057	2
2	0	0	35	35	37058	2
2	0	2	0	0	37059	2
2	0	2	0	0	37060	2
2	0	0	35	35	37061	2
2	0	2	0	0	37062	2
2	0	2	0	0	37063	2
2	0	2	0	0	37064	2
2	0	2	0	0	37065	2
2	0	2	0	0	37066	2
2	0	2	0	0	37067	2
2	0	2	0	0	37068	2
2	0	2	0	0	37069	2
2	0	2	0	0	37070	2
2	0	2	0	0	37071	2
2	0	2	0	0	37072	2
2	0	2	0	0	37073	2
2	0	2	0	0	37074	2
2	0	2	0	0	37075	2
2	0	2	0	0	37076	2
2	0	2	0	0	37077	2
2	0	2	0	0	37078	2
2	0	2	0	0	37079	2
2	0	2	0	0	37080	2
2	0	2	0	0	37081	2
2	0	2	0	0	37082	2
2	0	2	0	0	37083	2
2	0	2	0	0	37084	2
2	0	2	0	0	37085	2
2	0	2	0	0	37086	2
2	0	2	0	0	37087	2
2	0	4	2	2	37088	2
2	0	2	0	0	37089	2
2	0	4	5	5	37090	2
2	0	2	0	0	37091	2
2	0	2	0	0	37092	2
4	18	2	5	23	37093	0
2	0	2	0	0	37094	2
2	0	2	0	0	37095	2
2	0	2	0	0	37096	2
2	0	2	0	0	37097	2
2	0	2	0	0	37098	2
2	0	2	0	0	37099	2
2	0	2	0	0	37100	2
2	0	2	0	0	37101	2
2	0	2	0	0	37102	2
2	0	2	0	0	37103	2
2	0	2	0	0	37104	2
2	0	2	0	0	37105	2
2	0	2	0	0	37106	2
2	3	2	9	12	37107	1
2	0	2	2	2	37108	2
2	0	2	0	0	37109	2
2	0	2	0	0	37110	2
2	0	2	1	1	37111	2
2	4	4	33	37	37112	1
2	0	2	0	0	37113	2
2	0	2	0	0	37114	2
2	0	4	48	48	37115	2
2	0	2	7	7	37116	2
4	0	2	0	0	37117	2
2	28	2	0	28	37118	0
2	59	2	393	452	37119	1
2	0	2	1	1	37120	2
2	0	2	0	0	37121	2
2	12	2	2	14	37122	0
2	0	2	8	8	37123	2
2	0	2	0	0	37124	2
2	0	2	0	0	37125	2
2	0	2	0	0	37126	2
2	0	2	0	0	37127	2
2	0	2	0	0	37128	2
2	0	2	0	0	37129	2
2	0	2	0	0	37130	2
2	0	2	0	0	37131	2
2	0	2	0	0	37132	2
2	0	2	0	0	37133	2
2	0	2	0	0	37134	2
2	0	2	0	0	37135	2
0	1	4	69	70	37136	1
2	0	2	0	0	37137	2
2	0	2	0	0	37138	2
2	0	2	0	0	37139	2
2	1	2	2	3	37140	1
2	0	2	0	0	37141	2
2	0	2	0	0	37142	2
4	1995	2	292	2287	37143	0
4	1100	2	9	1109	37144	0
4	0	2	2293	2293	37145	2
4	1	2	152	153	37146	0
0	1	4	0	1	37147	1
0	0	4	1	1	37148	2
4	1	2	16	17	37149	0
4	1	2	1	2	37150	0
2	12	4	3072	3084	37151	0
2	649	2	10529	11178	37152	0
4	0	4	4	4	37153	2
4	0	4	0	0	37154	2
4	0	4	93	93	37155	2
4	0	2	1	1	37156	2
4	0	2	2	2	37157	2
4	0	2	2	2	37158	2
4	0	2	0	0	37159	2
4	3	2	0	3	37160	0
0	16	2	0	16	37161	0
4	1	2	1	2	37162	0
4	224	2	0	224	37163	0
2	213	6	16728	16941	37164	0
4	3189	2	508	3697	37165	0
4	1065	2	9	1074	37166	0
2	2	2	1	3	37167	0
2	0	2	0	0	37168	2
0	0	2	0	0	37169	2
0	0	2	0	0	37170	2
2	1	0	0	1	37171	0
2	0	2	0	0	37172	2
2	0	2	0	0	37173	2
2	0	2	0	0	37174	2
2	0	2	0	0	37175	2
2	0	2	0	0	37176	2
2	0	2	0	0	37177	2
2	0	2	0	0	37178	2
2	0	2	0	0	37179	2
2	0	2	0	0	37180	2
2	0	2	0	0	37181	2
2	0	2	0	0	37182	2
2	0	2	0	0	37183	2
2	0	2	0	0	37184	2
2	0	2	0	0	37185	2
2	0	2	0	0	37186	2
2	0	2	0	0	37187	2
2	0	2	0	0	37188	2
2	0	2	0	0	37189	2
2	0	2	0	0	37190	2
2	0	2	18	18	37191	2
2	0	2	0	0	37192	2
2	0	2	0	0	37193	2
2	1	2	1	2	37194	1
0	0	4	2	2	37195	2
0	0	4	2	2	37196	2
2	0	2	0	0	37197	2
2	0	2	0	0	37198	2
2	0	2	0	0	37199	2
2	0	2	0	0	37200	2
2	0	2	0	0	37201	2
2	0	2	0	0	37202	2
2	0	2	0	0	37203	2
2	0	2	0	0	37204	2
2	0	2	0	0	37205	2
2	0	2	0	0	37206	2
2	0	2	0	0	37207	2
2	0	2	0	0	37208	2
2	0	2	0	0	37209	2
2	0	2	0	0	37210	2
2	0	2	0	0	37211	2
2	0	2	0	0	37212	2
2	0	2	0	0	37213	2
2	0	2	0	0	37214	2
2	0	2	0	0	37215	2
2	0	2	0	0	37216	2
2	0	2	0	0	37217	2
2	0	2	0	0	37218	2
2	0	2	0	0	37219	2
2	0	2	0	0	37220	2
4	0	4	69	69	37221	2
2	0	2	0	0	37222	2
2	0	4	3	3	37223	2
2	0	2	0	0	37224	2
2	0	4	2	2	37225	2
2	0	2	0	0	37226	2
2	0	2	0	0	37227	2
2	0	2	0	0	37228	2
2	0	2	0	0	37229	2
2	0	2	0	0	37230	2
2	0	2	0	0	37231	2
2	0	2	0	0	37232	2
2	0	2	4	4	37233	2
0	4	4	143	147	37234	0
2	0	2	0	0	37235	2
2	0	2	0	0	37236	2
2	0	2	0	0	37237	2
2	0	2	0	0	37238	2
2	0	2	0	0	37239	2
2	0	2	0	0	37240	2
4	1	4	13	14	37241	0
2	0	2	0	0	37242	2
2	0	2	0	0	37243	2
2	0	2	0	0	37244	2
2	0	2	0	0	37245	2
2	0	2	0	0	37246	2
2	0	2	0	0	37247	2
2	0	2	0	0	37248	2
2	0	2	0	0	37249	2
2	0	2	0	0	37250	2
2	0	2	0	0	37251	2
2	0	2	0	0	37252	2
2	0	2	0	0	37253	2
4	0	4	4	4	37254	2
2	0	2	0	0	37255	2
2	0	2	1	1	37256	2
2	0	2	0	0	37257	2
2	0	2	1	1	37258	2
2	0	2	0	0	37259	2
2	0	2	0	0	37260	2
0	0	4	8	8	37261	2
2	0	2	0	0	37262	2
2	0	2	0	0	37263	2
2	0	2	0	0	37264	2
2	0	2	0	0	37265	2
2	0	2	0	0	37266	2
2	0	2	0	0	37267	2
2	0	2	0	0	37268	2
2	0	2	0	0	37269	2
2	0	2	0	0	37270	2
2	0	2	0	0	37271	2
2	0	2	0	0	37272	2
2	0	2	0	0	37273	2
2	0	2	0	0	37274	2
2	0	2	0	0	37275	2
2	0	2	0	0	37276	2
2	0	2	0	0	37277	2
2	0	2	0	0	37278	2
2	0	2	0	0	37279	2
4	0	4	8	8	37280	2
4	0	4	0	0	37281	2
2	0	2	0	0	37282	2
2	0	2	0	0	37283	2
2	0	2	0	0	37284	2
2	0	2	0	0	37285	2
2	0	2	0	0	37286	2
2	0	2	0	0	37287	2
2	0	2	0	0	37288	2
2	0	2	0	0	37289	2
2	0	2	0	0	37290	2
2	0	2	0	0	37291	2
2	0	2	0	0	37292	2
2	0	2	0	0	37293	2
2	0	2	0	0	37294	2
2	0	4	3	3	37295	2
2	0	2	0	0	37296	2
2	0	2	0	0	37297	2
2	0	2	1	1	37298	2
2	0	2	0	0	37299	2
2	0	2	0	0	37300	2
2	0	2	0	0	37301	2
2	0	2	0	0	37302	2
2	0	2	0	0	37303	2
2	0	2	0	0	37304	2
2	0	2	0	0	37305	2
2	0	2	0	0	37306	2
2	0	2	0	0	37307	2
2	0	2	0	0	37308	2
2	0	2	0	0	37309	2
2	0	2	0	0	37310	2
2	0	2	0	0	37311	2
2	0	2	0	0	37312	2
2	2	2	0	2	37313	1
2	0	2	0	0	37314	2
2	0	2	0	0	37315	2
2	0	2	0	0	37316	2
2	0	2	0	0	37317	2
2	0	2	0	0	37318	2
2	0	2	0	0	37319	2
2	0	2	0	0	37320	2
2	0	2	0	0	37321	2
2	0	2	0	0	37322	2
2	0	2	0	0	37323	2
2	0	2	0	0	37324	2
2	0	2	0	0	37325	2
2	0	2	0	0	37326	2
2	0	2	0	0	37327	2
2	0	2	0	0	37328	2
2	0	2	0	0	37329	2
0	2	4	1721	1723	37330	1
0	0	4	536	536	37331	2
2	0	2	0	0	37332	2
2	0	2	2	2	37333	2
2	0	2	0	0	37334	2
2	0	2	0	0	37335	2
2	0	2	0	0	37336	2
2	0	2	0	0	37337	2
2	0	2	0	0	37338	2
2	0	2	0	0	37339	2
2	0	4	64	64	37340	2
2	0	2	0	0	37341	2
2	0	2	0	0	37342	2
2	1	4	97	98	37343	1
2	0	2	0	0	37344	2
4	3	4	2	5	37345	1
4	1	4	0	1	37346	1
2	0	2	0	0	37347	2
2	0	2	0	0	37348	2
2	0	2	0	0	37349	2
2	0	2	0	0	37350	2
2	0	2	0	0	37351	2
2	0	2	0	0	37352	2
2	0	2	129	129	37353	2
2	0	2	0	0	37354	2
2	0	2	0	0	37355	2
2	0	2	337	337	37356	2
2	0	2	0	0	37357	2
4	0	2	7	7	37358	2
0	0	4	9	9	37359	2
0	0	4	53	53	37360	2
2	0	2	0	0	37361	2
2	0	2	0	0	37362	2
2	0	2	0	0	37363	2
2	0	2	0	0	37364	2
2	0	2	0	0	37365	2
2	0	2	0	0	37366	2
2	0	2	0	0	37367	2
2	0	2	0	0	37368	2
2	0	2	0	0	37369	2
2	0	2	0	0	37370	2
2	0	2	0	0	37371	2
2	0	2	0	0	37372	2
2	3	2	0	3	37373	0
2	0	4	39	39	37374	2
2	0	2	0	0	37375	2
2	0	2	0	0	37376	2
2	0	4	1	1	37377	2
2	0	2	0	0	37378	2
2	0	2	0	0	37379	2
2	0	2	0	0	37380	2
2	0	2	0	0	37381	2
2	1	2	0	1	37382	1
2	0	2	0	0	37383	2
2	0	2	0	0	37384	2
2	0	2	0	0	37385	2
2	0	4	0	0	37386	2
2	0	2	0	0	37387	2
2	0	2	0	0	37388	2
2	0	4	0	0	37389	2
2	0	2	0	0	37390	2
2	0	2	0	0	37391	2
2	0	2	0	0	37392	2
2	0	2	0	0	37393	2
2	0	2	0	0	37394	2
2	0	2	0	0	37395	2
2	0	2	0	0	37396	2
2	0	2	0	0	37397	2
2	0	4	0	0	37398	2
2	0	2	0	0	37399	2
2	0	2	0	0	37400	2
2	0	4	0	0	37401	2
2	0	2	0	0	37402	2
4	0	4	133	133	37403	2
4	0	4	53	53	37404	2
2	0	2	0	0	37405	2
2	0	2	0	0	37406	2
2	0	2	0	0	37407	2
2	0	2	0	0	37408	2
2	0	2	0	0	37409	2
2	0	2	0	0	37410	2
2	0	2	0	0	37411	2
2	0	2	0	0	37412	2
2	0	4	1	1	37413	2
2	0	2	0	0	37414	2
2	0	2	0	0	37415	2
2	0	4	2	2	37416	2
2	0	2	1	1	37417	2
2	0	2	0	0	37418	2
2	0	2	0	0	37419	2
2	0	2	0	0	37420	2
0	0	2	0	0	37421	2
2	879	2	0	879	37422	0
2	0	2	104	104	37423	2
2	0	2	0	0	37424	2
2	0	2	0	0	37425	2
2	0	2	0	0	37426	2
2	0	2	0	0	37427	2
2	0	2	0	0	37428	2
2	0	2	0	0	37429	2
2	0	2	0	0	37430	2
2	0	2	0	0	37431	2
2	0	2	0	0	37432	2
2	0	2	0	0	37433	2
2	0	2	0	0	37434	2
2	0	2	0	0	37435	2
2	0	2	0	0	37436	2
2	0	2	0	0	37437	2
2	0	2	0	0	37438	2
2	0	2	0	0	37439	2
2	0	2	0	0	37440	2
2	0	2	0	0	37441	2
2	0	2	0	0	37442	2
2	0	2	0	0	37443	2
2	0	4	0	0	37444	2
2	0	2	0	0	37445	2
2	0	2	0	0	37446	2
2	0	4	0	0	37447	2
2	0	2	0	0	37448	2
2	0	2	0	0	37449	2
2	0	4	0	0	37450	2
2	0	2	0	0	37451	2
2	0	2	0	0	37452	2
2	0	4	0	0	37453	2
2	0	2	0	0	37454	2
2	0	2	0	0	37455	2
2	0	2	0	0	37456	2
2	0	2	0	0	37457	2
2	0	2	0	0	37458	2
2	0	2	0	0	37459	2
2	0	2	0	0	37460	2
2	0	2	0	0	37461	2
2	0	2	0	0	37462	2
2	0	2	0	0	37463	2
2	0	2	0	0	37464	2
2	0	2	0	0	37465	2
2	0	2	0	0	37466	2
4	1	4	26	27	37467	0
0	0	4	0	0	37468	2
0	0	4	305	305	37469	2
2	0	2	0	0	37470	2
2	0	4	0	0	37471	2
2	0	2	0	0	37472	2
2	0	2	0	0	37473	2
2	0	4	1	1	37474	2
2	0	2	0	0	37475	2
2	0	2	0	0	37476	2
2	0	2	0	0	37477	2
2	0	2	0	0	37478	2
2	0	2	0	0	37479	2
2	0	2	0	0	37480	2
2	0	2	0	0	37481	2
2	0	2	0	0	37482	2
2	0	2	0	0	37483	2
2	0	2	0	0	37484	2
2	0	2	0	0	37485	2
2	0	2	0	0	37486	2
2	0	2	0	0	37487	2
2	0	2	0	0	37488	2
2	0	4	17	17	37489	2
2	0	2	0	0	37490	2
2	0	2	0	0	37491	2
2	0	4	5	5	37492	2
2	0	2	0	0	37493	2
2	0	2	0	0	37494	2
2	0	2	0	0	37495	2
2	0	2	0	0	37496	2
2	0	2	0	0	37497	2
2	0	2	0	0	37498	2
2	0	2	0	0	37499	2
2	0	2	0	0	37500	2
2	0	2	0	0	37501	2
2	0	2	0	0	37502	2
2	0	2	0	0	37503	2
2	0	2	0	0	37504	2
2	0	2	0	0	37505	2
2	0	2	0	0	37506	2
2	0	2	0	0	37507	2
2	0	2	0	0	37508	2
2	0	2	0	0	37509	2
2	0	2	0	0	37510	2
2	0	2	0	0	37511	2
2	0	2	0	0	37512	2
2	0	2	0	0	37513	2
2	0	2	0	0	37514	2
2	0	2	0	0	37515	2
2	0	2	0	0	37516	2
2	0	2	0	0	37517	2
2	0	2	1	1	37518	2
2	0	2	0	0	37519	2
2	1	2	0	1	37520	1
2	0	2	0	0	37521	2
2	0	2	0	0	37522	2
0	0	4	61	61	37523	2
2	0	2	0	0	37524	2
2	0	2	0	0	37525	2
2	0	2	0	0	37526	2
2	0	2	0	0	37527	2
2	0	2	0	0	37528	2
2	0	2	2	2	37529	2
2	0	2	0	0	37530	2
2	0	4	0	0	37531	2
2	0	2	0	0	37532	2
2	0	2	0	0	37533	2
2	0	4	0	0	37534	2
2	0	2	0	0	37535	2
2	0	2	0	0	37536	2
2	0	2	0	0	37537	2
2	0	2	0	0	37538	2
2	0	2	0	0	37539	2
2	0	2	0	0	37540	2
2	0	2	0	0	37541	2
2	0	2	0	0	37542	2
2	0	2	0	0	37543	2
2	0	2	0	0	37544	2
2	0	2	0	0	37545	2
2	0	2	0	0	37546	2
2	0	2	0	0	37547	2
2	0	2	0	0	37548	2
2	0	2	0	0	37549	2
2	0	2	0	0	37550	2
2	0	2	0	0	37551	2
2	0	2	0	0	37552	2
2	0	2	0	0	37553	2
0	0	4	212	212	37554	2
2	0	2	0	0	37555	2
2	0	4	0	0	37556	2
2	0	2	0	0	37557	2
2	0	2	0	0	37558	2
2	0	4	0	0	37559	2
2	0	2	0	0	37560	2
2	0	2	0	0	37561	2
2	0	2	0	0	37562	2
2	0	2	0	0	37563	2
2	0	2	0	0	37564	2
2	0	2	0	0	37565	2
2	0	2	0	0	37566	2
2	0	2	0	0	37567	2
2	0	2	0	0	37568	2
2	0	2	0	0	37569	2
2	0	2	0	0	37570	2
2	0	2	0	0	37571	2
2	0	2	0	0	37572	2
2	0	2	0	0	37573	2
2	0	2	0	0	37574	2
2	0	2	0	0	37575	2
2	0	2	0	0	37576	2
2	0	2	0	0	37577	2
2	0	2	0	0	37578	2
2	0	2	0	0	37579	2
2	0	2	0	0	37580	2
2	0	2	0	0	37581	2
2	0	2	0	0	37582	2
2	0	2	0	0	37583	2
2	0	2	0	0	37584	2
2	0	2	0	0	37585	2
2	0	4	0	0	37586	2
2	0	2	0	0	37587	2
2	0	2	0	0	37588	2
2	0	2	0	0	37589	2
2	0	2	0	0	37590	2
2	0	2	0	0	37591	2
2	0	2	0	0	37592	2
2	0	2	0	0	37593	2
2	0	2	0	0	37594	2
2	0	2	0	0	37595	2
2	0	2	0	0	37596	2
4	1	4	5	6	37597	1
2	0	2	0	0	37598	2
2	0	2	0	0	37599	2
2	0	2	0	0	37600	2
2	0	2	0	0	37601	2
2	0	2	0	0	37602	2
2	0	2	0	0	37603	2
2	0	2	0	0	37604	2
2	0	4	44	44	37605	2
2	0	2	0	0	37606	2
2	0	2	0	0	37607	2
2	0	4	32	32	37608	2
2	0	2	0	0	37609	2
4	0	2	0	0	37610	2
2	0	2	0	0	37611	2
2	0	2	0	0	37612	2
2	0	2	0	0	37613	2
2	0	2	0	0	37614	2
2	0	2	0	0	37615	2
2	0	2	0	0	37616	2
2	0	2	0	0	37617	2
2	0	2	0	0	37618	2
2	0	2	0	0	37619	2
2	0	2	0	0	37620	2
2	0	2	0	0	37621	2
2	0	2	0	0	37622	2
2	0	2	0	0	37623	2
2	0	4	0	0	37624	2
2	0	2	0	0	37625	2
2	0	2	0	0	37626	2
2	0	2	0	0	37627	2
2	0	2	0	0	37628	2
2	0	2	0	0	37629	2
2	54	2	0	54	37630	0
2	2	2	453	455	37631	1
2	0	2	34	34	37632	2
2	0	2	1	1	37633	2
2	17	2	11	28	37634	0
2	0	2	0	0	37635	2
2	0	2	0	0	37636	2
2	0	4	5	5	37637	2
2	0	2	0	0	37638	2
0	114	4	2896	3010	37639	0
2	0	2	0	0	37640	2
2	0	2	0	0	37641	2
2	0	2	0	0	37642	2
2	0	2	3	3	37643	2
2	0	2	0	0	37644	2
2	0	2	0	0	37645	2
2	0	2	0	0	37646	2
2	0	2	0	0	37647	2
2	0	2	0	0	37648	2
2	0	2	0	0	37649	2
2	0	2	0	0	37650	2
2	0	2	0	0	37651	2
2	0	2	0	0	37652	2
2	0	2	0	0	37653	2
2	0	2	0	0	37654	2
2	0	2	0	0	37655	2
2	0	2	0	0	37656	2
2	0	2	0	0	37657	2
2	0	2	0	0	37658	2
2	0	2	0	0	37659	2
2	0	2	0	0	37660	2
2	0	2	0	0	37661	2
2	0	2	0	0	37662	2
2	0	2	0	0	37663	2
2	0	2	0	0	37664	2
2	0	2	0	0	37665	2
2	0	2	0	0	37666	2
2	0	2	0	0	37667	2
2	0	2	0	0	37668	2
2	0	2	0	0	37669	2
2	0	2	0	0	37670	2
2	0	2	0	0	37671	2
2	0	2	0	0	37672	2
2	0	2	0	0	37673	2
2	0	2	0	0	37674	2
2	0	2	0	0	37675	2
2	0	2	0	0	37676	2
2	0	2	0	0	37677	2
2	0	2	0	0	37678	2
2	0	2	0	0	37679	2
2	0	2	0	0	37680	2
2	0	2	0	0	37681	2
2	0	2	0	0	37682	2
2	0	2	0	0	37683	2
2	0	2	0	0	37684	2
2	90	2	2	92	37685	0
2	0	2	25	25	37686	2
2	0	2	5	5	37687	2
2	26	4	3	29	37688	1
2	0	2	0	0	37689	2
2	0	2	0	0	37690	2
2	0	2	0	0	37691	2
2	0	2	0	0	37692	2
2	0	2	0	0	37693	2
2	0	2	0	0	37694	2
0	0	4	0	0	37695	2
4	20	4	98	118	37696	0
4	0	4	1	1	37697	2
2	0	2	0	0	37698	2
2	0	2	0	0	37699	2
2	0	2	0	0	37700	2
2	0	2	0	0	37701	2
2	0	2	0	0	37702	2
2	0	2	1	1	37703	2
2	3	2	0	3	37704	0
2	0	2	0	0	37705	2
2	0	2	1	1	37706	2
2	0	2	0	0	37707	2
2	0	2	0	0	37708	2
2	0	2	0	0	37709	2
2	0	2	0	0	37710	2
2	0	2	0	0	37711	2
2	0	2	0	0	37712	2
2	0	2	0	0	37713	2
2	0	2	0	0	37714	2
2	0	2	0	0	37715	2
2	0	2	0	0	37716	2
2	0	2	0	0	37717	2
2	0	2	0	0	37718	2
2	0	2	0	0	37719	2
2	0	2	0	0	37720	2
2	0	2	0	0	37721	2
2	0	2	0	0	37722	2
2	0	4	31	31	37723	2
2	0	2	1	1	37724	2
2	0	2	0	0	37725	2
2	1	2	1	2	37726	0
2	0	4	16	16	37727	2
2	0	2	0	0	37728	2
2	0	2	0	0	37729	2
2	0	2	0	0	37730	2
2	0	2	0	0	37731	2
0	0	2	0	0	37732	2
2	0	2	0	0	37733	2
2	0	2	0	0	37734	2
2	0	2	0	0	37735	2
2	0	2	0	0	37736	2
2	0	2	0	0	37737	2
2	0	2	0	0	37738	2
2	0	2	0	0	37739	2
2	0	2	0	0	37740	2
2	0	2	1	1	37741	2
2	1	2	5	6	37742	1
2	0	2	0	0	37743	2
2	0	2	0	0	37744	2
2	0	2	0	0	37745	2
2	0	2	0	0	37746	2
2	0	2	0	0	37747	2
2	0	2	9	9	37748	2
2	0	2	0	0	37749	2
2	0	2	0	0	37750	2
2	0	2	0	0	37751	2
2	0	2	164	164	37752	2
2	0	2	0	0	37753	2
2	0	0	0	0	37754	2
2	0	2	0	0	37755	2
2	0	2	0	0	37756	2
2	4	2	0	4	37757	0
2	5	2	85	90	37758	1
2	0	2	0	0	37759	2
2	0	2	0	0	37760	2
2	4	2	0	4	37761	0
2	0	2	13	13	37762	2
2	456	2	0	456	37763	0
2	39	2	2451	2490	37764	1
2	0	2	9	9	37765	2
2	0	2	4	4	37766	2
2	0	2	291	291	37767	2
2	0	2	0	0	37768	2
2	0	2	0	0	37769	2
2	0	2	0	0	37770	2
2	0	2	0	0	37771	2
2	0	2	0	0	37772	2
2	0	2	0	0	37773	2
2	0	2	0	0	37774	2
2	0	2	0	0	37775	2
2	0	2	0	0	37776	2
2	0	2	0	0	37777	2
2	0	2	0	0	37778	2
2	0	2	0	0	37779	2
2	0	2	0	0	37780	2
2	0	2	0	0	37781	2
2	0	2	0	0	37782	2
2	0	2	0	0	37783	2
2	0	2	0	0	37784	2
2	0	2	0	0	37785	2
2	0	2	0	0	37786	2
2	0	2	1	1	37787	2
2	0	2	0	0	37788	2
2	0	2	0	0	37789	2
2	0	2	0	0	37790	2
2	0	2	0	0	37791	2
2	0	2	0	0	37792	2
2	0	2	0	0	37793	2
2	0	2	0	0	37794	2
2	0	2	0	0	37795	2
2	0	2	0	0	37796	2
2	0	2	0	0	37797	2
2	1	2	0	1	37798	0
2	0	2	8	8	37799	2
2	0	2	0	0	37800	2
2	0	2	0	0	37801	2
2	0	2	0	0	37802	2
2	0	2	3	3	37803	2
4	0	4	0	0	37804	2
4	0	4	92	92	37805	2
2	0	2	0	0	37806	2
2	0	2	0	0	37807	2
2	0	2	2	2	37808	2
2	0	2	0	0	37809	2
2	0	2	0	0	37810	2
2	0	2	0	0	37811	2
2	0	2	0	0	37812	2
2	67	2	0	67	37813	0
2	5	2	1448	1453	37814	1
2	0	2	9	9	37815	2
2	0	2	1	1	37816	2
2	18	2	2	20	37817	0
2	0	2	128	128	37818	2
2	0	4	186	186	37819	2
2	0	2	0	0	37820	2
2	0	2	0	0	37821	2
2	0	4	106	106	37822	2
2	0	2	0	0	37823	2
2	0	2	0	0	37824	2
2	0	2	0	0	37825	2
2	0	2	0	0	37826	2
0	0	4	0	0	37827	2
2	0	2	0	0	37828	2
2	0	2	0	0	37829	2
2	0	2	0	0	37830	2
2	0	2	0	0	37831	2
2	0	2	0	0	37832	2
2	0	2	0	0	37833	2
2	0	2	0	0	37834	2
2	0	2	0	0	37835	2
2	0	2	0	0	37836	2
2	0	2	0	0	37837	2
2	0	2	0	0	37838	2
2	0	2	0	0	37839	2
2	0	2	0	0	37840	2
2	0	2	0	0	37841	2
2	0	2	0	0	37842	2
2	0	4	0	0	37843	2
2	0	2	0	0	37844	2
2	0	2	0	0	37845	2
2	0	4	9	9	37846	2
2	0	2	0	0	37847	2
2	66	2	0	66	37848	0
2	0	2	0	0	37849	2
2	1	4	2	3	37850	1
2	0	2	0	0	37851	2
2	0	2	0	0	37852	2
2	0	4	2	2	37853	2
2	0	2	0	0	37854	2
2	0	2	0	0	37855	2
2	0	2	0	0	37856	2
2	0	2	0	0	37857	2
2	0	2	0	0	37858	2
2	0	2	0	0	37859	2
2	0	2	0	0	37860	2
4	0	4	0	0	37861	2
4	0	4	0	0	37862	2
2	37	4	3354	3391	37863	1
2	0	2	2	2	37864	2
2	0	2	0	0	37865	2
2	0	2	101	101	37866	2
2	0	2	0	0	37867	2
2	0	4	0	0	37868	2
2	0	2	0	0	37869	2
2	0	2	0	0	37870	2
2	0	4	0	0	37871	2
2	0	2	0	0	37872	2
2	0	2	0	0	37873	2
2	1	4	38	39	37874	1
2	0	2	0	0	37875	2
2	0	2	0	0	37876	2
2	0	4	0	0	37877	2
2	0	2	0	0	37878	2
2	0	2	0	0	37879	2
2	0	2	0	0	37880	2
2	0	2	0	0	37881	2
2	0	2	0	0	37882	2
2	0	2	0	0	37883	2
2	0	2	0	0	37884	2
4	3	2	2	5	37885	0
4	1	4	1	2	37886	0
2	0	2	1	1	37887	2
2	0	2	0	0	37888	2
2	0	2	0	0	37889	2
2	0	2	0	0	37890	2
2	0	2	0	0	37891	2
2	0	2	0	0	37892	2
2	0	2	0	0	37893	2
2	0	2	0	0	37894	2
2	0	4	13	13	37895	2
2	0	2	0	0	37896	2
2	0	2	0	0	37897	2
4	4	2	0	4	37898	0
2	2	2	0	2	37899	0
2	0	2	12	12	37900	2
2	0	2	1	1	37901	2
2	0	2	0	0	37902	2
2	0	2	0	0	37903	2
2	0	2	0	0	37904	2
2	0	2	0	0	37905	2
2	0	2	0	0	37906	2
2	0	2	0	0	37907	2
2	0	2	0	0	37908	2
2	0	2	0	0	37909	2
2	0	2	0	0	37910	2
0	0	4	0	0	37911	2
0	0	4	0	0	37912	2
2	0	2	0	0	37913	2
2	0	2	0	0	37914	2
2	0	2	0	0	37915	2
2	0	2	0	0	37916	2
2	0	2	0	0	37917	2
2	0	2	0	0	37918	2
2	0	2	0	0	37919	2
2	1	2	0	1	37920	0
2	2	2	24	26	37921	1
2	0	2	0	0	37922	2
2	0	2	0	0	37923	2
2	0	2	0	0	37924	2
2	0	2	0	0	37925	2
2	0	2	173	173	37926	2
2	0	2	0	0	37927	2
2	0	2	0	0	37928	2
2	0	2	0	0	37929	2
2	0	2	0	0	37930	2
2	0	2	0	0	37931	2
2	0	2	0	0	37932	2
2	0	4	19	19	37933	2
2	0	2	0	0	37934	2
2	0	2	0	0	37935	2
2	0	4	30	30	37936	2
2	0	2	1	1	37937	2
2	0	4	7	7	37938	2
2	0	2	0	0	37939	2
2	0	2	0	0	37940	2
2	0	4	4	4	37941	2
2	0	2	0	0	37942	2
2	0	2	0	0	37943	2
2	0	2	0	0	37944	2
2	0	2	0	0	37945	2
2	0	2	0	0	37946	2
2	0	2	0	0	37947	2
2	0	2	0	0	37948	2
2	0	2	0	0	37949	2
2	0	4	0	0	37950	2
2	0	2	0	0	37951	2
2	0	2	0	0	37952	2
2	0	4	0	0	37953	2
2	0	2	0	0	37954	2
0	0	4	2	2	37955	2
0	0	4	4	4	37956	2
2	0	2	0	0	37957	2
2	0	4	0	0	37958	2
2	0	2	0	0	37959	2
2	0	2	0	0	37960	2
2	0	2	0	0	37961	2
2	0	2	0	0	37962	2
2	0	2	0	0	37963	2
2	0	2	3	3	37964	2
2	0	2	0	0	37965	2
2	0	2	0	0	37966	2
2	0	2	11	11	37967	2
2	0	2	0	0	37968	2
2	0	4	0	0	37969	2
2	0	2	3	3	37970	2
2	0	2	0	0	37971	2
2	0	4	0	0	37972	2
2	0	2	0	0	37973	2
2	0	2	0	0	37974	2
0	4	4	1	5	37975	0
2	0	2	0	0	37976	2
2	0	2	0	0	37977	2
2	0	2	0	0	37978	2
2	0	2	0	0	37979	2
2	0	2	0	0	37980	2
2	0	2	0	0	37981	2
2	0	2	0	0	37982	2
2	0	2	0	0	37983	2
2	0	2	0	0	37984	2
2	0	2	0	0	37985	2
2	0	2	0	0	37986	2
2	0	2	0	0	37987	2
2	0	2	0	0	37988	2
2	0	2	0	0	37989	2
2	0	2	0	0	37990	2
2	0	2	0	0	37991	2
2	0	2	0	0	37992	2
2	0	2	0	0	37993	2
2	0	2	0	0	37994	2
2	0	2	0	0	37995	2
2	0	2	0	0	37996	2
2	0	2	0	0	37997	2
2	0	2	0	0	37998	2
2	0	2	0	0	37999	2
4	0	4	1	1	38000	2
2	1	2	0	1	38001	1
2	0	2	0	0	38002	2
2	0	2	0	0	38003	2
2	0	2	0	0	38004	2
2	0	2	0	0	38005	2
2	0	2	0	0	38006	2
2	0	2	0	0	38007	2
2	0	2	0	0	38008	2
2	0	2	0	0	38009	2
2	0	2	0	0	38010	2
2	0	2	0	0	38011	2
2	0	2	0	0	38012	2
2	0	2	0	0	38013	2
2	0	2	0	0	38014	2
2	0	2	0	0	38015	2
2	0	2	0	0	38016	2
2	0	2	0	0	38017	2
2	0	2	0	0	38018	2
2	0	2	0	0	38019	2
2	0	2	0	0	38020	2
2	0	2	0	0	38021	2
2	0	2	0	0	38022	2
2	0	2	0	0	38023	2
2	0	2	0	0	38024	2
2	3	2	0	3	38025	0
2	1	2	23	24	38026	1
2	0	2	0	0	38027	2
2	0	2	1	1	38028	2
2	2	2	21	23	38029	1
2	0	2	7	7	38030	2
2	0	2	0	0	38031	2
2	0	2	0	0	38032	2
2	0	2	0	0	38033	2
2	0	2	6	6	38034	2
2	0	2	0	0	38035	2
2	0	2	0	0	38036	2
2	0	2	0	0	38037	2
2	0	2	0	0	38038	2
2	0	2	0	0	38039	2
2	0	2	0	0	38040	2
2	0	2	0	0	38041	2
2	0	2	0	0	38042	2
2	0	2	0	0	38043	2
2	0	2	0	0	38044	2
2	0	2	0	0	38045	2
2	0	2	0	0	38046	2
2	0	2	0	0	38047	2
2	0	2	0	0	38048	2
2	0	2	0	0	38049	2
2	0	2	0	0	38050	2
2	0	2	0	0	38051	2
2	0	2	0	0	38052	2
2	0	2	0	0	38053	2
2	0	2	0	0	38054	2
2	22	2	0	22	38055	0
2	100	2	262	362	38056	1
2	0	2	4	4	38057	2
2	0	2	0	0	38058	2
2	26	2	5	31	38059	1
2	0	2	40	40	38060	2
0	0	4	230	230	38061	2
0	0	4	230	230	38062	2
2	0	2	0	0	38063	2
2	0	2	0	0	38064	2
2	0	2	0	0	38065	2
2	3	2	101	104	38066	0
2	0	2	0	0	38067	2
2	2	2	0	2	38068	0
2	173	2	12	185	38069	1
2	0	2	0	0	38070	2
2	0	2	0	0	38071	2
2	7	2	0	7	38072	0
2	0	2	0	0	38073	2
2	0	2	0	0	38074	2
2	0	2	0	0	38075	2
2	0	2	0	0	38076	2
2	0	2	0	0	38077	2
2	0	2	0	0	38078	2
2	0	2	0	0	38079	2
2	0	2	0	0	38080	2
2	0	2	0	0	38081	2
2	0	2	0	0	38082	2
2	0	2	0	0	38083	2
2	0	2	0	0	38084	2
2	0	2	0	0	38085	2
2	0	4	57	57	38086	2
2	0	2	0	0	38087	2
2	0	2	0	0	38088	2
2	0	4	28	28	38089	2
2	0	2	0	0	38090	2
2	0	2	0	0	38091	2
2	0	4	12	12	38092	2
2	0	2	0	0	38093	2
2	0	2	0	0	38094	2
2	0	4	4	4	38095	2
2	0	2	0	0	38096	2
4	0	2	0	0	38097	2
2	0	2	0	0	38098	2
2	0	2	0	0	38099	2
2	0	2	0	0	38100	2
2	0	2	0	0	38101	2
2	0	2	0	0	38102	2
2	0	2	0	0	38103	2
2	0	2	0	0	38104	2
2	0	2	0	0	38105	2
2	0	2	0	0	38106	2
2	0	2	0	0	38107	2
2	0	2	0	0	38108	2
2	0	2	0	0	38109	2
2	0	2	0	0	38110	2
2	0	2	0	0	38111	2
2	0	2	0	0	38112	2
2	0	2	0	0	38113	2
2	0	2	0	0	38114	2
2	0	2	0	0	38115	2
2	0	2	0	0	38116	2
2	0	4	1	1	38117	2
2	0	2	0	0	38118	2
2	0	2	0	0	38119	2
2	0	4	0	0	38120	2
2	0	2	0	0	38121	2
2	0	2	0	0	38122	2
2	0	2	0	0	38123	2
2	0	2	0	0	38124	2
2	0	2	0	0	38125	2
2	0	2	0	0	38126	2
2	0	2	0	0	38127	2
2	0	2	0	0	38128	2
2	0	2	0	0	38129	2
2	0	2	0	0	38130	2
2	0	2	0	0	38131	2
2	0	2	0	0	38132	2
2	0	2	0	0	38133	2
2	0	2	0	0	38134	2
2	1	2	0	1	38135	0
2	0	2	0	0	38136	2
2	0	2	0	0	38137	2
2	0	2	0	0	38138	2
2	0	2	0	0	38139	2
2	0	2	0	0	38140	2
2	0	2	0	0	38141	2
2	0	4	0	0	38142	2
2	0	2	0	0	38143	2
2	0	2	0	0	38144	2
2	0	4	0	0	38145	2
2	0	2	0	0	38146	2
4	0	2	0	0	38147	2
2	0	2	0	0	38148	2
2	0	2	1	1	38149	2
2	0	2	0	0	38150	2
2	0	2	0	0	38151	2
2	0	2	1	1	38152	2
2	0	2	0	0	38153	2
2	1	0	18	19	38154	1
2	0	2	0	0	38155	2
2	0	2	0	0	38156	2
2	1	4	4	5	38157	1
2	0	2	2	2	38158	2
2	2	2	2	4	38159	0
4	0	4	0	0	38160	2
4	0	4	0	0	38161	2
2	0	2	0	0	38162	2
2	0	2	0	0	38163	2
2	0	2	0	0	38164	2
2	0	2	0	0	38165	2
2	0	2	2	2	38166	2
2	0	2	0	0	38167	2
2	0	2	0	0	38168	2
2	0	2	0	0	38169	2
2	0	2	0	0	38170	2
2	0	2	0	0	38171	2
2	0	2	0	0	38172	2
2	0	2	0	0	38173	2
2	0	2	0	0	38174	2
2	0	2	0	0	38175	2
2	0	2	0	0	38176	2
2	0	2	0	0	38177	2
2	0	2	0	0	38178	2
2	0	2	0	0	38179	2
2	0	2	0	0	38180	2
2	0	4	45	45	38181	2
2	0	2	0	0	38182	2
2	0	2	0	0	38183	2
2	0	4	44	44	38184	2
2	0	2	0	0	38185	2
4	0	2	0	0	38186	2
2	0	2	0	0	38187	2
2	0	2	0	0	38188	2
2	0	2	0	0	38189	2
2	0	2	0	0	38190	2
2	0	2	0	0	38191	2
2	0	2	0	0	38192	2
2	0	2	0	0	38193	2
2	0	2	0	0	38194	2
2	0	2	1	1	38195	2
2	0	2	0	0	38196	2
2	0	2	0	0	38197	2
2	0	2	1	1	38198	2
2	0	2	1	1	38199	2
2	0	2	0	0	38200	2
2	0	2	0	0	38201	2
2	0	2	0	0	38202	2
2	0	2	0	0	38203	2
2	0	2	0	0	38204	2
2	0	2	0	0	38205	2
2	0	2	0	0	38206	2
2	0	2	0	0	38207	2
2	0	2	0	0	38208	2
2	0	2	0	0	38209	2
2	0	2	0	0	38210	2
2	0	2	0	0	38211	2
2	0	4	114	114	38212	2
2	0	2	0	0	38213	2
2	0	2	0	0	38214	2
2	1	4	25	26	38215	1
2	0	2	1	1	38216	2
2	0	2	1	1	38217	2
2	39	2	1	40	38218	0
2	1	2	1	2	38219	0
2	1	2	10	11	38220	1
2	0	2	0	0	38221	2
2	0	2	0	0	38222	2
2	1	2	2	3	38223	1
2	19	2	1	20	38224	1
4	7	2	0	7	38225	0
2	25	4	398	423	38226	1
2	0	2	3	3	38227	2
2	0	2	0	0	38228	2
2	9	4	106	115	38229	0
2	0	2	28	28	38230	2
2	0	2	0	0	38231	2
2	0	2	0	0	38232	2
2	0	2	0	0	38233	2
2	0	2	0	0	38234	2
2	0	2	0	0	38235	2
2	0	2	0	0	38236	2
0	0	4	5	5	38237	2
2	0	2	0	0	38238	2
2	0	2	0	0	38239	2
2	0	2	0	0	38240	2
2	0	2	0	0	38241	2
2	0	2	0	0	38242	2
2	0	2	0	0	38243	2
2	0	2	0	0	38244	2
4	0	4	0	0	38245	2
2	0	2	1	1	38246	2
2	0	2	0	0	38247	2
2	0	2	0	0	38248	2
2	0	2	0	0	38249	2
2	0	2	0	0	38250	2
4	0	2	0	0	38251	2
0	16	4	324	340	38252	0
2	0	2	0	0	38253	2
2	0	2	0	0	38254	2
2	0	2	0	0	38255	2
2	0	2	0	0	38256	2
2	0	2	0	0	38257	2
2	0	2	0	0	38258	2
0	0	4	18	18	38259	2
2	0	4	70	70	38260	2
2	0	2	0	0	38261	2
2	0	2	0	0	38262	2
2	0	2	0	0	38263	2
2	0	2	0	0	38264	2
2	0	2	0	0	38265	2
2	0	2	0	0	38266	2
2	0	2	0	0	38267	2
2	0	2	0	0	38268	2
2	0	2	0	0	38269	2
2	0	2	0	0	38270	2
2	0	2	0	0	38271	2
2	0	2	0	0	38272	2
2	0	2	0	0	38273	2
2	0	2	0	0	38274	2
2	0	2	0	0	38275	2
2	0	2	0	0	38276	2
2	0	2	0	0	38277	2
2	0	2	0	0	38278	2
2	0	2	0	0	38279	2
2	0	2	0	0	38280	2
2	0	2	0	0	38281	2
2	0	2	0	0	38282	2
2	0	2	0	0	38283	2
2	0	2	0	0	38284	2
2	0	2	0	0	38285	2
2	0	2	0	0	38286	2
2	0	2	0	0	38287	2
2	0	2	0	0	38288	2
2	0	2	0	0	38289	2
2	0	2	0	0	38290	2
2	0	4	1	1	38291	2
2	0	2	0	0	38292	2
2	0	2	0	0	38293	2
2	0	4	0	0	38294	2
2	0	2	0	0	38295	2
4	14	2	2	16	38296	0
2	0	2	0	0	38297	2
2	0	2	1	1	38298	2
2	0	2	0	0	38299	2
2	0	2	0	0	38300	2
2	0	2	0	0	38301	2
2	0	2	0	0	38302	2
4	1	2	8	9	38303	0
2	0	2	0	0	38304	2
2	0	2	0	0	38305	2
2	0	2	0	0	38306	2
2	0	2	0	0	38307	2
2	0	2	0	0	38308	2
2	0	2	0	0	38309	2
2	0	2	0	0	38310	2
2	0	2	6	6	38311	2
2	0	2	0	0	38312	2
2	0	2	0	0	38313	2
2	0	2	0	0	38314	2
2	0	2	0	0	38315	2
2	0	2	0	0	38316	2
2	0	2	0	0	38317	2
2	0	2	0	0	38318	2
2	0	2	1	1	38319	2
2	0	2	0	0	38320	2
2	0	2	0	0	38321	2
0	19	0	599	618	38322	0
2	0	2	0	0	38323	2
2	0	2	0	0	38324	2
2	0	2	0	0	38325	2
2	0	2	0	0	38326	2
2	0	2	0	0	38327	2
2	0	2	0	0	38328	2
0	0	0	0	0	38329	2
2	0	2	0	0	38330	2
2	0	4	0	0	38331	2
2	0	2	0	0	38332	2
2	0	2	0	0	38333	2
2	0	4	0	0	38334	2
2	0	2	0	0	38335	2
2	0	2	0	0	38336	2
2	0	2	0	0	38337	2
2	0	2	0	0	38338	2
2	0	2	0	0	38339	2
2	0	2	0	0	38340	2
2	0	2	0	0	38341	2
2	0	2	0	0	38342	2
2	0	2	0	0	38343	2
2	0	2	0	0	38344	2
2	0	2	0	0	38345	2
2	0	2	0	0	38346	2
2	0	2	0	0	38347	2
2	0	2	0	0	38348	2
2	0	2	22	22	38349	2
2	0	2	0	0	38350	2
2	0	2	0	0	38351	2
2	0	2	0	0	38352	2
2	0	2	0	0	38353	2
2	0	2	0	0	38354	2
2	0	2	0	0	38355	2
2	0	2	0	0	38356	2
2	0	2	0	0	38357	2
2	0	2	0	0	38358	2
2	0	2	0	0	38359	2
2	0	2	0	0	38360	2
2	0	2	0	0	38361	2
2	0	4	0	0	38362	2
2	0	2	0	0	38363	2
2	0	2	0	0	38364	2
2	0	4	0	0	38365	2
2	0	2	0	0	38366	2
2	0	2	0	0	38367	2
2	0	2	0	0	38368	2
2	0	2	0	0	38369	2
2	0	2	0	0	38370	2
2	0	2	1	1	38371	2
2	0	2	0	0	38372	2
2	0	2	0	0	38373	2
2	0	2	0	0	38374	2
2	0	2	0	0	38375	2
2	0	2	0	0	38376	2
2	0	2	0	0	38377	2
2	0	2	0	0	38378	2
2	0	2	0	0	38379	2
2	0	2	0	0	38380	2
2	0	2	0	0	38381	2
2	0	2	0	0	38382	2
2	0	2	0	0	38383	2
2	0	4	118	118	38384	2
2	0	2	0	0	38385	2
2	0	2	0	0	38386	2
2	0	4	75	75	38387	2
4	0	2	0	0	38388	2
4	0	2	0	0	38389	2
4	10	2	0	10	38390	0
4	0	4	0	0	38391	2
4	0	4	0	0	38392	2
2	0	2	0	0	38393	2
2	0	4	112	112	38394	2
2	0	2	0	0	38395	2
2	0	2	0	0	38396	2
2	0	4	10	10	38397	2
2	0	2	0	0	38398	2
2	0	2	0	0	38399	2
2	0	2	0	0	38400	2
2	0	2	0	0	38401	2
2	0	2	0	0	38402	2
2	0	2	0	0	38403	2
2	0	2	0	0	38404	2
0	0	4	3	3	38405	2
2	172	2	5	177	38406	0
2	1112	2	803	1915	38407	1
2	0	2	126	126	38408	2
2	1	2	13	14	38409	1
2	136	2	51	187	38410	1
2	0	2	160	160	38411	2
2	27	2	2	29	38412	0
2	0	2	0	0	38413	2
2	6	2	4	10	38414	1
2	0	2	0	0	38415	2
2	0	2	0	0	38416	2
2	0	2	0	0	38417	2
2	0	2	0	0	38418	2
2	5	4	1084	1089	38419	1
2	0	2	18	18	38420	2
2	0	2	1	1	38421	2
2	16	4	149	165	38422	0
4	197	2	47	244	38423	0
2	0	2	0	0	38424	2
2	0	2	0	0	38425	2
2	0	2	0	0	38426	2
2	0	2	0	0	38427	2
2	0	2	0	0	38428	2
2	0	2	0	0	38429	2
4	0	2	0	0	38430	2
2	1	2	0	1	38431	1
2	0	2	0	0	38432	2
2	0	2	0	0	38433	2
2	0	2	0	0	38434	2
2	0	2	1	1	38435	2
2	0	2	0	0	38436	2
2	0	2	0	0	38437	2
2	0	2	0	0	38438	2
2	0	2	0	0	38439	2
2	0	2	0	0	38440	2
2	0	2	0	0	38441	2
2	0	2	0	0	38442	2
2	0	2	0	0	38443	2
2	0	2	0	0	38444	2
2	0	2	0	0	38445	2
2	0	2	0	0	38446	2
2	0	2	0	0	38447	2
2	0	2	0	0	38448	2
2	0	2	0	0	38449	2
2	0	0	15	15	38450	2
2	0	2	0	0	38451	2
2	0	2	0	0	38452	2
4	0	2	0	0	38453	2
4	0	2	0	0	38454	2
2	0	0	0	0	38455	2
2	0	2	0	0	38456	2
0	0	0	5	5	38457	2
2	0	2	0	0	38458	2
2	0	2	0	0	38459	2
2	0	2	0	0	38460	2
2	0	2	0	0	38461	2
2	0	2	0	0	38462	2
2	0	2	0	0	38463	2
2	110	2	0	110	38464	0
2	0	2	0	0	38465	2
2	0	2	0	0	38466	2
2	0	2	0	0	38467	2
2	0	2	0	0	38468	2
2	0	2	0	0	38469	2
2	0	2	1	1	38470	2
2	0	2	0	0	38471	2
2	0	2	0	0	38472	2
2	0	4	51	51	38473	2
2	0	2	0	0	38474	2
2	0	2	0	0	38475	2
2	0	4	3	3	38476	2
2	0	2	0	0	38477	2
2	0	4	2	2	38478	2
2	0	2	0	0	38479	2
2	0	2	0	0	38480	2
2	0	4	3	3	38481	2
2	0	2	0	0	38482	2
2	0	2	0	0	38483	2
2	0	2	0	0	38484	2
2	0	2	0	0	38485	2
2	0	2	0	0	38486	2
2	0	2	0	0	38487	2
2	0	2	0	0	38488	2
2	0	2	0	0	38489	2
2	0	2	0	0	38490	2
2	0	2	0	0	38491	2
2	0	2	0	0	38492	2
2	0	2	0	0	38493	2
2	0	2	0	0	38494	2
2	0	2	0	0	38495	2
2	0	4	38	38	38496	2
2	0	2	0	0	38497	2
2	0	2	0	0	38498	2
2	0	4	6	6	38499	2
2	0	2	0	0	38500	2
0	51	4	2641	2692	38501	0
0	0	4	2	2	38502	2
0	0	4	2	2	38503	2
2	0	2	0	0	38504	2
2	0	2	0	0	38505	2
2	0	2	0	0	38506	2
2	0	2	0	0	38507	2
2	0	2	0	0	38508	2
2	0	2	0	0	38509	2
2	0	2	0	0	38510	2
2	0	2	0	0	38511	2
2	0	2	0	0	38512	2
2	0	2	0	0	38513	2
2	0	2	0	0	38514	2
2	0	2	0	0	38515	2
2	0	2	0	0	38516	2
2	0	2	0	0	38517	2
2	0	2	0	0	38518	2
2	0	2	0	0	38519	2
2	0	2	0	0	38520	2
2	0	2	0	0	38521	2
2	0	2	0	0	38522	2
2	0	2	0	0	38523	2
2	0	2	0	0	38524	2
2	0	2	0	0	38525	2
2	0	2	0	0	38526	2
2	0	2	0	0	38527	2
2	0	2	0	0	38528	2
2	0	4	35	35	38529	2
2	0	2	0	0	38530	2
2	0	2	0	0	38531	2
2	0	4	0	0	38532	2
2	0	2	1	1	38533	2
2	0	2	2	2	38534	2
2	0	0	1	1	38535	2
2	0	2	0	0	38536	2
2	0	2	0	0	38537	2
2	0	0	0	0	38538	2
2	0	2	0	0	38539	2
2	0	2	0	0	38540	2
0	0	4	0	0	38541	2
0	0	4	0	0	38542	2
2	0	2	0	0	38543	2
2	0	2	0	0	38544	2
2	1	4	0	1	38545	1
2	0	2	0	0	38546	2
4	0	2	0	0	38547	2
2	2	4	2076	2078	38548	1
2	0	2	9	9	38549	2
2	0	2	1	1	38550	2
2	17	4	760	777	38551	0
2	0	2	0	0	38552	2
4	1324	2	10	1334	38553	0
2	0	2	0	0	38554	2
2	0	4	0	0	38555	2
2	0	2	0	0	38556	2
2	0	2	0	0	38557	2
2	0	4	0	0	38558	2
2	0	2	0	0	38559	2
4	35	4	130	165	38560	1
4	7	4	26	33	38561	1
2	0	2	0	0	38562	2
2	0	2	0	0	38563	2
2	0	2	0	0	38564	2
2	0	2	0	0	38565	2
2	0	2	0	0	38566	2
2	0	2	0	0	38567	2
2	0	2	0	0	38568	2
2	0	2	0	0	38569	2
2	0	2	0	0	38570	2
2	0	2	0	0	38571	2
2	0	2	0	0	38572	2
2	0	2	0	0	38573	2
2	0	2	0	0	38574	2
2	0	2	0	0	38575	2
2	0	2	0	0	38576	2
2	0	2	0	0	38577	2
2	0	2	3	3	38578	2
0	69	4	214	283	38579	0
4	0	4	1	1	38580	2
4	0	4	1	1	38581	2
4	0	2	0	0	38582	2
4	0	2	0	0	38583	2
4	3	2	0	3	38584	0
4	0	4	0	0	38585	2
4	0	4	0	0	38586	2
0	5	4	6	11	38587	0
0	4	2	9	13	38588	0
0	0	2	0	0	38589	2
4	2	2	164	166	38590	0
4	5	2	1	6	38591	0
4	1	2	2451	2452	38592	1
4	8525	2	8	8533	38593	0
4	1645	2	8	1653	38594	0
0	0	4	1	1	38595	2
0	0	4	0	0	38596	2
4	0	4	0	0	38597	2
2	0	2	0	0	38598	2
2	0	2	0	0	38599	2
2	0	2	0	0	38600	2
2	0	2	0	0	38601	2
2	0	2	0	0	38602	2
2	0	2	0	0	38603	2
2	62	2	0	62	38604	0
2	4	2	2077	2081	38605	1
2	0	2	2	2	38606	2
2	0	2	4	4	38607	2
2	1	2	3	4	38608	0
2	0	2	23	23	38609	2
2	0	2	1	1	38610	2
2	0	2	0	0	38611	2
2	0	2	1	1	38612	2
2	0	2	0	0	38613	2
2	0	2	0	0	38614	2
2	1	2	0	1	38615	1
2	4	2	223	227	38616	1
2	0	2	0	0	38617	2
2	0	2	0	0	38618	2
2	1	2	1	2	38619	1
2	0	2	16	16	38620	2
2	0	2	0	0	38621	2
2	0	2	0	0	38622	2
2	0	2	0	0	38623	2
2	0	2	1	1	38624	2
2	0	2	0	0	38625	2
2	0	2	0	0	38626	2
2	8282	2	10	8292	38627	0
2	1	2	5	6	38628	0
2	6	2	23	29	38629	1
2	0	2	29525	29525	38630	2
2	0	2	0	0	38631	2
2	0	2	124	124	38632	2
2	0	2	0	0	38633	2
2	0	2	0	0	38634	2
2	0	2	0	0	38635	2
2	0	7	15	15	38636	2
2	0	2	0	0	38637	2
2	0	2	0	0	38638	2
2	0	4	16	16	38639	2
2	0	2	15	15	38640	2
4	9	2	220	229	38641	1
2	0	2	0	0	38642	2
2	0	2	0	0	38643	2
2	0	2	0	0	38644	2
2	0	2	0	0	38645	2
2	1	2	0	1	38646	1
2	0	2	0	0	38647	2
4	0	4	4	4	38648	2
2	28	2	0	28	38649	0
2	1	2	79	80	38650	1
2	0	2	10	10	38651	2
2	0	2	0	0	38652	2
2	9	2	0	9	38653	0
2	0	2	69	69	38654	2
2	519	2	2	521	38655	0
2	0	2	0	0	38656	2
2	0	2	0	0	38657	2
2	0	2	0	0	38658	2
2	0	2	0	0	38659	2
2	0	2	0	0	38660	2
2	0	2	0	0	38661	2
2	0	2	0	0	38662	2
2	0	2	0	0	38663	2
2	0	2	0	0	38664	2
2	0	2	0	0	38665	2
2	0	2	0	0	38666	2
2	0	2	0	0	38667	2
2	0	2	0	0	38668	2
2	0	2	0	0	38669	2
2	0	2	0	0	38670	2
2	0	2	0	0	38671	2
2	0	2	0	0	38672	2
2	0	2	0	0	38673	2
2	0	2	0	0	38674	2
2	0	2	0	0	38675	2
2	0	2	0	0	38676	2
2	0	2	0	0	38677	2
2	0	2	0	0	38678	2
2	0	2	0	0	38679	2
2	0	2	0	0	38680	2
2	0	2	0	0	38681	2
2	0	2	0	0	38682	2
2	0	2	0	0	38683	2
2	0	2	0	0	38684	2
2	0	2	0	0	38685	2
4	0	4	0	0	38686	2
4	0	4	0	0	38687	2
2	0	2	0	0	38688	2
2	0	2	0	0	38689	2
2	0	2	0	0	38690	2
2	0	2	0	0	38691	2
2	0	2	0	0	38692	2
2	0	2	0	0	38693	2
2	0	2	0	0	38694	2
2	0	2	0	0	38695	2
2	0	2	0	0	38696	2
2	0	2	0	0	38697	2
2	0	2	0	0	38698	2
2	0	2	0	0	38699	2
4	0	4	0	0	38700	2
4	1	4	0	1	38701	1
2	0	2	0	0	38702	2
2	0	2	0	0	38703	2
2	0	2	0	0	38704	2
2	0	2	0	0	38705	2
2	0	2	0	0	38706	2
2	0	2	0	0	38707	2
2	0	2	0	0	38708	2
2	0	2	0	0	38709	2
2	0	2	0	0	38710	2
2	0	2	0	0	38711	2
2	0	2	0	0	38712	2
2	0	2	0	0	38713	2
2	0	2	0	0	38714	2
2	1	2	0	1	38715	1
2	0	2	0	0	38716	2
2	0	2	0	0	38717	2
2	0	2	0	0	38718	2
2	0	2	0	0	38719	2
2	9	2	0	9	38720	0
2	32	2	117	149	38721	1
2	0	2	0	0	38722	2
2	0	2	0	0	38723	2
2	3	2	1	4	38724	1
2	0	2	7	7	38725	2
2	0	2	0	0	38726	2
2	0	2	0	0	38727	2
2	0	2	0	0	38728	2
2	0	2	0	0	38729	2
2	0	2	0	0	38730	2
2	0	2	0	0	38731	2
2	0	2	0	0	38732	2
2	0	2	3	3	38733	2
2	0	2	0	0	38734	2
2	0	2	0	0	38735	2
0	0	2	0	0	38736	2
0	0	2	0	0	38737	2
2	0	2	0	0	38738	2
2	0	2	0	0	38739	2
2	0	2	0	0	38740	2
2	0	2	0	0	38741	2
2	0	2	0	0	38742	2
2	0	2	0	0	38743	2
2	0	2	0	0	38744	2
2	0	2	0	0	38745	2
2	0	2	0	0	38746	2
2	0	2	1	1	38747	2
2	0	2	0	0	38748	2
2	0	2	0	0	38749	2
2	0	2	0	0	38750	2
2	0	2	0	0	38751	2
2	0	2	0	0	38752	2
2	0	2	0	0	38753	2
2	0	2	0	0	38754	2
2	0	2	0	0	38755	2
2	0	2	0	0	38756	2
2	0	2	0	0	38757	2
4	0	4	0	0	38758	2
4	0	4	0	0	38759	2
4	0	4	0	0	38760	2
4	0	4	0	0	38761	2
4	0	4	0	0	38762	2
4	0	4	0	0	38763	2
4	4	4	1	5	38764	1
4	0	4	0	0	38765	2
2	1	2	0	1	38766	0
2	1	2	39	40	38767	1
2	0	2	0	0	38768	2
2	0	2	0	0	38769	2
2	0	2	0	0	38770	2
2	0	2	3	3	38771	2
2	1	2	0	1	38772	0
2	0	2	15	15	38773	2
2	0	2	0	0	38774	2
2	0	2	0	0	38775	2
2	0	2	1	1	38776	2
2	0	2	0	0	38777	2
2	0	2	0	0	38778	2
2	0	2	1	1	38779	2
2	0	2	0	0	38780	2
2	0	2	0	0	38781	2
2	0	2	0	0	38782	2
2	0	2	0	0	38783	2
2	1	2	0	1	38784	0
2	0	2	2	2	38785	2
2	0	2	0	0	38786	2
2	0	2	0	0	38787	2
2	0	2	0	0	38788	2
2	0	2	0	0	38789	2
2	0	4	1855	1855	38790	2
2	1	2	0	1	38791	0
2	0	2	26	26	38792	2
2	0	2	0	0	38793	2
2	0	2	0	0	38794	2
2	0	2	0	0	38795	2
2	0	2	0	0	38796	2
4	0	4	0	0	38797	2
4	0	4	0	0	38798	2
2	0	2	0	0	38799	2
2	0	2	0	0	38800	2
2	0	2	0	0	38801	2
2	0	2	0	0	38802	2
2	0	2	0	0	38803	2
2	0	2	1	1	38804	2
2	0	2	0	0	38805	2
2	0	2	0	0	38806	2
2	0	2	0	0	38807	2
2	0	2	0	0	38808	2
2	0	2	0	0	38809	2
2	0	2	0	0	38810	2
2	0	2	0	0	38811	2
2	0	2	0	0	38812	2
2	0	2	0	0	38813	2
2	0	2	0	0	38814	2
2	0	2	0	0	38815	2
2	0	2	0	0	38816	2
4	0	2	0	0	38817	2
4	0	2	0	0	38818	2
2	0	2	0	0	38819	2
2	0	2	1	1	38820	2
2	0	2	0	0	38821	2
2	0	2	0	0	38822	2
2	0	2	0	0	38823	2
2	0	2	0	0	38824	2
4	23	2	1	24	38825	0
4	0	2	0	0	38826	2
2	1	2	0	1	38827	0
2	1	2	5	6	38828	1
2	0	2	0	0	38829	2
2	0	2	0	0	38830	2
2	0	2	0	0	38831	2
2	0	2	0	0	38832	2
2	0	2	0	0	38833	2
2	0	2	0	0	38834	2
2	0	2	0	0	38835	2
2	0	2	0	0	38836	2
2	0	2	0	0	38837	2
2	0	2	0	0	38838	2
2	1	2	0	1	38839	1
2	0	4	148	148	38840	2
2	0	2	0	0	38841	2
2	0	2	0	0	38842	2
0	32	2	8	40	38843	0
0	16	2	0	16	38844	0
2	0	4	175	175	38845	2
2	0	2	7	7	38846	2
2	0	2	0	0	38847	2
2	1	2	1	2	38848	1
2	0	2	0	0	38849	2
2	0	2	0	0	38850	2
2	0	2	0	0	38851	2
2	0	2	0	0	38852	2
2	0	2	0	0	38853	2
2	0	2	0	0	38854	2
2	0	2	0	0	38855	2
2	0	2	0	0	38856	2
2	0	2	0	0	38857	2
2	0	2	0	0	38858	2
2	0	2	0	0	38859	2
2	6	2	10	16	38860	1
2	0	2	0	0	38861	2
2	0	2	0	0	38862	2
2	1	2	0	1	38863	0
2	0	2	9	9	38864	2
2	0	2	0	0	38865	2
2	0	2	345	345	38866	2
2	0	2	0	0	38867	2
2	0	2	0	0	38868	2
2	0	2	27	27	38869	2
2	0	2	1	1	38870	2
4	20756	2	345	21101	38871	0
4	2646	2	27	2673	38872	0
2	0	2	0	0	38873	2
2	1	2	20	21	38874	1
2	0	2	0	0	38875	2
2	0	2	0	0	38876	2
2	0	2	0	0	38877	2
2	0	2	0	0	38878	2
0	730	4	4	734	38879	1
0	9	4	4	13	38880	0
2	0	2	0	0	38881	2
2	0	4	5	5	38882	2
2	0	2	0	0	38883	2
2	0	2	0	0	38884	2
2	0	4	0	0	38885	2
2	0	2	0	0	38886	2
4	0	4	0	0	38887	2
4	0	4	0	0	38888	2
2	1	4	43	44	38889	1
2	0	2	0	0	38890	2
2	0	2	0	0	38891	2
2	1	2	7	8	38892	1
2	0	2	0	0	38893	2
2	0	2	0	0	38894	2
2	0	2	0	0	38895	2
2	0	2	0	0	38896	2
2	0	2	0	0	38897	2
2	0	2	0	0	38898	2
2	0	2	0	0	38899	2
2	0	2	0	0	38900	2
2	0	2	0	0	38901	2
2	0	2	3	3	38902	2
2	0	2	0	0	38903	2
2	0	2	0	0	38904	2
2	0	2	0	0	38905	2
2	0	2	2	2	38906	2
2	1	2	0	1	38907	0
2	0	2	1	1	38908	2
2	0	2	5	5	38909	2
2	0	2	1	1	38910	2
2	0	2	0	0	38911	2
2	0	2	0	0	38912	2
0	47	2	1	48	38913	0
0	66	2	1	67	38914	0
2	0	2	0	0	38915	2
2	0	2	0	0	38916	2
2	0	2	0	0	38917	2
2	0	2	0	0	38918	2
2	0	2	0	0	38919	2
2	0	2	0	0	38920	2
2	0	2	0	0	38921	2
2	8	2	39	47	38922	1
2	0	2	1	1	38923	2
2	0	2	0	0	38924	2
0	42	2	17	59	38925	0
0	3	2	0	3	38926	0
2	2	2	2	4	38927	1
2	0	4	75	75	38928	2
0	202	2	3	205	38929	0
0	51	2	0	51	38930	0
0	10	2	0	10	38931	0
2	18	2	0	18	38932	0
2	4	4	244	248	38933	1
2	0	2	8	8	38934	2
2	0	2	1	1	38935	2
2	1	4	6	7	38936	1
2	0	2	11	11	38937	2
2	0	2	0	0	38938	2
2	0	4	188	188	38939	2
2	0	2	0	0	38940	2
2	0	2	0	0	38941	2
2	0	4	619	619	38942	2
2	0	2	0	0	38943	2
2	0	2	0	0	38944	2
2	0	2	0	0	38945	2
2	0	2	0	0	38946	2
2	0	2	0	0	38947	2
2	0	2	0	0	38948	2
2	0	2	0	0	38949	2
2	0	2	0	0	38950	2
2	2	2	37	39	38951	1
2	0	2	0	0	38952	2
2	0	2	0	0	38953	2
2	0	2	0	0	38954	2
2	0	2	0	0	38955	2
2	0	2	0	0	38956	2
2	0	2	0	0	38957	2
2	0	2	0	0	38958	2
2	0	2	0	0	38959	2
2	0	2	0	0	38960	2
2	0	2	0	0	38961	2
2	0	2	0	0	38962	2
2	0	2	2	2	38963	2
2	0	2	0	0	38964	2
2	0	2	0	0	38965	2
2	1	2	0	1	38966	0
2	0	2	0	0	38967	2
2	0	4	57	57	38968	2
2	0	2	0	0	38969	2
2	1	2	0	1	38970	0
2	7	2	28	35	38971	1
2	0	2	0	0	38972	2
2	0	2	0	0	38973	2
2	0	2	0	0	38974	2
2	0	2	0	0	38975	2
2	0	2	0	0	38976	2
2	0	2	1	1	38977	2
2	0	2	0	0	38978	2
2	0	2	0	0	38979	2
2	0	2	0	0	38980	2
2	0	2	0	0	38981	2
2	0	2	0	0	38982	2
2	0	2	0	0	38983	2
2	0	2	0	0	38984	2
2	0	2	0	0	38985	2
0	0	3	1	1	38986	2
0	0	3	1	1	38987	2
2	0	2	0	0	38988	2
2	0	2	0	0	38989	2
2	0	2	0	0	38990	2
2	0	2	0	0	38991	2
2	0	2	0	0	38992	2
2	0	2	0	0	38993	2
2	2	2	0	2	38994	0
2	0	2	3	3	38995	2
2	0	2	0	0	38996	2
2	0	2	0	0	38997	2
2	0	2	1	1	38998	2
2	0	2	1	1	38999	2
2	0	2	0	0	39000	2
2	0	2	0	0	39001	2
2	0	2	0	0	39002	2
2	0	2	0	0	39003	2
2	0	2	0	0	39004	2
2	0	2	0	0	39005	2
2	0	2	0	0	39006	2
2	0	2	0	0	39007	2
2	0	2	0	0	39008	2
2	0	2	0	0	39009	2
2	0	2	0	0	39010	2
2	0	2	0	0	39011	2
2	0	2	0	0	39012	2
2	0	2	1	1	39013	2
2	0	2	0	0	39014	2
2	1	2	0	1	39015	0
2	1	2	0	1	39016	0
2	1	2	0	1	39017	0
2	0	2	1	1	39018	2
2	0	2	0	0	39019	2
2	0	2	4	4	39020	2
2	0	2	0	0	39021	2
2	0	2	0	0	39022	2
4	335	2	8	343	39023	0
4	946	2	255	1201	39024	0
4	763	2	86	849	39025	0
2	2	2	6	8	39026	1
2	17	2	24	41	39027	1
4	24	2	25	49	39028	0
4	36	2	3	39	39029	0
4	12	2	0	12	39030	0
0	294	2	2	296	39031	0
0	103	2	15	118	39032	0
0	47	2	1	48	39033	0
2	0	2	0	0	39034	2
2	0	2	7	7	39035	2
2	0	2	0	0	39036	2
2	0	2	0	0	39037	2
2	0	2	0	0	39038	2
2	0	2	0	0	39039	2
4	1	4	0	1	39040	1
4	0	4	0	0	39041	2
4	27	4	22	49	39042	1
4	1	4	1	2	39043	1
2	0	2	0	0	39044	2
2	0	2	3	3	39045	2
2	0	2	0	0	39046	2
2	0	2	0	0	39047	2
2	0	2	0	0	39048	2
2	0	2	0	0	39049	2
2	1	2	0	1	39050	0
2	36	2	2	38	39051	0
2	65	2	910	975	39052	1
2	0	2	9	9	39053	2
2	0	2	0	0	39054	2
2	24	2	3	27	39055	0
2	0	2	128	128	39056	2
2	0	2	0	0	39057	2
2	0	2	1	1	39058	2
2	0	2	0	0	39059	2
2	0	2	0	0	39060	2
2	0	2	0	0	39061	2
2	0	2	0	0	39062	2
2	8	4	16481	16489	39063	1
2	0	2	2	2	39064	2
2	0	2	0	0	39065	2
2	2	4	7311	7313	39066	1
2	0	2	3	3	39067	2
2	0	2	0	0	39068	2
2	0	2	0	0	39069	2
2	0	2	0	0	39070	2
2	0	2	0	0	39071	2
2	0	2	0	0	39072	2
2	0	2	0	0	39073	2
2	0	2	1	1	39074	2
2	0	2	5	5	39075	2
2	0	2	0	0	39076	2
2	0	2	0	0	39077	2
2	0	2	1	1	39078	2
2	0	2	0	0	39079	2
0	6	2	5	11	39080	0
0	7	2	1	8	39081	0
0	0	4	2	2	39082	2
2	0	2	0	0	39083	2
2	0	2	0	0	39084	2
2	0	2	0	0	39085	2
2	0	2	0	0	39086	2
2	0	2	0	0	39087	2
2	0	2	0	0	39088	2
2	155	2	0	155	39089	0
2	20	2	1263	1283	39090	1
2	0	2	2	2	39091	2
2	0	2	0	0	39092	2
2	27	2	3	30	39093	1
2	0	2	135	135	39094	2
0	13	2	0	13	39095	0
0	0	2	0	0	39096	2
0	15	2	0	15	39097	0
2	4	2	0	4	39098	0
2	18	4	57	75	39099	1
2	0	2	1	1	39100	2
2	0	2	0	0	39101	2
2	1	4	3	4	39102	0
2	0	2	8	8	39103	2
2	1	2	0	1	39104	0
2	1	2	6	7	39105	1
2	0	2	0	0	39106	2
2	0	2	0	0	39107	2
2	1	2	0	1	39108	1
2	0	2	2	2	39109	2
2	14	2	0	14	39110	0
2	4	2	115	119	39111	1
2	0	2	0	0	39112	2
2	0	2	1	1	39113	2
2	4	2	2	6	39114	1
2	0	2	17	17	39115	2
2	0	2	0	0	39116	2
2	0	2	5	5	39117	2
2	0	2	0	0	39118	2
2	0	2	0	0	39119	2
2	0	2	1	1	39120	2
2	0	2	1	1	39121	2
2	13	2	0	13	39122	0
2	17	2	671	688	39123	1
2	0	2	0	0	39124	2
2	0	2	0	0	39125	2
2	7	2	105	112	39126	1
2	0	2	7	7	39127	2
2	1	2	1	2	39128	0
2	4	2	212	216	39129	1
2	0	2	0	0	39130	2
2	0	2	1	1	39131	2
0	144	2	9	153	39132	0
0	48	2	5	53	39133	0
2	6	2	31	37	39134	0
2	0	2	71	71	39135	2
2	0	2	0	0	39136	2
2	0	2	0	0	39137	2
2	0	2	0	0	39138	2
2	0	2	0	0	39139	2
2	0	2	0	0	39140	2
2	0	2	0	0	39141	2
2	0	2	0	0	39142	2
2	0	2	2	2	39143	2
2	0	2	0	0	39144	2
2	0	2	0	0	39145	2
2	0	2	0	0	39146	2
2	0	2	0	0	39147	2
2	0	2	0	0	39148	2
2	0	2	0	0	39149	2
0	220	0	0	220	39150	1
6	1	6	0	1	39151	1
0	60	0	0	60	39152	1
2	4	2	0	4	39153	0
2	2	2	93	95	39154	1
2	0	2	1	1	39155	2
2	0	2	0	0	39156	2
2	6	2	0	6	39157	0
2	0	2	7	7	39158	2
2	0	2	0	0	39159	2
2	0	2	0	0	39160	2
2	0	2	0	0	39161	2
2	0	2	0	0	39162	2
2	0	2	0	0	39163	2
2	0	2	0	0	39164	2
2	0	2	0	0	39165	2
2	0	2	0	0	39166	2
2	0	2	0	0	39167	2
2	0	2	0	0	39168	2
2	0	2	0	0	39169	2
2	0	2	0	0	39170	2
2	0	2	0	0	39171	2
2	0	2	0	0	39172	2
2	0	2	0	0	39173	2
2	0	2	0	0	39174	2
2	1	2	0	1	39175	1
2	0	2	0	0	39176	2
2	0	2	0	0	39177	2
2	0	2	0	0	39178	2
2	0	2	0	0	39179	2
2	3	2	0	3	39180	0
2	0	2	2	2	39181	2
2	0	2	0	0	39182	2
2	1	2	0	1	39183	0
2	1	2	6	7	39184	1
2	0	2	1	1	39185	2
2	0	2	0	0	39186	2
2	1	2	1	2	39187	1
2	0	2	0	0	39188	2
2	0	2	2	2	39189	2
2	2	2	0	2	39190	1
2	0	2	0	0	39191	2
2	0	2	0	0	39192	2
2	0	2	0	0	39193	2
2	0	2	0	0	39194	2
2	0	2	0	0	39195	2
2	0	2	2	2	39196	2
2	0	2	0	0	39197	2
2	0	2	0	0	39198	2
2	0	2	0	0	39199	2
2	0	2	1	1	39200	2
2	0	2	0	0	39201	2
2	0	2	1	1	39202	2
2	0	2	0	0	39203	2
2	0	2	0	0	39204	2
2	0	2	0	0	39205	2
2	0	2	0	0	39206	2
2	0	2	0	0	39207	2
2	0	2	0	0	39208	2
2	0	2	0	0	39209	2
2	0	2	0	0	39210	2
2	0	2	0	0	39211	2
2	0	2	0	0	39212	2
2	0	2	0	0	39213	2
2	0	2	3	3	39214	2
2	0	2	0	0	39215	2
2	0	2	0	0	39216	2
2	0	2	2	2	39217	2
2	0	2	0	0	39218	2
2	0	2	0	0	39219	2
2	0	2	3	3	39220	2
2	0	2	0	0	39221	2
2	0	2	0	0	39222	2
2	1	2	0	1	39223	1
2	0	2	2	2	39224	2
2	12	2	0	12	39225	0
2	23	2	29	52	39226	1
2	0	2	1	1	39227	2
2	0	2	0	0	39228	2
2	6	2	717	723	39229	0
2	0	2	6	6	39230	2
2	13	2	0	13	39231	0
2	0	2	2	2	39232	2
2	0	2	0	0	39233	2
2	268	2	1	269	39234	0
2	0	2	23	23	39235	2
2	0	2	4	4	39236	2
2	0	2	0	0	39237	2
2	0	2	0	0	39238	2
2	0	2	0	0	39239	2
2	4	2	0	4	39240	0
2	0	2	0	0	39241	2
2	0	2	0	0	39242	2
2	0	2	0	0	39243	2
2	0	2	0	0	39244	2
2	0	2	0	0	39245	2
2	0	2	2	2	39246	2
2	0	2	0	0	39247	2
2	0	2	0	0	39248	2
2	0	2	0	0	39249	2
2	0	2	0	0	39250	2
2	0	2	0	0	39251	2
2	0	2	0	0	39252	2
2	0	2	126	126	39253	2
2	0	2	0	0	39254	2
2	0	2	0	0	39255	2
2	3	2	0	3	39256	1
2	0	2	7452	7452	39257	2
2	0	2	0	0	39258	2
2	0	2	0	0	39259	2
2	0	2	0	0	39260	2
2	0	2	0	0	39261	2
2	0	2	0	0	39262	2
2	0	2	0	0	39263	2
2	22	2	0	22	39264	0
2	2	2	34	36	39265	1
2	0	2	4	4	39266	2
2	0	2	0	0	39267	2
2	11	2	0	11	39268	0
2	0	2	63	63	39269	2
2	22	2	0	22	39270	0
2	19	2	399	418	39271	1
2	0	2	3	3	39272	2
2	0	2	0	0	39273	2
2	29	2	0	29	39274	1
2	0	2	46	46	39275	2
2	389	2	0	389	39276	0
2	25	2	5773	5798	39277	1
2	0	2	8	8	39278	2
2	0	2	0	0	39279	2
2	57	2	2	59	39280	1
2	0	2	504	504	39281	2
2	0	2	0	0	39282	2
2	3	2	22	25	39283	1
2	0	2	0	0	39284	2
2	0	2	0	0	39285	2
2	0	2	0	0	39286	2
2	0	2	1	1	39287	2
2	127	2	0	127	39288	0
2	0	2	0	0	39289	2
2	0	2	6	6	39290	2
2	0	2	0	0	39291	2
2	0	2	0	0	39292	2
2	0	2	0	0	39293	2
2	0	2	2	2	39294	2
2	4	2	4010	4014	39295	1
2	0	2	10	10	39296	2
2	0	2	2	2	39297	2
2	41	2	16	57	39298	1
2	0	2	134	134	39299	2
2	164	2	0	164	39300	0
2	6	2	0	6	39301	0
2	1	2	49	50	39302	1
2	0	2	0	0	39303	2
2	0	2	0	0	39304	2
2	2	2	0	2	39305	1
2	0	2	8	8	39306	2
2	0	2	0	0	39307	2
2	0	4	11	11	39308	2
2	0	2	0	0	39309	2
2	0	2	0	0	39310	2
2	0	4	12	12	39311	2
2	0	2	0	0	39312	2
2	54	2	1579	1633	39313	1
2	0	2	17	17	39314	2
2	0	2	0	0	39315	2
2	60	2	1	61	39316	0
2	0	2	400	400	39317	2
2	0	2	0	0	39318	2
2	0	2	0	0	39319	2
2	0	2	0	0	39320	2
2	0	2	0	0	39321	2
2	3	2	0	3	39322	0
2	3	2	61	64	39323	1
2	0	2	0	0	39324	2
2	0	2	0	0	39325	2
2	2	2	0	2	39326	0
2	0	2	10	10	39327	2
2	0	2	0	0	39328	2
2	0	4	281	281	39329	2
2	0	2	0	0	39330	2
2	0	2	0	0	39331	2
2	0	4	52	52	39332	2
2	0	2	0	0	39333	2
2	0	2	0	0	39334	2
2	0	2	0	0	39335	2
2	11	2	1	12	39336	0
2	13	2	73	86	39337	1
2	0	2	0	0	39338	2
2	0	2	0	0	39339	2
2	1	2	1	2	39340	1
2	0	2	3	3	39341	2
2	103	2	1	104	39342	0
2	0	2	0	0	39343	2
2	0	2	1	1	39344	2
2	0	2	0	0	39345	2
2	0	2	0	0	39346	2
2	0	2	0	0	39347	2
2	0	2	0	0	39348	2
2	0	2	0	0	39349	2
2	0	2	0	0	39350	2
2	0	2	0	0	39351	2
2	0	2	0	0	39352	2
2	4	2	19	23	39353	1
2	0	2	1	1	39354	2
2	0	2	0	0	39355	2
2	2	2	1	3	39356	0
2	0	2	0	0	39357	2
2	0	2	0	0	39358	2
2	0	2	0	0	39359	2
2	0	2	0	0	39360	2
2	0	2	1	1	39361	2
2	0	2	0	0	39362	2
2	33	2	0	33	39363	0
2	2	2	0	2	39364	0
2	2	2	15	17	39365	1
2	0	2	0	0	39366	2
2	0	2	0	0	39367	2
2	3	2	0	3	39368	0
2	0	2	5	5	39369	2
2	143	2	0	143	39370	0
2	29	2	283	312	39371	1
2	0	2	21	21	39372	2
2	0	2	0	0	39373	2
2	18	2	0	18	39374	0
2	0	2	187	187	39375	2
2	0	2	0	0	39376	2
2	0	2	0	0	39377	2
2	0	2	0	0	39378	2
2	0	2	0	0	39379	2
2	0	2	0	0	39380	2
2	0	2	0	0	39381	2
2	2	2	0	2	39382	0
2	0	2	14	14	39383	2
2	0	2	1	1	39384	2
2	0	2	0	0	39385	2
2	1	2	0	1	39386	0
2	0	2	7	7	39387	2
2	1	2	0	1	39388	0
2	0	0	241	241	39389	2
2	0	2	0	0	39390	2
2	0	2	1	1	39391	2
2	0	0	137	137	39392	2
2	0	2	1	1	39393	2
2	0	2	0	0	39394	2
2	0	2	0	0	39395	2
2	0	2	0	0	39396	2
2	30	2	0	30	39397	0
2	63	2	55	118	39398	1
2	0	2	6	6	39399	2
2	0	2	0	0	39400	2
2	4	2	0	4	39401	0
2	0	2	20	20	39402	2
2	1	2	0	1	39403	0
2	1	2	4	5	39404	1
2	0	2	0	0	39405	2
2	0	2	0	0	39406	2
2	0	2	0	0	39407	2
2	0	2	1	1	39408	2
2	0	2	0	0	39409	2
2	0	2	5	5	39410	2
2	0	2	0	0	39411	2
2	0	2	0	0	39412	2
2	0	2	0	0	39413	2
2	0	2	0	0	39414	2
2	0	2	0	0	39415	2
2	0	0	2	2	39416	2
2	0	2	0	0	39417	2
2	0	2	0	0	39418	2
2	0	0	1	1	39419	2
2	0	2	0	0	39420	2
2	1	2	0	1	39421	0
2	6	2	22	28	39422	1
2	0	2	0	0	39423	2
2	0	2	0	0	39424	2
0	23	2	1	24	39425	0
0	44	2	0	44	39426	0
2	3	2	1	4	39427	0
2	0	2	0	0	39428	2
2	12	2	0	12	39429	0
2	2	2	37	39	39430	1
2	0	2	3	3	39431	2
2	0	2	0	0	39432	2
2	1	2	3	4	39433	0
2	0	2	24	24	39434	2
2	16	2	0	16	39435	0
2	0	2	0	0	39436	2
2	0	2	0	0	39437	2
2	0	2	0	0	39438	2
2	0	2	7	7	39439	2
2	0	2	0	0	39440	2
2	0	2	0	0	39441	2
2	1	2	0	1	39442	0
2	0	2	2	2	39443	2
2	13	2	0	13	39444	0
2	10	2	124	134	39445	1
2	0	2	2	2	39446	2
2	0	2	0	0	39447	2
2	7	2	0	7	39448	1
2	0	2	34	34	39449	2
2	14	2	0	14	39450	0
2	15	2	235	250	39451	1
2	0	2	1	1	39452	2
2	0	2	0	0	39453	2
2	12	2	0	12	39454	0
2	0	2	34	34	39455	2
2	374	2	0	374	39456	0
2	1	2	2081	2082	39457	1
2	11	2	10868	10879	39458	0
2	3	2	0	3	39459	0
2	1	2	0	1	39460	0
2	0	2	30	30	39461	2
2	0	2	0	0	39462	2
2	0	2	0	0	39463	2
2	1	2	1	2	39464	0
2	0	2	5	5	39465	2
2	6	2	1	7	39466	0
2	0	2	3	3	39467	2
2	0	2	0	0	39468	2
2	0	2	0	0	39469	2
2	0	2	0	0	39470	2
2	0	2	0	0	39471	2
2	0	2	0	0	39472	2
2	1	2	0	1	39473	0
2	0	2	1	1	39474	2
2	103	2	1	104	39475	0
2	91	2	824	915	39476	1
2	0	2	19	19	39477	2
2	0	2	0	0	39478	2
2	49	2	0	49	39479	0
2	0	2	304	304	39480	2
2	1	2	5	6	39481	1
2	0	2	1	1	39482	2
2	0	2	0	0	39483	2
2	8	2	0	8	39484	0
2	291	2	1	292	39485	0
2	72	2	752	824	39486	1
2	0	2	13	13	39487	2
2	0	2	1	1	39488	2
2	34	2	1	35	39489	0
2	0	2	229	229	39490	2
2	0	2	0	0	39491	2
2	0	2	3	3	39492	2
2	0	2	0	0	39493	2
2	0	2	0	0	39494	2
2	0	2	0	0	39495	2
2	0	2	0	0	39496	2
2	0	2	0	0	39497	2
2	0	2	6	6	39498	2
2	0	2	0	0	39499	2
2	0	2	0	0	39500	2
2	1	2	0	1	39501	1
2	0	2	4	4	39502	2
2	10	2	0	10	39503	0
2	0	2	136	136	39504	2
2	0	2	1	1	39505	2
2	0	2	0	0	39506	2
2	0	2	0	0	39507	2
2	0	2	1	1	39508	2
2	1	2	0	1	39509	0
2	0	2	11	11	39510	2
2	0	2	0	0	39511	2
2	0	2	0	0	39512	2
2	0	2	0	0	39513	2
2	0	2	2	2	39514	2
2	0	2	1	1	39515	2
2	1	2	14	15	39516	1
2	0	2	0	0	39517	2
2	0	2	0	0	39518	2
2	0	2	0	0	39519	2
2	1	2	4	5	39520	1
2	0	2	0	0	39521	2
2	0	2	0	0	39522	2
2	0	2	0	0	39523	2
2	0	2	0	0	39524	2
2	0	2	0	0	39525	2
2	0	2	0	0	39526	2
2	11	2	0	11	39527	0
2	0	2	0	0	39528	2
2	0	2	0	0	39529	2
0	200	2	30	230	39530	0
0	268	2	0	268	39531	0
0	174	2	1	175	39532	0
2	3	2	0	3	39533	0
2	2	2	0	2	39534	0
2	0	2	5	5	39535	2
2	0	2	12	12	39536	2
2	0	2	1	1	39537	2
2	0	2	0	0	39538	2
2	9	2	0	9	39539	0
2	0	2	6	6	39540	2
2	0	2	0	0	39541	2
2	0	2	0	0	39542	2
2	2	2	0	2	39543	0
2	0	2	14	14	39544	2
2	0	2	0	0	39545	2
2	11	2	14	25	39546	1
2	0	2	1	1	39547	2
2	0	2	0	0	39548	2
2	11	2	0	11	39549	0
2	0	2	3	3	39550	2
2	3	2	0	3	39551	0
2	0	2	51	51	39552	2
2	0	2	0	0	39553	2
2	0	2	0	0	39554	2
2	0	2	5	5	39555	2
2	0	2	5	5	39556	2
2	166	2	0	166	39557	0
2	0	2	0	0	39558	2
2	0	2	0	0	39559	2
2	0	2	0	0	39560	2
2	0	2	0	0	39561	2
0	0	2	0	0	39562	2
0	1	2	0	1	39563	1
2	0	2	1	1	39564	2
2	0	2	0	0	39565	2
2	44	2	5636	5680	39566	1
2	0	2	9	9	39567	2
2	0	2	4	4	39568	2
2	0	2	0	0	39569	2
2	0	0	6	6	39570	2
2	0	2	0	0	39571	2
2	0	2	0	0	39572	2
2	0	0	1	1	39573	2
2	0	2	0	0	39574	2
2	0	2	0	0	39575	2
2	1	2	97	98	39576	1
2	0	2	0	0	39577	2
2	0	2	0	0	39578	2
2	0	2	74	74	39579	2
2	0	2	1	1	39580	2
2	81	2	1	82	39581	1
2	0	2	631	631	39582	2
2	0	2	0	0	39583	2
2	0	4	14	14	39584	2
2	0	2	0	0	39585	2
2	0	2	0	0	39586	2
2	0	4	0	0	39587	2
2	0	2	0	0	39588	2
2	0	2	0	0	39589	2
2	0	2	0	0	39590	2
2	0	2	0	0	39591	2
2	0	2	0	0	39592	2
2	0	2	0	0	39593	2
2	0	2	0	0	39594	2
2	0	2	0	0	39595	2
2	0	2	1	1	39596	2
2	0	2	0	0	39597	2
2	0	2	0	0	39598	2
2	0	2	0	0	39599	2
2	0	2	1	1	39600	2
2	0	2	0	0	39601	2
2	0	2	1	1	39602	2
2	0	2	0	0	39603	2
2	0	2	0	0	39604	2
2	0	2	0	0	39605	2
0	0	2	1	1	39606	2
0	0	2	0	0	39607	2
2	0	2	0	0	39608	2
2	0	2	1	1	39609	2
2	0	2	0	0	39610	2
2	0	2	0	0	39611	2
2	0	2	0	0	39612	2
2	0	2	0	0	39613	2
4	165	2	1	166	39614	0
4	28	2	0	28	39615	0
2	0	2	0	0	39616	2
2	1	2	3	4	39617	1
2	0	2	0	0	39618	2
2	0	2	0	0	39619	2
2	3	2	0	3	39620	0
2	0	2	1	1	39621	2
2	0	2	0	0	39622	2
2	0	2	0	0	39623	2
2	0	2	0	0	39624	2
2	0	2	0	0	39625	2
2	0	2	0	0	39626	2
2	0	2	1	1	39627	2
2	0	2	0	0	39628	2
2	0	2	42	42	39629	2
2	0	2	0	0	39630	2
2	0	2	0	0	39631	2
2	0	2	107	107	39632	2
2	0	2	0	0	39633	2
2	0	2	1	1	39634	2
2	0	2	0	0	39635	2
4	17716	2	42	17758	39636	0
4	2874	2	107	2981	39637	0
2	0	2	0	0	39638	2
2	0	2	0	0	39639	2
2	0	2	0	0	39640	2
2	0	2	0	0	39641	2
2	0	2	0	0	39642	2
2	0	2	0	0	39643	2
2	0	2	0	0	39644	2
2	0	2	0	0	39645	2
2	0	2	0	0	39646	2
2	0	2	0	0	39647	2
2	0	2	0	0	39648	2
2	0	2	0	0	39649	2
2	0	2	0	0	39650	2
2	0	2	0	0	39651	2
2	0	2	0	0	39652	2
2	0	2	0	0	39653	2
2	0	2	55	55	39654	2
2	0	2	0	0	39655	2
2	0	2	0	0	39656	2
2	0	2	0	0	39657	2
2	0	2	4	4	39658	2
2	0	2	0	0	39659	2
2	0	2	0	0	39660	2
2	0	2	0	0	39661	2
2	0	2	0	0	39662	2
2	3	4	35	38	39663	1
2	0	2	0	0	39664	2
2	0	2	0	0	39665	2
2	0	4	4	4	39666	2
2	0	2	0	0	39667	2
4	0	2	0	0	39668	2
2	0	2	0	0	39669	2
2	0	2	0	0	39670	2
2	0	2	0	0	39671	2
2	0	2	0	0	39672	2
2	0	2	0	0	39673	2
2	0	2	0	0	39674	2
2	0	2	0	0	39675	2
2	0	2	0	0	39676	2
2	0	2	0	0	39677	2
2	0	2	5	5	39678	2
2	0	2	0	0	39679	2
2	1	2	0	1	39680	0
2	0	2	50	50	39681	2
2	0	2	0	0	39682	2
2	0	2	0	0	39683	2
2	4	2	4	8	39684	0
2	0	2	11	11	39685	2
2	0	2	0	0	39686	2
2	0	2	0	0	39687	2
2	0	2	0	0	39688	2
2	0	2	0	0	39689	2
2	0	0	10	10	39690	2
2	0	2	0	0	39691	2
2	0	2	0	0	39692	2
2	0	0	0	0	39693	2
2	0	2	0	0	39694	2
2	0	2	0	0	39695	2
2	2	2	0	2	39696	1
2	0	2	0	0	39697	2
2	0	2	0	0	39698	2
2	0	2	0	0	39699	2
2	0	2	0	0	39700	2
2	0	2	0	0	39701	2
2	0	2	0	0	39702	2
2	0	2	0	0	39703	2
2	0	2	0	0	39704	2
2	0	2	0	0	39705	2
2	0	2	0	0	39706	2
2	1	2	1	2	39707	0
2	3	2	15	18	39708	1
2	0	2	2	2	39709	2
2	0	2	0	0	39710	2
2	0	2	0	0	39711	2
2	0	2	7	7	39712	2
2	0	2	0	0	39713	2
2	0	2	0	0	39714	2
2	0	2	0	0	39715	2
2	0	2	0	0	39716	2
2	0	2	0	0	39717	2
2	0	2	1	1	39718	2
2	0	2	0	0	39719	2
2	0	2	0	0	39720	2
2	0	2	0	0	39721	2
2	0	2	0	0	39722	2
2	0	2	0	0	39723	2
2	0	2	0	0	39724	2
2	3	2	0	3	39725	0
2	2	2	9	11	39726	1
2	0	2	0	0	39727	2
2	0	2	0	0	39728	2
2	0	2	0	0	39729	2
2	0	2	3	3	39730	2
2	4	2	0	4	39731	0
2	0	2	0	0	39732	2
2	0	2	0	0	39733	2
2	0	2	0	0	39734	2
2	0	2	0	0	39735	2
2	0	2	0	0	39736	2
2	0	2	0	0	39737	2
2	0	2	1	1	39738	2
2	0	2	0	0	39739	2
2	0	2	0	0	39740	2
2	2	2	0	2	39741	0
2	21	2	52	73	39742	1
2	0	2	0	0	39743	2
2	0	2	0	0	39744	2
2	3	2	1	4	39745	1
2	0	2	1	1	39746	2
4	7578	2	52	7630	39747	0
4	930	2	1	931	39748	0
2	0	2	2	2	39749	2
2	0	2	0	0	39750	2
2	0	2	28	28	39751	2
2	0	2	0	0	39752	2
2	0	2	0	0	39753	2
2	1	2	0	1	39754	0
2	0	2	6	6	39755	2
2	0	2	194	194	39756	2
2	0	2	0	0	39757	2
2	0	2	19	19	39758	2
2	355	2	1	356	39759	0
2	0	2	0	0	39760	2
2	0	2	0	0	39761	2
2	0	2	0	0	39762	2
2	0	2	0	0	39763	2
2	0	2	0	0	39764	2
2	0	2	0	0	39765	2
2	228	2	1070	1298	39766	1
2	0	2	72	72	39767	2
2	0	2	1	1	39768	2
2	465	2	12239	12704	39769	1
2	0	2	441	441	39770	2
2	0	2	0	0	39771	2
2	0	2	0	0	39772	2
2	0	2	0	0	39773	2
2	0	2	0	0	39774	2
2	0	2	0	0	39775	2
2	0	2	0	0	39776	2
4	1	2	0	1	39777	0
2	0	2	0	0	39778	2
2	0	2	0	0	39779	2
2	0	2	0	0	39780	2
2	0	2	0	0	39781	2
2	0	2	0	0	39782	2
2	0	2	0	0	39783	2
2	0	2	0	0	39784	2
2	0	2	0	0	39785	2
2	0	2	0	0	39786	2
2	0	2	0	0	39787	2
2	0	2	0	0	39788	2
2	0	2	0	0	39789	2
4	77	4	8	85	39790	0
2	0	2	0	0	39791	2
2	0	2	3	3	39792	2
2	0	2	0	0	39793	2
2	0	2	0	0	39794	2
2	0	2	0	0	39795	2
2	0	2	0	0	39796	2
2	1	2	0	1	39797	0
2	1	2	26	27	39798	1
2	0	2	0	0	39799	2
2	0	2	0	0	39800	2
2	0	2	1	1	39801	2
2	0	2	2	2	39802	2
2	9	2	0	9	39803	0
2	0	2	0	0	39804	2
2	0	2	0	0	39805	2
2	0	2	0	0	39806	2
2	0	2	0	0	39807	2
2	0	2	0	0	39808	2
2	0	2	0	0	39809	2
2	0	2	0	0	39810	2
2	0	2	0	0	39811	2
2	1	2	0	1	39812	0
2	0	2	2	2	39813	2
2	0	2	0	0	39814	2
2	12	2	1	13	39815	0
2	179	2	55	234	39816	1
2	0	2	0	0	39817	2
2	0	2	0	0	39818	2
2	27	2	0	27	39819	1
2	0	2	48	48	39820	2
2	0	2	0	0	39821	2
2	0	2	0	0	39822	2
2	0	2	0	0	39823	2
2	0	2	0	0	39824	2
2	0	2	0	0	39825	2
2	0	2	0	0	39826	2
2	47	2	0	47	39827	0
2	0	2	646	646	39828	2
2	0	2	0	0	39829	2
2	0	2	0	0	39830	2
2	0	2	0	0	39831	2
2	0	2	7	7	39832	2
2	0	2	0	0	39833	2
2	0	2	16	16	39834	2
2	0	2	0	0	39835	2
2	0	2	0	0	39836	2
2	0	2	0	0	39837	2
2	0	2	3	3	39838	2
2	4	2	0	4	39839	0
2	0	2	0	0	39840	2
2	0	2	0	0	39841	2
2	0	2	0	0	39842	2
2	271	2	1	272	39843	0
2	0	2	0	0	39844	2
2	0	2	0	0	39845	2
2	0	2	0	0	39846	2
2	0	2	0	0	39847	2
2	11	2	0	11	39848	0
2	0	2	89	89	39849	2
2	0	2	0	0	39850	2
2	0	2	0	0	39851	2
2	0	2	0	0	39852	2
2	0	2	4	4	39853	2
2	444	2	1	445	39854	0
2	450	2	2172	2622	39855	1
2	0	2	87	87	39856	2
2	0	2	4	4	39857	2
2	132	2	15	147	39858	0
2	1	2	5	6	39859	0
2	7	2	0	7	39860	0
2	0	2	46	46	39861	2
2	0	2	1	1	39862	2
2	0	2	0	0	39863	2
2	0	2	1	1	39864	2
2	0	2	8	8	39865	2
2	0	2	0	0	39866	2
2	0	2	2	2	39867	2
2	0	2	0	0	39868	2
2	0	2	0	0	39869	2
2	0	2	0	0	39870	2
2	0	2	0	0	39871	2
4	20	2	2	22	39872	0
4	23	2	0	23	39873	0
2	0	2	0	0	39874	2
2	0	2	8	8	39875	2
2	0	2	0	0	39876	2
2	0	2	0	0	39877	2
2	0	2	0	0	39878	2
2	0	2	0	0	39879	2
2	2	2	0	2	39880	0
2	0	2	8	8	39881	2
2	0	2	1	1	39882	2
2	0	2	0	0	39883	2
2	0	2	0	0	39884	2
2	0	2	5	5	39885	2
2	0	2	0	0	39886	2
2	1	2	1	2	39887	1
2	0	2	0	0	39888	2
2	0	2	0	0	39889	2
2	0	2	0	0	39890	2
2	0	2	2	2	39891	2
2	0	2	0	0	39892	2
2	0	2	0	0	39893	2
2	0	2	0	0	39894	2
2	0	2	0	0	39895	2
2	0	2	0	0	39896	2
2	0	2	0	0	39897	2
2	1	2	0	1	39898	0
2	1	0	204	205	39899	1
2	0	2	0	0	39900	2
2	0	2	0	0	39901	2
2	1	0	17	18	39902	1
2	0	2	3	3	39903	2
2	0	2	0	0	39904	2
2	0	2	0	0	39905	2
2	0	2	0	0	39906	2
2	0	2	0	0	39907	2
2	0	2	0	0	39908	2
2	0	2	0	0	39909	2
2	0	2	0	0	39910	2
2	0	2	0	0	39911	2
2	0	2	0	0	39912	2
2	0	2	0	0	39913	2
2	0	2	0	0	39914	2
2	0	2	0	0	39915	2
2	0	2	0	0	39916	2
2	0	2	0	0	39917	2
2	0	2	0	0	39918	2
2	1	2	0	1	39919	0
2	0	2	47	47	39920	2
2	0	2	592	592	39921	2
2	1	2	0	1	39922	0
2	0	2	2	2	39923	2
2	0	2	0	0	39924	2
2	0	2	0	0	39925	2
2	0	2	0	0	39926	2
2	0	2	0	0	39927	2
2	0	2	0	0	39928	2
2	0	2	0	0	39929	2
2	0	2	0	0	39930	2
2	0	2	0	0	39931	2
2	0	2	0	0	39932	2
2	0	2	0	0	39933	2
2	139	2	2	141	39934	0
2	0	2	2	2	39935	2
2	0	2	5	5	39936	2
2	0	2	0	0	39937	2
2	0	2	0	0	39938	2
2	0	2	0	0	39939	2
2	0	2	0	0	39940	2
2	0	2	0	0	39941	2
2	0	2	0	0	39942	2
2	0	2	0	0	39943	2
2	2	2	51	53	39944	1
2	0	2	0	0	39945	2
2	0	2	0	0	39946	2
2	0	2	2	2	39947	2
2	67	2	0	67	39948	0
2	0	2	88	88	39949	2
2	0	2	0	0	39950	2
2	0	2	0	0	39951	2
2	0	2	0	0	39952	2
2	0	2	0	0	39953	2
2	0	2	0	0	39954	2
2	0	2	0	0	39955	2
2	0	2	0	0	39956	2
2	0	2	0	0	39957	2
2	0	2	0	0	39958	2
2	0	2	0	0	39959	2
2	0	2	0	0	39960	2
2	0	2	0	0	39961	2
2	0	2	0	0	39962	2
2	0	2	0	0	39963	2
2	0	2	0	0	39964	2
2	0	2	0	0	39965	2
2	0	2	0	0	39966	2
2	0	2	0	0	39967	2
2	0	2	0	0	39968	2
2	4	2	0	4	39969	0
2	2	2	51	53	39970	1
2	0	2	1	1	39971	2
2	0	2	0	0	39972	2
2	4	2	0	4	39973	1
2	0	2	14	14	39974	2
2	23	2	0	23	39975	0
2	63	2	403	466	39976	1
2	0	2	4	4	39977	2
2	0	2	0	0	39978	2
2	7	2	2	9	39979	0
2	0	2	106	106	39980	2
2	119	2	1	120	39981	0
2	88	2	869	957	39982	1
2	0	2	6	6	39983	2
2	0	2	1	1	39984	2
2	23	2	26	49	39985	0
2	0	2	75	75	39986	2
2	0	2	0	0	39987	2
2	0	2	16	16	39988	2
2	0	2	0	0	39989	2
2	0	2	0	0	39990	2
2	0	2	5	5	39991	2
2	0	2	0	0	39992	2
2	40	2	1	41	39993	0
2	17	2	0	17	39994	0
2	7	2	44	51	39995	1
2	0	2	2	2	39996	2
2	0	2	0	0	39997	2
2	11	2	0	11	39998	0
2	0	2	68	68	39999	2
2	1	2	0	1	40000	0
2	1	2	0	1	40001	0
2	0	2	3	3	40002	2
2	8	2	9	17	40003	1
2	0	2	0	0	40004	2
2	0	2	0	0	40005	2
2	0	2	0	0	40006	2
2	0	2	0	0	40007	2
2	0	2	0	0	40008	2
2	0	2	0	0	40009	2
2	0	2	0	0	40010	2
2	0	2	1	1	40011	2
2	5	2	0	5	40012	0
2	1	2	13	14	40013	1
2	0	2	0	0	40014	2
2	0	2	0	0	40015	2
2	3	2	0	3	40016	0
2	0	2	9	9	40017	2
2	0	2	2	2	40018	2
2	0	2	0	0	40019	2
2	0	2	0	0	40020	2
2	0	2	2	2	40021	2
2	0	2	0	0	40022	2
2	0	2	0	0	40023	2
2	0	2	0	0	40024	2
2	0	2	3	3	40025	2
2	0	2	0	0	40026	2
2	0	2	1	1	40027	2
2	0	2	0	0	40028	2
2	0	2	0	0	40029	2
0	0	2	0	0	40030	2
0	0	2	0	0	40031	2
2	0	2	1	1	40032	2
2	0	2	1	1	40033	2
2	0	2	1	1	40034	2
2	0	2	0	0	40035	2
2	16	2	1029	1045	40036	1
4	3423	2	16	3439	40037	0
4	1175	2	5	1180	40038	0
2	0	2	14	14	40039	2
2	0	2	0	0	40040	2
2	18	2	0	18	40041	1
2	0	2	126	126	40042	2
2	0	2	0	0	40043	2
2	0	2	0	0	40044	2
2	0	2	0	0	40045	2
2	0	2	0	0	40046	2
2	0	2	0	0	40047	2
2	0	2	0	0	40048	2
2	1	2	0	1	40049	0
2	0	2	4	4	40050	2
2	0	2	0	0	40051	2
2	0	2	0	0	40052	2
2	0	2	0	0	40053	2
2	0	2	4	4	40054	2
2	0	2	0	0	40055	2
2	0	2	47	47	40056	2
2	0	2	0	0	40057	2
2	0	2	0	0	40058	2
2	1	2	3	4	40059	1
2	0	2	10	10	40060	2
2	0	2	0	0	40061	2
2	0	2	0	0	40062	2
2	0	2	0	0	40063	2
2	0	2	0	0	40064	2
2	0	2	0	0	40065	2
2	0	2	0	0	40066	2
2	0	2	0	0	40067	2
2	0	2	0	0	40068	2
2	0	2	0	0	40069	2
4	2	2	0	2	40070	0
4	2	2	0	2	40071	0
2	57	2	0	57	40072	0
2	30	2	385	415	40073	1
2	0	2	11	11	40074	2
2	0	2	0	0	40075	2
2	30	2	0	30	40076	0
2	0	2	234	234	40077	2
2	0	2	0	0	40078	2
2	0	2	0	0	40079	2
2	0	2	0	0	40080	2
2	0	2	0	0	40081	2
2	0	2	0	0	40082	2
2	0	2	0	0	40083	2
2	93	2	0	93	40084	0
2	21	2	96	117	40085	1
2	0	2	15	15	40086	2
2	0	2	0	0	40087	2
2	18	2	0	18	40088	0
2	0	2	139	139	40089	2
2	495	2	4	499	40090	0
2	335	2	3237	3572	40091	1
2	3	2	395	398	40092	1
2	0	2	3	3	40093	2
2	151	2	116	267	40094	1
2	0	2	577	577	40095	2
2	1	2	0	1	40096	0
2	1	2	100	101	40097	1
2	0	2	0	0	40098	2
2	0	2	0	0	40099	2
2	0	2	1	1	40100	2
2	0	2	6	6	40101	2
2	6	2	1	7	40102	0
2	0	2	76	76	40103	2
2	0	2	2	2	40104	2
2	0	2	1	1	40105	2
2	1	2	2	3	40106	1
2	1	2	0	1	40107	0
2	0	2	14	14	40108	2
2	0	2	0	0	40109	2
2	0	2	0	0	40110	2
2	0	2	0	0	40111	2
2	0	2	0	0	40112	2
2	8	2	0	8	40113	0
2	6	2	195	201	40114	1
2	0	2	5	5	40115	2
2	0	2	0	0	40116	2
2	2	2	0	2	40117	0
2	0	2	0	0	40118	2
2	0	2	1	1	40119	2
2	0	2	0	0	40120	2
2	0	2	0	0	40121	2
2	0	2	0	0	40122	2
2	8	2	20	28	40123	1
2	0	2	0	0	40124	2
2	0	2	0	0	40125	2
2	3	2	0	3	40126	0
2	0	2	1	1	40127	2
2	0	2	0	0	40128	2
2	0	2	0	0	40129	2
2	0	2	0	0	40130	2
2	0	2	0	0	40131	2
2	0	2	0	0	40132	2
2	0	2	0	0	40133	2
2	2	2	0	2	40134	0
2	0	2	3	3	40135	2
2	0	2	0	0	40136	2
2	0	2	0	0	40137	2
2	0	2	0	0	40138	2
2	0	2	2	2	40139	2
2	0	2	0	0	40140	2
2	0	2	0	0	40141	2
2	54	2	0	54	40142	0
2	42	2	1885	1927	40143	1
2	0	2	2	2	40144	2
2	0	2	0	0	40145	2
2	30	2	8	38	40146	0
2	0	2	117	117	40147	2
2	20	2	0	20	40148	0
2	0	2	3	3	40149	2
2	0	2	0	0	40150	2
2	0	2	0	0	40151	2
2	0	2	0	0	40152	2
2	0	2	0	0	40153	2
2	0	2	0	0	40154	2
2	0	2	0	0	40155	2
2	0	2	0	0	40156	2
2	0	2	0	0	40157	2
2	0	2	2	2	40158	2
2	0	2	0	0	40159	2
2	0	2	0	0	40160	2
2	0	2	0	0	40161	2
2	0	2	2	2	40162	2
2	0	2	0	0	40163	2
2	0	2	0	0	40164	2
2	0	2	0	0	40165	2
2	0	2	0	0	40166	2
2	0	2	0	0	40167	2
2	0	2	0	0	40168	2
2	0	2	0	0	40169	2
2	0	2	22	22	40170	2
2	0	2	0	0	40171	2
2	0	2	0	0	40172	2
0	33	2	0	33	40173	0
0	34	2	1	35	40174	1
2	0	2	1	1	40175	2
2	0	2	0	0	40176	2
0	1548	2	22	1570	40177	0
0	273	2	1	274	40178	0
2	1	2	0	1	40179	0
2	0	2	4	4	40180	2
2	0	2	0	0	40181	2
2	0	2	0	0	40182	2
2	0	2	0	0	40183	2
2	0	2	1	1	40184	2
2	0	2	0	0	40185	2
2	0	2	5	5	40186	2
2	0	2	0	0	40187	2
2	0	2	0	0	40188	2
2	0	2	0	0	40189	2
2	0	2	1	1	40190	2
2	2	2	0	2	40191	0
2	0	2	0	0	40192	2
2	0	2	0	0	40193	2
2	0	2	0	0	40194	2
2	0	2	0	0	40195	2
2	0	2	0	0	40196	2
2	0	2	0	0	40197	2
2	2	0	3492	3494	40198	1
2	0	2	0	0	40199	2
2	0	2	0	0	40200	2
2	0	0	1950	1950	40201	2
2	0	2	6	6	40202	2
2	0	2	0	0	40203	2
2	0	2	17	17	40204	2
2	0	2	0	0	40205	2
2	0	2	0	0	40206	2
2	0	2	0	0	40207	2
2	0	2	3	3	40208	2
2	0	2	0	0	40209	2
2	0	2	0	0	40210	2
2	0	2	0	0	40211	2
2	0	2	0	0	40212	2
2	0	2	0	0	40213	2
2	0	2	0	0	40214	2
2	2	2	0	2	40215	0
2	0	2	33	33	40216	2
2	0	2	0	0	40217	2
2	0	2	0	0	40218	2
2	0	2	0	0	40219	2
2	0	2	0	0	40220	2
2	7	2	0	7	40221	0
2	3	2	33	36	40222	1
2	0	2	0	0	40223	2
2	0	2	0	0	40224	2
2	10	2	1	11	40225	0
2	0	2	30	30	40226	2
2	55	2	2	57	40227	0
2	101	2	677	778	40228	1
2	0	2	8	8	40229	2
2	0	2	0	0	40230	2
2	31	2	3	34	40231	0
2	0	2	92	92	40232	2
2	0	2	0	0	40233	2
2	0	2	5	5	40234	2
2	0	2	0	0	40235	2
2	0	2	0	0	40236	2
2	0	2	0	0	40237	2
2	0	2	0	0	40238	2
2	4	2	0	4	40239	0
2	0	2	1	1	40240	2
2	0	2	4	4	40241	2
2	4	2	25	29	40242	1
2	0	2	3	3	40243	2
2	0	2	0	0	40244	2
2	10	2	854	864	40245	0
2	20	2	1	21	40246	0
2	0	2	103	103	40247	2
2	1	2	0	1	40248	0
2	0	2	82	82	40249	2
2	0	2	0	0	40250	2
2	0	2	0	0	40251	2
2	0	2	0	0	40252	2
2	0	2	3	3	40253	2
2	0	2	0	0	40254	2
2	0	2	0	0	40255	2
2	0	2	0	0	40256	2
2	0	2	0	0	40257	2
2	75	2	3	78	40258	0
2	90	2	0	90	40259	0
2	0	2	446	446	40260	2
2	0	2	0	0	40261	2
2	0	2	0	0	40262	2
2	0	2	0	0	40263	2
2	0	2	0	0	40264	2
2	0	2	0	0	40265	2
2	0	2	0	0	40266	2
2	0	2	0	0	40267	2
2	0	2	0	0	40268	2
2	1	2	19	20	40269	1
2	0	2	0	0	40270	2
2	0	2	0	0	40271	2
2	2	2	0	2	40272	1
2	0	2	7	7	40273	2
2	1	4	2	3	40274	1
2	0	2	0	0	40275	2
2	0	2	0	0	40276	2
2	1	4	5	6	40277	1
2	0	2	0	0	40278	2
2	0	2	0	0	40279	2
2	3	2	0	3	40280	1
2	0	2	0	0	40281	2
2	0	2	0	0	40282	2
2	0	2	0	0	40283	2
2	0	2	0	0	40284	2
2	0	2	0	0	40285	2
2	0	2	4	4	40286	2
2	0	2	0	0	40287	2
2	0	2	0	0	40288	2
2	0	2	0	0	40289	2
2	0	2	0	0	40290	2
2	0	2	0	0	40291	2
2	0	2	6	6	40292	2
2	0	2	0	0	40293	2
2	0	2	0	0	40294	2
2	0	2	0	0	40295	2
2	0	2	0	0	40296	2
2	0	2	0	0	40297	2
2	0	2	0	0	40298	2
2	0	2	0	0	40299	2
2	0	2	0	0	40300	2
2	1	2	0	1	40301	0
2	0	4	103	103	40302	2
2	0	2	0	0	40303	2
2	0	4	102	102	40304	2
2	0	2	0	0	40305	2
2	0	2	0	0	40306	2
2	0	2	0	0	40307	2
2	0	2	0	0	40308	2
2	1	2	63	64	40309	1
2	0	2	12	12	40310	2
2	0	2	0	0	40311	2
2	0	2	0	0	40312	2
2	0	2	0	0	40313	2
2	0	2	0	0	40314	2
2	0	2	0	0	40315	2
2	0	2	0	0	40316	2
2	0	2	0	0	40317	2
2	0	2	0	0	40318	2
2	0	2	0	0	40319	2
2	0	2	0	0	40320	2
2	0	2	0	0	40321	2
2	0	2	0	0	40322	2
2	0	2	0	0	40323	2
2	0	2	0	0	40324	2
2	0	2	0	0	40325	2
2	0	2	0	0	40326	2
2	0	2	0	0	40327	2
2	0	2	0	0	40328	2
2	0	2	0	0	40329	2
4	923	2	9	932	40330	0
2	13	2	0	13	40331	0
2	7	2	30	37	40332	1
2	0	2	0	0	40333	2
2	0	2	0	0	40334	2
2	5	2	0	5	40335	0
2	0	2	7	7	40336	2
2	2	2	0	2	40337	0
2	1	2	5	6	40338	1
2	0	2	0	0	40339	2
2	0	2	0	0	40340	2
2	0	2	0	0	40341	2
2	0	2	0	0	40342	2
2	0	2	0	0	40343	2
2	0	2	0	0	40344	2
2	0	2	0	0	40345	2
2	0	2	0	0	40346	2
2	0	2	2	2	40347	2
2	0	2	0	0	40348	2
2	0	2	0	0	40349	2
2	0	2	0	0	40350	2
2	0	2	1	1	40351	2
2	7	2	0	7	40352	0
2	2	2	75	77	40353	1
2	0	2	0	0	40354	2
2	0	2	1	1	40355	2
2	3	2	4	7	40356	0
2	0	2	7	7	40357	2
2	0	2	0	0	40358	2
2	0	4	5	5	40359	2
2	0	2	0	0	40360	2
2	0	2	0	0	40361	2
2	0	4	12	12	40362	2
2	0	2	0	0	40363	2
2	0	2	0	0	40364	2
2	0	2	4	4	40365	2
2	0	2	0	0	40366	2
2	0	2	0	0	40367	2
2	0	2	0	0	40368	2
2	0	2	0	0	40369	2
2	6	2	0	6	40370	0
2	0	2	0	0	40371	2
2	0	2	0	0	40372	2
2	56	2	55	111	40373	1
2	0	2	3	3	40374	2
2	0	2	0	0	40375	2
2	11	2	3	14	40376	0
2	0	2	13	13	40377	2
2	61	2	0	61	40378	0
2	0	2	19	19	40379	2
2	0	2	1	1	40380	2
2	49	2	2	51	40381	0
2	72	2	2	74	40382	1
2	0	2	290	290	40383	2
2	45	2	191	236	40384	1
2	0	2	37	37	40385	2
2	0	2	0	0	40386	2
2	1	2	0	1	40387	0
2	0	2	1	1	40388	2
2	0	2	0	0	40389	2
2	0	2	0	0	40390	2
2	0	2	0	0	40391	2
2	0	2	0	0	40392	2
2	0	2	0	0	40393	2
2	0	2	0	0	40394	2
2	0	2	0	0	40395	2
2	0	2	0	0	40396	2
2	0	2	0	0	40397	2
2	0	2	0	0	40398	2
2	0	2	0	0	40399	2
2	0	2	0	0	40400	2
2	0	2	0	0	40401	2
2	1	2	0	1	40402	0
2	8	2	22	30	40403	1
2	0	2	0	0	40404	2
2	0	2	0	0	40405	2
2	2	2	3	5	40406	1
2	0	2	1	1	40407	2
2	18	2	0	18	40408	0
2	3	2	205	208	40409	1
2	0	2	2	2	40410	2
2	0	2	0	0	40411	2
2	0	2	0	0	40412	2
2	0	2	1	1	40413	2
2	0	2	0	0	40414	2
2	0	2	0	0	40415	2
2	0	2	0	0	40416	2
2	0	2	0	0	40417	2
2	23	2	0	23	40418	0
2	30	2	168	198	40419	1
2	0	2	4	4	40420	2
2	0	2	0	0	40421	2
2	16	2	2	18	40422	0
2	0	2	91	91	40423	2
2	6	2	1	7	40424	0
2	0	2	136	136	40425	2
2	0	2	0	0	40426	2
2	0	2	0	0	40427	2
2	0	2	0	0	40428	2
2	0	2	0	0	40429	2
2	0	2	0	0	40430	2
2	0	2	0	0	40431	2
0	383	2	7	390	40432	0
0	204	2	75	279	40433	0
0	67	2	4	71	40434	0
4	7	2	0	7	40435	0
2	0	2	0	0	40436	2
2	0	2	0	0	40437	2
2	0	2	0	0	40438	2
2	0	2	0	0	40439	2
2	0	2	0	0	40440	2
2	0	2	0	0	40441	2
2	0	2	0	0	40442	2
2	0	2	0	0	40443	2
2	0	2	0	0	40444	2
2	0	2	0	0	40445	2
2	0	2	0	0	40446	2
2	0	2	0	0	40447	2
2	0	2	0	0	40448	2
2	0	2	1	1	40449	2
2	0	2	0	0	40450	2
2	0	2	0	0	40451	2
2	0	2	0	0	40452	2
2	0	2	1	1	40453	2
2	0	2	0	0	40454	2
2	0	2	13	13	40455	2
2	0	2	0	0	40456	2
2	0	2	0	0	40457	2
2	0	2	0	0	40458	2
2	0	2	2	2	40459	2
2	0	2	0	0	40460	2
2	0	2	0	0	40461	2
2	0	2	0	0	40462	2
2	0	2	0	0	40463	2
2	0	2	0	0	40464	2
2	0	2	0	0	40465	2
2	0	2	0	0	40466	2
2	0	2	0	0	40467	2
2	0	2	0	0	40468	2
2	0	2	0	0	40469	2
2	0	2	0	0	40470	2
2	0	2	0	0	40471	2
2	0	2	0	0	40472	2
2	0	2	0	0	40473	2
2	0	2	0	0	40474	2
2	0	2	0	0	40475	2
2	0	2	0	0	40476	2
2	0	2	0	0	40477	2
2	0	2	0	0	40478	2
2	0	2	0	0	40479	2
2	0	2	0	0	40480	2
2	0	2	0	0	40481	2
2	0	2	0	0	40482	2
2	0	2	0	0	40483	2
2	0	2	1	1	40484	2
2	0	2	0	0	40485	2
2	1	2	3	4	40486	1
2	0	2	0	0	40487	2
2	0	2	0	0	40488	2
2	0	2	0	0	40489	2
2	0	2	0	0	40490	2
2	2	2	0	2	40491	0
2	0	2	50	50	40492	2
2	0	2	0	0	40493	2
2	0	2	0	0	40494	2
2	0	2	0	0	40495	2
2	0	2	0	0	40496	2
2	0	2	0	0	40497	2
2	0	2	0	0	40498	2
2	0	2	0	0	40499	2
2	0	2	3	3	40500	2
2	0	2	0	0	40501	2
2	0	2	0	0	40502	2
2	0	2	0	0	40503	2
2	4	2	52	56	40504	1
2	0	2	1	1	40505	2
2	0	2	0	0	40506	2
2	0	2	0	0	40507	2
2	0	2	5	5	40508	2
2	0	2	0	0	40509	2
2	0	2	0	0	40510	2
2	0	2	0	0	40511	2
2	0	2	0	0	40512	2
2	0	2	0	0	40513	2
2	0	2	0	0	40514	2
2	0	2	114	114	40515	2
2	3	2	0	3	40516	0
2	0	2	2	2	40517	2
2	1	4	849	850	40518	1
2	0	2	0	0	40519	2
2	0	2	0	0	40520	2
2	0	2	12	12	40521	2
2	0	4	15	15	40522	2
2	0	2	17	17	40523	2
2	0	2	232	232	40524	2
2	0	2	0	0	40525	2
2	0	2	0	0	40526	2
2	0	2	0	0	40527	2
2	0	2	0	0	40528	2
2	1	2	0	1	40529	0
2	0	2	0	0	40530	2
2	0	2	0	0	40531	2
2	0	2	0	0	40532	2
2	0	2	0	0	40533	2
2	0	2	0	0	40534	2
2	0	2	0	0	40535	2
2	0	2	0	0	40536	2
2	0	2	0	0	40537	2
2	0	2	16	16	40538	2
2	0	2	0	0	40539	2
2	0	2	0	0	40540	2
2	7	2	0	7	40541	1
2	0	2	0	0	40542	2
2	0	2	2	2	40543	2
2	0	2	0	0	40544	2
2	0	2	0	0	40545	2
2	0	2	0	0	40546	2
2	0	2	0	0	40547	2
2	0	2	1	1	40548	2
2	0	4	5	5	40549	2
2	0	2	0	0	40550	2
2	0	2	0	0	40551	2
2	0	2	0	0	40552	2
2	0	2	0	0	40553	2
2	1	2	0	1	40554	1
2	0	2	0	0	40555	2
2	0	2	0	0	40556	2
2	0	2	10	10	40557	2
2	0	2	0	0	40558	2
2	0	2	0	0	40559	2
2	0	2	0	0	40560	2
2	0	2	1	1	40561	2
0	18	4	76	94	40562	0
2	0	2	0	0	40563	2
2	0	2	3	3	40564	2
2	0	2	0	0	40565	2
2	0	2	0	0	40566	2
2	0	2	0	0	40567	2
2	0	2	0	0	40568	2
2	0	2	0	0	40569	2
2	0	2	0	0	40570	2
2	0	2	0	0	40571	2
2	0	2	0	0	40572	2
2	0	2	0	0	40573	2
2	0	2	0	0	40574	2
2	0	2	0	0	40575	2
2	0	2	0	0	40576	2
0	66	4	423	489	40577	0
2	0	2	0	0	40578	2
2	0	2	0	0	40579	2
2	0	2	0	0	40580	2
2	0	2	0	0	40581	2
2	0	2	0	0	40582	2
2	0	2	0	0	40583	2
2	0	2	0	0	40584	2
2	0	4	0	0	40585	2
2	0	2	0	0	40586	2
2	0	2	0	0	40587	2
2	0	4	0	0	40588	2
2	0	2	0	0	40589	2
0	0	2	0	0	40590	2
2	0	2	0	0	40591	2
0	0	4	12	12	40592	2
0	0	4	12	12	40593	2
2	0	2	0	0	40594	2
2	0	2	0	0	40595	2
2	0	2	0	0	40596	2
2	0	2	0	0	40597	2
2	0	2	0	0	40598	2
2	0	2	0	0	40599	2
2	0	2	0	0	40600	2
2	0	2	0	0	40601	2
2	0	2	0	0	40602	2
2	0	2	1	1	40603	2
2	0	2	0	0	40604	2
2	0	2	0	0	40605	2
2	0	2	0	0	40606	2
2	0	2	0	0	40607	2
2	0	2	0	0	40608	2
2	0	2	0	0	40609	2
2	0	2	0	0	40610	2
2	0	2	0	0	40611	2
2	0	2	0	0	40612	2
2	0	2	0	0	40613	2
2	1	2	2	3	40614	1
2	0	2	0	0	40615	2
2	0	2	0	0	40616	2
2	0	2	0	0	40617	2
2	0	2	0	0	40618	2
2	0	2	0	0	40619	2
2	0	2	0	0	40620	2
2	0	2	0	0	40621	2
2	0	2	1	1	40622	2
2	0	2	0	0	40623	2
2	0	2	0	0	40624	2
2	0	2	0	0	40625	2
2	0	2	2	2	40626	2
2	0	2	0	0	40627	2
2	0	2	1	1	40628	2
2	0	2	0	0	40629	2
2	0	2	0	0	40630	2
2	0	2	0	0	40631	2
2	0	2	0	0	40632	2
2	0	2	0	0	40633	2
2	0	2	0	0	40634	2
2	0	2	0	0	40635	2
2	0	2	0	0	40636	2
2	0	2	0	0	40637	2
2	0	2	0	0	40638	2
2	0	2	0	0	40639	2
2	0	2	0	0	40640	2
2	0	2	0	0	40641	2
2	0	2	0	0	40642	2
2	0	2	0	0	40643	2
2	0	2	0	0	40644	2
0	1	4	0	1	40645	1
2	6	2	0	6	40646	0
2	5	2	10	15	40647	1
2	0	2	0	0	40648	2
2	0	2	0	0	40649	2
2	3	2	1	4	40650	0
2	0	2	7	7	40651	2
2	0	2	0	0	40652	2
2	0	2	0	0	40653	2
2	0	2	0	0	40654	2
2	0	2	0	0	40655	2
2	0	2	0	0	40656	2
2	0	2	0	0	40657	2
2	0	2	0	0	40658	2
2	0	2	0	0	40659	2
2	0	2	0	0	40660	2
2	0	2	0	0	40661	2
2	0	2	0	0	40662	2
2	0	2	0	0	40663	2
2	0	2	0	0	40664	2
2	0	2	0	0	40665	2
2	0	2	0	0	40666	2
2	0	2	0	0	40667	2
2	0	2	0	0	40668	2
2	0	2	0	0	40669	2
2	84	2	0	84	40670	0
2	0	2	0	0	40671	2
2	0	2	0	0	40672	2
2	0	2	0	0	40673	2
2	0	2	0	0	40674	2
2	0	2	0	0	40675	2
2	0	2	0	0	40676	2
2	45	2	55	100	40677	1
2	0	2	88	88	40678	2
2	321	2	1619	1940	40679	1
2	0	2	18	18	40680	2
2	0	2	1	1	40681	2
0	0	4	4	4	40682	2
2	0	2	0	0	40683	2
2	0	2	0	0	40684	2
2	0	2	0	0	40685	2
2	0	2	0	0	40686	2
2	0	2	0	0	40687	2
2	0	2	1	1	40688	2
2	0	2	0	0	40689	2
2	0	2	0	0	40690	2
2	0	2	0	0	40691	2
2	0	2	0	0	40692	2
2	0	2	0	0	40693	2
2	0	2	0	0	40694	2
2	0	2	0	0	40695	2
2	0	2	0	0	40696	2
2	0	2	0	0	40697	2
2	0	2	0	0	40698	2
2	0	2	0	0	40699	2
2	0	2	0	0	40700	2
2	0	2	0	0	40701	2
2	0	2	0	0	40702	2
2	0	2	0	0	40703	2
2	0	2	0	0	40704	2
2	13	4	98	111	40705	1
2	0	2	0	0	40706	2
2	1	2	2	3	40707	1
2	4	4	17	21	40708	0
2	0	2	26	26	40709	2
2	0	2	0	0	40710	2
2	0	2	0	0	40711	2
2	0	2	0	0	40712	2
2	0	2	0	0	40713	2
2	0	2	0	0	40714	2
2	0	2	0	0	40715	2
2	0	2	0	0	40716	2
2	20	2	0	20	40717	0
2	9	2	995	1004	40718	1
2	0	2	1	1	40719	2
2	0	2	0	0	40720	2
2	20	2	1	21	40721	1
2	0	2	225	225	40722	2
2	0	4	2596	2596	40723	2
2	0	2	0	0	40724	2
2	0	2	0	0	40725	2
2	0	4	987	987	40726	2
2	14	4	1305	1319	40727	0
2	0	2	86	86	40728	2
2	117	2	0	117	40729	0
2	7	2	138	145	40730	1
2	0	2	53	53	40731	2
2	0	2	0	0	40732	2
2	0	2	0	0	40733	2
2	0	2	10	10	40734	2
2	0	2	0	0	40735	2
2	0	2	0	0	40736	2
2	0	2	0	0	40737	2
2	0	2	0	0	40738	2
4	58	4	2	60	40739	1
4	0	4	0	0	40740	2
4	1	4	6577	6578	40741	1
0	260	0	381	641	40742	1
0	7	0	59	66	40743	1
2	0	4	3	3	40744	2
0	19	4	960	979	40745	0
2	0	2	0	0	40746	2
2	0	2	0	0	40747	2
2	0	2	0	0	40748	2
2	0	2	0	0	40749	2
2	0	2	0	0	40750	2
2	0	2	0	0	40751	2
2	0	2	0	0	40752	2
2	0	2	0	0	40753	2
2	0	2	0	0	40754	2
2	0	2	0	0	40755	2
2	0	2	0	0	40756	2
2	0	2	0	0	40757	2
2	0	2	0	0	40758	2
2	0	2	0	0	40759	2
2	0	2	0	0	40760	2
2	0	2	0	0	40761	2
2	0	2	0	0	40762	2
2	0	2	0	0	40763	2
2	0	2	0	0	40764	2
2	0	2	6	6	40765	2
2	0	2	1	1	40766	2
2	0	2	0	0	40767	2
2	0	2	1	1	40768	2
2	0	2	3	3	40769	2
2	0	2	0	0	40770	2
2	0	2	0	0	40771	2
2	0	2	0	0	40772	2
2	0	2	0	0	40773	2
2	0	2	0	0	40774	2
2	0	2	0	0	40775	2
2	0	2	0	0	40776	2
2	0	2	0	0	40777	2
2	0	2	1	1	40778	2
2	0	2	0	0	40779	2
2	0	2	0	0	40780	2
2	0	2	1	1	40781	2
2	0	2	0	0	40782	2
2	0	2	0	0	40783	2
2	0	2	1	1	40784	2
2	0	2	0	0	40785	2
2	0	2	0	0	40786	2
2	0	2	0	0	40787	2
2	0	2	342	342	40788	2
2	0	4	57	57	40789	2
2	0	2	0	0	40790	2
2	0	2	0	0	40791	2
2	19	2	0	19	40792	0
2	15	2	569	584	40793	1
2	0	2	20	20	40794	2
2	0	2	0	0	40795	2
2	8	2	2	10	40796	0
2	0	2	33	33	40797	2
2	0	2	0	0	40798	2
2	0	2	13	13	40799	2
2	0	2	0	0	40800	2
2	0	2	0	0	40801	2
4	0	2	14	14	40802	2
4	1	2	0	1	40803	0
2	0	2	9	9	40804	2
2	0	2	0	0	40805	2
4	0	4	27	27	40806	2
2	0	2	0	0	40807	2
2	0	2	0	0	40808	2
2	0	2	0	0	40809	2
2	0	2	0	0	40810	2
2	0	2	0	0	40811	2
2	0	2	0	0	40812	2
2	0	2	0	0	40813	2
2	0	2	2	2	40814	2
2	0	2	0	0	40815	2
2	0	2	0	0	40816	2
0	2	2	1	3	40817	0
0	3	2	0	3	40818	0
2	0	2	0	0	40819	2
2	0	2	1	1	40820	2
2	0	4	12	12	40821	2
2	0	2	0	0	40822	2
2	0	2	1	1	40823	2
2	0	2	0	0	40824	2
2	0	2	0	0	40825	2
2	0	2	0	0	40826	2
2	0	2	0	0	40827	2
2	0	2	0	0	40828	2
2	0	2	0	0	40829	2
2	0	2	0	0	40830	2
2	0	2	0	0	40831	2
2	0	2	0	0	40832	2
2	0	2	0	0	40833	2
2	0	2	1	1	40834	2
2	0	2	0	0	40835	2
2	0	2	0	0	40836	2
2	0	0	11	11	40837	2
2	0	2	0	0	40838	2
2	0	2	0	0	40839	2
2	0	0	0	0	40840	2
2	0	2	2	2	40841	2
2	0	2	19	19	40842	2
2	0	2	0	0	40843	2
2	0	2	0	0	40844	2
2	0	2	0	0	40845	2
2	0	2	1	1	40846	2
2	0	2	0	0	40847	2
2	0	2	0	0	40848	2
2	0	2	0	0	40849	2
2	0	2	0	0	40850	2
2	0	2	0	0	40851	2
2	0	2	0	0	40852	2
2	0	2	0	0	40853	2
2	0	2	0	0	40854	2
2	0	2	0	0	40855	2
2	0	2	0	0	40856	2
2	0	2	0	0	40857	2
2	0	2	0	0	40858	2
2	0	2	0	0	40859	2
2	0	4	20	20	40860	2
2	0	2	0	0	40861	2
2	0	2	0	0	40862	2
2	0	4	8	8	40863	2
2	0	2	0	0	40864	2
2	0	2	0	0	40865	2
2	0	0	76	76	40866	2
2	0	2	0	0	40867	2
2	0	2	0	0	40868	2
2	0	0	35	35	40869	2
2	0	2	0	0	40870	2
2	0	2	0	0	40871	2
2	0	2	0	0	40872	2
2	0	2	0	0	40873	2
2	0	2	0	0	40874	2
2	0	2	0	0	40875	2
2	0	2	0	0	40876	2
2	3	2	0	3	40877	0
2	6	2	38	44	40878	1
2	0	2	0	0	40879	2
2	0	2	0	0	40880	2
2	3	2	0	3	40881	1
2	0	2	13	13	40882	2
2	9	2	0	9	40883	0
2	5	2	45	50	40884	1
2	0	2	3	3	40885	2
2	0	2	0	0	40886	2
2	11	2	0	11	40887	0
2	0	2	55	55	40888	2
2	11	2	0	11	40889	0
2	4	2	79	83	40890	1
2	0	2	2	2	40891	2
2	0	2	0	0	40892	2
4	0	2	9	9	40893	2
4	0	2	0	0	40894	2
2	2	2	2	4	40895	1
2	0	2	16	16	40896	2
0	1203	2	3	1206	40897	0
0	883	2	79	962	40898	0
0	728	2	2	730	40899	0
2	0	2	0	0	40900	2
2	0	2	0	0	40901	2
2	0	2	0	0	40902	2
2	0	2	0	0	40903	2
2	0	2	0	0	40904	2
2	0	2	0	0	40905	2
2	0	2	0	0	40906	2
2	0	2	0	0	40907	2
2	0	2	0	0	40908	2
2	0	2	0	0	40909	2
2	0	2	0	0	40910	2
2	0	2	0	0	40911	2
2	0	2	0	0	40912	2
2	0	2	0	0	40913	2
2	0	2	0	0	40914	2
2	0	2	0	0	40915	2
2	0	2	0	0	40916	2
2	0	2	0	0	40917	2
2	3	2	0	3	40918	0
2	8	2	29	37	40919	1
2	0	2	0	0	40920	2
2	0	2	0	0	40921	2
2	1	2	4	5	40922	0
2	0	2	3	3	40923	2
2	0	2	0	0	40924	2
2	0	2	0	0	40925	2
2	0	2	0	0	40926	2
2	0	2	0	0	40927	2
2	0	2	0	0	40928	2
2	0	2	0	0	40929	2
2	0	2	0	0	40930	2
2	0	0	7	7	40931	2
2	0	2	0	0	40932	2
2	0	2	0	0	40933	2
2	0	0	6	6	40934	2
2	0	2	0	0	40935	2
2	0	2	0	0	40936	2
2	0	2	0	0	40937	2
2	0	2	0	0	40938	2
2	0	2	0	0	40939	2
2	0	2	0	0	40940	2
2	0	2	0	0	40941	2
2	0	2	0	0	40942	2
2	17	2	0	17	40943	0
2	1	2	27	28	40944	1
2	0	2	5	5	40945	2
2	0	2	0	0	40946	2
2	4	2	0	4	40947	0
2	0	2	19	19	40948	2
2	0	2	1	1	40949	2
2	0	2	0	0	40950	2
2	0	2	0	0	40951	2
2	0	2	0	0	40952	2
2	0	2	162	162	40953	2
2	0	2	0	0	40954	2
2	1	2	0	1	40955	1
2	0	2	0	0	40956	2
2	0	2	0	0	40957	2
2	0	2	0	0	40958	2
2	0	2	0	0	40959	2
2	17	2	2	19	40960	0
2	48	2	104	152	40961	1
2	0	2	4	4	40962	2
2	0	2	0	0	40963	2
2	10	2	3	13	40964	1
2	0	2	50	50	40965	2
2	0	2	0	0	40966	2
2	0	2	19	19	40967	2
2	0	2	0	0	40968	2
2	0	2	0	0	40969	2
2	0	2	0	0	40970	2
2	0	2	0	0	40971	2
2	0	2	0	0	40972	2
2	0	2	0	0	40973	2
2	0	2	0	0	40974	2
2	0	2	0	0	40975	2
2	0	2	0	0	40976	2
2	0	2	0	0	40977	2
2	0	2	0	0	40978	2
2	0	2	0	0	40979	2
2	0	2	0	0	40980	2
2	0	2	0	0	40981	2
2	0	2	0	0	40982	2
2	0	2	0	0	40983	2
4	5	4	135	140	40984	1
2	192	2	0	192	40985	0
2	16	2	2566	2582	40986	1
2	0	2	43	43	40987	2
2	0	2	1	1	40988	2
2	64	2	6	70	40989	0
2	0	2	491	491	40990	2
2	0	2	0	0	40991	2
2	0	2	3	3	40992	2
2	0	2	0	0	40993	2
2	0	2	0	0	40994	2
2	0	2	0	0	40995	2
2	0	2	0	0	40996	2
2	0	2	0	0	40997	2
2	0	2	1	1	40998	2
2	0	2	0	0	40999	2
2	0	2	0	0	41000	2
2	1	2	0	1	41001	1
2	0	2	1	1	41002	2
2	0	2	0	0	41003	2
2	0	2	0	0	41004	2
2	0	2	0	0	41005	2
2	0	2	0	0	41006	2
2	0	2	0	0	41007	2
2	0	2	0	0	41008	2
2	0	2	0	0	41009	2
2	5	2	0	5	41010	0
2	1	2	12	13	41011	1
2	0	2	1	1	41012	2
2	0	2	0	0	41013	2
2	3	2	0	3	41014	1
2	0	2	5	5	41015	2
2	1	2	7	8	41016	1
2	0	2	0	0	41017	2
2	0	2	0	0	41018	2
2	0	2	0	0	41019	2
2	0	2	0	0	41020	2
2	0	2	0	0	41021	2
2	0	2	0	0	41022	2
2	0	2	319	319	41023	2
2	0	2	0	0	41024	2
2	0	2	0	0	41025	2
2	0	2	0	0	41026	2
2	0	2	116	116	41027	2
2	0	2	0	0	41028	2
2	0	2	0	0	41029	2
2	0	2	0	0	41030	2
2	0	2	0	0	41031	2
2	0	2	0	0	41032	2
2	0	2	0	0	41033	2
2	0	2	0	0	41034	2
2	0	2	0	0	41035	2
2	0	2	0	0	41036	2
2	0	2	1	1	41037	2
2	0	2	0	0	41038	2
2	0	2	0	0	41039	2
2	0	2	0	0	41040	2
2	0	4	65	65	41041	2
2	0	2	0	0	41042	2
2	0	2	0	0	41043	2
2	0	4	50	50	41044	2
2	0	2	0	0	41045	2
4	0	4	0	0	41046	2
4	0	4	0	0	41047	2
2	0	2	0	0	41048	2
2	0	2	1	1	41049	2
2	0	2	0	0	41050	2
2	0	2	0	0	41051	2
2	0	2	0	0	41052	2
2	0	2	0	0	41053	2
2	0	2	1	1	41054	2
2	0	2	0	0	41055	2
2	0	2	0	0	41056	2
2	0	2	0	0	41057	2
2	0	2	0	0	41058	2
2	0	2	0	0	41059	2
2	0	2	0	0	41060	2
2	0	2	0	0	41061	2
2	0	2	0	0	41062	2
2	0	2	0	0	41063	2
2	0	2	0	0	41064	2
2	0	2	0	0	41065	2
2	0	2	0	0	41066	2
2	0	2	0	0	41067	2
2	0	2	0	0	41068	2
2	0	2	0	0	41069	2
2	0	2	0	0	41070	2
2	0	2	0	0	41071	2
2	0	2	0	0	41072	2
2	0	2	0	0	41073	2
2	0	2	0	0	41074	2
2	0	2	0	0	41075	2
2	0	2	0	0	41076	2
2	0	2	0	0	41077	2
2	0	2	0	0	41078	2
2	0	2	0	0	41079	2
2	0	2	0	0	41080	2
2	0	2	11	11	41081	2
2	0	2	0	0	41082	2
2	0	2	0	0	41083	2
2	0	2	312	312	41084	2
2	0	2	0	0	41085	2
2	0	2	0	0	41086	2
2	0	2	0	0	41087	2
2	0	2	0	0	41088	2
2	0	2	0	0	41089	2
2	0	2	0	0	41090	2
2	0	2	0	0	41091	2
2	0	2	0	0	41092	2
2	0	2	0	0	41093	2
2	0	2	0	0	41094	2
2	0	2	0	0	41095	2
2	0	2	0	0	41096	2
2	0	2	0	0	41097	2
2	0	2	0	0	41098	2
2	0	4	2	2	41099	2
2	0	2	0	0	41100	2
2	0	4	2	2	41101	2
2	0	2	0	0	41102	2
2	0	2	0	0	41103	2
2	0	2	0	0	41104	2
2	0	2	0	0	41105	2
2	0	4	0	0	41106	2
2	0	2	0	0	41107	2
2	0	4	1	1	41108	2
2	0	2	0	0	41109	2
2	0	2	0	0	41110	2
2	0	2	0	0	41111	2
2	0	2	0	0	41112	2
2	0	2	0	0	41113	2
2	0	2	1	1	41114	2
2	0	2	0	0	41115	2
2	0	2	0	0	41116	2
2	0	2	0	0	41117	2
2	0	2	0	0	41118	2
2	0	2	0	0	41119	2
2	0	2	0	0	41120	2
2	0	2	0	0	41121	2
2	0	2	0	0	41122	2
2	0	2	0	0	41123	2
2	0	2	0	0	41124	2
2	0	2	0	0	41125	2
2	0	2	0	0	41126	2
2	0	2	0	0	41127	2
2	0	2	0	0	41128	2
2	0	2	0	0	41129	2
2	0	2	0	0	41130	2
2	0	2	0	0	41131	2
2	0	2	0	0	41132	2
2	0	2	0	0	41133	2
2	0	2	2	2	41134	2
2	0	2	0	0	41135	2
2	0	2	0	0	41136	2
2	0	2	0	0	41137	2
2	0	2	0	0	41138	2
2	0	2	0	0	41139	2
2	0	2	0	0	41140	2
2	0	2	0	0	41141	2
2	0	2	0	0	41142	2
2	0	2	0	0	41143	2
2	0	2	2	2	41144	2
2	0	2	0	0	41145	2
2	0	2	0	0	41146	2
2	0	2	0	0	41147	2
2	0	4	1	1	41148	2
2	0	2	0	0	41149	2
2	0	4	4	4	41150	2
2	0	2	0	0	41151	2
2	0	2	0	0	41152	2
2	0	2	0	0	41153	2
2	0	2	0	0	41154	2
2	0	2	0	0	41155	2
2	0	2	0	0	41156	2
2	0	2	0	0	41157	2
2	0	2	0	0	41158	2
2	0	2	0	0	41159	2
2	0	2	0	0	41160	2
2	0	2	0	0	41161	2
2	0	2	0	0	41162	2
2	0	2	0	0	41163	2
2	0	2	0	0	41164	2
2	0	2	1	1	41165	2
2	0	2	0	0	41166	2
2	0	2	0	0	41167	2
2	0	2	0	0	41168	2
2	1	2	0	1	41169	1
4	0	2	1	1	41170	2
2	0	2	0	0	41171	2
2	0	2	0	0	41172	2
2	0	2	0	0	41173	2
2	0	2	0	0	41174	2
2	0	2	0	0	41175	2
2	0	2	0	0	41176	2
2	65	4	168	233	41177	0
2	0	2	142	142	41178	2
2	0	2	0	0	41179	2
2	0	4	17	17	41180	2
2	0	2	0	0	41181	2
2	0	2	0	0	41182	2
2	0	4	14	14	41183	2
2	0	2	0	0	41184	2
2	0	2	0	0	41185	2
2	0	2	0	0	41186	2
2	0	2	0	0	41187	2
2	0	2	0	0	41188	2
2	0	2	0	0	41189	2
2	0	2	0	0	41190	2
2	1	2	1	2	41191	0
2	0	2	0	0	41192	2
2	0	2	0	0	41193	2
2	126	2	1	127	41194	0
2	0	2	44	44	41195	2
2	0	2	2	2	41196	2
2	0	2	0	0	41197	2
2	0	2	0	0	41198	2
2	0	2	0	0	41199	2
2	0	2	0	0	41200	2
2	0	2	0	0	41201	2
2	0	2	0	0	41202	2
2	0	2	0	0	41203	2
2	0	0	0	0	41204	2
2	0	2	0	0	41205	2
2	0	2	0	0	41206	2
2	0	0	0	0	41207	2
2	0	2	0	0	41208	2
4	0	2	0	0	41209	2
2	0	2	0	0	41210	2
2	0	2	0	0	41211	2
2	0	2	2	2	41212	2
2	0	2	0	0	41213	2
2	0	2	0	0	41214	2
2	0	2	2	2	41215	2
2	0	2	0	0	41216	2
2	0	2	0	0	41217	2
2	0	2	15	15	41218	2
2	0	2	0	0	41219	2
2	0	2	0	0	41220	2
2	0	2	1	1	41221	2
2	0	2	0	0	41222	2
2	0	2	1	1	41223	2
2	0	2	0	0	41224	2
2	0	2	0	0	41225	2
2	0	2	0	0	41226	2
2	0	2	0	0	41227	2
2	0	2	0	0	41228	2
2	0	2	0	0	41229	2
2	1	2	0	1	41230	1
2	0	2	0	0	41231	2
2	0	2	0	0	41232	2
2	0	2	0	0	41233	2
2	0	2	0	0	41234	2
2	0	4	6	6	41235	2
2	0	2	0	0	41236	2
2	0	2	0	0	41237	2
2	0	4	1	1	41238	2
2	2542	2	4	2546	41239	0
2	0	2	0	0	41240	2
2	0	4	151	151	41241	2
2	0	2	0	0	41242	2
2	0	2	0	0	41243	2
2	0	4	144	144	41244	2
2	0	2	0	0	41245	2
2	2	2	0	2	41246	0
2	3	4	24	27	41247	1
2	0	2	0	0	41248	2
2	0	2	0	0	41249	2
2	0	4	66	66	41250	2
2	0	2	0	0	41251	2
2	0	2	0	0	41252	2
2	0	2	0	0	41253	2
2	0	2	0	0	41254	2
2	0	2	0	0	41255	2
2	0	2	0	0	41256	2
2	0	2	0	0	41257	2
2	0	2	0	0	41258	2
2	0	2	0	0	41259	2
2	0	2	0	0	41260	2
2	0	2	0	0	41261	2
2	0	2	0	0	41262	2
2	0	2	0	0	41263	2
2	0	2	0	0	41264	2
2	0	4	2	2	41265	2
2	0	2	0	0	41266	2
2	0	2	0	0	41267	2
2	0	4	5	5	41268	2
2	0	2	0	0	41269	2
2	0	2	0	0	41270	2
2	0	2	0	0	41271	2
2	0	2	0	0	41272	2
2	0	2	0	0	41273	2
2	0	2	0	0	41274	2
2	0	2	0	0	41275	2
2	0	2	2	2	41276	2
2	0	2	0	0	41277	2
2	0	2	0	0	41278	2
2	0	2	2	2	41279	2
2	1	2	86	87	41280	0
2	0	2	0	0	41281	2
2	0	2	4	4	41282	2
2	0	2	0	0	41283	2
2	0	2	0	0	41284	2
2	0	2	0	0	41285	2
2	0	2	0	0	41286	2
2	0	2	0	0	41287	2
2	0	2	0	0	41288	2
2	0	2	0	0	41289	2
2	0	2	0	0	41290	2
2	1	2	0	1	41291	0
2	65	2	1	66	41292	0
2	0	2	1	1	41293	2
2	0	0	3	3	41294	2
2	0	2	0	0	41295	2
2	5	0	39	44	41296	1
2	0	2	6	6	41297	2
2	0	2	0	0	41298	2
2	1	2	14	15	41299	1
2	0	2	5	5	41300	2
4	0	2	0	0	41301	2
2	0	2	0	0	41302	2
2	0	2	0	0	41303	2
2	0	2	0	0	41304	2
2	0	2	0	0	41305	2
2	0	2	0	0	41306	2
2	0	2	0	0	41307	2
2	0	2	0	0	41308	2
2	0	2	0	0	41309	2
2	0	2	0	0	41310	2
2	0	4	10	10	41311	2
2	0	2	0	0	41312	2
2	6	4	10	16	41313	0
2	0	2	12	12	41314	2
2	0	2	0	0	41315	2
2	0	4	0	0	41316	2
2	0	2	0	0	41317	2
2	0	4	3	3	41318	2
2	0	2	0	0	41319	2
2	0	2	0	0	41320	2
2	0	2	0	0	41321	2
2	0	2	0	0	41322	2
2	0	2	0	0	41323	2
2	0	2	1	1	41324	2
2	0	2	0	0	41325	2
2	0	2	0	0	41326	2
2	0	2	0	0	41327	2
2	0	4	236	236	41328	2
2	0	2	0	0	41329	2
2	0	2	0	0	41330	2
2	0	4	2	2	41331	2
2	0	2	0	0	41332	2
2	5	2	0	5	41333	0
2	22	4	124	146	41334	1
2	0	2	2	2	41335	2
2	0	2	1	1	41336	2
0	5	4	19	24	41337	0
0	0	4	19	19	41338	2
2	0	2	0	0	41339	2
2	0	2	0	0	41340	2
2	0	2	0	0	41341	2
2	0	2	0	0	41342	2
2	0	2	0	0	41343	2
2	0	2	0	0	41344	2
2	0	2	0	0	41345	2
2	0	2	0	0	41346	2
2	0	2	0	0	41347	2
2	0	2	0	0	41348	2
2	0	2	0	0	41349	2
2	0	2	0	0	41350	2
2	0	2	0	0	41351	2
2	0	4	25	25	41352	2
2	0	2	0	0	41353	2
2	0	2	0	0	41354	2
2	2	4	3	5	41355	1
2	0	2	1	1	41356	2
0	0	2	3	3	41357	2
2	0	2	0	0	41358	2
2	0	4	32	32	41359	2
2	0	2	0	0	41360	2
2	0	2	0	0	41361	2
2	0	4	38	38	41362	2
2	0	2	0	0	41363	2
2	0	2	0	0	41364	2
2	0	2	1	1	41365	2
2	0	2	0	0	41366	2
2	0	2	12	12	41367	2
2	0	2	0	0	41368	2
2	0	2	0	0	41369	2
2	0	2	0	0	41370	2
2	0	4	1	1	41371	2
2	0	2	0	0	41372	2
2	0	2	0	0	41373	2
2	0	4	0	0	41374	2
2	0	2	0	0	41375	2
2	0	2	0	0	41376	2
2	0	2	0	0	41377	2
2	0	2	0	0	41378	2
2	0	2	0	0	41379	2
2	0	2	0	0	41380	2
2	0	2	0	0	41381	2
2	15	2	3	18	41382	0
2	5	4	214	219	41383	1
2	0	2	6	6	41384	2
2	0	2	1	1	41385	2
2	10	4	53	63	41386	0
2	0	2	62	62	41387	2
2	0	2	0	0	41388	2
2	0	4	13	13	41389	2
2	0	2	0	0	41390	2
2	0	2	0	0	41391	2
0	28	2	1	29	41392	1
0	13	2	0	13	41393	0
2	0	4	6	6	41394	2
2	15	2	1	16	41395	0
2	2	2	0	2	41396	0
2	56	2	25	81	41397	1
2	0	2	0	0	41398	2
2	0	2	0	0	41399	2
2	0	2	14	14	41400	2
2	0	2	0	0	41401	2
4	2734	2	25	2759	41402	0
4	1376	2	14	1390	41403	0
2	3	2	1	4	41404	0
2	4	4	273	277	41405	0
2	0	2	20	20	41406	2
2	3	4	3649	3652	41407	1
2	0	2	2	2	41408	2
2	0	2	0	0	41409	2
4	0	2	4	4	41410	2
2	0	2	0	0	41411	2
2	0	4	0	0	41412	2
2	0	2	0	0	41413	2
2	0	2	0	0	41414	2
2	0	4	0	0	41415	2
2	0	2	0	0	41416	2
2	0	2	0	0	41417	2
2	0	4	59	59	41418	2
2	0	2	1	1	41419	2
2	0	2	0	0	41420	2
2	0	4	7	7	41421	2
2	0	2	1	1	41422	2
4	4	2	0	4	41423	0
2	0	2	0	0	41424	2
2	0	2	0	0	41425	2
2	0	2	0	0	41426	2
2	0	2	0	0	41427	2
2	0	2	0	0	41428	2
2	0	2	0	0	41429	2
2	1	2	0	1	41430	0
2	1	2	109	110	41431	1
2	0	2	0	0	41432	2
2	0	2	0	0	41433	2
2	0	2	0	0	41434	2
2	0	4	0	0	41435	2
2	0	2	0	0	41436	2
2	0	2	0	0	41437	2
2	0	4	0	0	41438	2
2	0	2	0	0	41439	2
2	5	2	2	7	41440	0
2	0	2	18	18	41441	2
2	30	2	0	30	41442	0
2	4	4	27256	27260	41443	1
2	0	2	1	1	41444	2
2	0	2	0	0	41445	2
2	0	4	3171	3171	41446	2
2	0	2	5	5	41447	2
4	159	2	4	163	41448	0
2	0	2	0	0	41449	2
2	0	2	2	2	41450	2
2	0	2	0	0	41451	2
2	0	2	0	0	41452	2
2	0	2	0	0	41453	2
2	0	2	0	0	41454	2
2	87	2	0	87	41455	0
2	54	4	560	614	41456	1
2	0	2	27	27	41457	2
2	0	2	1	1	41458	2
2	49	4	5398	5447	41459	0
2	0	2	122	122	41460	2
2	1	2	0	1	41461	0
2	0	2	0	0	41462	2
2	0	4	0	0	41463	2
2	0	2	0	0	41464	2
2	0	2	0	0	41465	2
2	0	2	0	0	41466	2
2	0	2	0	0	41467	2
4	0	2	0	0	41468	2
2	0	2	0	0	41469	2
2	0	2	0	0	41470	2
2	0	2	0	0	41471	2
2	0	2	0	0	41472	2
2	0	2	0	0	41473	2
2	0	2	0	0	41474	2
2	3	2	0	3	41475	0
2	4	4	1	5	41476	1
2	0	2	3	3	41477	2
2	10	4	50	60	41478	1
2	0	2	1	1	41479	2
2	0	2	0	0	41480	2
0	0	4	3	3	41481	2
2	0	2	0	0	41482	2
2	0	2	0	0	41483	2
2	0	2	0	0	41484	2
2	0	2	0	0	41485	2
2	0	2	0	0	41486	2
2	0	2	0	0	41487	2
2	0	2	0	0	41488	2
2	0	4	0	0	41489	2
2	0	2	0	0	41490	2
2	0	4	0	0	41491	2
2	0	2	0	0	41492	2
2	0	2	0	0	41493	2
4	1	2	0	1	41494	1
2	0	2	0	0	41495	2
2	0	2	0	0	41496	2
2	0	2	0	0	41497	2
2	0	2	0	0	41498	2
2	0	2	0	0	41499	2
2	0	2	0	0	41500	2
2	0	2	0	0	41501	2
2	0	2	0	0	41502	2
2	0	2	0	0	41503	2
2	0	4	3	3	41504	2
2	0	2	0	0	41505	2
2	0	2	0	0	41506	2
2	0	2	0	0	41507	2
2	0	2	0	0	41508	2
2	0	2	0	0	41509	2
2	0	2	0	0	41510	2
2	0	2	0	0	41511	2
2	0	2	0	0	41512	2
2	0	2	0	0	41513	2
2	0	2	0	0	41514	2
2	0	2	0	0	41515	2
2	0	2	0	0	41516	2
2	0	2	0	0	41517	2
2	20	4	85	105	41518	0
2	0	2	0	0	41519	2
2	0	2	0	0	41520	2
2	2	4	8	10	41521	1
2	0	2	0	0	41522	2
2	0	2	0	0	41523	2
2	0	2	0	0	41524	2
2	0	2	0	0	41525	2
2	0	2	0	0	41526	2
2	0	2	0	0	41527	2
2	0	2	0	0	41528	2
2	0	2	0	0	41529	2
2	0	2	0	0	41530	2
2	0	2	0	0	41531	2
2	0	2	0	0	41532	2
2	0	2	4	4	41533	2
2	0	2	0	0	41534	2
2	0	2	0	0	41535	2
2	0	2	2	2	41536	2
2	0	2	0	0	41537	2
4	0	2	0	0	41538	2
2	0	2	0	0	41539	2
2	0	2	0	0	41540	2
2	0	2	0	0	41541	2
2	0	2	0	0	41542	2
2	0	2	0	0	41543	2
2	0	2	0	0	41544	2
2	0	2	0	0	41545	2
2	0	4	5	5	41546	2
2	0	2	0	0	41547	2
2	0	2	0	0	41548	2
2	0	4	0	0	41549	2
2	0	2	0	0	41550	2
2	50	2	1	51	41551	0
2	107	4	20673	20780	41552	1
2	1	2	116	117	41553	1
2	0	2	6	6	41554	2
2	22	4	723	745	41555	0
2	0	2	136	136	41556	2
2	0	2	0	0	41557	2
2	0	2	0	0	41558	2
2	0	2	0	0	41559	2
2	0	2	0	0	41560	2
2	0	2	0	0	41561	2
2	0	2	0	0	41562	2
2	0	2	0	0	41563	2
2	0	2	0	0	41564	2
2	0	2	0	0	41565	2
2	0	2	0	0	41566	2
2	0	2	0	0	41567	2
2	0	2	0	0	41568	2
2	0	2	0	0	41569	2
2	0	2	0	0	41570	2
2	0	2	0	0	41571	2
2	0	2	0	0	41572	2
2	0	2	0	0	41573	2
2	0	2	0	0	41574	2
0	712	0	2	714	41575	0
2	0	2	0	0	41576	2
2	0	2	0	0	41577	2
2	0	2	0	0	41578	2
2	0	2	0	0	41579	2
2	0	2	0	0	41580	2
2	0	2	0	0	41581	2
2	0	2	0	0	41582	2
2	0	2	0	0	41583	2
2	0	2	0	0	41584	2
2	0	2	0	0	41585	2
2	0	2	0	0	41586	2
2	0	2	0	0	41587	2
2	0	2	0	0	41588	2
2	0	2	0	0	41589	2
2	0	2	0	0	41590	2
2	0	2	0	0	41591	2
2	0	2	0	0	41592	2
2	0	2	0	0	41593	2
2	0	2	0	0	41594	2
2	0	2	0	0	41595	2
2	0	2	0	0	41596	2
2	0	2	0	0	41597	2
4	770	2	2	772	41598	0
4	1	2	2	3	41599	1
4	0	4	0	0	41600	2
4	0	4	0	0	41601	2
2	0	2	0	0	41602	2
2	0	2	0	0	41603	2
2	0	2	0	0	41604	2
2	0	2	0	0	41605	2
2	0	2	0	0	41606	2
2	0	2	0	0	41607	2
2	4	2	0	4	41608	0
2	10	2	274	284	41609	1
2	0	2	1	1	41610	2
2	0	2	0	0	41611	2
2	3	2	0	3	41612	0
2	0	2	7	7	41613	2
2	0	2	0	0	41614	2
2	0	2	0	0	41615	2
2	0	2	0	0	41616	2
2	0	2	0	0	41617	2
2	0	2	0	0	41618	2
2	0	2	0	0	41619	2
2	0	2	0	0	41620	2
2	0	2	1	1	41621	2
2	0	2	0	0	41622	2
2	0	2	0	0	41623	2
2	0	2	0	0	41624	2
2	0	2	0	0	41625	2
0	0	4	2	2	41626	2
4	0	4	0	0	41627	2
4	0	4	0	0	41628	2
2	0	2	0	0	41629	2
2	0	2	3	3	41630	2
2	0	2	0	0	41631	2
2	0	2	0	0	41632	2
2	0	2	0	0	41633	2
2	0	2	1	1	41634	2
2	0	2	0	0	41635	2
2	0	2	0	0	41636	2
2	0	2	0	0	41637	2
2	0	2	0	0	41638	2
2	0	2	0	0	41639	2
2	0	2	0	0	41640	2
2	0	2	0	0	41641	2
2	0	2	1	1	41642	2
2	0	2	0	0	41643	2
2	0	2	0	0	41644	2
2	0	2	7	7	41645	2
2	1	2	1	2	41646	1
2	0	2	0	0	41647	2
2	0	2	0	0	41648	2
2	0	2	0	0	41649	2
2	0	2	0	0	41650	2
2	0	2	0	0	41651	2
2	0	2	0	0	41652	2
2	0	2	0	0	41653	2
2	0	2	0	0	41654	2
2	0	2	0	0	41655	2
2	0	2	0	0	41656	2
2	0	2	0	0	41657	2
2	0	2	0	0	41658	2
2	0	2	0	0	41659	2
2	0	2	0	0	41660	2
2	0	2	0	0	41661	2
2	0	2	0	0	41662	2
2	0	2	31	31	41663	2
2	0	2	0	0	41664	2
4	1	2	2	3	41665	0
4	0	4	18	18	41666	2
4	159	2	13	172	41667	0
4	233	2	9	242	41668	0
4	98	2	2	100	41669	0
4	69	2	0	69	41670	0
0	512	2	52	564	41671	0
0	82	2	0	82	41672	0
0	40	2	0	40	41673	0
0	15	2	0	15	41674	0
0	4981	2	15	4996	41675	0
0	7668	2	44	7712	41676	0
0	1083	2	21	1104	41677	0
0	251	2	12	263	41678	1
0	40	2	0	40	41679	0
0	11	2	0	11	41680	0
0	0	2	0	0	41681	2
0	0	2	3	3	41682	2
0	0	2	0	0	41683	2
2	0	2	0	0	41684	2
2	0	2	0	0	41685	2
2	0	2	0	0	41686	2
2	0	2	0	0	41687	2
2	0	2	0	0	41688	2
2	0	2	0	0	41689	2
2	0	2	0	0	41690	2
2	0	2	0	0	41691	2
2	0	2	0	0	41692	2
2	0	2	0	0	41693	2
2	0	2	0	0	41694	2
2	0	2	0	0	41695	2
2	0	2	1	1	41696	2
2	0	2	0	0	41697	2
2	0	2	0	0	41698	2
2	0	2	0	0	41699	2
2	0	2	0	0	41700	2
2	0	2	0	0	41701	2
2	0	2	0	0	41702	2
2	0	2	0	0	41703	2
2	0	2	2	2	41704	2
2	0	2	0	0	41705	2
2	0	2	0	0	41706	2
2	0	2	0	0	41707	2
2	1	2	0	1	41708	1
2	0	2	268	268	41709	2
2	0	2	0	0	41710	2
2	0	4	0	0	41711	2
2	0	2	0	0	41712	2
2	0	2	0	0	41713	2
2	0	2	0	0	41714	2
2	0	2	0	0	41715	2
2	0	2	0	0	41716	2
2	0	2	0	0	41717	2
2	0	2	0	0	41718	2
2	0	4	46	46	41719	2
2	0	2	0	0	41720	2
2	0	2	0	0	41721	2
2	0	4	118	118	41722	2
2	0	2	0	0	41723	2
2	6	2	0	6	41724	0
2	2	4	312	314	41725	1
2	0	2	0	0	41726	2
2	0	2	0	0	41727	2
0	1	0	128	129	41728	1
2	3	0	128	131	41729	0
2	0	2	14	14	41730	2
0	0	4	3	3	41731	2
2	0	2	0	0	41732	2
2	0	4	0	0	41733	2
2	0	2	0	0	41734	2
2	0	2	0	0	41735	2
2	0	4	0	0	41736	2
2	0	2	0	0	41737	2
2	0	2	0	0	41738	2
2	0	0	0	0	41739	2
2	0	2	0	0	41740	2
2	0	2	0	0	41741	2
2	0	0	0	0	41742	2
2	0	2	0	0	41743	2
2	0	2	0	0	41744	2
2	0	2	3	3	41745	2
2	0	2	0	0	41746	2
2	0	2	0	0	41747	2
2	0	2	0	0	41748	2
2	0	2	0	0	41749	2
4	14	4	24	38	41750	0
2	0	2	0	0	41751	2
2	4	2	17	21	41752	1
2	0	2	0	0	41753	2
2	0	2	0	0	41754	2
2	1	2	2	3	41755	1
2	0	2	0	0	41756	2
0	1027	2	2	1029	41757	0
0	494	2	17	511	41758	0
4	2	2	19	21	41759	1
4	2	2	4	6	41760	0
0	117	2	2	119	41761	0
2	0	2	0	0	41762	2
2	0	2	0	0	41763	2
2	0	2	0	0	41764	2
2	0	2	0	0	41765	2
2	0	2	0	0	41766	2
2	0	2	0	0	41767	2
2	0	2	0	0	41768	2
2	0	2	0	0	41769	2
2	0	2	0	0	41770	2
2	0	2	0	0	41771	2
2	0	2	0	0	41772	2
2	0	2	0	0	41773	2
2	0	2	0	0	41774	2
2	0	2	0	0	41775	2
2	0	2	0	0	41776	2
2	0	2	0	0	41777	2
2	0	2	0	0	41778	2
2	0	2	0	0	41779	2
2	0	2	0	0	41780	2
2	0	4	21	21	41781	2
2	0	2	0	0	41782	2
2	0	2	0	0	41783	2
2	0	4	1	1	41784	2
2	0	2	2	2	41785	2
2	0	2	0	0	41786	2
2	0	2	0	0	41787	2
2	0	2	0	0	41788	2
2	0	2	0	0	41789	2
2	0	2	0	0	41790	2
2	0	2	0	0	41791	2
2	0	2	0	0	41792	2
2	0	2	0	0	41793	2
2	0	2	0	0	41794	2
2	0	2	0	0	41795	2
2	0	2	0	0	41796	2
2	0	2	0	0	41797	2
2	0	2	0	0	41798	2
2	0	2	0	0	41799	2
2	0	2	0	0	41800	2
2	0	2	0	0	41801	2
2	0	2	0	0	41802	2
2	0	2	0	0	41803	2
2	0	2	0	0	41804	2
2	0	2	0	0	41805	2
2	0	2	0	0	41806	2
2	0	2	0	0	41807	2
2	0	2	0	0	41808	2
2	0	2	0	0	41809	2
2	0	2	0	0	41810	2
2	0	2	0	0	41811	2
2	0	2	0	0	41812	2
2	0	2	0	0	41813	2
2	0	2	0	0	41814	2
2	0	2	0	0	41815	2
2	0	2	0	0	41816	2
2	0	2	0	0	41817	2
2	0	2	0	0	41818	2
2	0	2	0	0	41819	2
2	0	2	0	0	41820	2
2	0	2	0	0	41821	2
2	0	2	0	0	41822	2
2	0	2	2	2	41823	2
2	0	2	0	0	41824	2
2	0	2	0	0	41825	2
2	0	2	0	0	41826	2
2	0	2	0	0	41827	2
2	0	2	0	0	41828	2
2	0	2	25	25	41829	2
2	0	2	3	3	41830	2
2	0	2	0	0	41831	2
2	0	2	0	0	41832	2
2	0	2	8	8	41833	2
2	0	2	0	0	41834	2
2	0	2	1	1	41835	2
2	0	2	0	0	41836	2
2	0	2	0	0	41837	2
2	0	2	0	0	41838	2
2	0	2	0	0	41839	2
2	0	2	0	0	41840	2
2	0	0	0	0	41841	2
2	0	2	0	0	41842	2
2	0	2	0	0	41843	2
2	0	0	0	0	41844	2
2	0	2	0	0	41845	2
2	0	2	0	0	41846	2
2	0	2	0	0	41847	2
2	0	2	0	0	41848	2
2	0	2	0	0	41849	2
2	0	2	0	0	41850	2
2	0	2	0	0	41851	2
2	0	2	0	0	41852	2
2	0	2	2	2	41853	2
2	0	2	0	0	41854	2
2	0	2	0	0	41855	2
2	0	2	0	0	41856	2
2	0	2	0	0	41857	2
2	0	2	0	0	41858	2
2	0	2	0	0	41859	2
2	0	2	0	0	41860	2
2	0	2	0	0	41861	2
2	0	2	0	0	41862	2
2	0	2	0	0	41863	2
2	0	2	0	0	41864	2
2	0	2	0	0	41865	2
2	0	2	0	0	41866	2
2	0	2	0	0	41867	2
2	0	2	0	0	41868	2
2	0	2	3	3	41869	2
2	0	2	0	0	41870	2
2	0	2	0	0	41871	2
2	0	2	0	0	41872	2
2	0	2	0	0	41873	2
2	0	2	0	0	41874	2
2	0	2	0	0	41875	2
2	0	2	0	0	41876	2
2	0	2	0	0	41877	2
2	0	2	0	0	41878	2
2	0	2	0	0	41879	2
2	0	2	0	0	41880	2
2	0	2	0	0	41881	2
2	0	2	0	0	41882	2
2	0	2	0	0	41883	2
2	0	2	0	0	41884	2
2	0	2	0	0	41885	2
2	0	2	0	0	41886	2
2	0	2	0	0	41887	2
2	0	2	0	0	41888	2
2	0	2	0	0	41889	2
2	0	2	0	0	41890	2
2	0	2	0	0	41891	2
2	0	2	0	0	41892	2
2	0	2	0	0	41893	2
2	0	2	0	0	41894	2
2	0	2	0	0	41895	2
2	0	2	0	0	41896	2
2	0	2	0	0	41897	2
2	0	2	0	0	41898	2
2	0	2	0	0	41899	2
2	0	2	0	0	41900	2
2	0	2	2	2	41901	2
2	0	2	0	0	41902	2
2	0	2	0	0	41903	2
2	0	2	0	0	41904	2
2	0	2	0	0	41905	2
2	0	2	0	0	41906	2
2	0	2	0	0	41907	2
2	0	2	0	0	41908	2
2	0	2	0	0	41909	2
2	0	2	0	0	41910	2
2	0	2	0	0	41911	2
2	0	2	0	0	41912	2
2	0	2	0	0	41913	2
2	0	2	0	0	41914	2
2	0	2	0	0	41915	2
2	0	2	0	0	41916	2
2	0	2	0	0	41917	2
2	0	2	0	0	41918	2
2	0	2	0	0	41919	2
2	0	2	0	0	41920	2
2	0	2	0	0	41921	2
2	0	2	0	0	41922	2
2	0	2	0	0	41923	2
2	0	2	0	0	41924	2
2	0	2	0	0	41925	2
2	0	2	0	0	41926	2
2	0	2	0	0	41927	2
2	0	2	0	0	41928	2
2	0	2	0	0	41929	2
2	0	2	0	0	41930	2
2	0	2	0	0	41931	2
2	0	2	0	0	41932	2
2	0	2	0	0	41933	2
2	0	2	0	0	41934	2
2	0	2	0	0	41935	2
2	0	2	3	3	41936	2
2	0	2	0	0	41937	2
2	0	2	0	0	41938	2
2	0	2	0	0	41939	2
2	0	2	0	0	41940	2
2	13	2	0	13	41941	0
2	0	2	61	61	41942	2
2	0	2	8	8	41943	2
2	0	2	1	1	41944	2
2	2	2	2	4	41945	0
2	0	2	31	31	41946	2
2	0	2	0	0	41947	2
2	0	2	0	0	41948	2
2	0	2	0	0	41949	2
2	0	2	0	0	41950	2
2	0	2	0	0	41951	2
2	0	2	0	0	41952	2
2	0	2	0	0	41953	2
2	0	2	1	1	41954	2
2	0	2	0	0	41955	2
2	0	2	0	0	41956	2
2	0	2	0	0	41957	2
2	0	2	0	0	41958	2
2	0	2	0	0	41959	2
2	0	2	0	0	41960	2
2	0	2	0	0	41961	2
2	0	2	0	0	41962	2
2	0	2	0	0	41963	2
2	0	2	0	0	41964	2
2	0	2	0	0	41965	2
2	0	2	38	38	41966	2
2	0	2	0	0	41967	2
2	0	2	0	0	41968	2
2	0	2	82	82	41969	2
2	0	2	0	0	41970	2
2	0	2	0	0	41971	2
2	1	2	22	23	41972	1
2	0	2	0	0	41973	2
2	0	2	0	0	41974	2
2	1	2	0	1	41975	1
2	0	2	22	22	41976	2
2	0	2	0	0	41977	2
2	0	2	0	0	41978	2
2	0	2	0	0	41979	2
2	0	2	0	0	41980	2
2	0	2	0	0	41981	2
2	0	2	0	0	41982	2
2	0	2	0	0	41983	2
2	0	2	0	0	41984	2
2	0	2	0	0	41985	2
2	0	2	0	0	41986	2
2	0	2	0	0	41987	2
2	0	2	0	0	41988	2
2	0	2	0	0	41989	2
2	0	4	482	482	41990	2
2	0	2	0	0	41991	2
2	0	2	0	0	41992	2
2	0	4	137	137	41993	2
2	0	2	1	1	41994	2
4	0	2	5	5	41995	2
2	0	2	0	0	41996	2
2	0	2	0	0	41997	2
2	0	2	0	0	41998	2
2	0	2	0	0	41999	2
2	0	2	0	0	42000	2
2	0	2	0	0	42001	2
2	0	2	0	0	42002	2
2	0	2	0	0	42003	2
2	0	2	0	0	42004	2
2	0	2	0	0	42005	2
2	0	2	0	0	42006	2
2	0	2	0	0	42007	2
2	0	2	0	0	42008	2
2	0	2	0	0	42009	2
2	0	2	0	0	42010	2
2	0	2	0	0	42011	2
2	0	2	0	0	42012	2
2	0	2	0	0	42013	2
2	0	2	0	0	42014	2
2	0	2	0	0	42015	2
2	0	2	0	0	42016	2
2	0	2	0	0	42017	2
2	0	2	0	0	42018	2
2	0	2	0	0	42019	2
2	0	2	98	98	42020	2
2	3	2	0	3	42021	0
2	0	2	7	7	42022	2
2	0	2	0	0	42023	2
2	0	2	0	0	42024	2
2	0	2	0	0	42025	2
2	0	2	0	0	42026	2
2	0	2	0	0	42027	2
2	0	2	0	0	42028	2
2	0	2	0	0	42029	2
2	0	2	0	0	42030	2
2	0	2	0	0	42031	2
2	0	2	1	1	42032	2
2	0	2	0	0	42033	2
2	0	2	0	0	42034	2
2	0	2	0	0	42035	2
2	0	2	0	0	42036	2
2	0	2	0	0	42037	2
2	0	2	0	0	42038	2
2	0	2	0	0	42039	2
2	0	2	0	0	42040	2
2	0	2	0	0	42041	2
2	0	2	0	0	42042	2
2	0	2	0	0	42043	2
2	0	2	0	0	42044	2
2	0	2	0	0	42045	2
2	0	2	0	0	42046	2
2	0	2	0	0	42047	2
2	0	2	17	17	42048	2
2	0	2	0	0	42049	2
2	0	2	0	0	42050	2
2	0	2	0	0	42051	2
2	0	2	0	0	42052	2
2	0	2	0	0	42053	2
2	0	2	0	0	42054	2
2	0	2	0	0	42055	2
2	0	2	0	0	42056	2
2	0	2	0	0	42057	2
2	0	2	0	0	42058	2
2	0	2	0	0	42059	2
2	1	2	23	24	42060	1
2	0	2	0	0	42061	2
2	0	2	0	0	42062	2
2	0	2	5	5	42063	2
2	0	2	4	4	42064	2
0	166	4	1	167	42065	0
2	0	2	0	0	42066	2
2	0	2	0	0	42067	2
2	0	2	0	0	42068	2
2	0	2	0	0	42069	2
2	0	2	0	0	42070	2
2	0	2	0	0	42071	2
2	0	2	0	0	42072	2
2	0	2	9	9	42073	2
2	0	2	0	0	42074	2
2	0	2	0	0	42075	2
2	0	2	0	0	42076	2
2	0	2	1	1	42077	2
2	0	2	0	0	42078	2
2	0	2	0	0	42079	2
2	0	2	0	0	42080	2
2	0	2	1	1	42081	2
2	0	2	0	0	42082	2
2	0	2	0	0	42083	2
2	0	2	0	0	42084	2
2	0	4	0	0	42085	2
2	0	2	0	0	42086	2
2	0	2	0	0	42087	2
2	0	4	1	1	42088	2
2	0	2	0	0	42089	2
2	0	2	0	0	42090	2
2	0	2	0	0	42091	2
2	0	2	0	0	42092	2
2	0	2	0	0	42093	2
2	0	4	6	6	42094	2
2	0	2	0	0	42095	2
2	0	2	0	0	42096	2
2	0	2	0	0	42097	2
2	0	2	0	0	42098	2
2	0	2	0	0	42099	2
2	0	2	0	0	42100	2
2	0	2	0	0	42101	2
4	42	2	1	43	42102	0
4	0	2	0	0	42103	2
2	0	2	0	0	42104	2
2	0	2	0	0	42105	2
2	0	2	0	0	42106	2
2	0	2	0	0	42107	2
2	0	2	0	0	42108	2
2	0	2	0	0	42109	2
2	0	2	0	0	42110	2
2	0	2	0	0	42111	2
2	0	2	0	0	42112	2
2	0	2	0	0	42113	2
2	0	2	0	0	42114	2
2	0	2	0	0	42115	2
2	0	2	0	0	42116	2
2	0	2	3	3	42117	2
2	0	2	0	0	42118	2
2	0	2	0	0	42119	2
2	0	2	0	0	42120	2
2	0	2	0	0	42121	2
2	0	2	0	0	42122	2
2	0	2	0	0	42123	2
2	0	2	0	0	42124	2
2	0	2	0	0	42125	2
2	122	4	1078	1200	42126	0
2	0	2	0	0	42127	2
2	0	2	0	0	42128	2
0	20	2	0	20	42129	0
0	20	2	0	20	42130	0
2	0	2	28	28	42131	2
4	3	2	7	10	42132	1
2	10	2	3	13	42133	0
2	55	2	0	55	42134	0
2	0	2	0	0	42135	2
2	0	2	0	0	42136	2
2	0	2	0	0	42137	2
2	0	2	0	0	42138	2
2	0	2	0	0	42139	2
2	0	2	0	0	42140	2
2	0	0	4323	4323	42141	2
2	0	2	9	9	42142	2
2	0	2	0	0	42143	2
2	0	2	0	0	42144	2
2	0	2	0	0	42145	2
2	0	2	0	0	42146	2
2	0	2	0	0	42147	2
2	0	2	0	0	42148	2
2	0	2	0	0	42149	2
2	0	2	0	0	42150	2
2	0	2	0	0	42151	2
2	0	2	0	0	42152	2
2	0	2	0	0	42153	2
2	0	2	0	0	42154	2
2	0	2	0	0	42155	2
2	0	2	0	0	42156	2
2	0	4	1	1	42157	2
2	0	2	0	0	42158	2
2	0	2	0	0	42159	2
2	0	4	0	0	42160	2
2	0	2	0	0	42161	2
2	0	2	0	0	42162	2
2	0	2	0	0	42163	2
2	0	2	0	0	42164	2
2	0	2	0	0	42165	2
2	0	2	0	0	42166	2
2	0	2	0	0	42167	2
2	0	2	0	0	42168	2
2	0	2	1	1	42169	2
2	0	2	2	2	42170	2
2	3	2	9	12	42171	1
2	0	2	0	0	42172	2
2	0	2	0	0	42173	2
2	3	2	2	5	42174	0
2	0	2	20	20	42175	2
2	14	2	0	14	42176	0
2	0	2	139	139	42177	2
2	0	2	9	9	42178	2
2	0	2	0	0	42179	2
2	0	2	0	0	42180	2
4	2	4	70	72	42181	1
2	0	4	27	27	42182	2
2	0	2	0	0	42183	2
2	1	4	459	460	42184	0
2	0	2	0	0	42185	2
2	0	2	0	0	42186	2
2	0	2	0	0	42187	2
2	0	2	0	0	42188	2
2	0	2	0	0	42189	2
2	0	2	1	1	42190	2
2	0	2	0	0	42191	2
2	0	2	0	0	42192	2
2	41	2	0	41	42193	0
2	39	0	1223	1262	42194	1
2	0	2	12	12	42195	2
2	0	2	0	0	42196	2
2	55	0	53	108	42197	0
2	0	2	235	235	42198	2
2	0	2	0	0	42199	2
2	6	4	1004	1010	42200	1
2	0	2	0	0	42201	2
2	0	2	0	0	42202	2
2	2	4	487	489	42203	1
2	0	2	0	0	42204	2
2	0	2	0	0	42205	2
2	1	2	92	93	42206	1
2	0	2	0	0	42207	2
2	0	2	0	0	42208	2
2	2	2	3	5	42209	1
2	0	2	18	18	42210	2
2	0	2	0	0	42211	2
2	0	4	0	0	42212	2
2	0	2	0	0	42213	2
2	0	2	0	0	42214	2
2	0	4	0	0	42215	2
2	0	2	0	0	42216	2
2	2	2	0	2	42217	0
2	0	2	28	28	42218	2
2	0	2	0	0	42219	2
2	0	2	0	0	42220	2
2	1	2	0	1	42221	1
2	0	2	1	1	42222	2
2	0	2	0	0	42223	2
2	0	2	0	0	42224	2
2	0	2	0	0	42225	2
2	0	2	0	0	42226	2
2	0	2	0	0	42227	2
2	0	2	0	0	42228	2
2	0	2	0	0	42229	2
2	0	2	0	0	42230	2
2	0	2	0	0	42231	2
2	0	2	0	0	42232	2
2	0	2	0	0	42233	2
2	0	2	0	0	42234	2
2	0	2	0	0	42235	2
2	0	2	0	0	42236	2
2	0	2	0	0	42237	2
2	0	2	0	0	42238	2
2	0	2	0	0	42239	2
2	0	2	0	0	42240	2
2	15	0	609	624	42241	0
2	0	2	90	90	42242	2
0	2	4	61	63	42243	0
4	0	4	0	0	42244	2
4	0	4	0	0	42245	2
2	0	2	0	0	42246	2
2	0	2	0	0	42247	2
2	0	2	0	0	42248	2
2	0	2	0	0	42249	2
2	0	2	0	0	42250	2
2	0	2	0	0	42251	2
2	0	2	0	0	42252	2
2	109	2	91	200	42253	0
2	298	2	87	385	42254	0
2	0	2	1727	1727	42255	2
2	0	2	0	0	42256	2
2	0	2	0	0	42257	2
2	0	2	0	0	42258	2
2	0	2	0	0	42259	2
2	0	2	0	0	42260	2
2	0	2	0	0	42261	2
4	3	4	3	6	42262	1
2	0	2	0	0	42263	2
2	0	4	144	144	42264	2
2	0	2	0	0	42265	2
2	0	2	0	0	42266	2
2	0	4	66	66	42267	2
2	0	2	0	0	42268	2
2	0	2	0	0	42269	2
2	0	2	0	0	42270	2
2	0	2	0	0	42271	2
2	0	2	0	0	42272	2
2	0	4	226	226	42273	2
2	0	2	0	0	42274	2
2	0	2	0	0	42275	2
2	0	4	19	19	42276	2
2	0	2	0	0	42277	2
4	0	2	1	1	42278	2
2	0	2	0	0	42279	2
2	0	2	0	0	42280	2
2	0	2	0	0	42281	2
2	0	2	0	0	42282	2
2	0	2	0	0	42283	2
2	0	2	0	0	42284	2
2	0	2	0	0	42285	2
2	0	2	0	0	42286	2
2	0	2	0	0	42287	2
2	0	2	0	0	42288	2
2	0	2	0	0	42289	2
2	0	2	0	0	42290	2
2	0	2	0	0	42291	2
2	0	2	0	0	42292	2
2	0	2	0	0	42293	2
2	0	2	0	0	42294	2
2	0	2	0	0	42295	2
2	0	2	0	0	42296	2
2	18	4	216	234	42297	1
2	0	2	5	5	42298	2
2	0	2	1	1	42299	2
2	9	4	20	29	42300	1
2	3	4	115	118	42301	1
4	3	2	0	3	42302	0
2	1	2	0	1	42303	0
2	0	4	4191	4191	42304	2
2	0	2	0	0	42305	2
2	0	2	0	0	42306	2
2	0	4	1559	1559	42307	2
2	0	2	39	39	42308	2
4	0	2	0	0	42309	2
2	0	2	0	0	42310	2
2	0	4	90	90	42311	2
2	0	2	0	0	42312	2
2	0	2	0	0	42313	2
2	0	4	71	71	42314	2
2	0	2	0	0	42315	2
2	0	2	0	0	42316	2
2	0	2	6	6	42317	2
2	0	2	0	0	42318	2
2	0	2	0	0	42319	2
2	0	2	0	0	42320	2
2	0	2	1	1	42321	2
2	0	2	0	0	42322	2
2	0	2	0	0	42323	2
2	0	2	0	0	42324	2
2	0	2	0	0	42325	2
2	0	2	0	0	42326	2
2	0	2	0	0	42327	2
2	0	2	0	0	42328	2
2	0	2	14	14	42329	2
2	0	2	0	0	42330	2
2	0	2	0	0	42331	2
4	805	2	18	823	42332	0
4	16	2	0	16	42333	0
2	0	2	14	14	42334	2
2	0	2	2	2	42335	2
2	0	2	64	64	42336	2
2	0	2	4	4	42337	2
2	0	2	0	0	42338	2
4	0	2	10	10	42339	2
2	0	2	0	0	42340	2
2	0	2	0	0	42341	2
2	0	2	0	0	42342	2
2	0	2	0	0	42343	2
2	0	2	0	0	42344	2
2	0	2	0	0	42345	2
2	0	2	0	0	42346	2
2	0	2	0	0	42347	2
2	0	2	0	0	42348	2
2	0	2	0	0	42349	2
2	0	2	39	39	42350	2
2	0	2	0	0	42351	2
2	214	2	1	215	42352	0
2	0	2	0	0	42353	2
2	0	2	1	1	42354	2
2	0	2	0	0	42355	2
2	0	2	16	16	42356	2
2	0	2	0	0	42357	2
2	0	2	0	0	42358	2
2	1	2	0	1	42359	0
2	185	4	5789	5974	42360	1
2	0	2	6	6	42361	2
2	0	2	2	2	42362	2
2	0	4	25	25	42363	2
2	0	2	0	0	42364	2
2	0	2	0	0	42365	2
4	5	4	3	8	42366	0
4	1	4	0	1	42367	0
2	0	2	2	2	42368	2
2	0	2	1	1	42369	2
2	0	2	0	0	42370	2
2	0	2	3	3	42371	2
2	0	2	0	0	42372	2
2	0	2	0	0	42373	2
2	0	2	0	0	42374	2
2	0	2	0	0	42375	2
2	0	2	0	0	42376	2
2	0	2	0	0	42377	2
2	0	2	0	0	42378	2
2	0	2	0	0	42379	2
0	0	4	10	10	42380	2
2	0	2	0	0	42381	2
2	0	2	0	0	42382	2
2	0	2	0	0	42383	2
2	0	2	0	0	42384	2
2	0	2	0	0	42385	2
2	0	2	0	0	42386	2
2	0	2	0	0	42387	2
2	0	2	0	0	42388	2
2	1	2	1	2	42389	1
2	0	2	0	0	42390	2
2	0	2	0	0	42391	2
2	0	2	0	0	42392	2
2	0	2	0	0	42393	2
2	6	2	0	6	42394	0
2	0	2	30	30	42395	2
2	0	2	0	0	42396	2
2	0	2	0	0	42397	2
2	2	2	0	2	42398	0
2	0	2	11	11	42399	2
2	0	4	9	9	42400	2
2	0	4	24	24	42401	2
2	0	2	0	0	42402	2
2	0	2	0	0	42403	2
2	0	2	0	0	42404	2
2	0	2	0	0	42405	2
2	0	2	0	0	42406	2
2	0	2	0	0	42407	2
2	0	2	0	0	42408	2
2	0	2	0	0	42409	2
2	0	2	1	1	42410	2
2	0	2	0	0	42411	2
2	0	2	0	0	42412	2
2	0	2	0	0	42413	2
2	0	2	0	0	42414	2
2	0	2	0	0	42415	2
2	0	2	0	0	42416	2
2	0	4	2609	2609	42417	2
2	0	2	0	0	42418	2
2	0	2	0	0	42419	2
2	0	4	1223	1223	42420	2
2	1	2	10	11	42421	1
0	0	2	9	9	42422	2
2	0	2	0	0	42423	2
2	0	2	0	0	42424	2
2	0	2	0	0	42425	2
2	0	2	0	0	42426	2
2	0	2	0	0	42427	2
2	0	2	0	0	42428	2
2	0	2	0	0	42429	2
2	0	2	0	0	42430	2
2	0	2	0	0	42431	2
2	0	2	0	0	42432	2
2	0	2	0	0	42433	2
2	0	2	0	0	42434	2
0	0	2	0	0	42435	2
2	0	2	154	154	42436	2
2	0	2	0	0	42437	2
2	0	2	0	0	42438	2
2	0	2	0	0	42439	2
2	0	2	0	0	42440	2
2	0	2	0	0	42441	2
2	0	2	0	0	42442	2
2	0	2	0	0	42443	2
2	0	2	0	0	42444	2
2	0	2	0	0	42445	2
2	0	2	0	0	42446	2
2	0	2	0	0	42447	2
2	0	2	0	0	42448	2
2	0	2	1	1	42449	2
2	0	2	0	0	42450	2
2	0	4	176	176	42451	2
2	0	2	0	0	42452	2
2	0	2	0	0	42453	2
2	0	4	187	187	42454	2
2	0	2	0	0	42455	2
2	0	2	0	0	42456	2
2	0	2	0	0	42457	2
2	0	2	0	0	42458	2
2	0	2	0	0	42459	2
2	0	2	0	0	42460	2
2	0	2	0	0	42461	2
2	0	2	0	0	42462	2
2	0	2	0	0	42463	2
2	0	2	0	0	42464	2
2	0	2	0	0	42465	2
2	0	2	0	0	42466	2
2	1	2	0	1	42467	1
2	19	4	5	24	42468	0
2	0	2	0	0	42469	2
2	0	2	0	0	42470	2
2	0	2	1	1	42471	2
2	0	2	3	3	42472	2
2	0	2	0	0	42473	2
2	0	4	0	0	42474	2
2	0	2	0	0	42475	2
2	0	2	0	0	42476	2
2	0	4	0	0	42477	2
2	0	2	0	0	42478	2
2	0	2	0	0	42479	2
2	0	2	0	0	42480	2
2	0	2	0	0	42481	2
2	0	2	0	0	42482	2
2	0	2	0	0	42483	2
2	0	2	0	0	42484	2
2	0	2	0	0	42485	2
2	1	2	0	1	42486	1
2	0	2	1	1	42487	2
2	0	2	0	0	42488	2
2	0	2	0	0	42489	2
2	0	2	1	1	42490	2
2	39	2	1	40	42491	0
2	233	4	9486	9719	42492	1
2	1	2	28	29	42493	1
2	0	2	2	2	42494	2
2	94	4	197	291	42495	0
2	0	2	117	117	42496	2
4	4	4	1063	1067	42497	0
2	0	2	0	0	42498	2
2	0	4	20	20	42499	2
2	0	2	0	0	42500	2
2	0	2	0	0	42501	2
2	0	4	4	4	42502	2
2	0	2	0	0	42503	2
2	0	2	0	0	42504	2
2	0	2	0	0	42505	2
2	0	2	0	0	42506	2
2	0	2	0	0	42507	2
2	0	2	0	0	42508	2
2	0	2	0	0	42509	2
2	0	2	0	0	42510	2
2	0	2	1	1	42511	2
2	0	2	0	0	42512	2
2	0	2	0	0	42513	2
2	0	2	0	0	42514	2
2	0	2	0	0	42515	2
2	0	2	0	0	42516	2
2	0	4	0	0	42517	2
2	0	2	0	0	42518	2
2	0	4	0	0	42519	2
2	0	2	0	0	42520	2
2	0	2	0	0	42521	2
2	0	2	0	0	42522	2
2	2	2	12	14	42523	1
2	0	2	0	0	42524	2
2	0	2	0	0	42525	2
2	1	2	372	373	42526	1
2	0	2	1	1	42527	2
2	0	2	0	0	42528	2
2	0	2	0	0	42529	2
2	0	2	0	0	42530	2
2	0	2	0	0	42531	2
2	0	2	0	0	42532	2
2	0	2	0	0	42533	2
2	0	2	0	0	42534	2
2	0	2	1	1	42535	2
2	0	2	0	0	42536	2
2	0	2	0	0	42537	2
2	0	2	0	0	42538	2
2	0	2	0	0	42539	2
2	0	2	0	0	42540	2
2	0	4	5	5	42541	2
2	0	2	0	0	42542	2
2	0	2	0	0	42543	2
2	0	4	0	0	42544	2
2	0	2	0	0	42545	2
2	0	2	0	0	42546	2
2	0	2	21	21	42547	2
2	0	2	0	0	42548	2
2	0	2	0	0	42549	2
2	0	2	10	10	42550	2
2	0	2	0	0	42551	2
2	1	2	0	1	42552	0
2	1	2	4	5	42553	1
2	0	2	1	1	42554	2
2	2	2	10	12	42555	1
2	0	2	0	0	42556	2
2	0	2	0	0	42557	2
4	0	2	0	0	42558	2
2	0	2	0	0	42559	2
2	0	2	0	0	42560	2
2	0	2	0	0	42561	2
2	0	2	0	0	42562	2
2	0	2	0	0	42563	2
2	0	2	0	0	42564	2
2	0	2	0	0	42565	2
2	0	2	0	0	42566	2
2	0	2	0	0	42567	2
2	0	2	0	0	42568	2
2	0	2	0	0	42569	2
2	0	2	0	0	42570	2
2	0	2	0	0	42571	2
2	0	2	0	0	42572	2
2	0	2	0	0	42573	2
2	0	2	0	0	42574	2
2	0	2	0	0	42575	2
2	0	2	0	0	42576	2
2	0	2	0	0	42577	2
2	0	2	3	3	42578	2
2	0	2	0	0	42579	2
2	0	2	0	0	42580	2
2	0	2	0	0	42581	2
2	0	2	0	0	42582	2
2	0	2	0	0	42583	2
2	0	2	0	0	42584	2
2	0	2	0	0	42585	2
2	0	2	0	0	42586	2
2	0	2	0	0	42587	2
2	0	2	0	0	42588	2
0	0	4	0	0	42589	2
0	0	4	0	0	42590	2
4	0	4	0	0	42591	2
2	0	2	0	0	42592	2
2	0	2	0	0	42593	2
2	0	2	0	0	42594	2
2	0	2	0	0	42595	2
2	0	2	0	0	42596	2
2	0	2	0	0	42597	2
2	150	4	27	177	42598	0
2	0	2	0	0	42599	2
2	0	2	0	0	42600	2
2	0	2	0	0	42601	2
2	0	2	0	0	42602	2
2	0	2	0	0	42603	2
2	0	2	0	0	42604	2
2	21	2	0	21	42605	0
2	2	2	49	51	42606	1
2	0	2	3	3	42607	2
2	0	2	0	0	42608	2
2	18	2	0	18	42609	0
2	0	2	57	57	42610	2
2	0	2	0	0	42611	2
2	0	2	0	0	42612	2
2	0	2	0	0	42613	2
2	0	2	0	0	42614	2
2	0	2	0	0	42615	2
2	0	2	0	0	42616	2
0	0	4	0	0	42617	2
2	0	2	0	0	42618	2
2	0	2	0	0	42619	2
2	0	2	0	0	42620	2
2	0	2	0	0	42621	2
2	0	2	2	2	42622	2
2	0	2	0	0	42623	2
2	0	2	0	0	42624	2
2	0	2	6	6	42625	2
2	0	2	0	0	42626	2
2	0	2	0	0	42627	2
4	1	2	3	4	42628	0
2	2	2	27	29	42629	0
2	0	2	0	0	42630	2
2	0	2	0	0	42631	2
2	1	2	19	20	42632	1
2	0	2	1	1	42633	2
2	0	2	0	0	42634	2
2	2	2	0	2	42635	0
2	0	2	3	3	42636	2
2	0	2	0	0	42637	2
2	0	2	0	0	42638	2
2	0	2	0	0	42639	2
2	0	2	0	0	42640	2
2	0	2	0	0	42641	2
2	0	2	0	0	42642	2
2	0	2	0	0	42643	2
2	14	2	20	34	42644	1
2	0	2	0	0	42645	2
2	0	2	0	0	42646	2
2	1	2	1	2	42647	1
2	0	2	0	0	42648	2
4	301	2	20	321	42649	0
4	64	2	1	65	42650	0
2	0	2	0	0	42651	2
2	0	2	0	0	42652	2
2	0	2	0	0	42653	2
2	0	2	0	0	42654	2
2	0	2	0	0	42655	2
2	0	2	0	0	42656	2
4	0	4	4	4	42657	2
2	64	4	833	897	42658	1
2	0	2	44	44	42659	2
2	0	2	15	15	42660	2
2	59	4	121	180	42661	0
2	6343	2	116	6459	42662	0
2	1	2	115	116	42663	1
2	141	2	42	183	42664	0
2	0	2	0	0	42665	2
2	0	4	3	3	42666	2
2	0	2	0	0	42667	2
2	0	2	0	0	42668	2
2	0	4	2	2	42669	2
2	0	2	0	0	42670	2
2	0	2	0	0	42671	2
2	0	4	22	22	42672	2
2	0	2	0	0	42673	2
2	0	2	0	0	42674	2
2	0	4	25	25	42675	2
2	1	2	0	1	42676	0
2	1	2	114	115	42677	1
2	0	2	2	2	42678	2
2	0	2	0	0	42679	2
2	2	2	0	2	42680	1
2	0	2	15	15	42681	2
2	0	2	0	0	42682	2
2	0	4	0	0	42683	2
2	0	2	0	0	42684	2
2	0	2	0	0	42685	2
2	0	4	0	0	42686	2
2	0	2	0	0	42687	2
2	0	2	0	0	42688	2
2	0	2	1	1	42689	2
2	0	2	0	0	42690	2
2	0	2	0	0	42691	2
2	0	2	2	2	42692	2
2	0	2	0	0	42693	2
2	0	2	0	0	42694	2
2	0	2	2	2	42695	2
2	0	2	0	0	42696	2
2	0	2	0	0	42697	2
2	0	2	0	0	42698	2
2	0	2	0	0	42699	2
2	0	2	0	0	42700	2
2	0	4	42	42	42701	2
2	0	2	0	0	42702	2
2	0	2	0	0	42703	2
2	0	4	0	0	42704	2
2	0	2	0	0	42705	2
2	3	2	0	3	42706	1
2	0	2	0	0	42707	2
2	0	2	0	0	42708	2
2	0	2	0	0	42709	2
2	0	2	0	0	42710	2
2	0	2	0	0	42711	2
2	0	2	0	0	42712	2
2	0	2	0	0	42713	2
2	0	2	0	0	42714	2
2	0	2	0	0	42715	2
2	0	2	0	0	42716	2
2	0	2	0	0	42717	2
2	0	2	0	0	42718	2
2	0	2	0	0	42719	2
2	0	2	37	37	42720	2
2	0	2	0	0	42721	2
2	0	2	0	0	42722	2
0	0	4	0	0	42723	2
0	0	4	0	0	42724	2
2	0	2	2	2	42725	2
2	0	2	0	0	42726	2
2	0	2	0	0	42727	2
2	2	2	11	13	42728	1
2	0	2	0	0	42729	2
2	0	2	0	0	42730	2
2	1	2	2	3	42731	1
2	0	2	6	6	42732	2
2	0	2	0	0	42733	2
2	0	2	0	0	42734	2
2	0	2	0	0	42735	2
2	0	2	0	0	42736	2
2	0	2	0	0	42737	2
2	0	2	0	0	42738	2
2	7	2	698	705	42739	0
2	0	2	1	1	42740	2
2	0	2	0	0	42741	2
2	0	4	2	2	42742	2
2	10	2	0	10	42743	1
2	0	2	9	9	42744	2
2	0	2	0	0	42745	2
2	0	2	0	0	42746	2
2	0	2	0	0	42747	2
2	0	2	0	0	42748	2
2	0	2	0	0	42749	2
2	0	2	1	1	42750	2
4	0	4	271	271	42751	2
2	0	2	1	1	42752	2
2	0	2	0	0	42753	2
2	0	2	0	0	42754	2
2	0	2	0	0	42755	2
2	0	2	0	0	42756	2
2	0	2	0	0	42757	2
2	0	2	0	0	42758	2
0	2	4	1	3	42759	0
2	0	2	0	0	42760	2
2	0	2	0	0	42761	2
2	0	2	0	0	42762	2
2	0	2	0	0	42763	2
2	0	2	0	0	42764	2
2	0	2	0	0	42765	2
0	0	2	0	0	42766	2
0	0	2	0	0	42767	2
0	0	2	0	0	42768	2
2	0	2	14	14	42769	2
2	0	2	0	0	42770	2
2	0	2	0	0	42771	2
4	20	2	2	22	42772	0
2	1	2	41	42	42773	0
2	0	2	5	5	42774	2
4	64	2	58	122	42775	0
2	0	2	0	0	42776	2
2	0	2	1	1	42777	2
2	0	2	0	0	42778	2
2	0	2	0	0	42779	2
2	0	2	112575	112575	42780	2
2	0	2	0	0	42781	2
2	0	2	0	0	42782	2
2	2	2	0	2	42783	0
2	0	2	3	3	42784	2
2	0	2	0	0	42785	2
2	0	2	1	1	42786	2
2	0	2	1	1	42787	2
2	0	2	1	1	42788	2
2	0	2	0	0	42789	2
2	0	2	0	0	42790	2
2	0	2	0	0	42791	2
2	0	2	0	0	42792	2
2	0	2	0	0	42793	2
2	0	2	2	2	42794	2
2	0	2	0	0	42795	2
2	28	2	329	357	42796	1
2	1	2	1	2	42797	1
2	0	2	0	0	42798	2
2	6	2	1	7	42799	0
2	0	2	6	6	42800	2
2	0	2	0	0	42801	2
2	0	2	0	0	42802	2
2	0	2	0	0	42803	2
2	0	2	0	0	42804	2
2	0	2	0	0	42805	2
2	0	2	0	0	42806	2
2	0	2	0	0	42807	2
2	0	2	0	0	42808	2
2	0	2	0	0	42809	2
2	0	2	0	0	42810	2
2	0	2	0	0	42811	2
2	0	2	0	0	42812	2
4	0	2	0	0	42813	2
2	19	4	79	98	42814	0
2	1	2	45	46	42815	1
2	37	2	0	37	42816	0
2	0	2	0	0	42817	2
2	0	2	0	0	42818	2
2	0	2	0	0	42819	2
2	0	2	0	0	42820	2
2	0	2	0	0	42821	2
2	0	2	0	0	42822	2
2	0	2	0	0	42823	2
2	0	2	0	0	42824	2
2	0	2	0	0	42825	2
2	0	2	0	0	42826	2
2	0	2	0	0	42827	2
2	0	2	0	0	42828	2
2	0	2	0	0	42829	2
2	0	2	0	0	42830	2
2	0	2	0	0	42831	2
2	0	2	0	0	42832	2
2	0	2	0	0	42833	2
2	0	2	0	0	42834	2
2	0	2	0	0	42835	2
2	0	4	0	0	42836	2
2	0	2	0	0	42837	2
2	0	2	0	0	42838	2
2	0	4	0	0	42839	2
2	0	2	0	0	42840	2
2	7	4	694	701	42841	1
2	1	2	27	28	42842	1
2	0	2	2	2	42843	2
2	0	2	0	0	42844	2
2	0	2	0	0	42845	2
2	0	2	0	0	42846	2
2	0	2	0	0	42847	2
2	0	2	0	0	42848	2
2	0	2	0	0	42849	2
2	0	2	0	0	42850	2
2	0	2	0	0	42851	2
2	0	2	0	0	42852	2
2	0	2	0	0	42853	2
2	0	2	0	0	42854	2
2	3	2	1	4	42855	0
2	0	2	0	0	42856	2
2	0	2	0	0	42857	2
2	0	2	0	0	42858	2
2	0	2	0	0	42859	2
2	0	2	0	0	42860	2
2	0	2	0	0	42861	2
2	0	2	0	0	42862	2
2	0	4	22	22	42863	2
2	0	2	0	0	42864	2
2	0	2	0	0	42865	2
2	0	4	5	5	42866	2
2	0	2	0	0	42867	2
4	0	4	68	68	42868	2
2	2	2	2	4	42869	1
2	0	2	1	1	42870	2
2	0	2	1	1	42871	2
2	7	2	3	10	42872	0
4	16	2	2	18	42873	0
2	12	2	0	12	42874	0
2	0	2	75	75	42875	2
2	0	2	1	1	42876	2
2	0	2	0	0	42877	2
2	4	2	0	4	42878	1
2	0	2	26	26	42879	2
2	0	2	0	0	42880	2
2	0	2	0	0	42881	2
2	0	2	0	0	42882	2
2	0	2	0	0	42883	2
2	0	2	0	0	42884	2
2	0	2	0	0	42885	2
2	0	2	0	0	42886	2
2	0	2	0	0	42887	2
2	0	2	0	0	42888	2
2	0	2	0	0	42889	2
2	0	2	0	0	42890	2
2	0	2	0	0	42891	2
2	0	2	0	0	42892	2
2	3	2	0	3	42893	0
2	3	2	132	135	42894	1
2	0	2	0	0	42895	2
2	0	2	0	0	42896	2
2	4	2	3	7	42897	0
2	0	2	1	1	42898	2
2	0	2	0	0	42899	2
2	0	2	0	0	42900	2
2	0	2	0	0	42901	2
2	0	2	2	2	42902	2
2	0	2	0	0	42903	2
2	0	2	1	1	42904	2
2	0	2	0	0	42905	2
2	0	2	0	0	42906	2
2	0	2	0	0	42907	2
2	0	2	0	0	42908	2
2	4	4	8891	8895	42909	1
2	0	2	0	0	42910	2
2	0	2	0	0	42911	2
2	0	4	82	82	42912	2
2	0	2	4	4	42913	2
0	0	4	26	26	42914	2
2	1	2	0	1	42915	0
2	0	4	142	142	42916	2
2	0	2	0	0	42917	2
2	0	2	0	0	42918	2
2	0	4	214	214	42919	2
2	0	2	1	1	42920	2
2	0	2	0	0	42921	2
2	0	2	0	0	42922	2
2	0	2	0	0	42923	2
2	0	2	1	1	42924	2
2	0	2	0	0	42925	2
2	0	2	0	0	42926	2
2	0	2	0	0	42927	2
2	0	2	0	0	42928	2
2	0	2	0	0	42929	2
2	0	2	0	0	42930	2
2	0	2	0	0	42931	2
2	0	2	0	0	42932	2
2	0	2	0	0	42933	2
2	0	2	0	0	42934	2
2	0	2	0	0	42935	2
2	0	2	0	0	42936	2
2	0	2	0	0	42937	2
2	0	2	0	0	42938	2
2	0	2	1	1	42939	2
2	0	2	0	0	42940	2
2	9	2	78	87	42941	0
2	0	2	117	117	42942	2
2	1	2	0	1	42943	0
2	0	2	0	0	42944	2
2	3	2	0	3	42945	0
2	0	4	7	7	42946	2
2	0	2	0	0	42947	2
2	0	2	0	0	42948	2
2	0	4	0	0	42949	2
2	0	2	0	0	42950	2
2	0	2	0	0	42951	2
2	0	4	0	0	42952	2
2	0	2	0	0	42953	2
2	0	2	0	0	42954	2
2	0	4	0	0	42955	2
2	0	2	0	0	42956	2
4	0	4	0	0	42957	2
4	0	4	0	0	42958	2
2	0	2	1	1	42959	2
2	11	2	0	11	42960	0
2	2	4	1199	1201	42961	1
2	0	2	0	0	42962	2
2	0	2	0	0	42963	2
2	0	4	291	291	42964	2
2	0	2	2	2	42965	2
2	0	2	0	0	42966	2
2	0	2	0	0	42967	2
2	0	2	0	0	42968	2
2	0	2	0	0	42969	2
2	0	2	0	0	42970	2
2	0	2	0	0	42971	2
2	0	2	0	0	42972	2
2	0	4	10	10	42973	2
2	0	2	0	0	42974	2
2	0	2	0	0	42975	2
2	0	2	0	0	42976	2
2	0	2	0	0	42977	2
2	0	2	0	0	42978	2
2	0	4	36	36	42979	2
2	0	2	0	0	42980	2
2	0	2	0	0	42981	2
2	0	4	7	7	42982	2
2	0	2	0	0	42983	2
2	0	2	0	0	42984	2
2	0	2	0	0	42985	2
2	0	2	0	0	42986	2
2	0	2	0	0	42987	2
2	0	2	0	0	42988	2
2	0	2	0	0	42989	2
2	0	2	0	0	42990	2
2	0	2	0	0	42991	2
2	0	2	0	0	42992	2
2	0	2	0	0	42993	2
2	0	2	0	0	42994	2
2	0	2	0	0	42995	2
2	0	2	0	0	42996	2
2	0	2	0	0	42997	2
2	0	2	0	0	42998	2
2	0	2	0	0	42999	2
2	0	2	0	0	43000	2
2	0	2	0	0	43001	2
2	0	2	0	0	43002	2
2	0	4	0	0	43003	2
2	0	2	0	0	43004	2
2	0	2	0	0	43005	2
2	0	4	0	0	43006	2
2	0	2	0	0	43007	2
2	44	2	0	44	43008	0
2	14	4	17914	17928	43009	1
2	2	2	12	14	43010	1
2	0	2	0	0	43011	2
2	7	4	48550	48557	43012	0
2	0	2	25	25	43013	2
4	0	2	12	12	43014	2
2	0	4	1690	1690	43015	2
2	0	2	0	0	43016	2
2	0	2	0	0	43017	2
0	0	2	4	4	43018	2
0	0	2	4	4	43019	2
2	1	4	18	19	43020	1
2	0	2	14	14	43021	2
4	26	2	10	36	43022	1
2	1	2	0	1	43023	0
2	0	2	20	20	43024	2
2	0	2	0	0	43025	2
2	0	2	0	0	43026	2
2	1	2	0	1	43027	0
2	0	2	0	0	43028	2
2	0	2	0	0	43029	2
2	0	2	0	0	43030	2
2	0	2	0	0	43031	2
2	0	2	0	0	43032	2
2	0	2	0	0	43033	2
2	0	2	0	0	43034	2
2	0	2	0	0	43035	2
2	0	2	0	0	43036	2
2	0	2	0	0	43037	2
2	0	2	0	0	43038	2
2	0	2	0	0	43039	2
2	0	2	0	0	43040	2
2	0	2	0	0	43041	2
2	0	2	0	0	43042	2
2	0	2	0	0	43043	2
2	0	2	0	0	43044	2
2	0	2	0	0	43045	2
2	0	2	0	0	43046	2
2	0	2	0	0	43047	2
2	0	2	1	1	43048	2
2	0	2	0	0	43049	2
2	0	2	0	0	43050	2
2	0	2	0	0	43051	2
2	0	2	0	0	43052	2
2	0	2	0	0	43053	2
2	0	2	0	0	43054	2
2	0	2	0	0	43055	2
2	0	2	0	0	43056	2
2	0	2	0	0	43057	2
2	0	2	0	0	43058	2
2	0	2	0	0	43059	2
2	0	2	0	0	43060	2
2	0	2	0	0	43061	2
2	0	2	0	0	43062	2
2	0	2	0	0	43063	2
2	0	2	77	77	43064	2
2	0	2	0	0	43065	2
2	0	2	0	0	43066	2
2	0	2	0	0	43067	2
2	0	2	0	0	43068	2
2	0	2	0	0	43069	2
2	0	2	0	0	43070	2
2	0	2	0	0	43071	2
2	0	2	0	0	43072	2
2	0	2	0	0	43073	2
2	0	2	0	0	43074	2
2	0	2	0	0	43075	2
2	0	2	0	0	43076	2
2	0	4	1800	1800	43077	2
2	0	2	0	0	43078	2
2	0	2	0	0	43079	2
2	0	2	1	1	43080	2
2	0	2	0	0	43081	2
2	0	2	0	0	43082	2
4	25	2	0	25	43083	0
4	1	2	0	1	43084	1
2	0	2	0	0	43085	2
2	0	2	0	0	43086	2
2	0	2	0	0	43087	2
2	0	2	0	0	43088	2
2	0	2	0	0	43089	2
2	0	2	0	0	43090	2
2	0	2	0	0	43091	2
2	0	2	0	0	43092	2
2	0	2	0	0	43093	2
2	0	2	0	0	43094	2
2	0	2	0	0	43095	2
2	0	2	0	0	43096	2
2	0	2	0	0	43097	2
2	0	4	43	43	43098	2
2	0	2	0	0	43099	2
2	0	2	0	0	43100	2
2	0	4	0	0	43101	2
2	0	2	0	0	43102	2
2	0	2	0	0	43103	2
2	0	2	0	0	43104	2
2	0	2	0	0	43105	2
2	0	2	0	0	43106	2
2	0	2	0	0	43107	2
2	0	2	0	0	43108	2
0	336	4	2	338	43109	0
2	0	4	532	532	43110	2
4	379	4	1134	1513	43111	0
2	0	4	822	822	43112	2
2	0	2	4	4	43113	2
0	489	0	3	492	43114	1
2	0	2	0	0	43115	2
2	0	4	2	2	43116	2
2	0	2	0	0	43117	2
2	0	2	0	0	43118	2
2	0	4	2	2	43119	2
2	0	2	0	0	43120	2
4	0	4	2	2	43121	2
2	0	2	0	0	43122	2
2	0	2	0	0	43123	2
2	0	2	0	0	43124	2
2	0	2	0	0	43125	2
2	0	2	0	0	43126	2
2	0	2	0	0	43127	2
2	0	2	0	0	43128	2
2	0	2	0	0	43129	2
2	0	2	0	0	43130	2
2	0	2	0	0	43131	2
2	0	2	0	0	43132	2
2	0	2	0	0	43133	2
2	0	2	0	0	43134	2
2	0	2	0	0	43135	2
2	0	2	0	0	43136	2
2	0	2	0	0	43137	2
2	0	2	0	0	43138	2
2	0	2	0	0	43139	2
4	2	4	172	174	43140	1
4	0	4	1	1	43141	2
4	0	4	0	0	43142	2
2	0	2	0	0	43143	2
2	0	4	10224	10224	43144	2
2	0	2	0	0	43145	2
2	0	2	0	0	43146	2
2	0	4	773	773	43147	2
2	0	4	456	456	43148	2
4	145	2	4	149	43149	0
2	0	2	0	0	43150	2
2	0	2	0	0	43151	2
2	0	2	0	0	43152	2
2	0	2	0	0	43153	2
2	0	2	0	0	43154	2
2	0	2	0	0	43155	2
2	0	2	0	0	43156	2
2	0	2	0	0	43157	2
2	0	2	0	0	43158	2
2	0	2	0	0	43159	2
2	0	2	0	0	43160	2
2	0	2	0	0	43161	2
2	0	2	0	0	43162	2
2	0	2	0	0	43163	2
2	0	2	0	0	43164	2
2	3	2	0	3	43165	0
2	0	2	0	0	43166	2
2	0	2	0	0	43167	2
2	0	2	0	0	43168	2
2	0	2	0	0	43169	2
2	0	2	0	0	43170	2
2	0	2	0	0	43171	2
2	6	2	62	68	43172	1
2	0	2	0	0	43173	2
2	0	2	0	0	43174	2
2	0	2	0	0	43175	2
2	0	2	4	4	43176	2
0	18	4	1	19	43177	0
0	5	4	1	6	43178	0
2	4	2	0	4	43179	0
2	0	2	3	3	43180	2
2	0	2	0	0	43181	2
2	0	2	0	0	43182	2
2	1	2	0	1	43183	0
2	0	2	2	2	43184	2
2	0	2	0	0	43185	2
2	13	2	27	40	43186	1
2	0	2	0	0	43187	2
2	0	2	0	0	43188	2
2	2	2	2	4	43189	1
2	0	2	0	0	43190	2
4	0	4	1	1	43191	2
4	0	4	1	1	43192	2
2	728	2	1	729	43193	0
2	66	4	9709	9775	43194	1
2	0	2	76	76	43195	2
2	0	2	1	1	43196	2
2	56	4	4179	4235	43197	0
2	0	2	679	679	43198	2
2	0	2	0	0	43199	2
2	0	2	0	0	43200	2
2	0	4	0	0	43201	2
2	0	2	0	0	43202	2
2	0	2	0	0	43203	2
2	0	4	0	0	43204	2
2	0	2	0	0	43205	2
2	0	2	0	0	43206	2
2	0	2	2	2	43207	2
2	0	2	0	0	43208	2
2	0	2	0	0	43209	2
2	0	2	0	0	43210	2
2	0	2	1	1	43211	2
2	0	2	5	5	43212	2
2	0	2	0	0	43213	2
2	0	2	0	0	43214	2
2	0	2	2	2	43215	2
2	3	2	70	73	43216	1
2	24	2	0	24	43217	0
2	0	2	0	0	43218	2
2	0	2	0	0	43219	2
2	0	2	0	0	43220	2
2	0	2	0	0	43221	2
2	0	2	0	0	43222	2
2	0	2	0	0	43223	2
2	0	2	1	1	43224	2
2	0	2	0	0	43225	2
2	2	2	0	2	43226	0
2	0	2	0	0	43227	2
2	0	2	0	0	43228	2
2	0	2	0	0	43229	2
2	0	2	0	0	43230	2
2	0	2	0	0	43231	2
2	0	4	775	775	43232	2
2	0	2	0	0	43233	2
2	0	2	0	0	43234	2
2	0	4	809	809	43235	2
2	0	2	0	0	43236	2
2	14	2	0	14	43237	0
2	0	2	191	191	43238	2
2	0	2	1	1	43239	2
2	0	2	0	0	43240	2
2	4	2	0	4	43241	0
2	0	2	33	33	43242	2
2	0	2	0	0	43243	2
2	0	2	1368	1368	43244	2
2	0	2	0	0	43245	2
2	0	2	0	0	43246	2
2	0	2	8296	8296	43247	2
2	0	2	1	1	43248	2
2	0	2	1	1	43249	2
2	0	2	0	0	43250	2
2	0	2	0	0	43251	2
2	0	2	0	0	43252	2
2	0	2	0	0	43253	2
2	1	2	0	1	43254	0
2	0	2	0	0	43255	2
2	0	2	0	0	43256	2
2	0	2	0	0	43257	2
2	0	2	0	0	43258	2
2	1	2	0	1	43259	1
2	0	2	0	0	43260	2
2	0	2	5	5	43261	2
2	0	2	0	0	43262	2
2	0	2	0	0	43263	2
2	1	2	4	5	43264	1
2	0	2	12	12	43265	2
2	0	2	0	0	43266	2
2	0	4	7	7	43267	2
2	0	2	0	0	43268	2
2	0	2	0	0	43269	2
2	0	4	63	63	43270	2
2	0	2	1	1	43271	2
2	18	2	0	18	43272	0
2	6	4	74	80	43273	1
2	0	2	1	1	43274	2
2	0	2	0	0	43275	2
2	5	4	2	7	43276	0
2	0	2	16	16	43277	2
2	0	2	0	0	43278	2
2	0	2	0	0	43279	2
2	0	2	0	0	43280	2
2	0	2	0	0	43281	2
2	0	2	0	0	43282	2
2	0	2	0	0	43283	2
2	6	4	1066	1072	43284	1
2	0	2	0	0	43285	2
2	0	2	0	0	43286	2
2	5	4	2586	2591	43287	0
2	0	2	256	256	43288	2
2	0	2	0	0	43289	2
2	0	2	2	2	43290	2
2	0	2	0	0	43291	2
2	0	2	0	0	43292	2
2	0	2	0	0	43293	2
2	0	2	0	0	43294	2
2	0	2	0	0	43295	2
2	0	2	0	0	43296	2
2	0	2	0	0	43297	2
2	0	2	0	0	43298	2
2	0	2	0	0	43299	2
2	0	2	0	0	43300	2
2	43	2	2	45	43301	0
0	2	4	2	4	43302	0
2	0	2	0	0	43303	2
2	0	2	0	0	43304	2
2	0	2	0	0	43305	2
2	0	2	0	0	43306	2
2	0	2	0	0	43307	2
2	0	2	0	0	43308	2
2	0	2	0	0	43309	2
2	0	4	25	25	43310	2
2	0	2	0	0	43311	2
2	0	2	0	0	43312	2
2	0	4	0	0	43313	2
2	0	2	2	2	43314	2
2	15	4	3765	3780	43315	1
2	1	2	37	38	43316	1
2	0	2	5	5	43317	2
2	37	4	626	663	43318	0
2	0	2	540	540	43319	2
2	0	2	0	0	43320	2
2	0	2	0	0	43321	2
2	0	2	0	0	43322	2
2	0	2	0	0	43323	2
2	0	2	0	0	43324	2
2	0	2	0	0	43325	2
2	0	2	0	0	43326	2
2	0	2	0	0	43327	2
2	0	2	0	0	43328	2
2	0	2	0	0	43329	2
2	0	2	0	0	43330	2
2	0	2	0	0	43331	2
2	0	2	0	0	43332	2
2	0	2	0	0	43333	2
2	0	2	1	1	43334	2
2	0	2	0	0	43335	2
2	0	2	0	0	43336	2
2	0	2	1	1	43337	2
2	0	2	0	0	43338	2
2	0	4	689	689	43339	2
2	0	2	0	0	43340	2
2	0	2	0	0	43341	2
2	0	4	138	138	43342	2
2	0	2	3	3	43343	2
2	0	2	0	0	43344	2
2	0	2	2	2	43345	2
2	0	2	0	0	43346	2
2	0	2	0	0	43347	2
2	0	2	0	0	43348	2
2	0	2	0	0	43349	2
0	1	0	7	8	43350	1
0	0	0	0	0	43351	2
0	0	0	0	0	43352	2
0	0	0	0	0	43353	2
2	0	2	0	0	43354	2
2	0	2	0	0	43355	2
2	0	2	0	0	43356	2
2	0	2	0	0	43357	2
2	0	2	0	0	43358	2
2	0	2	0	0	43359	2
2	10	2	0	10	43360	0
2	0	2	0	0	43361	2
2	0	2	8	8	43362	2
2	1	2	15	16	43363	1
2	0	2	0	0	43364	2
2	0	2	0	0	43365	2
2	0	2	0	0	43366	2
2	0	2	0	0	43367	2
2	0	2	0	0	43368	2
2	0	2	0	0	43369	2
2	0	2	0	0	43370	2
2	0	2	0	0	43371	2
2	0	2	0	0	43372	2
2	0	2	0	0	43373	2
2	0	2	0	0	43374	2
2	0	4	8422	8422	43375	2
2	0	2	0	0	43376	2
2	0	2	0	0	43377	2
2	0	2	0	0	43378	2
2	1	2	2	3	43379	1
2	0	2	0	0	43380	2
2	0	2	0	0	43381	2
2	0	4	5028	5028	43382	2
2	0	2	0	0	43383	2
2	0	2	0	0	43384	2
2	0	2	0	0	43385	2
2	0	2	0	0	43386	2
2	0	2	0	0	43387	2
2	0	2	0	0	43388	2
2	0	2	0	0	43389	2
2	0	2	0	0	43390	2
2	0	4	39	39	43391	2
2	0	2	0	0	43392	2
2	0	2	0	0	43393	2
2	0	4	3	3	43394	2
2	0	2	0	0	43395	2
2	0	2	0	0	43396	2
2	0	4	0	0	43397	2
2	0	2	0	0	43398	2
2	0	2	0	0	43399	2
2	0	4	0	0	43400	2
2	0	2	0	0	43401	2
2	0	2	0	0	43402	2
2	0	4	5	5	43403	2
2	0	2	0	0	43404	2
2	0	2	0	0	43405	2
2	0	4	2	2	43406	2
2	0	2	0	0	43407	2
2	22	2	0	22	43408	0
2	11	2	60	71	43409	1
2	0	2	6	6	43410	2
2	0	2	0	0	43411	2
2	10	2	0	10	43412	0
2	0	2	58	58	43413	2
2	0	2	0	0	43414	2
2	0	2	0	0	43415	2
2	0	2	0	0	43416	2
2	0	2	0	0	43417	2
2	0	2	420	420	43418	2
2	0	2	0	0	43419	2
2	0	2	0	0	43420	2
2	0	4	23	23	43421	2
2	0	2	0	0	43422	2
2	0	2	0	0	43423	2
2	0	2	0	0	43424	2
2	0	2	0	0	43425	2
2	0	2	0	0	43426	2
2	0	2	0	0	43427	2
2	0	2	0	0	43428	2
2	0	2	0	0	43429	2
2	3	2	0	3	43430	0
2	0	2	0	0	43431	2
2	0	2	4	4	43432	2
2	0	2	0	0	43433	2
2	0	2	0	0	43434	2
2	0	2	0	0	43435	2
2	0	2	0	0	43436	2
2	2	2	41	43	43437	1
2	0	2	0	0	43438	2
2	0	2	0	0	43439	2
2	1	2	0	1	43440	1
2	0	2	3	3	43441	2
2	3	2	0	3	43442	0
2	7	2	0	7	43443	0
2	4	2	23	27	43444	1
2	0	2	1	1	43445	2
2	0	2	0	0	43446	2
2	2	2	0	2	43447	0
2	0	2	9	9	43448	2
2	0	2	27	27	43449	2
2	0	2	0	0	43450	2
2	0	2	0	0	43451	2
2	4	2	0	4	43452	0
2	0	2	15	15	43453	2
2	190	2	0	190	43454	0
2	33	2	2177	2210	43455	1
2	0	2	28	28	43456	2
2	0	2	1	1	43457	2
2	70	2	2	72	43458	0
2	0	2	431	431	43459	2
2	1	2	0	1	43460	0
2	0	2	28	28	43461	2
2	0	2	0	0	43462	2
2	0	2	0	0	43463	2
2	0	2	14	14	43464	2
2	0	2	1	1	43465	2
2	0	2	0	0	43466	2
2	0	4	36	36	43467	2
2	0	2	0	0	43468	2
2	0	2	0	0	43469	2
2	0	4	5	5	43470	2
2	0	2	3	3	43471	2
2	40	4	3	43	43472	0
2	0	2	208	208	43473	2
0	0	4	0	0	43474	2
2	1	2	0	1	43475	0
2	0	2	74	74	43476	2
2	22	2	0	22	43477	0
2	3	0	396	399	43478	1
2	0	2	4	4	43479	2
2	0	2	0	0	43480	2
2	11	0	54	65	43481	0
2	0	2	51	51	43482	2
0	0	0	118	118	43483	2
2	0	2	0	0	43484	2
2	0	2	0	0	43485	2
2	0	2	0	0	43486	2
2	0	2	0	0	43487	2
2	0	2	0	0	43488	2
2	0	2	0	0	43489	2
2	0	2	0	0	43490	2
2	0	2	0	0	43491	2
2	0	2	0	0	43492	2
2	0	4	101	101	43493	2
2	0	2	0	0	43494	2
2	0	2	0	0	43495	2
2	0	4	4	4	43496	2
2	0	2	0	0	43497	2
2	0	2	0	0	43498	2
2	0	2	0	0	43499	2
2	0	2	0	0	43500	2
2	0	2	0	0	43501	2
2	0	2	0	0	43502	2
2	0	2	0	0	43503	2
0	0	4	0	0	43504	2
2	0	2	0	0	43505	2
2	0	2	0	0	43506	2
2	0	2	0	0	43507	2
2	0	2	0	0	43508	2
2	0	2	0	0	43509	2
2	0	2	0	0	43510	2
2	0	2	0	0	43511	2
2	0	4	0	0	43512	2
2	0	2	0	0	43513	2
2	0	2	0	0	43514	2
2	0	4	0	0	43515	2
2	0	2	0	0	43516	2
2	0	2	0	0	43517	2
2	0	2	0	0	43518	2
2	0	2	0	0	43519	2
2	0	2	0	0	43520	2
2	0	2	0	0	43521	2
2	0	2	0	0	43522	2
4	0	4	0	0	43523	2
4	0	4	0	0	43524	2
2	0	4	72	72	43525	2
2	0	2	0	0	43526	2
2	0	2	0	0	43527	2
2	0	4	25	25	43528	2
2	0	2	4	4	43529	2
4	1	2	5	6	43530	0
2	0	2	0	0	43531	2
2	0	2	1	1	43532	2
2	0	2	0	0	43533	2
2	0	2	0	0	43534	2
2	0	2	0	0	43535	2
2	0	2	0	0	43536	2
2	0	2	0	0	43537	2
2	0	4	5985	5985	43538	2
2	0	2	0	0	43539	2
2	0	2	0	0	43540	2
2	0	4	2499	2499	43541	2
2	0	2	0	0	43542	2
2	0	2	0	0	43543	2
2	0	2	0	0	43544	2
2	0	2	0	0	43545	2
2	0	2	0	0	43546	2
2	0	2	0	0	43547	2
2	0	2	0	0	43548	2
2	0	2	0	0	43549	2
2	0	2	0	0	43550	2
2	0	2	0	0	43551	2
2	0	2	0	0	43552	2
2	0	2	0	0	43553	2
2	0	2	0	0	43554	2
2	3	2	0	3	43555	0
2	0	4	40	40	43556	2
2	0	2	0	0	43557	2
2	0	2	0	0	43558	2
2	0	4	2	2	43559	2
2	0	2	25	25	43560	2
2	0	2	0	0	43561	2
2	0	4	0	0	43562	2
2	0	2	0	0	43563	2
2	0	2	0	0	43564	2
2	0	4	0	0	43565	2
2	0	2	0	0	43566	2
2	0	2	0	0	43567	2
2	0	2	0	0	43568	2
2	0	2	0	0	43569	2
2	0	2	0	0	43570	2
2	0	2	0	0	43571	2
2	0	2	0	0	43572	2
2	0	2	0	0	43573	2
2	0	2	3	3	43574	2
2	0	2	0	0	43575	2
2	0	2	0	0	43576	2
2	0	2	0	0	43577	2
2	0	2	0	0	43578	2
2	0	2	0	0	43579	2
2	1	2	6	7	43580	1
2	0	2	0	0	43581	2
2	0	2	0	0	43582	2
2	2	2	0	2	43583	1
2	0	2	6	6	43584	2
2	0	2	0	0	43585	2
2	0	2	0	0	43586	2
2	0	2	0	0	43587	2
2	0	2	0	0	43588	2
2	0	2	0	0	43589	2
2	0	2	0	0	43590	2
0	0	4	3	3	43591	2
2	0	2	0	0	43592	2
2	0	2	0	0	43593	2
2	0	2	0	0	43594	2
2	0	2	0	0	43595	2
2	0	2	0	0	43596	2
2	0	2	0	0	43597	2
4	10	4	8	18	43598	1
2	0	2	0	0	43599	2
2	0	2	0	0	43600	2
2	0	2	0	0	43601	2
2	0	2	0	0	43602	2
2	0	2	0	0	43603	2
2	0	2	0	0	43604	2
2	0	4	2	2	43605	2
2	0	2	1	1	43606	2
4	0	2	0	0	43607	2
2	0	2	0	0	43608	2
2	0	4	3	3	43609	2
2	0	2	0	0	43610	2
2	0	4	17	17	43611	2
2	0	2	0	0	43612	2
2	0	2	0	0	43613	2
2	0	2	0	0	43614	2
2	0	2	1	1	43615	2
2	0	2	0	0	43616	2
2	0	2	0	0	43617	2
2	0	2	0	0	43618	2
2	0	2	1	1	43619	2
0	5	4	0	5	43620	1
2	0	2	0	0	43621	2
2	0	4	0	0	43622	2
2	0	2	0	0	43623	2
2	0	2	0	0	43624	2
2	0	2	0	0	43625	2
2	0	2	0	0	43626	2
2	0	2	0	0	43627	2
2	0	2	0	0	43628	2
2	0	2	0	0	43629	2
2	0	2	0	0	43630	2
2	0	2	0	0	43631	2
2	0	2	0	0	43632	2
2	0	2	0	0	43633	2
2	0	2	0	0	43634	2
2	0	2	0	0	43635	2
2	0	2	0	0	43636	2
2	0	2	0	0	43637	2
2	0	2	0	0	43638	2
2	0	2	0	0	43639	2
2	0	2	0	0	43640	2
2	0	2	0	0	43641	2
2	0	2	0	0	43642	2
0	0	0	0	0	43643	2
0	0	0	0	0	43644	2
2	0	2	0	0	43645	2
2	0	2	0	0	43646	2
2	0	2	0	0	43647	2
2	0	2	0	0	43648	2
2	0	2	0	0	43649	2
2	0	2	0	0	43650	2
2	0	2	0	0	43651	2
2	0	4	92	92	43652	2
2	0	2	0	0	43653	2
2	0	2	0	0	43654	2
2	0	4	1	1	43655	2
2	0	2	0	0	43656	2
2	0	2	0	0	43657	2
2	0	2	0	0	43658	2
2	0	2	0	0	43659	2
4	0	4	0	0	43660	2
2	0	2	0	0	43661	2
2	0	2	0	0	43662	2
2	0	2	0	0	43663	2
2	0	2	0	0	43664	2
2	0	2	0	0	43665	2
2	0	2	0	0	43666	2
2	204	2	7	211	43667	0
2	0	2	0	0	43668	2
2	0	2	0	0	43669	2
2	0	2	0	0	43670	2
2	0	2	0	0	43671	2
2	0	2	0	0	43672	2
2	0	2	0	0	43673	2
2	0	2	0	0	43674	2
2	0	2	0	0	43675	2
2	0	2	0	0	43676	2
2	0	2	0	0	43677	2
2	0	2	0	0	43678	2
2	0	2	0	0	43679	2
2	0	2	0	0	43680	2
2	0	4	0	0	43681	2
2	0	2	0	0	43682	2
2	0	2	0	0	43683	2
2	0	4	0	0	43684	2
2	0	2	0	0	43685	2
0	68	2	0	68	43686	1
2	0	4	0	0	43687	2
2	0	4	0	0	43688	2
2	0	2	0	0	43689	2
2	0	2	0	0	43690	2
2	0	2	0	0	43691	2
2	0	2	0	0	43692	2
2	0	2	0	0	43693	2
2	0	2	0	0	43694	2
2	0	2	0	0	43695	2
2	0	2	0	0	43696	2
2	0	2	0	0	43697	2
2	0	2	1	1	43698	2
2	0	2	0	0	43699	2
2	0	2	0	0	43700	2
4	0	4	94	94	43701	2
2	0	2	0	0	43702	2
2	0	4	0	0	43703	2
2	0	2	0	0	43704	2
2	0	2	0	0	43705	2
2	0	4	0	0	43706	2
2	0	2	0	0	43707	2
2	1	2	0	1	43708	0
2	0	2	3	3	43709	2
2	0	2	0	0	43710	2
2	0	2	0	0	43711	2
2	0	2	0	0	43712	2
2	0	2	0	0	43713	2
2	743	4	277	1020	43714	1
2	0	2	82	82	43715	2
2	0	2	18	18	43716	2
2	180	2	56	236	43717	1
0	5	0	80	85	43718	0
2	0	2	0	0	43719	2
2	0	2	0	0	43720	2
2	0	2	0	0	43721	2
2	0	2	0	0	43722	2
2	0	2	0	0	43723	2
2	0	2	0	0	43724	2
2	0	2	0	0	43725	2
2	0	4	185	185	43726	2
2	0	2	0	0	43727	2
2	0	2	0	0	43728	2
2	0	2	0	0	43729	2
2	0	2	0	0	43730	2
2	0	2	0	0	43731	2
2	0	2	0	0	43732	2
2	0	2	0	0	43733	2
2	0	2	0	0	43734	2
2	0	2	0	0	43735	2
2	0	2	0	0	43736	2
2	0	2	0	0	43737	2
2	0	2	0	0	43738	2
2	0	2	0	0	43739	2
2	0	2	0	0	43740	2
2	0	4	160	160	43741	2
2	0	2	0	0	43742	2
2	5	2	0	5	43743	0
2	1	4	0	1	43744	1
2	0	2	2	2	43745	2
2	1	4	75	76	43746	1
2	0	2	1	1	43747	2
2	0	2	0	0	43748	2
0	0	4	38	38	43749	2
4	0	4	110	110	43750	2
4	0	4	0	0	43751	2
2	2261	2	4	2265	43752	0
2	0	2	0	0	43753	2
2	0	2	0	0	43754	2
2	3	2	0	3	43755	0
2	0	2	9	9	43756	2
2	0	2	0	0	43757	2
2	0	2	0	0	43758	2
2	215	4	24822	25037	43759	1
2	0	2	53	53	43760	2
2	0	2	1	1	43761	2
2	119	4	2036	2155	43762	1
2	0	2	979	979	43763	2
0	0	4	55	55	43764	2
2	0	2	0	0	43765	2
2	0	2	4	4	43766	2
2	0	2	0	0	43767	2
2	0	2	0	0	43768	2
2	0	2	0	0	43769	2
2	0	2	0	0	43770	2
2	0	2	0	0	43771	2
2	0	2	0	0	43772	2
2	0	2	0	0	43773	2
2	0	2	0	0	43774	2
2	0	2	0	0	43775	2
2	0	2	0	0	43776	2
2	13	2	0	13	43777	0
2	9	0	92	101	43778	1
2	0	2	2	2	43779	2
2	0	2	0	0	43780	2
2	5	0	3	8	43781	0
2	0	2	26	26	43782	2
2	0	2	0	0	43783	2
2	0	4	24	24	43784	2
2	0	2	0	0	43785	2
2	0	2	0	0	43786	2
2	0	4	42	42	43787	2
2	0	2	0	0	43788	2
2	0	2	0	0	43789	2
2	0	4	0	0	43790	2
2	0	2	0	0	43791	2
2	0	2	0	0	43792	2
2	0	4	1	1	43793	2
2	0	2	0	0	43794	2
2	0	2	0	0	43795	2
2	0	2	0	0	43796	2
2	0	2	0	0	43797	2
2	0	2	0	0	43798	2
2	0	2	0	0	43799	2
2	0	2	0	0	43800	2
2	12	2	4167	4179	43801	0
2	0	2	0	0	43802	2
2	25	2	205	230	43803	1
2	2	2	1	3	43804	1
2	0	2	0	0	43805	2
2	9	2	70	79	43806	0
2	0	2	8	8	43807	2
2	0	2	0	0	43808	2
2	0	2	0	0	43809	2
2	0	2	0	0	43810	2
2	0	2	0	0	43811	2
2	0	2	0	0	43812	2
2	0	2	0	0	43813	2
2	0	2	0	0	43814	2
2	0	2	0	0	43815	2
2	0	2	0	0	43816	2
2	0	2	0	0	43817	2
2	0	2	0	0	43818	2
2	0	2	0	0	43819	2
2	0	2	0	0	43820	2
2	0	2	0	0	43821	2
2	0	2	2	2	43822	2
2	0	2	0	0	43823	2
2	2	4	28	30	43824	1
2	0	2	0	0	43825	2
2	0	2	0	0	43826	2
2	1	4	0	1	43827	1
2	0	2	5	5	43828	2
2	0	2	0	0	43829	2
2	0	2	0	0	43830	2
2	0	2	0	0	43831	2
2	0	2	0	0	43832	2
2	0	2	0	0	43833	2
2	0	2	0	0	43834	2
2	0	2	0	0	43835	2
4	1	2	0	1	43836	0
4	0	2	0	0	43837	2
2	0	2	0	0	43838	2
2	0	2	3	3	43839	2
2	0	2	0	0	43840	2
2	0	2	0	0	43841	2
2	0	2	0	0	43842	2
2	0	2	0	0	43843	2
2	24	2	0	24	43844	0
2	3	2	228	231	43845	1
2	0	2	2	2	43846	2
2	0	2	0	0	43847	2
2	4	2	1	5	43848	0
2	0	2	13	13	43849	2
2	2	4	386	388	43850	1
2	0	2	0	0	43851	2
2	0	2	0	0	43852	2
2	0	4	591	591	43853	2
2	0	2	99	99	43854	2
2	0	2	0	0	43855	2
2	0	2	0	0	43856	2
2	0	2	0	0	43857	2
2	0	2	0	0	43858	2
2	0	2	0	0	43859	2
2	0	2	0	0	43860	2
2	0	2	0	0	43861	2
2	28	2	26	54	43862	0
2	0	2	0	0	43863	2
2	0	2	0	0	43864	2
2	0	2	2	2	43865	2
2	0	2	56	56	43866	2
2	0	2	0	0	43867	2
2	0	2	0	0	43868	2
2	0	2	0	0	43869	2
2	0	2	0	0	43870	2
2	0	2	0	0	43871	2
2	0	2	0	0	43872	2
2	0	2	0	0	43873	2
2	0	2	0	0	43874	2
2	0	2	0	0	43875	2
2	0	2	0	0	43876	2
2	0	2	0	0	43877	2
2	0	2	0	0	43878	2
2	0	2	1	1	43879	2
2	0	2	0	0	43880	2
2	0	2	0	0	43881	2
2	0	2	0	0	43882	2
2	0	2	0	0	43883	2
2	0	2	0	0	43884	2
2	0	2	0	0	43885	2
0	2	4	3494	3496	43886	1
0	0	4	3494	3494	43887	2
2	27	2	0	27	43888	0
2	21	4	258	279	43889	1
2	0	2	1	1	43890	2
2	0	2	1	1	43891	2
0	0	4	5	5	43892	2
2	4	4	5	9	43893	0
2	0	2	13	13	43894	2
2	0	2	0	0	43895	2
2	0	2	0	0	43896	2
2	0	2	0	0	43897	2
2	0	2	0	0	43898	2
2	0	2	0	0	43899	2
2	0	4	35	35	43900	2
2	0	2	0	0	43901	2
2	0	2	0	0	43902	2
2	0	2	0	0	43903	2
2	0	4	495	495	43904	2
2	0	2	0	0	43905	2
2	0	2	0	0	43906	2
2	0	4	500	500	43907	2
2	0	2	0	0	43908	2
2	0	2	0	0	43909	2
2	0	2	0	0	43910	2
2	0	2	0	0	43911	2
2	0	2	0	0	43912	2
2	0	2	0	0	43913	2
2	0	2	0	0	43914	2
2	0	2	0	0	43915	2
2	2	2	0	2	43916	0
2	0	2	0	0	43917	2
2	0	2	0	0	43918	2
2	0	2	0	0	43919	2
2	0	2	0	0	43920	2
2	0	2	0	0	43921	2
2	0	2	0	0	43922	2
2	1	2	15	16	43923	1
2	0	2	0	0	43924	2
2	0	2	0	0	43925	2
2	1	2	2	3	43926	1
2	0	2	34	34	43927	2
2	0	2	0	0	43928	2
2	0	2	0	0	43929	2
2	0	2	0	0	43930	2
2	0	2	0	0	43931	2
2	0	2	0	0	43932	2
2	0	2	0	0	43933	2
0	0	0	10	10	43934	2
2	0	4	32	32	43935	2
2	0	2	0	0	43936	2
2	0	2	0	0	43937	2
2	0	4	2	2	43938	2
2	2	2	7	9	43939	0
4	0	4	218	218	43940	2
2	0	2	0	0	43941	2
2	0	2	0	0	43942	2
2	0	2	0	0	43943	2
2	0	2	0	0	43944	2
2	0	2	0	0	43945	2
2	0	2	0	0	43946	2
2	0	2	0	0	43947	2
2	0	2	0	0	43948	2
2	0	2	0	0	43949	2
2	0	2	0	0	43950	2
2	0	2	0	0	43951	2
2	0	2	0	0	43952	2
2	0	2	0	0	43953	2
2	0	2	0	0	43954	2
2	1	2	59	60	43955	0
2	0	2	0	0	43956	2
2	0	2	0	0	43957	2
2	0	2	1	1	43958	2
2	0	2	1	1	43959	2
2	0	2	0	0	43960	2
2	0	2	0	0	43961	2
2	0	2	0	0	43962	2
2	0	2	0	0	43963	2
2	0	2	0	0	43964	2
2	0	2	0	0	43965	2
2	0	2	0	0	43966	2
2	0	2	0	0	43967	2
2	0	2	0	0	43968	2
2	0	2	0	0	43969	2
2	0	2	0	0	43970	2
2	0	2	0	0	43971	2
2	0	2	0	0	43972	2
2	0	2	0	0	43973	2
2	0	2	0	0	43974	2
2	0	2	0	0	43975	2
2	0	2	0	0	43976	2
2	0	2	0	0	43977	2
2	0	2	0	0	43978	2
2	0	2	0	0	43979	2
2	2	4	162	164	43980	0
2	0	2	0	0	43981	2
2	0	2	0	0	43982	2
2	0	4	56	56	43983	2
2	1	2	4	5	43984	1
2	0	2	19	19	43985	2
2	0	2	0	0	43986	2
2	3	2	4	7	43987	1
2	0	2	0	0	43988	2
2	0	2	1	1	43989	2
2	0	2	1	1	43990	2
2	0	2	0	0	43991	2
2	0	2	0	0	43992	2
2	0	2	0	0	43993	2
2	0	2	0	0	43994	2
2	0	2	0	0	43995	2
2	0	2	0	0	43996	2
2	0	2	0	0	43997	2
2	0	2	15	15	43998	2
2	0	2	0	0	43999	2
2	0	2	0	0	44000	2
2	0	2	0	0	44001	2
2	0	2	16	16	44002	2
4	0	2	11	11	44003	2
4	8861	3	831	9692	44004	0
4	11	2	2	13	44005	0
4	5	2	0	5	44006	0
4	47	2	1	48	44007	0
4	3182	2	14	3196	44008	0
4	1864	2	14	1878	44009	0
4	1651	4	20	1671	44010	0
4	471	4	4	475	44011	1
4	11	4	2	13	44012	1
4	9	4	0	9	44013	1
0	18	4	0	18	44014	0
4	1	4	0	1	44015	1
4	0	4	0	0	44016	2
4	7	2	0	7	44017	0
7	110	4	1002	1112	44018	0
0	1355	2	3	1358	44019	0
0	2266	2	37	2303	44020	1
6	29	4	473	502	44021	0
0	698	2	2	700	44022	0
0	0	4	65	65	44023	2
0	0	4	3	3	44024	2
4	0	2	2	2	44025	2
4	10	2	1	11	44026	0
4	1237	2	21	1258	44027	0
4	3	4	59489	59492	44028	1
4	0	4	11612	11612	44029	2
4	423587	1	10911	434498	44030	0
7	62	2	246	308	44031	0
0	0	0	0	0	44032	2
0	0	0	0	0	44033	2
0	0	0	0	0	44034	2
0	0	0	0	0	44035	2
4	8	4	52	60	44036	0
4	0	4	0	0	44037	2
0	121	2	0	121	44038	0
0	3	4	4	7	44039	0
4	2913	2	14	2927	44040	0
4	0	4	2	2	44041	2
4	0	4	1	1	44042	2
2	33	2	154977	155010	44043	1
2	42	2	8119	8161	44044	1
2	2	2	31482	31484	44045	1
2	4	2	47153	47157	44046	1
4	19	4	8	27	44047	1
4	8	4	3	11	44048	1
4	7	2	194	201	44049	0
4	0	2	4	4	44050	2
4	43247	3	438	43685	44051	0
4	13	4	33	46	44052	0
0	0	4	0	0	44053	2
0	0	4	0	0	44054	2
0	8	2	7	15	44055	0
0	794	2	1151	1945	44056	0
0	11372	2	59	11431	44057	0
0	70	2	1	71	44058	0
0	0	2	0	0	44059	2
0	2	2	0	2	44060	0
0	1	2	0	1	44061	1
0	0	2	0	0	44062	2
0	0	2	0	0	44063	2
2	0	2	0	0	44064	2
2	8	2	3	11	44065	1
2	0	2	0	0	44066	2
2	0	2	0	0	44067	2
2	1	2	0	1	44068	0
2	0	2	3	3	44069	2
2	0	2	0	0	44070	2
2	0	2	33	33	44071	2
2	0	2	0	0	44072	2
2	0	2	0	0	44073	2
2	1	2	2	3	44074	0
2	0	2	9	9	44075	2
4	0	2	0	0	44076	2
4	551	2	1	552	44077	0
2	0	2	0	0	44078	2
2	0	4	83	83	44079	2
2	0	2	0	0	44080	2
2	0	2	0	0	44081	2
2	0	4	24	24	44082	2
2	0	2	1	1	44083	2
2	0	2	1	1	44084	2
2	0	2	0	0	44085	2
2	25	2	0	25	44086	0
2	0	2	2	2	44087	2
4	0	2	0	0	44088	2
2	0	2	0	0	44089	2
2	0	2	20	20	44090	2
2	0	2	0	0	44091	2
2	0	2	0	0	44092	2
2	0	2	0	0	44093	2
2	0	2	4	4	44094	2
2	0	2	0	0	44095	2
2	0	2	0	0	44096	2
2	0	2	0	0	44097	2
2	0	2	0	0	44098	2
2	0	2	0	0	44099	2
2	0	2	0	0	44100	2
2	0	2	0	0	44101	2
2	0	4	24	24	44102	2
2	0	2	0	0	44103	2
2	0	2	0	0	44104	2
2	0	4	0	0	44105	2
2	0	2	2	2	44106	2
4	0	2	3	3	44107	2
0	0	4	0	0	44108	2
2	0	2	0	0	44109	2
2	0	2	0	0	44110	2
2	0	2	0	0	44111	2
2	0	2	0	0	44112	2
2	0	2	0	0	44113	2
2	0	2	0	0	44114	2
2	0	2	0	0	44115	2
2	9	2	315	324	44116	1
2	0	2	0	0	44117	2
2	0	2	0	0	44118	2
2	1	2	0	1	44119	0
2	0	2	1	1	44120	2
2	0	2	0	0	44121	2
2	0	2	1	1	44122	2
2	0	2	0	0	44123	2
2	0	2	0	0	44124	2
2	0	2	0	0	44125	2
2	0	2	0	0	44126	2
2	0	2	0	0	44127	2
2	0	4	0	0	44128	2
2	0	2	0	0	44129	2
2	0	2	0	0	44130	2
2	0	4	0	0	44131	2
2	0	2	0	0	44132	2
2	19	2	0	19	44133	0
2	0	2	0	0	44134	2
2	0	2	0	0	44135	2
2	0	2	0	0	44136	2
2	0	2	0	0	44137	2
2	0	2	0	0	44138	2
2	0	2	0	0	44139	2
2	0	4	30	30	44140	2
2	0	2	0	0	44141	2
2	0	2	0	0	44142	2
2	0	2	0	0	44143	2
2	0	2	0	0	44144	2
2	0	2	0	0	44145	2
2	1	2	5	6	44146	1
2	0	2	0	0	44147	2
2	0	2	0	0	44148	2
2	0	2	0	0	44149	2
2	0	2	0	0	44150	2
2	3	2	0	3	44151	0
2	5	2	0	5	44152	1
2	0	2	6	6	44153	2
2	2	2	8	10	44154	1
2	0	2	0	0	44155	2
2	0	2	0	0	44156	2
2	9	2	0	9	44157	0
2	9	2	8	17	44158	1
2	0	2	13	13	44159	2
2	43	2	443	486	44160	1
2	0	2	3	3	44161	2
2	0	2	4	4	44162	2
2	0	2	0	0	44163	2
2	0	2	0	0	44164	2
2	0	2	0	0	44165	2
2	0	2	0	0	44166	2
2	0	2	0	0	44167	2
2	0	2	0	0	44168	2
2	0	2	0	0	44169	2
2	0	2	0	0	44170	2
2	0	2	0	0	44171	2
2	0	2	0	0	44172	2
2	0	2	0	0	44173	2
2	0	2	0	0	44174	2
2	556	2	0	556	44175	0
2	15	2	10288	10303	44176	1
2	1	2	589	590	44177	1
2	0	2	262	262	44178	2
2	50	2	587	637	44179	0
2	0	2	379	379	44180	2
2	0	2	0	0	44181	2
2	0	2	0	0	44182	2
2	0	2	0	0	44183	2
2	0	2	0	0	44184	2
2	0	2	0	0	44185	2
2	0	2	56	56	44186	2
2	0	2	0	0	44187	2
2	5	2	105	110	44188	1
2	0	2	0	0	44189	2
2	0	2	0	0	44190	2
2	2	2	1	3	44191	1
2	0	2	0	0	44192	2
2	0	2	0	0	44193	2
2	0	2	0	0	44194	2
2	0	2	0	0	44195	2
2	0	2	0	0	44196	2
2	0	2	0	0	44197	2
2	0	2	0	0	44198	2
2	51	2	8	59	44199	0
2	0	2	0	0	44200	2
2	0	2	0	0	44201	2
2	0	2	0	0	44202	2
2	0	2	0	0	44203	2
2	0	2	0	0	44204	2
2	0	2	0	0	44205	2
2	0	2	0	0	44206	2
2	0	0	2846	2846	44207	2
2	0	2	0	0	44208	2
2	0	2	0	0	44209	2
2	0	0	1733	1733	44210	2
2	0	2	0	0	44211	2
2	0	2	0	0	44212	2
2	0	2	0	0	44213	2
2	0	2	0	0	44214	2
2	42	2	0	42	44215	0
2	0	2	0	0	44216	2
2	0	2	0	0	44217	2
2	0	2	0	0	44218	2
2	0	2	0	0	44219	2
2	0	2	0	0	44220	2
2	0	2	0	0	44221	2
2	32	2	174	206	44222	1
2	0	2	42	42	44223	2
2	0	2	2	2	44224	2
2	29	2	8	37	44225	1
2	0	2	1	1	44226	2
2	0	2	0	0	44227	2
2	0	2	0	0	44228	2
2	0	2	0	0	44229	2
2	0	2	0	0	44230	2
2	0	2	0	0	44231	2
2	0	2	0	0	44232	2
2	0	2	0	0	44233	2
2	0	4	0	0	44234	2
2	0	2	0	0	44235	2
2	0	2	0	0	44236	2
2	0	4	0	0	44237	2
2	0	2	0	0	44238	2
0	0	2	0	0	44239	2
2	0	2	0	0	44240	2
2	0	2	0	0	44241	2
2	0	2	0	0	44242	2
2	0	2	2	2	44243	2
2	0	2	0	0	44244	2
2	0	2	0	0	44245	2
2	69	2	14	83	44246	0
2	0	2	176	176	44247	2
2	111	2	1275	1386	44248	1
2	0	2	10	10	44249	2
2	0	2	1	1	44250	2
0	0	4	229	229	44251	2
4	0	4	0	0	44252	2
2	6	4	56	62	44253	0
2	0	2	26	26	44254	2
2	42	2	0	42	44255	0
2	9	4	2246	2255	44256	1
2	0	2	3	3	44257	2
2	0	2	1	1	44258	2
2	0	2	0	0	44259	2
2	0	2	0	0	44260	2
2	0	0	4	4	44261	2
2	0	2	0	0	44262	2
2	0	2	0	0	44263	2
2	0	0	11	11	44264	2
2	0	2	0	0	44265	2
2	0	2	0	0	44266	2
2	0	2	0	0	44267	2
2	0	2	0	0	44268	2
4	10	4	9	19	44269	0
2	0	2	0	0	44270	2
2	0	2	0	0	44271	2
2	0	2	0	0	44272	2
2	0	2	0	0	44273	2
2	0	2	0	0	44274	2
2	0	2	0	0	44275	2
2	5	2	0	5	44276	0
2	1	2	31	32	44277	1
2	0	2	1	1	44278	2
2	0	2	0	0	44279	2
2	1	2	2	3	44280	0
2	0	2	8	8	44281	2
2	2	2	0	2	44282	0
2	0	2	0	0	44283	2
2	0	2	0	0	44284	2
2	0	2	0	0	44285	2
2	0	2	0	0	44286	2
2	0	2	0	0	44287	2
2	0	2	0	0	44288	2
2	0	2	0	0	44289	2
2	0	2	0	0	44290	2
2	0	2	0	0	44291	2
2	0	2	0	0	44292	2
2	0	2	0	0	44293	2
2	0	2	0	0	44294	2
2	0	2	0	0	44295	2
2	0	2	0	0	44296	2
2	0	2	0	0	44297	2
2	0	2	0	0	44298	2
2	0	2	0	0	44299	2
2	0	2	0	0	44300	2
2	0	2	0	0	44301	2
2	0	2	0	0	44302	2
2	2	4	209	211	44303	1
2	0	2	9	9	44304	2
2	0	2	2	2	44305	2
2	0	2	0	0	44306	2
2	0	2	0	0	44307	2
2	0	2	0	0	44308	2
2	0	2	0	0	44309	2
2	0	2	0	0	44310	2
2	0	2	0	0	44311	2
2	0	2	0	0	44312	2
2	0	4	1	1	44313	2
2	0	2	0	0	44314	2
2	0	2	0	0	44315	2
2	0	4	0	0	44316	2
2	0	2	0	0	44317	2
2	0	2	0	0	44318	2
2	0	4	6	6	44319	2
2	0	2	0	0	44320	2
2	0	2	0	0	44321	2
2	0	2	2	2	44322	2
2	0	2	0	0	44323	2
4	0	4	36	36	44324	2
2	0	2	0	0	44325	2
2	0	2	0	0	44326	2
2	0	2	0	0	44327	2
2	0	2	0	0	44328	2
2	0	2	0	0	44329	2
2	0	2	0	0	44330	2
2	0	2	0	0	44331	2
2	0	2	0	0	44332	2
2	0	2	0	0	44333	2
2	0	2	0	0	44334	2
2	0	2	0	0	44335	2
2	0	2	0	0	44336	2
2	0	2	0	0	44337	2
2	0	2	0	0	44338	2
2	0	2	0	0	44339	2
2	0	2	0	0	44340	2
2	0	2	0	0	44341	2
2	0	2	0	0	44342	2
2	0	2	0	0	44343	2
2	0	2	0	0	44344	2
2	0	2	0	0	44345	2
2	0	2	0	0	44346	2
2	0	2	0	0	44347	2
2	0	2	0	0	44348	2
2	0	2	0	0	44349	2
2	0	4	796	796	44350	2
2	0	2	0	0	44351	2
2	0	2	0	0	44352	2
2	0	2	0	0	44353	2
2	0	2	0	0	44354	2
2	0	2	0	0	44355	2
2	0	2	0	0	44356	2
2	0	4	22	22	44357	2
2	0	2	0	0	44358	2
2	0	2	0	0	44359	2
2	0	2	0	0	44360	2
2	0	2	0	0	44361	2
0	34	4	3	37	44362	0
2	0	2	0	0	44363	2
2	0	2	0	0	44364	2
2	0	2	0	0	44365	2
2	0	2	0	0	44366	2
2	0	2	0	0	44367	2
2	0	2	0	0	44368	2
2	0	2	44	44	44369	2
2	0	2	0	0	44370	2
2	0	2	0	0	44371	2
2	0	4	5	5	44372	2
2	0	2	1	1	44373	2
2	0	2	13	13	44374	2
2	0	2	0	0	44375	2
2	0	2	3	3	44376	2
2	0	2	0	0	44377	2
2	0	2	0	0	44378	2
2	5	2	0	5	44379	0
2	0	2	0	0	44380	2
2	0	2	0	0	44381	2
0	0	4	2	2	44382	2
0	0	4	2	2	44383	2
2	0	2	0	0	44384	2
2	0	2	0	0	44385	2
2	0	2	0	0	44386	2
2	0	2	0	0	44387	2
2	0	2	0	0	44388	2
2	0	2	0	0	44389	2
2	0	2	0	0	44390	2
2	0	2	0	0	44391	2
2	0	2	0	0	44392	2
2	0	2	0	0	44393	2
2	1	2	1	2	44394	1
2	0	2	0	0	44395	2
2	0	2	0	0	44396	2
2	0	2	0	0	44397	2
2	0	4	5	5	44398	2
2	0	2	0	0	44399	2
2	0	2	0	0	44400	2
2	0	4	3467	3467	44401	2
2	0	2	0	0	44402	2
2	28	2	1	29	44403	0
2	266	2	195	461	44404	1
2	0	2	7	7	44405	2
2	0	2	0	0	44406	2
2	48	2	1	49	44407	0
2	0	2	89	89	44408	2
2	0	2	0	0	44409	2
2	0	2	0	0	44410	2
2	0	2	0	0	44411	2
2	0	2	0	0	44412	2
2	0	2	0	0	44413	2
2	0	2	0	0	44414	2
2	0	2	0	0	44415	2
2	0	2	0	0	44416	2
2	3	2	24	27	44417	1
2	0	2	0	0	44418	2
2	0	2	0	0	44419	2
2	2	2	0	2	44420	0
2	0	2	3	3	44421	2
2	0	2	38	38	44422	2
2	0	2	0	0	44423	2
2	0	2	0	0	44424	2
6	82510	4	276	82786	44425	0
2	0	2	8	8	44426	2
2	0	2	0	0	44427	2
2	0	2	0	0	44428	2
2	0	2	0	0	44429	2
2	0	2	0	0	44430	2
2	0	2	0	0	44431	2
2	0	2	0	0	44432	2
2	0	2	0	0	44433	2
4	1	4	18	19	44434	0
2	0	2	0	0	44435	2
2	0	2	0	0	44436	2
2	0	2	0	0	44437	2
2	0	2	3	3	44438	2
2	0	2	0	0	44439	2
2	0	2	0	0	44440	2
2	0	2	0	0	44441	2
2	0	2	0	0	44442	2
0	0	3	8	8	44443	2
0	0	3	8	8	44444	2
2	0	2	0	0	44445	2
2	0	2	0	0	44446	2
2	0	2	0	0	44447	2
2	0	2	0	0	44448	2
2	0	2	0	0	44449	2
2	0	2	0	0	44450	2
2	0	2	0	0	44451	2
2	0	2	0	0	44452	2
2	0	2	0	0	44453	2
2	0	2	0	0	44454	2
2	0	2	0	0	44455	2
2	0	2	0	0	44456	2
2	4	2	0	4	44457	0
2	0	2	52	52	44458	2
2	0	2	0	0	44459	2
2	0	2	0	0	44460	2
2	2	2	0	2	44461	1
2	0	2	15	15	44462	2
2	0	2	0	0	44463	2
2	0	2	0	0	44464	2
2	0	2	0	0	44465	2
2	0	2	0	0	44466	2
2	0	2	0	0	44467	2
2	0	2	0	0	44468	2
2	0	2	0	0	44469	2
2	0	4	3688	3688	44470	2
2	0	2	0	0	44471	2
2	0	2	0	0	44472	2
2	0	4	27460	27460	44473	2
2	0	2	0	0	44474	2
2	26	2	1	27	44475	0
2	0	2	0	0	44476	2
2	0	2	38	38	44477	2
2	0	2	0	0	44478	2
2	0	2	0	0	44479	2
2	0	2	97	97	44480	2
2	0	2	0	0	44481	2
2	65	2	0	65	44482	0
2	7	2	173	180	44483	1
2	0	2	23	23	44484	2
2	0	2	2	2	44485	2
2	6	2	0	6	44486	0
2	0	2	40	40	44487	2
2	17	4	7813	7830	44488	1
2	0	2	8	8	44489	2
2	0	2	32	32	44490	2
4	1	2	11	12	44491	1
4	0	2	2	2	44492	2
2	11	4	3624	3635	44493	0
2	0	2	66	66	44494	2
4	2094	2	38	2132	44495	0
4	3704	2	97	3801	44496	0
2	0	2	2	2	44497	2
2	0	2	0	0	44498	2
2	1	4	3150	3151	44499	1
2	0	2	0	0	44500	2
2	0	2	0	0	44501	2
2	0	4	1060	1060	44502	2
2	0	2	0	0	44503	2
2	0	2	0	0	44504	2
2	0	2	0	0	44505	2
2	0	2	0	0	44506	2
2	0	2	0	0	44507	2
2	0	2	0	0	44508	2
2	0	2	0	0	44509	2
2	0	2	0	0	44510	2
2	0	2	0	0	44511	2
2	0	2	0	0	44512	2
2	0	2	0	0	44513	2
2	0	2	2	2	44514	2
2	0	2	0	0	44515	2
2	0	2	0	0	44516	2
2	0	2	0	0	44517	2
2	2	2	20	22	44518	1
2	0	2	0	0	44519	2
2	0	2	0	0	44520	2
0	2	2	0	2	44521	0
0	0	2	0	0	44522	2
2	0	2	0	0	44523	2
2	0	2	5	5	44524	2
2	0	0	164	164	44525	2
2	0	2	0	0	44526	2
2	0	2	0	0	44527	2
2	0	0	86	86	44528	2
2	0	2	0	0	44529	2
2	0	2	0	0	44530	2
2	0	2	0	0	44531	2
2	0	2	0	0	44532	2
2	0	2	0	0	44533	2
2	0	2	0	0	44534	2
2	0	2	0	0	44535	2
2	0	2	0	0	44536	2
2	0	2	0	0	44537	2
2	0	2	0	0	44538	2
2	0	2	0	0	44539	2
2	0	2	0	0	44540	2
2	0	2	0	0	44541	2
2	0	2	0	0	44542	2
2	0	2	0	0	44543	2
2	0	2	0	0	44544	2
2	0	2	0	0	44545	2
2	0	2	0	0	44546	2
4	0	0	0	0	44547	2
4	0	0	0	0	44548	2
0	15	2	0	15	44549	0
0	0	2	8	8	44550	2
0	0	2	0	0	44551	2
4	178	0	1058	1236	44552	0
4	19	0	628	647	44553	0
4	331	0	878	1209	44554	0
4	326	2	2	328	44555	0
4	70	2	24	94	44556	0
4	30	2	0	30	44557	0
4	49	4	37	86	44558	1
4	1	4	0	1	44559	1
5	13	4	95	108	44560	0
4	4	4	37	41	44561	1
4	0	4	0	0	44562	2
4	9359	2	74	9433	44563	0
2	0	2	0	0	44564	2
2	0	2	1	1	44565	2
2	0	2	0	0	44566	2
2	0	2	0	0	44567	2
2	0	2	0	0	44568	2
2	0	2	0	0	44569	2
2	0	2	0	0	44570	2
2	0	2	0	0	44571	2
2	5	2	0	5	44572	0
2	0	2	0	0	44573	2
2	0	0	916	916	44574	2
2	0	2	0	0	44575	2
2	0	2	0	0	44576	2
2	0	0	321	321	44577	2
2	0	2	0	0	44578	2
2	5	2	14	19	44579	1
2	0	2	0	0	44580	2
2	0	2	0	0	44581	2
2	0	2	7014	7014	44582	2
2	0	2	1	1	44583	2
2	0	2	0	0	44584	2
2	0	2	0	0	44585	2
2	0	2	0	0	44586	2
2	0	2	0	0	44587	2
2	0	2	0	0	44588	2
2	0	2	0	0	44589	2
2	50	2	1	51	44590	0
2	11	2	506	517	44591	1
2	0	2	72	72	44592	2
2	0	2	3	3	44593	2
2	28	2	50	78	44594	0
2	0	2	223	223	44595	2
2	234	2	1	235	44596	0
2	54	2	5	59	44597	1
2	0	2	253	253	44598	2
2	86	2	1550	1636	44599	1
2	0	2	18	18	44600	2
2	0	2	2	2	44601	2
2	0	2	0	0	44602	2
2	0	0	64	64	44603	2
2	0	2	0	0	44604	2
2	0	2	0	0	44605	2
2	0	0	12	12	44606	2
2	0	2	0	0	44607	2
2	0	2	0	0	44608	2
2	0	2	0	0	44609	2
2	0	2	0	0	44610	2
2	0	2	0	0	44611	2
2	0	2	0	0	44612	2
2	0	2	0	0	44613	2
2	0	2	0	0	44614	2
2	0	2	1	1	44615	2
2	0	2	0	0	44616	2
2	0	2	0	0	44617	2
2	0	2	0	0	44618	2
2	0	2	0	0	44619	2
2	3	2	0	3	44620	0
2	928	2	4	932	44621	0
2	0	4	12663	12663	44622	2
2	0	2	4	4	44623	2
2	0	2	0	0	44624	2
2	4	4	9487	9491	44625	0
2	140	2	625	765	44626	1
2	0	2	55	55	44627	2
2	0	2	15	15	44628	2
2	81	2	48	129	44629	0
2	0	2	0	0	44630	2
2	0	2	0	0	44631	2
2	0	2	0	0	44632	2
2	0	2	0	0	44633	2
2	0	2	0	0	44634	2
2	0	2	0	0	44635	2
2	0	2	0	0	44636	2
2	1	2	6	7	44637	1
2	0	2	0	0	44638	2
2	0	2	0	0	44639	2
2	0	2	0	0	44640	2
2	0	2	0	0	44641	2
2	50	2	0	50	44642	0
2	109	2	1209	1318	44643	1
2	2	2	53	55	44644	1
2	0	2	10	10	44645	2
2	27	2	3	30	44646	0
2	0	2	95	95	44647	2
2	3	2	0	3	44648	0
2	1	2	13	14	44649	1
2	0	2	0	0	44650	2
2	0	2	0	0	44651	2
2	0	2	1	1	44652	2
2	0	2	6	6	44653	2
2	25	2	0	25	44654	0
2	5	2	136	141	44655	1
2	0	2	1	1	44656	2
2	0	2	0	0	44657	2
2	9	2	0	9	44658	0
2	0	2	67	67	44659	2
2	0	2	0	0	44660	2
2	4	2	0	4	44661	0
2	0	2	58	58	44662	2
2	0	2	1	1	44663	2
2	0	2	0	0	44664	2
2	3	2	1	4	44665	0
2	0	2	14	14	44666	2
2	0	2	0	0	44667	2
2	0	2	0	0	44668	2
2	0	2	26	26	44669	2
2	0	2	0	0	44670	2
2	0	2	0	0	44671	2
2	0	2	0	0	44672	2
2	0	2	0	0	44673	2
2	0	2	0	0	44674	2
2	0	2	0	0	44675	2
2	0	2	0	0	44676	2
2	0	2	0	0	44677	2
2	0	2	0	0	44678	2
2	0	2	0	0	44679	2
2	0	2	0	0	44680	2
2	0	2	0	0	44681	2
2	12	2	116	128	44682	0
2	119	2	12	131	44683	0
2	0	2	404	404	44684	2
2	0	2	0	0	44685	2
2	0	2	0	0	44686	2
2	0	2	0	0	44687	2
2	0	2	0	0	44688	2
2	0	2	0	0	44689	2
2	0	2	0	0	44690	2
2	0	2	0	0	44691	2
2	1	2	0	1	44692	0
2	0	2	0	0	44693	2
2	0	2	0	0	44694	2
2	0	2	0	0	44695	2
2	0	2	17	17	44696	2
2	0	2	0	0	44697	2
2	0	2	1	1	44698	2
2	1	2	4	5	44699	0
2	0	2	0	0	44700	2
2	85	2	1	86	44701	0
2	28	2	254	282	44702	1
2	0	2	2	2	44703	2
2	0	2	0	0	44704	2
2	4	2	3	7	44705	0
2	0	2	52	52	44706	2
2	0	2	0	0	44707	2
2	1	2	0	1	44708	1
2	0	2	0	0	44709	2
2	0	2	0	0	44710	2
2	0	2	0	0	44711	2
2	0	2	1	1	44712	2
2	0	2	0	0	44713	2
2	0	2	0	0	44714	2
2	0	2	0	0	44715	2
2	0	2	0	0	44716	2
2	0	2	0	0	44717	2
2	0	2	0	0	44718	2
2	0	2	0	0	44719	2
2	0	2	0	0	44720	2
2	0	2	0	0	44721	2
2	0	2	0	0	44722	2
2	0	2	0	0	44723	2
2	0	2	0	0	44724	2
4	1	4	46	47	44725	1
4	0	4	0	0	44726	2
4	0	4	0	0	44727	2
2	0	2	0	0	44728	2
2	0	2	0	0	44729	2
2	0	2	0	0	44730	2
2	0	2	0	0	44731	2
2	0	2	1	1	44732	2
2	0	2	0	0	44733	2
2	0	2	0	0	44734	2
2	0	2	0	0	44735	2
2	0	2	0	0	44736	2
2	0	2	0	0	44737	2
2	0	2	0	0	44738	2
2	0	2	0	0	44739	2
4	6	4	21	27	44740	1
4	22	4	16	38	44741	1
4	8	4	5	13	44742	1
2	62	2	0	62	44743	0
2	3	0	1622	1625	44744	1
2	0	2	2	2	44745	2
2	0	2	0	0	44746	2
2	6	0	368	374	44747	0
2	0	2	50	50	44748	2
2	366	2	1	367	44749	0
2	252	2	4057	4309	44750	1
2	1	2	146	147	44751	1
2	0	2	0	0	44752	2
2	145	2	15	160	44753	0
2	0	2	800	800	44754	2
2	5	2	0	5	44755	0
2	0	2	161	161	44756	2
2	0	2	2	2	44757	2
2	0	2	0	0	44758	2
2	2	2	57	59	44759	1
2	0	2	0	0	44760	2
2	0	2	0	0	44761	2
2	0	2	0	0	44762	2
2	0	2	0	0	44763	2
2	0	2	0	0	44764	2
2	0	2	0	0	44765	2
2	0	2	1	1	44766	2
2	13	2	0	13	44767	0
2	5	2	5	10	44768	0
2	0	2	15	15	44769	2
2	6	2	61	67	44770	1
2	0	2	4	4	44771	2
2	0	2	0	0	44772	2
2	3	2	206	209	44773	0
2	1	2	0	1	44774	0
2	0	2	15	15	44775	2
2	658	2	2	660	44776	0
2	0	2	67	67	44777	2
2	0	2	1	1	44778	2
2	1	2	0	1	44779	0
2	5	2	2	7	44780	1
2	0	2	0	0	44781	2
2	0	2	0	0	44782	2
2	0	2	0	0	44783	2
2	0	2	1	1	44784	2
2	1	2	0	1	44785	1
2	4	2	6	10	44786	1
2	0	2	0	0	44787	2
2	0	2	0	0	44788	2
2	0	2	0	0	44789	2
2	1	2	1	2	44790	0
2	0	2	0	0	44791	2
2	0	4	88	88	44792	2
2	0	2	0	0	44793	2
2	0	2	0	0	44794	2
2	0	4	159	159	44795	2
2	0	2	1	1	44796	2
4	0	4	0	0	44797	2
4	0	4	0	0	44798	2
2	0	2	0	0	44799	2
2	0	2	3	3	44800	2
2	0	2	0	0	44801	2
2	0	2	0	0	44802	2
2	0	2	0	0	44803	2
2	0	2	0	0	44804	2
2	0	2	0	0	44805	2
2	0	2	1	1	44806	2
2	0	2	0	0	44807	2
2	0	2	0	0	44808	2
2	0	2	1	1	44809	2
2	0	2	0	0	44810	2
0	0	4	11	11	44811	2
2	0	4	0	0	44812	2
2	0	2	0	0	44813	2
0	0	4	0	0	44814	2
0	0	4	0	0	44815	2
2	0	2	0	0	44816	2
2	0	2	0	0	44817	2
0	1	4	0	1	44818	0
2	0	4	683	683	44819	2
2	0	2	0	0	44820	2
2	0	2	0	0	44821	2
0	0	2	0	0	44822	2
0	0	2	0	0	44823	2
2	1	4	177	178	44824	0
2	2	2	1	3	44825	1
2	0	2	0	0	44826	2
2	0	2	0	0	44827	2
2	0	2	0	0	44828	2
2	0	2	0	0	44829	2
0	0	4	3	3	44830	2
2	0	2	0	0	44831	2
2	0	2	24	24	44832	2
2	0	2	0	0	44833	2
2	0	2	0	0	44834	2
2	0	2	10	10	44835	2
2	0	2	1	1	44836	2
2	0	2	0	0	44837	2
2	0	2	0	0	44838	2
2	0	2	0	0	44839	2
2	0	2	0	0	44840	2
2	0	2	0	0	44841	2
2	3	2	0	3	44842	0
2	0	2	8	8	44843	2
2	0	2	0	0	44844	2
2	0	2	0	0	44845	2
2	0	4	1602	1602	44846	2
2	0	2	0	0	44847	2
2	0	2	0	0	44848	2
2	0	4	692	692	44849	2
2	0	2	0	0	44850	2
2	7	2	397	404	44851	1
2	6	2	0	6	44852	0
2	0	2	24	24	44853	2
2	92	2	1	93	44854	0
2	10	2	94	104	44855	1
2	0	2	7	7	44856	2
2	0	2	2	2	44857	2
2	9	2	6	15	44858	0
2	189	4	4	193	44859	0
2	2	4	4	6	44860	1
4	2	0	3	5	44861	1
4	0	0	3	3	44862	2
0	3	4	5	8	44863	1
2	0	4	7	7	44864	2
2	0	2	0	0	44865	2
2	0	2	0	0	44866	2
2	1	2	0	1	44867	0
2	0	2	0	0	44868	2
2	0	2	0	0	44869	2
2	0	2	0	0	44870	2
2	0	2	0	0	44871	2
2	0	2	5	5	44872	2
2	0	2	0	0	44873	2
2	0	2	0	0	44874	2
2	0	2	0	0	44875	2
2	0	2	0	0	44876	2
2	0	4	38	38	44877	2
2	0	2	0	0	44878	2
2	0	2	0	0	44879	2
2	0	4	7	7	44880	2
2	3	2	0	3	44881	1
2	0	2	5	5	44882	2
2	3	2	0	3	44883	0
2	1	2	18	19	44884	1
2	0	2	0	0	44885	2
2	0	2	0	0	44886	2
0	137	3	1795	1932	44887	0
0	2	3	1795	1797	44888	0
2	0	2	0	0	44889	2
2	0	2	0	0	44890	2
2	0	2	0	0	44891	2
2	0	2	0	0	44892	2
2	0	2	0	0	44893	2
2	0	2	0	0	44894	2
2	27	2	0	27	44895	0
2	0	2	0	0	44896	2
2	0	2	0	0	44897	2
2	0	2	0	0	44898	2
2	0	2	0	0	44899	2
2	0	2	0	0	44900	2
2	0	2	0	0	44901	2
2	24	2	1618	1642	44902	1
2	0	2	4	4	44903	2
2	0	2	0	0	44904	2
4	5	2	10	15	44905	0
4	0	2	0	0	44906	2
2	19	2	3	22	44907	0
2	0	2	91	91	44908	2
4	52	2	3	55	44909	0
2	0	2	0	0	44910	2
2	0	2	0	0	44911	2
2	0	2	0	0	44912	2
2	0	2	0	0	44913	2
2	0	2	0	0	44914	2
2	0	2	1	1	44915	2
2	4	2	0	4	44916	0
2	13	2	1039	1052	44917	1
2	0	2	0	0	44918	2
2	0	2	0	0	44919	2
2	4	2	22	26	44920	1
2	0	2	46	46	44921	2
2	63	2	1	64	44922	0
2	0	2	0	0	44923	2
2	0	2	0	0	44924	2
2	0	2	0	0	44925	2
2	0	2	0	0	44926	2
2	0	2	0	0	44927	2
2	0	2	0	0	44928	2
2	77	2	1151	1228	44929	1
2	0	2	76	76	44930	2
2	0	2	0	0	44931	2
2	38	2	3	41	44932	0
2	0	2	188	188	44933	2
2	0	2	0	0	44934	2
2	0	2	0	0	44935	2
2	0	2	0	0	44936	2
2	0	2	0	0	44937	2
2	0	2	0	0	44938	2
2	0	2	0	0	44939	2
2	0	2	0	0	44940	2
2	0	2	0	0	44941	2
2	0	2	0	0	44942	2
2	0	2	0	0	44943	2
2	0	2	0	0	44944	2
2	0	2	0	0	44945	2
2	0	2	0	0	44946	2
2	0	2	0	0	44947	2
2	0	2	0	0	44948	2
2	25	2	0	25	44949	0
2	0	2	0	0	44950	2
2	6	2	0	6	44951	0
2	0	2	78	78	44952	2
2	0	2	1	1	44953	2
2	0	2	0	0	44954	2
2	0	2	0	0	44955	2
2	0	2	11	11	44956	2
2	0	2	4	4	44957	2
2	0	2	0	0	44958	2
2	0	2	0	0	44959	2
2	0	2	2	2	44960	2
2	0	2	0	0	44961	2
2	22	2	175	197	44962	1
2	1	2	11	12	44963	1
2	0	2	1	1	44964	2
2	27	2	0	27	44965	1
2	0	2	79	79	44966	2
2	0	2	0	0	44967	2
2	0	2	0	0	44968	2
2	0	2	0	0	44969	2
2	0	2	0	0	44970	2
2	0	2	0	0	44971	2
2	0	2	0	0	44972	2
4	0	2	0	0	44973	2
2	0	2	0	0	44974	2
2	0	2	0	0	44975	2
0	0	4	0	0	44976	2
2	4	2	0	4	44977	0
2	2	2	161	163	44978	1
2	0	2	0	0	44979	2
2	0	2	0	0	44980	2
0	3	2	2	5	44981	0
0	0	2	0	0	44982	2
2	1	2	1	2	44983	1
2	0	2	6	6	44984	2
2	0	4	4	4	44985	2
2	0	2	0	0	44986	2
2	0	2	0	0	44987	2
2	0	0	7	7	44988	2
2	38	2	1	39	44989	0
2	436	2	1221	1657	44990	1
2	0	2	5	5	44991	2
2	0	2	1	1	44992	2
2	30	2	7	37	44993	1
2	0	2	40	40	44994	2
2	0	2	0	0	44995	2
0	0	4	4	4	44996	2
0	0	4	4	4	44997	2
2	0	2	0	0	44998	2
2	0	2	0	0	44999	2
2	0	2	0	0	45000	2
2	0	2	0	0	45001	2
2	0	2	0	0	45002	2
2	0	2	0	0	45003	2
2	1	4	155	156	45004	1
2	0	2	0	0	45005	2
2	0	2	0	0	45006	2
2	0	2	0	0	45007	2
2	0	2	0	0	45008	2
2	1	4	5	6	45009	0
2	0	2	0	0	45010	2
2	0	2	0	0	45011	2
2	0	2	0	0	45012	2
2	0	2	25	25	45013	2
2	0	2	0	0	45014	2
2	0	2	0	0	45015	2
2	0	2	0	0	45016	2
2	0	2	0	0	45017	2
2	0	2	0	0	45018	2
2	0	4	505	505	45019	2
2	0	2	1	1	45020	2
4	0	2	0	0	45021	2
2	143	2	1	144	45022	0
2	176	2	767	943	45023	1
2	0	2	66	66	45024	2
2	0	2	1	1	45025	2
2	60	2	4	64	45026	0
2	0	2	186	186	45027	2
2	0	2	0	0	45028	2
2	0	2	0	0	45029	2
2	0	2	0	0	45030	2
2	0	2	0	0	45031	2
2	0	2	0	0	45032	2
2	0	2	0	0	45033	2
2	0	2	0	0	45034	2
2	0	2	0	0	45035	2
2	0	2	0	0	45036	2
2	0	2	0	0	45037	2
2	0	2	0	0	45038	2
2	0	2	0	0	45039	2
2	45	2	0	45	45040	0
2	4	2	198	202	45041	1
2	0	2	4	4	45042	2
2	0	2	0	0	45043	2
2	14	2	2	16	45044	0
2	0	2	71	71	45045	2
2	35	2	0	35	45046	0
2	69	2	358	427	45047	1
2	0	2	2	2	45048	2
2	0	2	0	0	45049	2
0	393	2	23	416	45050	0
0	142	2	0	142	45051	0
2	8	2	7	15	45052	0
2	0	2	29	29	45053	2
2	0	2	0	0	45054	2
2	0	2	0	0	45055	2
2	0	2	0	0	45056	2
2	0	2	0	0	45057	2
2	0	2	0	0	45058	2
2	0	2	0	0	45059	2
2	0	2	0	0	45060	2
2	1	4	245	246	45061	1
2	0	2	0	0	45062	2
2	0	2	0	0	45063	2
2	0	4	3	3	45064	2
2	0	2	0	0	45065	2
0	1	4	16	17	45066	1
2	0	2	0	0	45067	2
2	0	2	0	0	45068	2
2	0	2	0	0	45069	2
2	0	2	0	0	45070	2
2	0	2	0	0	45071	2
2	0	2	0	0	45072	2
2	0	2	0	0	45073	2
2	2	4	20	22	45074	0
2	0	2	0	0	45075	2
2	0	2	0	0	45076	2
2	0	4	9	9	45077	2
2	0	2	1	1	45078	2
4	0	2	0	0	45079	2
2	0	2	0	0	45080	2
2	0	2	0	0	45081	2
2	0	2	0	0	45082	2
2	0	2	0	0	45083	2
2	0	2	0	0	45084	2
2	0	2	0	0	45085	2
2	0	2	0	0	45086	2
2	0	2	1	1	45087	2
2	0	2	0	0	45088	2
2	0	2	0	0	45089	2
0	0	2	0	0	45090	2
0	0	2	0	0	45091	2
2	0	2	0	0	45092	2
2	0	2	0	0	45093	2
2	0	2	0	0	45094	2
2	0	2	3	3	45095	2
2	0	2	0	0	45096	2
2	0	2	0	0	45097	2
2	0	2	2	2	45098	2
2	0	2	3	3	45099	2
2	0	2	0	0	45100	2
2	0	2	0	0	45101	2
2	0	2	0	0	45102	2
2	0	2	0	0	45103	2
2	0	2	0	0	45104	2
2	0	2	0	0	45105	2
2	0	2	0	0	45106	2
2	0	2	0	0	45107	2
2	0	2	0	0	45108	2
2	0	2	0	0	45109	2
2	0	2	0	0	45110	2
2	0	2	0	0	45111	2
2	0	2	0	0	45112	2
2	6	4	2149	2155	45113	1
2	0	2	0	0	45114	2
2	0	2	0	0	45115	2
2	1	4	179	180	45116	1
2	0	2	0	0	45117	2
2	0	2	0	0	45118	2
2	0	2	0	0	45119	2
2	0	2	0	0	45120	2
2	0	2	0	0	45121	2
2	0	2	0	0	45122	2
2	0	2	0	0	45123	2
2	0	2	0	0	45124	2
2	0	4	10	10	45125	2
2	0	2	0	0	45126	2
2	0	2	0	0	45127	2
2	0	4	0	0	45128	2
2	0	2	3	3	45129	2
2	0	2	0	0	45130	2
2	0	4	6	6	45131	2
2	0	2	0	0	45132	2
2	0	4	5	5	45133	2
2	0	2	0	0	45134	2
2	0	2	0	0	45135	2
2	0	2	0	0	45136	2
2	0	4	740	740	45137	2
2	0	2	0	0	45138	2
2	0	2	0	0	45139	2
2	0	4	37	37	45140	2
2	0	2	0	0	45141	2
4	2	4	4	6	45142	1
4	0	4	0	0	45143	2
2	0	2	0	0	45144	2
2	0	2	0	0	45145	2
2	0	2	0	0	45146	2
2	0	2	0	0	45147	2
2	0	2	0	0	45148	2
2	0	2	0	0	45149	2
0	0	4	3	3	45150	2
0	0	4	5	5	45151	2
2	0	2	0	0	45152	2
2	0	2	0	0	45153	2
2	0	4	1	1	45154	2
2	0	2	30	30	45155	2
2	0	2	13	13	45156	2
2	0	2	0	0	45157	2
2	8	2	0	8	45158	0
2	2	2	184	186	45159	1
2	0	2	0	0	45160	2
2	0	2	0	0	45161	2
2	2	2	0	2	45162	1
2	0	2	5	5	45163	2
2	3	4	69	72	45164	0
2	0	2	0	0	45165	2
2	0	2	0	0	45166	2
2	0	2	0	0	45167	2
2	0	2	0	0	45168	2
2	0	2	0	0	45169	2
2	0	2	0	0	45170	2
2	0	2	0	0	45171	2
2	0	2	0	0	45172	2
2	0	0	26	26	45173	2
2	0	2	0	0	45174	2
2	0	2	0	0	45175	2
2	0	2	0	0	45176	2
2	0	2	0	0	45177	2
2	0	2	0	0	45178	2
2	0	2	0	0	45179	2
2	0	2	0	0	45180	2
0	0	2	0	0	45181	2
0	0	2	0	0	45182	2
0	0	2	0	0	45183	2
0	0	4	1075	1075	45184	2
2	12	2	0	12	45185	0
2	23	2	253	276	45186	1
2	0	2	0	0	45187	2
2	0	2	0	0	45188	2
2	2	2	0	2	45189	1
2	0	2	28	28	45190	2
2	0	2	0	0	45191	2
2	0	2	0	0	45192	2
2	0	2	0	0	45193	2
2	0	2	0	0	45194	2
2	0	2	0	0	45195	2
2	0	2	0	0	45196	2
2	0	2	0	0	45197	2
2	0	2	2	2	45198	2
2	0	2	0	0	45199	2
2	0	2	0	0	45200	2
2	0	2	0	0	45201	2
2	0	2	0	0	45202	2
2	0	2	0	0	45203	2
2	0	2	1	1	45204	2
2	0	2	0	0	45205	2
2	0	2	0	0	45206	2
2	0	2	0	0	45207	2
2	0	2	0	0	45208	2
2	0	2	0	0	45209	2
2	0	2	2	2	45210	2
2	0	2	0	0	45211	2
2	0	2	0	0	45212	2
2	0	2	0	0	45213	2
2	0	2	0	0	45214	2
2	2	2	0	2	45215	0
2	0	2	54	54	45216	2
2	0	2	0	0	45217	2
2	0	2	0	0	45218	2
2	0	2	0	0	45219	2
2	0	2	2	2	45220	2
2	0	2	0	0	45221	2
2	0	2	2	2	45222	2
2	0	2	0	0	45223	2
2	0	2	0	0	45224	2
2	0	2	0	0	45225	2
2	0	2	0	0	45226	2
2	0	4	1584	1584	45227	2
2	0	2	0	0	45228	2
2	0	2	0	0	45229	2
2	0	2	0	0	45230	2
2	0	2	0	0	45231	2
2	0	2	0	0	45232	2
2	0	2	0	0	45233	2
2	0	7	2413	2413	45234	2
2	0	2	0	0	45235	2
2	0	2	0	0	45236	2
2	0	2	0	0	45237	2
2	0	2	0	0	45238	2
2	0	4	4	4	45239	2
2	0	2	0	0	45240	2
2	0	2	0	0	45241	2
2	0	2	0	0	45242	2
2	0	2	0	0	45243	2
2	0	2	0	0	45244	2
2	0	2	0	0	45245	2
2	1	2	0	1	45246	0
2	2	2	20	22	45247	1
2	0	2	0	0	45248	2
2	0	2	0	0	45249	2
2	1	2	0	1	45250	1
2	0	2	2	2	45251	2
2	1	2	0	1	45252	0
2	0	2	0	0	45253	2
2	0	2	0	0	45254	2
2	0	2	0	0	45255	2
2	0	2	0	0	45256	2
2	0	2	0	0	45257	2
2	0	2	0	0	45258	2
2	5	2	39	44	45259	1
2	0	2	3	3	45260	2
2	0	2	0	0	45261	2
2	1	2	277	278	45262	0
2	0	2	12	12	45263	2
0	2071	2	20	2091	45264	0
0	412	2	0	412	45265	0
2	0	2	0	0	45266	2
2	0	2	0	0	45267	2
2	0	2	0	0	45268	2
2	0	2	0	0	45269	2
2	0	2	0	0	45270	2
2	0	2	0	0	45271	2
2	0	2	0	0	45272	2
2	0	2	0	0	45273	2
2	0	2	0	0	45274	2
2	0	2	0	0	45275	2
2	0	2	0	0	45276	2
2	0	2	0	0	45277	2
2	268	2	0	268	45278	0
4	10	2	0	10	45279	0
2	0	2	0	0	45280	2
2	0	2	0	0	45281	2
2	0	2	0	0	45282	2
2	0	2	0	0	45283	2
2	0	2	0	0	45284	2
2	0	2	0	0	45285	2
2	0	2	0	0	45286	2
2	0	2	18	18	45287	2
2	0	2	0	0	45288	2
2	0	2	0	0	45289	2
2	0	2	3	3	45290	2
2	0	2	0	0	45291	2
2	74	4	54	128	45292	0
2	0	2	253	253	45293	2
2	0	2	85	85	45294	2
2	0	2	10	10	45295	2
2	0	2	0	0	45296	2
2	0	2	0	0	45297	2
2	0	2	0	0	45298	2
2	0	2	0	0	45299	2
2	0	2	0	0	45300	2
2	0	2	0	0	45301	2
2	0	2	0	0	45302	2
2	0	2	0	0	45303	2
2	0	2	1	1	45304	2
2	0	2	0	0	45305	2
2	0	2	0	0	45306	2
2	0	2	0	0	45307	2
2	0	2	0	0	45308	2
2	0	2	0	0	45309	2
2	0	2	0	0	45310	2
2	0	2	0	0	45311	2
2	0	2	0	0	45312	2
2	0	2	0	0	45313	2
2	0	2	0	0	45314	2
2	0	2	0	0	45315	2
2	0	2	0	0	45316	2
2	0	2	0	0	45317	2
2	0	2	0	0	45318	2
2	0	4	0	0	45319	2
2	0	2	0	0	45320	2
2	0	4	0	0	45321	2
2	0	2	0	0	45322	2
2	0	2	0	0	45323	2
2	0	2	0	0	45324	2
2	0	2	0	0	45325	2
2	1	2	0	1	45326	0
2	0	2	0	0	45327	2
2	0	2	0	0	45328	2
2	0	2	0	0	45329	2
0	2	4	0	2	45330	1
2	0	2	0	0	45331	2
2	0	2	1	1	45332	2
2	0	2	0	0	45333	2
2	0	2	0	0	45334	2
2	0	2	0	0	45335	2
2	0	2	0	0	45336	2
2	0	2	0	0	45337	2
2	0	2	0	0	45338	2
2	0	2	0	0	45339	2
2	0	2	1	1	45340	2
2	0	2	0	0	45341	2
2	0	2	0	0	45342	2
4	0	4	0	0	45343	2
4	0	4	0	0	45344	2
2	0	2	0	0	45345	2
2	0	2	267	267	45346	2
2	0	2	0	0	45347	2
2	0	2	0	0	45348	2
2	0	2	25	25	45349	2
2	0	2	0	0	45350	2
2	0	2	0	0	45351	2
2	0	2	0	0	45352	2
2	0	2	0	0	45353	2
2	0	2	0	0	45354	2
2	0	2	0	0	45355	2
2	0	2	0	0	45356	2
2	0	2	0	0	45357	2
0	1	2	0	1	45358	1
2	0	2	0	0	45359	2
2	0	2	0	0	45360	2
2	0	2	0	0	45361	2
2	0	2	0	0	45362	2
2	0	2	0	0	45363	2
2	0	4	289	289	45364	2
2	0	2	0	0	45365	2
2	0	2	0	0	45366	2
2	0	4	10	10	45367	2
4	0	2	0	0	45368	2
2	0	2	0	0	45369	2
2	0	2	0	0	45370	2
2	0	2	0	0	45371	2
2	0	2	0	0	45372	2
2	0	2	0	0	45373	2
2	0	2	0	0	45374	2
2	0	2	0	0	45375	2
2	0	2	0	0	45376	2
2	0	2	0	0	45377	2
2	0	2	0	0	45378	2
2	0	2	0	0	45379	2
2	0	2	0	0	45380	2
2	0	2	0	0	45381	2
2	0	2	0	0	45382	2
2	0	2	0	0	45383	2
2	0	2	0	0	45384	2
2	0	2	0	0	45385	2
2	0	2	0	0	45386	2
2	0	2	0	0	45387	2
2	0	2	0	0	45388	2
2	0	2	0	0	45389	2
2	0	2	0	0	45390	2
2	0	2	0	0	45391	2
2	0	2	0	0	45392	2
2	0	2	0	0	45393	2
2	0	2	0	0	45394	2
2	0	2	0	0	45395	2
2	0	2	0	0	45396	2
2	0	2	0	0	45397	2
2	0	2	0	0	45398	2
2	0	2	0	0	45399	2
2	0	2	0	0	45400	2
2	0	2	0	0	45401	2
2	0	2	0	0	45402	2
2	0	2	0	0	45403	2
2	0	2	0	0	45404	2
2	0	2	0	0	45405	2
2	0	2	0	0	45406	2
2	0	2	1	1	45407	2
2	0	2	0	0	45408	2
2	0	2	0	0	45409	2
2	0	2	0	0	45410	2
2	0	2	0	0	45411	2
2	0	2	0	0	45412	2
2	0	2	0	0	45413	2
2	0	2	0	0	45414	2
2	0	2	0	0	45415	2
2	0	2	0	0	45416	2
2	0	2	0	0	45417	2
2	0	2	0	0	45418	2
2	0	2	0	0	45419	2
2	0	2	0	0	45420	2
2	0	2	0	0	45421	2
2	0	2	0	0	45422	2
2	0	2	0	0	45423	2
2	0	2	0	0	45424	2
2	0	2	0	0	45425	2
2	0	2	0	0	45426	2
2	0	2	0	0	45427	2
2	0	2	0	0	45428	2
2	0	2	0	0	45429	2
2	1	2	9	10	45430	1
2	0	2	0	0	45431	2
2	0	2	0	0	45432	2
2	0	2	0	0	45433	2
2	0	2	0	0	45434	2
4	0	2	0	0	45435	2
2	0	2	0	0	45436	2
2	0	2	0	0	45437	2
2	0	2	0	0	45438	2
2	0	2	0	0	45439	2
2	0	2	0	0	45440	2
2	0	2	0	0	45441	2
2	0	2	0	0	45442	2
2	0	2	0	0	45443	2
2	0	2	0	0	45444	2
2	0	2	0	0	45445	2
2	0	2	0	0	45446	2
2	0	2	0	0	45447	2
2	0	2	0	0	45448	2
2	0	2	3	3	45449	2
2	0	2	1	1	45450	2
2	0	2	0	0	45451	2
2	0	2	0	0	45452	2
2	0	2	2	2	45453	2
2	277	4	77	354	45454	1
0	3	4	77	80	45455	0
4	0	4	64	64	45456	2
2	0	2	0	0	45457	2
2	0	2	0	0	45458	2
2	0	2	0	0	45459	2
2	0	2	0	0	45460	2
2	0	2	0	0	45461	2
2	0	2	0	0	45462	2
2	0	2	0	0	45463	2
2	0	2	0	0	45464	2
2	0	2	0	0	45465	2
2	0	2	0	0	45466	2
2	0	2	2	2	45467	2
2	0	2	0	0	45468	2
2	0	2	0	0	45469	2
2	0	2	14	14	45470	2
2	0	2	0	0	45471	2
2	0	2	0	0	45472	2
2	0	2	0	0	45473	2
2	0	2	0	0	45474	2
2	0	2	0	0	45475	2
2	0	2	0	0	45476	2
2	0	2	0	0	45477	2
2	0	2	0	0	45478	2
2	0	2	0	0	45479	2
2	0	2	0	0	45480	2
2	0	2	0	0	45481	2
2	0	2	0	0	45482	2
2	0	2	0	0	45483	2
2	0	2	0	0	45484	2
2	0	2	0	0	45485	2
2	0	2	0	0	45486	2
2	0	2	0	0	45487	2
2	0	2	0	0	45488	2
2	0	2	0	0	45489	2
2	0	2	0	0	45490	2
2	0	2	0	0	45491	2
2	0	2	0	0	45492	2
2	0	2	0	0	45493	2
2	0	2	0	0	45494	2
2	0	2	0	0	45495	2
2	0	2	0	0	45496	2
2	0	2	0	0	45497	2
2	0	2	0	0	45498	2
2	0	2	0	0	45499	2
2	0	2	0	0	45500	2
2	0	2	0	0	45501	2
2	0	2	0	0	45502	2
2	0	2	0	0	45503	2
2	0	2	0	0	45504	2
2	0	2	0	0	45505	2
2	0	2	0	0	45506	2
2	0	2	0	0	45507	2
0	0	4	0	0	45508	2
2	0	2	0	0	45509	2
2	0	2	1	1	45510	2
2	0	2	0	0	45511	2
2	0	2	0	0	45512	2
2	0	2	0	0	45513	2
2	0	2	0	0	45514	2
2	0	2	0	0	45515	2
2	0	2	2	2	45516	2
2	0	2	0	0	45517	2
2	0	2	0	0	45518	2
2	0	2	0	0	45519	2
2	0	2	1	1	45520	2
2	0	2	0	0	45521	2
2	0	2	0	0	45522	2
2	0	2	0	0	45523	2
2	0	2	0	0	45524	2
2	0	2	0	0	45525	2
2	0	2	0	0	45526	2
2	0	2	0	0	45527	2
2	0	2	0	0	45528	2
2	0	2	0	0	45529	2
2	0	2	0	0	45530	2
2	0	2	0	0	45531	2
2	0	2	0	0	45532	2
2	0	2	0	0	45533	2
2	0	2	0	0	45534	2
2	0	2	0	0	45535	2
2	0	2	0	0	45536	2
2	0	2	0	0	45537	2
2	0	2	0	0	45538	2
2	0	2	0	0	45539	2
2	117	4	4703	4820	45540	0
2	0	2	0	0	45541	2
2	0	2	0	0	45542	2
2	0	4	285	285	45543	2
2	0	2	28	28	45544	2
0	6	4	3	9	45545	0
0	9	4	8	17	45546	1
2	0	2	0	0	45547	2
2	0	2	0	0	45548	2
2	0	2	0	0	45549	2
2	0	2	0	0	45550	2
2	0	2	0	0	45551	2
2	0	2	0	0	45552	2
2	0	2	0	0	45553	2
2	0	4	37	37	45554	2
2	0	2	0	0	45555	2
2	0	2	0	0	45556	2
2	0	4	6	6	45557	2
2	0	2	0	0	45558	2
2	0	2	0	0	45559	2
2	0	2	1	1	45560	2
2	0	2	0	0	45561	2
2	0	2	9	9	45562	2
2	0	2	0	0	45563	2
2	0	2	0	0	45564	2
2	14	2	0	14	45565	0
2	2	2	48	50	45566	1
2	0	2	1	1	45567	2
2	0	2	0	0	45568	2
2	8	2	0	8	45569	0
2	0	2	28	28	45570	2
2	0	2	0	0	45571	2
2	0	2	0	0	45572	2
2	0	2	0	0	45573	2
2	0	2	0	0	45574	2
2	0	2	0	0	45575	2
2	0	2	0	0	45576	2
2	0	2	0	0	45577	2
2	0	2	0	0	45578	2
2	0	2	0	0	45579	2
2	0	2	0	0	45580	2
2	0	2	0	0	45581	2
2	0	2	0	0	45582	2
2	0	2	0	0	45583	2
2	0	2	0	0	45584	2
2	0	2	0	0	45585	2
2	0	2	0	0	45586	2
2	0	2	0	0	45587	2
2	0	2	0	0	45588	2
2	0	2	0	0	45589	2
2	0	2	9	9	45590	2
2	0	2	0	0	45591	2
2	0	2	0	0	45592	2
2	0	2	0	0	45593	2
2	0	2	0	0	45594	2
2	0	2	0	0	45595	2
2	0	4	0	0	45596	2
2	0	2	0	0	45597	2
2	0	2	0	0	45598	2
2	0	4	0	0	45599	2
2	0	2	0	0	45600	2
2	0	2	0	0	45601	2
2	0	2	3	3	45602	2
2	0	2	0	0	45603	2
2	0	2	0	0	45604	2
2	0	2	0	0	45605	2
2	0	2	0	0	45606	2
2	185	2	2	187	45607	0
2	0	2	0	0	45608	2
2	0	2	8	8	45609	2
2	0	2	0	0	45610	2
2	0	2	0	0	45611	2
0	22	2	2	24	45612	0
0	29	2	0	29	45613	0
2	0	2	0	0	45614	2
2	0	2	0	0	45615	2
2	0	2	0	0	45616	2
2	0	2	0	0	45617	2
2	0	2	0	0	45618	2
2	0	2	0	0	45619	2
2	0	2	0	0	45620	2
2	0	2	0	0	45621	2
2	0	2	0	0	45622	2
2	0	2	0	0	45623	2
2	0	2	0	0	45624	2
2	0	2	0	0	45625	2
2	0	2	0	0	45626	2
2	0	2	0	0	45627	2
2	0	2	0	0	45628	2
2	0	2	0	0	45629	2
2	0	2	0	0	45630	2
2	0	2	0	0	45631	2
2	0	2	0	0	45632	2
2	0	2	0	0	45633	2
2	0	2	0	0	45634	2
2	0	4	164	164	45635	2
2	0	2	0	0	45636	2
2	0	2	0	0	45637	2
0	3	2	0	3	45638	0
0	2	2	0	2	45639	0
2	0	4	234	234	45640	2
2	0	2	0	0	45641	2
2	0	2	0	0	45642	2
2	0	2	0	0	45643	2
2	0	2	0	0	45644	2
2	0	2	0	0	45645	2
2	0	2	0	0	45646	2
2	0	2	0	0	45647	2
0	0	4	2	2	45648	2
0	0	4	2	2	45649	2
2	0	2	0	0	45650	2
2	0	2	0	0	45651	2
2	0	2	0	0	45652	2
2	0	2	0	0	45653	2
2	0	2	29	29	45654	2
2	0	2	0	0	45655	2
2	0	2	0	0	45656	2
2	0	2	1	1	45657	2
2	0	2	0	0	45658	2
2	0	2	0	0	45659	2
2	0	2	0	0	45660	2
2	0	2	0	0	45661	2
2	0	2	0	0	45662	2
2	0	2	0	0	45663	2
4	1	4	43	44	45664	0
2	0	2	0	0	45665	2
2	0	2	0	0	45666	2
2	0	2	0	0	45667	2
2	0	2	0	0	45668	2
2	0	2	0	0	45669	2
2	0	2	0	0	45670	2
2	0	2	0	0	45671	2
2	0	2	1	1	45672	2
2	0	2	0	0	45673	2
2	0	2	0	0	45674	2
2	0	2	0	0	45675	2
2	0	2	0	0	45676	2
2	0	2	0	0	45677	2
2	0	2	0	0	45678	2
2	0	2	0	0	45679	2
2	0	2	0	0	45680	2
2	0	2	0	0	45681	2
2	0	2	0	0	45682	2
2	0	2	0	0	45683	2
2	0	2	0	0	45684	2
2	0	2	0	0	45685	2
2	0	2	0	0	45686	2
2	0	2	0	0	45687	2
0	4535	2	2	4537	45688	0
0	1667	2	1	1668	45689	0
2	0	2	0	0	45690	2
2	0	2	1	1	45691	2
2	286	2	8	294	45692	0
2	0	2	0	0	45693	2
2	0	2	0	0	45694	2
2	0	2	0	0	45695	2
2	0	2	2	2	45696	2
2	0	2	0	0	45697	2
2	0	2	0	0	45698	2
2	0	2	0	0	45699	2
2	0	2	0	0	45700	2
2	0	2	0	0	45701	2
2	0	2	0	0	45702	2
2	0	2	0	0	45703	2
2	0	2	0	0	45704	2
2	69	4	6522	6591	45705	1
2	2	2	381	383	45706	0
2	0	2	5	5	45707	2
2	210	4	379	589	45708	1
2	1	2	884	885	45709	1
2	0	2	0	0	45710	2
2	0	2	19	19	45711	2
2	0	2	0	0	45712	2
2	0	2	0	0	45713	2
2	0	2	5	5	45714	2
2	0	2	0	0	45715	2
2	0	2	0	0	45716	2
2	0	2	0	0	45717	2
2	0	2	0	0	45718	2
2	0	2	0	0	45719	2
2	0	2	0	0	45720	2
2	0	2	0	0	45721	2
2	0	2	1	1	45722	2
2	0	2	14	14	45723	2
2	12	2	0	12	45724	0
2	0	2	29	29	45725	2
2	0	2	0	0	45726	2
2	0	2	0	0	45727	2
2	0	2	0	0	45728	2
2	0	2	0	0	45729	2
2	0	2	0	0	45730	2
2	0	2	0	0	45731	2
2	0	2	0	0	45732	2
2	0	2	0	0	45733	2
2	0	2	0	0	45734	2
2	0	2	0	0	45735	2
2	0	2	0	0	45736	2
2	0	2	0	0	45737	2
2	0	2	0	0	45738	2
2	0	2	0	0	45739	2
2	0	2	0	0	45740	2
2	0	2	0	0	45741	2
2	0	2	0	0	45742	2
2	0	2	0	0	45743	2
2	0	2	0	0	45744	2
2	0	2	0	0	45745	2
2	297	2	1	298	45746	0
2	624	2	1142	1766	45747	1
2	0	2	66	66	45748	2
2	0	2	0	0	45749	2
2	126	2	4	130	45750	1
2	0	2	686	686	45751	2
2	0	2	0	0	45752	2
2	0	2	1	1	45753	2
2	0	2	0	0	45754	2
2	0	2	0	0	45755	2
2	0	2	0	0	45756	2
2	0	2	0	0	45757	2
2	0	2	0	0	45758	2
2	0	2	0	0	45759	2
2	0	2	0	0	45760	2
2	0	2	0	0	45761	2
2	0	2	0	0	45762	2
2	0	2	0	0	45763	2
2	29	2	0	29	45764	0
0	81	2	0	81	45765	0
2	0	2	8	8	45766	2
2	0	2	1	1	45767	2
2	6	4	823	829	45768	1
2	0	2	40	40	45769	2
2	0	2	0	0	45770	2
0	213	2	0	213	45771	0
0	26	2	8	34	45772	0
0	21	2	0	21	45773	0
2	2	2	353	355	45774	1
2	0	2	0	0	45775	2
2	0	2	0	0	45776	2
4	213	2	19	232	45777	0
4	59	2	5	64	45778	0
2	0	2	0	0	45779	2
2	0	2	0	0	45780	2
2	0	2	0	0	45781	2
2	0	2	0	0	45782	2
2	0	2	0	0	45783	2
2	0	2	0	0	45784	2
2	0	2	0	0	45785	2
2	1211	2	11	1222	45786	0
2	1	2	4	5	45787	0
2	0	2	2	2	45788	2
2	0	2	0	0	45789	2
2	0	2	78	78	45790	2
2	0	2	1	1	45791	2
2	0	2	0	0	45792	2
2	0	2	0	0	45793	2
2	0	0	403	403	45794	2
2	0	2	0	0	45795	2
2	0	2	0	0	45796	2
2	0	0	80	80	45797	2
2	0	2	0	0	45798	2
2	902	4	7923	8825	45799	1
2	1	2	172	173	45800	1
2	0	2	13	13	45801	2
2	319	4	273	592	45802	0
2	1	2	1603	1604	45803	1
4	0	2	563	563	45804	2
2	0	2	0	0	45805	2
2	0	2	0	0	45806	2
2	0	2	0	0	45807	2
2	0	2	0	0	45808	2
2	0	2	0	0	45809	2
2	0	2	0	0	45810	2
2	0	2	0	0	45811	2
2	0	2	0	0	45812	2
2	0	2	0	0	45813	2
2	0	2	0	0	45814	2
2	0	2	0	0	45815	2
2	0	2	0	0	45816	2
2	0	2	0	0	45817	2
2	0	2	0	0	45818	2
2	0	2	1	1	45819	2
2	0	2	0	0	45820	2
2	0	2	0	0	45821	2
2	0	2	0	0	45822	2
2	0	2	0	0	45823	2
2	0	2	0	0	45824	2
2	0	2	0	0	45825	2
2	0	2	0	0	45826	2
2	0	2	0	0	45827	2
2	0	2	0	0	45828	2
2	0	2	0	0	45829	2
2	0	2	0	0	45830	2
2	0	4	179	179	45831	2
2	0	2	0	0	45832	2
2	0	2	0	0	45833	2
2	0	4	263	263	45834	2
2	0	2	3	3	45835	2
2	0	4	330	330	45836	2
2	0	2	0	0	45837	2
2	0	2	0	0	45838	2
2	1	4	32	33	45839	1
2	0	2	0	0	45840	2
4	534	2	1	535	45841	0
0	5	4	1	6	45842	0
2	0	2	0	0	45843	2
2	0	2	0	0	45844	2
2	0	2	0	0	45845	2
2	0	2	0	0	45846	2
2	0	2	0	0	45847	2
2	0	2	0	0	45848	2
2	0	2	0	0	45849	2
2	0	2	0	0	45850	2
2	0	2	0	0	45851	2
2	0	2	0	0	45852	2
2	0	2	0	0	45853	2
2	0	2	0	0	45854	2
2	0	2	0	0	45855	2
2	7	4	9	16	45856	1
2	0	2	0	0	45857	2
2	0	2	0	0	45858	2
2	5	4	2	7	45859	0
2	0	2	18	18	45860	2
2	1	2	0	1	45861	0
2	0	2	16	16	45862	2
2	0	2	0	0	45863	2
2	0	2	0	0	45864	2
2	0	2	1	1	45865	2
2	0	2	0	0	45866	2
2	28	2	3	31	45867	0
2	0	2	0	0	45868	2
2	0	4	0	0	45869	2
2	0	2	0	0	45870	2
2	0	2	0	0	45871	2
2	0	4	0	0	45872	2
2	0	2	0	0	45873	2
2	0	2	0	0	45874	2
2	0	2	0	0	45875	2
2	0	2	0	0	45876	2
2	0	2	0	0	45877	2
2	0	2	0	0	45878	2
2	0	2	0	0	45879	2
2	0	2	0	0	45880	2
2	0	2	0	0	45881	2
2	0	2	0	0	45882	2
2	0	2	0	0	45883	2
2	0	2	0	0	45884	2
2	0	2	0	0	45885	2
2	1	2	0	1	45886	0
2	20	2	68	88	45887	1
2	0	2	1	1	45888	2
2	0	2	0	0	45889	2
2	2	2	0	2	45890	1
2	0	4	381	381	45891	2
2	0	2	0	0	45892	2
2	0	2	0	0	45893	2
2	0	2	0	0	45894	2
2	0	2	0	0	45895	2
2	0	2	0	0	45896	2
2	0	2	0	0	45897	2
2	0	2	0	0	45898	2
2	5	4	364	369	45899	1
2	0	2	0	0	45900	2
2	0	2	0	0	45901	2
2	1	4	316	317	45902	0
2	0	2	2	2	45903	2
2	184	4	749	933	45904	0
2	0	2	5	5	45905	2
2	0	2	3	3	45906	2
2	22	4	107	129	45907	1
2	0	2	0	0	45908	2
2	0	2	0	0	45909	2
2	0	2	0	0	45910	2
2	0	2	0	0	45911	2
2	0	2	0	0	45912	2
2	0	2	0	0	45913	2
2	0	2	0	0	45914	2
2	0	4	177	177	45915	2
2	0	2	0	0	45916	2
2	0	2	0	0	45917	2
2	0	4	446	446	45918	2
2	0	2	0	0	45919	2
2	0	2	0	0	45920	2
2	0	2	0	0	45921	2
2	0	2	0	0	45922	2
2	0	2	0	0	45923	2
2	0	2	0	0	45924	2
2	0	2	0	0	45925	2
2	0	2	0	0	45926	2
2	0	2	0	0	45927	2
2	0	2	0	0	45928	2
2	0	2	0	0	45929	2
2	0	2	0	0	45930	2
2	0	2	1	1	45931	2
2	0	2	0	0	45932	2
2	0	2	0	0	45933	2
2	3	2	0	3	45934	0
2	0	2	22	22	45935	2
2	0	2	1	1	45936	2
2	0	2	0	0	45937	2
2	0	2	0	0	45938	2
2	0	2	0	0	45939	2
2	0	2	0	0	45940	2
2	0	2	0	0	45941	2
2	0	2	4	4	45942	2
2	0	2	0	0	45943	2
2	0	2	0	0	45944	2
2	0	2	2	2	45945	2
2	0	2	0	0	45946	2
2	0	2	0	0	45947	2
2	0	2	0	0	45948	2
2	0	2	0	0	45949	2
2	0	2	0	0	45950	2
2	0	2	0	0	45951	2
2	0	2	0	0	45952	2
2	0	2	0	0	45953	2
2	0	2	0	0	45954	2
2	0	2	0	0	45955	2
2	0	2	0	0	45956	2
2	0	4	0	0	45957	2
2	0	2	0	0	45958	2
2	0	4	3	3	45959	2
2	0	2	0	0	45960	2
2	0	2	0	0	45961	2
2	0	2	0	0	45962	2
2	0	2	0	0	45963	2
2	0	2	0	0	45964	2
2	0	2	0	0	45965	2
2	0	2	0	0	45966	2
2	0	2	0	0	45967	2
0	0	4	11	11	45968	2
0	0	4	1	1	45969	2
2	4	2	0	4	45970	0
2	3	0	25	28	45971	1
2	0	2	8	8	45972	2
2	0	0	103	103	45973	2
2	0	2	1	1	45974	2
2	0	2	0	0	45975	2
2	0	2	0	0	45976	2
2	0	2	0	0	45977	2
2	0	2	0	0	45978	2
2	0	2	0	0	45979	2
2	0	2	0	0	45980	2
2	0	2	0	0	45981	2
2	0	2	0	0	45982	2
2	0	2	0	0	45983	2
2	0	2	0	0	45984	2
2	0	2	0	0	45985	2
2	0	2	1	1	45986	2
2	0	2	0	0	45987	2
2	0	2	0	0	45988	2
4	0	4	18	18	45989	2
2	0	2	0	0	45990	2
2	1	4	17	18	45991	1
2	0	2	0	0	45992	2
2	0	2	0	0	45993	2
2	0	4	7	7	45994	2
2	0	2	0	0	45995	2
2	0	2	0	0	45996	2
2	0	4	4	4	45997	2
2	0	2	0	0	45998	2
2	0	2	0	0	45999	2
2	0	4	0	0	46000	2
2	0	2	0	0	46001	2
4	0	2	0	0	46002	2
2	0	2	0	0	46003	2
2	0	2	0	0	46004	2
2	0	2	0	0	46005	2
2	0	2	0	0	46006	2
2	0	2	0	0	46007	2
2	0	2	0	0	46008	2
2	0	2	0	0	46009	2
2	0	2	0	0	46010	2
2	0	2	0	0	46011	2
2	0	2	0	0	46012	2
2	0	2	0	0	46013	2
2	0	2	0	0	46014	2
2	0	2	0	0	46015	2
2	0	2	0	0	46016	2
2	0	2	0	0	46017	2
2	0	2	0	0	46018	2
2	0	2	0	0	46019	2
2	0	2	0	0	46020	2
2	0	2	0	0	46021	2
2	0	2	0	0	46022	2
2	0	2	0	0	46023	2
2	0	2	0	0	46024	2
2	0	2	0	0	46025	2
2	0	2	0	0	46026	2
2	0	2	0	0	46027	2
2	0	2	0	0	46028	2
2	0	2	0	0	46029	2
2	0	2	0	0	46030	2
2	0	2	0	0	46031	2
2	0	2	0	0	46032	2
2	0	2	0	0	46033	2
2	0	2	0	0	46034	2
2	0	2	0	0	46035	2
2	0	4	11	11	46036	2
2	0	2	0	0	46037	2
2	0	2	0	0	46038	2
2	0	4	0	0	46039	2
2	0	2	3	3	46040	2
2	0	2	0	0	46041	2
2	0	4	0	0	46042	2
2	0	2	0	0	46043	2
2	0	2	0	0	46044	2
2	0	4	0	0	46045	2
2	0	2	0	0	46046	2
2	0	4	105	105	46047	2
2	0	2	0	0	46048	2
2	0	2	0	0	46049	2
2	0	4	15	15	46050	2
2	0	2	9	9	46051	2
2	41	2	0	41	46052	0
2	0	2	117	117	46053	2
2	0	2	2	2	46054	2
2	0	2	0	0	46055	2
2	2	2	0	2	46056	1
2	0	2	51	51	46057	2
2	0	2	0	0	46058	2
2	0	2	0	0	46059	2
2	0	4	1	1	46060	2
2	0	2	0	0	46061	2
2	0	2	0	0	46062	2
2	0	2	0	0	46063	2
2	0	2	0	0	46064	2
2	0	2	0	0	46065	2
2	0	2	0	0	46066	2
2	0	2	0	0	46067	2
2	0	2	0	0	46068	2
2	0	2	0	0	46069	2
2	0	2	2	2	46070	2
2	0	2	0	0	46071	2
2	0	2	0	0	46072	2
2	0	2	0	0	46073	2
2	0	2	0	0	46074	2
2	6	2	0	6	46075	0
2	3	2	0	3	46076	0
2	0	2	3	3	46077	2
2	0	2	4	4	46078	2
2	4	2	0	4	46079	0
2	7	2	0	7	46080	0
2	17	2	93	110	46081	1
2	0	2	0	0	46082	2
2	0	2	0	0	46083	2
2	8	2	0	8	46084	1
2	0	2	21	21	46085	2
2	3	2	3	6	46086	0
2	0	2	34	34	46087	2
2	0	2	0	0	46088	2
2	0	2	0	0	46089	2
2	0	2	0	0	46090	2
2	0	2	0	0	46091	2
0	35	2	19	54	46092	0
0	32	2	0	32	46093	0
2	0	2	0	0	46094	2
2	0	2	0	0	46095	2
4	87	2	0	87	46096	0
4	3	2	0	3	46097	0
2	7	2	0	7	46098	0
2	0	2	0	0	46099	2
2	0	2	0	0	46100	2
2	0	2	0	0	46101	2
2	0	2	0	0	46102	2
2	0	2	0	0	46103	2
2	0	2	0	0	46104	2
2	0	2	0	0	46105	2
2	0	2	0	0	46106	2
2	0	2	0	0	46107	2
2	0	2	0	0	46108	2
2	0	2	0	0	46109	2
2	0	2	0	0	46110	2
2	5	2	292	297	46111	1
2	0	2	5	5	46112	2
2	0	2	1	1	46113	2
2	0	4	3	3	46114	2
2	0	2	0	0	46115	2
2	79	2	2	81	46116	0
2	0	2	0	0	46117	2
2	0	2	0	0	46118	2
2	0	2	0	0	46119	2
2	0	2	0	0	46120	2
4	0	2	0	0	46121	2
4	0	2	0	0	46122	2
2	0	2	0	0	46123	2
2	0	2	0	0	46124	2
2	56	4	3966	4022	46125	1
2	3	2	26	29	46126	1
2	0	2	13	13	46127	2
2	87	4	928	1015	46128	0
2	1	2	486	487	46129	1
4	0	4	0	0	46130	2
4	0	4	0	0	46131	2
2	0	2	0	0	46132	2
2	0	2	13	13	46133	2
2	0	2	0	0	46134	2
2	0	2	0	0	46135	2
2	0	2	0	0	46136	2
2	0	2	0	0	46137	2
4	0	4	12	12	46138	2
4	5	4	17	22	46139	0
4	0	4	0	0	46140	2
4	0	4	0	0	46141	2
2	0	2	0	0	46142	2
2	0	4	21	21	46143	2
2	0	2	0	0	46144	2
2	0	2	0	0	46145	2
2	0	4	2	2	46146	2
2	0	2	0	0	46147	2
2	0	4	6506	6506	46148	2
2	0	2	0	0	46149	2
2	0	2	0	0	46150	2
2	0	4	3140	3140	46151	2
4	6	2	1	7	46152	0
2	0	2	0	0	46153	2
2	0	4	0	0	46154	2
2	0	2	0	0	46155	2
2	0	2	0	0	46156	2
2	0	4	0	0	46157	2
2	0	2	2	2	46158	2
2	0	2	0	0	46159	2
2	0	2	0	0	46160	2
2	0	2	0	0	46161	2
2	0	2	0	0	46162	2
2	0	2	0	0	46163	2
2	0	2	0	0	46164	2
2	0	2	0	0	46165	2
2	0	2	0	0	46166	2
2	0	2	0	0	46167	2
2	0	2	0	0	46168	2
2	0	2	0	0	46169	2
2	0	2	0	0	46170	2
2	0	2	1	1	46171	2
2	0	2	4	4	46172	2
2	0	2	0	0	46173	2
2	0	4	27	27	46174	2
2	0	2	0	0	46175	2
2	0	2	0	0	46176	2
2	0	4	0	0	46177	2
2	0	2	0	0	46178	2
2	0	2	0	0	46179	2
2	0	2	0	0	46180	2
2	0	2	0	0	46181	2
2	0	2	0	0	46182	2
2	0	2	0	0	46183	2
2	0	2	0	0	46184	2
2	0	2	0	0	46185	2
2	0	2	0	0	46186	2
2	0	2	0	0	46187	2
2	0	2	0	0	46188	2
2	0	2	0	0	46189	2
2	0	4	0	0	46190	2
2	0	2	0	0	46191	2
2	0	2	0	0	46192	2
2	0	4	0	0	46193	2
2	0	2	0	0	46194	2
2	0	2	0	0	46195	2
2	0	2	653	653	46196	2
2	3	4	4	7	46197	1
2	9	4	9	18	46198	0
2	0	2	70	70	46199	2
2	0	2	0	0	46200	2
2	0	2	1	1	46201	2
2	0	2	0	0	46202	2
2	0	2	0	0	46203	2
2	0	2	0	0	46204	2
2	0	2	0	0	46205	2
2	0	2	0	0	46206	2
2	0	2	0	0	46207	2
2	0	2	0	0	46208	2
2	0	2	0	0	46209	2
2	0	2	0	0	46210	2
2	45	2	1	46	46211	0
2	6	2	470	476	46212	1
2	0	2	0	0	46213	2
2	0	2	3	3	46214	2
2	9	2	22	31	46215	1
2	0	2	340	340	46216	2
2	51	2	7485	7536	46217	0
2	19	2	0	19	46218	0
2	9	2	72	81	46219	1
2	0	2	0	0	46220	2
2	0	2	0	0	46221	2
2	3	2	0	3	46222	1
2	0	2	33	33	46223	2
2	166	2	4	170	46224	0
2	0	2	383	383	46225	2
4	633	2	74	707	46226	0
2	0	2	0	0	46227	2
2	0	2	7	7	46228	2
2	0	2	0	0	46229	2
2	0	2	0	0	46230	2
2	0	2	1	1	46231	2
2	0	2	16	16	46232	2
2	1	2	0	1	46233	0
2	8	2	14	22	46234	1
2	0	2	3	3	46235	2
2	0	2	0	0	46236	2
2	0	2	0	0	46237	2
2	0	2	12	12	46238	2
2	6	2	0	6	46239	0
2	0	2	114	114	46240	2
2	0	2	0	0	46241	2
2	0	2	0	0	46242	2
2	2	2	0	2	46243	0
2	0	2	13	13	46244	2
2	0	2	1	1	46245	2
2	0	2	0	0	46246	2
2	0	2	0	0	46247	2
2	0	2	0	0	46248	2
2	2	2	18	20	46249	1
2	0	2	0	0	46250	2
2	0	2	0	0	46251	2
2	0	2	0	0	46252	2
2	0	2	1	1	46253	2
2	0	2	0	0	46254	2
2	0	2	0	0	46255	2
2	0	2	0	0	46256	2
2	0	2	0	0	46257	2
2	0	2	1	1	46258	2
2	0	2	0	0	46259	2
2	0	2	0	0	46260	2
4	2	4	1	3	46261	0
4	0	4	0	0	46262	2
2	0	2	0	0	46263	2
2	0	2	0	0	46264	2
2	0	2	0	0	46265	2
2	0	2	0	0	46266	2
2	0	2	0	0	46267	2
2	0	2	0	0	46268	2
2	0	2	0	0	46269	2
2	0	2	0	0	46270	2
2	0	2	0	0	46271	2
2	0	2	0	0	46272	2
2	0	2	0	0	46273	2
2	0	2	0	0	46274	2
2	0	2	0	0	46275	2
2	0	2	0	0	46276	2
2	0	2	0	0	46277	2
2	0	2	0	0	46278	2
2	0	2	0	0	46279	2
2	0	2	0	0	46280	2
2	0	2	0	0	46281	2
2	0	2	0	0	46282	2
2	0	2	0	0	46283	2
2	0	2	0	0	46284	2
2	0	2	0	0	46285	2
2	0	2	0	0	46286	2
2	2	2	0	2	46287	0
2	0	2	40	40	46288	2
2	0	2	0	0	46289	2
2	0	2	0	0	46290	2
2	3	2	0	3	46291	1
2	0	2	15	15	46292	2
2	0	2	0	0	46293	2
2	0	2	0	0	46294	2
2	0	2	0	0	46295	2
2	0	2	0	0	46296	2
2	0	2	0	0	46297	2
2	0	2	0	0	46298	2
2	0	2	0	0	46299	2
2	0	2	0	0	46300	2
2	0	2	0	0	46301	2
2	0	2	0	0	46302	2
2	0	2	0	0	46303	2
2	0	2	0	0	46304	2
2	2	2	0	2	46305	0
2	0	2	0	0	46306	2
2	0	2	0	0	46307	2
2	0	2	0	0	46308	2
2	0	2	0	0	46309	2
2	0	2	0	0	46310	2
2	0	2	0	0	46311	2
2	0	2	0	0	46312	2
2	0	0	0	0	46313	2
2	0	2	0	0	46314	2
2	0	2	0	0	46315	2
2	0	0	1	1	46316	2
2	0	2	0	0	46317	2
2	123	2	1	124	46318	0
2	3	2	528	531	46319	1
2	0	2	12	12	46320	2
2	0	2	0	0	46321	2
2	13	2	0	13	46322	1
2	0	2	137	137	46323	2
2	0	2	0	0	46324	2
2	0	0	0	0	46325	2
2	0	2	0	0	46326	2
2	0	2	0	0	46327	2
2	0	0	0	0	46328	2
2	0	2	22	22	46329	2
2	0	2	0	0	46330	2
2	0	2	0	0	46331	2
2	0	2	0	0	46332	2
2	0	2	0	0	46333	2
2	0	2	0	0	46334	2
2	0	2	0	0	46335	2
2	2	2	0	2	46336	0
2	0	4	0	0	46337	2
2	0	2	0	0	46338	2
2	13	4	17	30	46339	1
2	0	2	0	0	46340	2
2	0	2	0	0	46341	2
0	0	4	180	180	46342	2
2	0	2	0	0	46343	2
2	0	2	1	1	46344	2
2	0	2	0	0	46345	2
2	0	2	0	0	46346	2
2	0	2	0	0	46347	2
2	0	2	0	0	46348	2
2	177	2	15504	15681	46349	0
2	544	2	2	546	46350	0
2	0	2	7525	7525	46351	2
2	0	2	0	0	46352	2
2	0	4	39	39	46353	2
2	0	2	0	0	46354	2
2	0	2	0	0	46355	2
2	0	4	38	38	46356	2
2	0	2	1	1	46357	2
2	0	2	0	0	46358	2
2	0	2	0	0	46359	2
2	0	2	0	0	46360	2
2	0	2	0	0	46361	2
2	0	2	0	0	46362	2
2	0	2	0	0	46363	2
2	0	2	0	0	46364	2
2	0	2	0	0	46365	2
2	0	2	0	0	46366	2
2	0	2	0	0	46367	2
2	1	2	2	3	46368	1
2	0	2	0	0	46369	2
2	0	2	0	0	46370	2
2	0	2	0	0	46371	2
2	0	2	1	1	46372	2
2	0	2	0	0	46373	2
2	0	2	0	0	46374	2
2	0	2	0	0	46375	2
2	0	2	0	0	46376	2
2	0	2	0	0	46377	2
2	0	2	0	0	46378	2
2	0	2	0	0	46379	2
2	0	2	0	0	46380	2
2	0	2	0	0	46381	2
2	0	2	0	0	46382	2
2	0	2	0	0	46383	2
2	0	2	0	0	46384	2
2	0	2	0	0	46385	2
2	0	2	0	0	46386	2
2	0	2	0	0	46387	2
2	0	2	0	0	46388	2
2	0	2	0	0	46389	2
2	0	2	0	0	46390	2
2	0	2	0	0	46391	2
2	0	2	0	0	46392	2
2	0	2	0	0	46393	2
2	0	2	0	0	46394	2
2	1	2	13	14	46395	1
2	0	2	0	0	46396	2
2	0	2	0	0	46397	2
2	1	2	0	1	46398	1
2	0	2	8	8	46399	2
2	9	2	0	9	46400	0
2	1	2	61	62	46401	1
2	0	2	1	1	46402	2
2	0	2	0	0	46403	2
2	1	2	1	2	46404	1
2	0	2	0	0	46405	2
2	0	2	0	0	46406	2
2	0	2	0	0	46407	2
2	0	2	0	0	46408	2
2	0	2	0	0	46409	2
2	0	2	0	0	46410	2
2	0	2	0	0	46411	2
2	0	2	0	0	46412	2
2	0	2	0	0	46413	2
4	18	4	7	25	46414	1
2	34	2	0	34	46415	0
2	0	2	18	18	46416	2
2	0	2	0	0	46417	2
2	3	2	1	4	46418	0
2	0	2	7	7	46419	2
2	0	2	6	6	46420	2
2	0	2	0	0	46421	2
2	3	2	0	3	46422	1
2	0	2	20	20	46423	2
2	0	2	0	0	46424	2
2	0	2	0	0	46425	2
2	0	2	0	0	46426	2
2	0	2	0	0	46427	2
2	0	2	0	0	46428	2
2	0	2	0	0	46429	2
2	23	2	1	24	46430	0
2	0	2	5	5	46431	2
2	0	2	0	0	46432	2
2	0	2	0	0	46433	2
2	0	2	207	207	46434	2
2	0	2	1	1	46435	2
2	0	2	0	0	46436	2
2	0	2	1	1	46437	2
2	0	2	5	5	46438	2
2	1	2	0	1	46439	0
2	1	2	0	1	46440	0
2	0	2	39	39	46441	2
2	0	2	0	0	46442	2
2	0	2	0	0	46443	2
2	0	2	0	0	46444	2
2	0	2	0	0	46445	2
2	0	4	12291	12291	46446	2
2	0	2	1	1	46447	2
2	0	2	0	0	46448	2
2	2	4	54565	54567	46449	1
2	0	2	2	2	46450	2
2	0	2	0	0	46451	2
2	0	2	0	0	46452	2
2	0	2	0	0	46453	2
2	0	2	0	0	46454	2
2	0	2	0	0	46455	2
2	0	2	0	0	46456	2
2	1	2	0	1	46457	0
2	0	2	1	1	46458	2
2	0	2	0	0	46459	2
0	0	0	922	922	46460	2
2	0	2	0	0	46461	2
2	0	2	0	0	46462	2
2	18	2	1	19	46463	0
2	0	2	0	0	46464	2
2	0	2	0	0	46465	2
2	23	2	0	23	46466	0
2	0	2	101	101	46467	2
2	4	2	0	4	46468	0
2	0	2	39	39	46469	2
2	0	2	0	0	46470	2
2	0	2	0	0	46471	2
2	2	2	0	2	46472	1
2	0	2	18	18	46473	2
2	3	2	0	3	46474	0
2	4	2	45	49	46475	1
2	0	2	0	0	46476	2
2	0	2	0	0	46477	2
2	3	2	0	3	46478	0
2	0	2	12	12	46479	2
2	0	2	0	0	46480	2
2	0	2	0	0	46481	2
2	0	2	0	0	46482	2
2	0	2	0	0	46483	2
2	0	2	0	0	46484	2
2	0	2	0	0	46485	2
2	0	2	0	0	46486	2
2	0	2	0	0	46487	2
2	0	2	2	2	46488	2
2	0	2	5	5	46489	2
2	0	2	0	0	46490	2
2	0	2	0	0	46491	2
2	0	2	0	0	46492	2
2	0	2	0	0	46493	2
2	0	2	0	0	46494	2
2	0	2	0	0	46495	2
2	0	2	0	0	46496	2
2	0	4	47	47	46497	2
2	0	2	0	0	46498	2
2	0	2	0	0	46499	2
2	1	4	4	5	46500	0
2	0	2	0	0	46501	2
4	3	2	0	3	46502	0
4	2	2	0	2	46503	1
2	0	2	0	0	46504	2
2	0	2	0	0	46505	2
2	0	4	16	16	46506	2
4	89	2	0	89	46507	0
2	18	2	1	19	46508	0
2	0	2	0	0	46509	2
2	0	2	0	0	46510	2
2	0	2	0	0	46511	2
2	0	2	0	0	46512	2
2	0	2	0	0	46513	2
2	0	2	0	0	46514	2
2	4	4	47	51	46515	0
2	0	4	12649	12649	46516	2
2	0	2	4	4	46517	2
2	0	2	0	0	46518	2
2	5	4	27	32	46519	0
2	0	2	18	18	46520	2
2	0	2	0	0	46521	2
2	0	2	0	0	46522	2
2	0	2	0	0	46523	2
2	0	2	0	0	46524	2
2	0	2	0	0	46525	2
2	0	2	0	0	46526	2
2	0	2	0	0	46527	2
2	1	2	0	1	46528	1
2	0	2	0	0	46529	2
2	0	2	9	9	46530	2
2	0	2	0	0	46531	2
2	0	2	0	0	46532	2
2	1	2	0	1	46533	1
2	0	2	0	0	46534	2
2	0	2	0	0	46535	2
2	0	2	1	1	46536	2
2	0	2	0	0	46537	2
2	0	2	0	0	46538	2
2	2	2	288	290	46539	1
2	0	2	0	0	46540	2
2	0	2	0	0	46541	2
2	3	2	60	63	46542	1
2	0	2	177	177	46543	2
2	0	2	0	0	46544	2
2	0	2	0	0	46545	2
2	0	2	0	0	46546	2
2	0	2	1	1	46547	2
2	0	2	0	0	46548	2
2	0	2	0	0	46549	2
2	0	2	0	0	46550	2
2	0	2	0	0	46551	2
2	0	2	0	0	46552	2
2	0	2	0	0	46553	2
2	0	2	0	0	46554	2
2	0	2	0	0	46555	2
2	2	2	0	2	46556	0
2	0	4	1	1	46557	2
2	0	2	0	0	46558	2
2	0	2	0	0	46559	2
2	0	2	0	0	46560	2
2	0	2	0	0	46561	2
2	0	2	0	0	46562	2
2	0	2	0	0	46563	2
2	0	4	8	8	46564	2
2	0	2	0	0	46565	2
2	0	2	0	0	46566	2
2	1	2	0	1	46567	1
2	0	2	0	0	46568	2
2	0	2	0	0	46569	2
0	3	2	0	3	46570	0
0	4	2	0	4	46571	0
2	0	2	1	1	46572	2
2	0	2	0	0	46573	2
2	0	2	0	0	46574	2
2	0	4	5	5	46575	2
2	0	2	0	0	46576	2
2	0	2	0	0	46577	2
2	0	2	0	0	46578	2
2	0	2	0	0	46579	2
2	0	2	0	0	46580	2
2	0	2	0	0	46581	2
2	0	2	0	0	46582	2
2	0	2	0	0	46583	2
2	0	2	0	0	46584	2
2	0	2	0	0	46585	2
2	0	2	0	0	46586	2
2	0	2	0	0	46587	2
2	0	2	0	0	46588	2
2	0	2	0	0	46589	2
2	0	2	0	0	46590	2
2	0	2	0	0	46591	2
2	0	2	0	0	46592	2
2	0	2	0	0	46593	2
2	0	2	0	0	46594	2
2	0	2	2	2	46595	2
2	0	2	36	36	46596	2
2	0	2	0	0	46597	2
2	0	2	0	0	46598	2
2	0	2	0	0	46599	2
2	0	2	9	9	46600	2
4	371	2	24	395	46601	1
2	0	2	0	0	46602	2
2	0	2	0	0	46603	2
2	0	2	0	0	46604	2
2	0	2	0	0	46605	2
2	0	2	0	0	46606	2
2	0	2	0	0	46607	2
2	0	2	0	0	46608	2
2	0	4	15	15	46609	2
2	0	2	0	0	46610	2
2	0	2	0	0	46611	2
2	0	4	33	33	46612	2
2	0	2	0	0	46613	2
2	0	2	0	0	46614	2
2	0	2	0	0	46615	2
2	0	2	0	0	46616	2
2	0	2	0	0	46617	2
2	0	2	0	0	46618	2
2	0	2	0	0	46619	2
2	0	2	0	0	46620	2
2	0	2	0	0	46621	2
2	0	2	0	0	46622	2
2	0	2	0	0	46623	2
2	0	2	0	0	46624	2
2	0	2	0	0	46625	2
2	6	2	0	6	46626	0
2	0	2	0	0	46627	2
2	0	4	0	0	46628	2
2	0	2	0	0	46629	2
2	0	2	0	0	46630	2
2	0	4	0	0	46631	2
2	0	2	0	0	46632	2
2	0	2	0	0	46633	2
2	0	4	0	0	46634	2
2	0	2	0	0	46635	2
2	0	2	0	0	46636	2
2	0	4	0	0	46637	2
2	0	2	0	0	46638	2
2	0	2	0	0	46639	2
2	0	2	0	0	46640	2
2	0	2	0	0	46641	2
2	0	2	0	0	46642	2
2	0	2	0	0	46643	2
2	0	2	0	0	46644	2
2	0	2	0	0	46645	2
2	0	2	0	0	46646	2
2	0	2	0	0	46647	2
2	0	2	2	2	46648	2
2	0	2	0	0	46649	2
2	0	2	0	0	46650	2
2	1	4	201	202	46651	1
2	0	2	1	1	46652	2
2	0	2	0	0	46653	2
2	0	2	0	0	46654	2
2	0	2	0	0	46655	2
2	0	2	0	0	46656	2
2	0	2	0	0	46657	2
2	0	2	0	0	46658	2
2	0	2	0	0	46659	2
2	0	2	0	0	46660	2
2	0	2	0	0	46661	2
2	0	2	0	0	46662	2
2	0	2	0	0	46663	2
2	0	2	0	0	46664	2
2	0	2	0	0	46665	2
0	0	2	0	0	46666	2
2	0	2	0	0	46667	2
2	0	2	0	0	46668	2
2	0	2	0	0	46669	2
2	0	2	0	0	46670	2
2	0	2	0	0	46671	2
2	0	2	0	0	46672	2
2	0	2	0	0	46673	2
2	0	2	0	0	46674	2
2	0	2	0	0	46675	2
2	0	2	0	0	46676	2
0	3	2	0	3	46677	0
0	2	2	0	2	46678	0
2	0	2	0	0	46679	2
2	0	2	0	0	46680	2
2	0	2	0	0	46681	2
2	0	2	1	1	46682	2
2	0	2	0	0	46683	2
2	0	2	0	0	46684	2
2	0	2	0	0	46685	2
2	0	2	0	0	46686	2
2	0	2	0	0	46687	2
2	0	2	0	0	46688	2
2	0	2	0	0	46689	2
2	0	2	0	0	46690	2
2	0	2	0	0	46691	2
2	0	2	0	0	46692	2
2	2	2	0	2	46693	0
2	0	2	0	0	46694	2
2	0	2	0	0	46695	2
2	0	2	0	0	46696	2
2	0	2	0	0	46697	2
2	0	2	0	0	46698	2
2	0	2	0	0	46699	2
2	0	4	2	2	46700	2
2	0	2	0	0	46701	2
2	0	2	1	1	46702	2
2	0	4	2	2	46703	2
2	0	2	2	2	46704	2
2	0	2	0	0	46705	2
2	0	4	3	3	46706	2
2	0	2	0	0	46707	2
2	0	2	0	0	46708	2
2	0	4	4	4	46709	2
2	0	2	0	0	46710	2
2	0	2	0	0	46711	2
2	0	2	0	0	46712	2
2	0	2	0	0	46713	2
2	0	2	0	0	46714	2
2	0	2	0	0	46715	2
2	0	2	0	0	46716	2
2	0	2	0	0	46717	2
2	9	4	1229	1238	46718	1
2	0	2	0	0	46719	2
2	0	2	0	0	46720	2
2	0	4	220	220	46721	2
2	0	2	4	4	46722	2
2	0	4	86	86	46723	2
2	0	2	1	1	46724	2
0	0	4	0	0	46725	2
2	0	2	0	0	46726	2
2	0	2	0	0	46727	2
2	0	2	0	0	46728	2
2	0	2	0	0	46729	2
2	0	2	0	0	46730	2
2	0	2	0	0	46731	2
2	14	2	2	16	46732	0
0	0	4	0	0	46733	2
2	47	4	514	561	46734	1
2	0	2	2	2	46735	2
2	0	2	9	9	46736	2
2	16	4	35	51	46737	0
2	0	2	9	9	46738	2
2	0	2	0	0	46739	2
2	0	2	0	0	46740	2
2	0	2	0	0	46741	2
2	0	2	0	0	46742	2
2	0	2	0	0	46743	2
2	0	2	0	0	46744	2
2	0	2	0	0	46745	2
2	0	2	0	0	46746	2
2	0	2	0	0	46747	2
2	0	2	0	0	46748	2
2	0	2	0	0	46749	2
2	0	2	0	0	46750	2
2	0	2	0	0	46751	2
2	0	4	0	0	46752	2
2	0	2	0	0	46753	2
2	0	2	0	0	46754	2
2	0	4	0	0	46755	2
2	0	2	0	0	46756	2
2	0	2	0	0	46757	2
2	0	2	1	1	46758	2
2	0	2	0	0	46759	2
2	0	2	0	0	46760	2
2	0	2	0	0	46761	2
2	0	2	0	0	46762	2
4	0	4	17	17	46763	2
2	0	2	0	0	46764	2
2	1	4	69	70	46765	1
2	0	2	0	0	46766	2
2	0	2	0	0	46767	2
2	0	2	0	0	46768	2
2	0	2	0	0	46769	2
2	0	2	0	0	46770	2
2	0	2	0	0	46771	2
2	0	2	0	0	46772	2
2	0	2	0	0	46773	2
2	0	2	0	0	46774	2
2	0	2	0	0	46775	2
2	0	2	0	0	46776	2
2	0	2	0	0	46777	2
2	0	2	0	0	46778	2
2	0	2	0	0	46779	2
2	0	2	0	0	46780	2
2	0	2	0	0	46781	2
2	0	2	0	0	46782	2
2	0	2	0	0	46783	2
2	0	2	0	0	46784	2
2	0	2	0	0	46785	2
2	0	2	0	0	46786	2
2	0	4	79	79	46787	2
2	0	2	0	0	46788	2
2	0	2	0	0	46789	2
2	0	4	42	42	46790	2
2	118	2	3	121	46791	0
4	1	2	1	2	46792	1
2	0	2	0	0	46793	2
2	0	2	0	0	46794	2
2	0	2	0	0	46795	2
2	0	2	0	0	46796	2
2	0	2	0	0	46797	2
2	0	2	0	0	46798	2
4	39	2	4	43	46799	0
2	2	4	147	149	46800	0
2	0	2	2	2	46801	2
2	0	2	0	0	46802	2
2	0	2	1	1	46803	2
2	0	2	0	0	46804	2
2	0	2	0	0	46805	2
2	0	2	1	1	46806	2
2	0	2	1	1	46807	2
2	0	2	0	0	46808	2
4	0	4	0	0	46809	2
4	0	4	0	0	46810	2
2	0	2	0	0	46811	2
2	0	2	0	0	46812	2
2	0	2	0	0	46813	2
2	0	2	0	0	46814	2
2	0	2	0	0	46815	2
2	0	2	0	0	46816	2
2	1	4	38	39	46817	1
2	0	2	0	0	46818	2
2	0	2	0	0	46819	2
4	1	2	3	4	46820	1
4	0	2	3	3	46821	2
2	0	4	86	86	46822	2
2	0	2	37	37	46823	2
2	0	2	0	0	46824	2
2	0	2	0	0	46825	2
2	0	2	4	4	46826	2
2	0	2	0	0	46827	2
2	0	2	0	0	46828	2
2	0	2	0	0	46829	2
2	0	2	5	5	46830	2
2	0	2	0	0	46831	2
2	0	2	0	0	46832	2
2	0	2	5	5	46833	2
2	0	2	0	0	46834	2
2	0	2	0	0	46835	2
2	0	2	0	0	46836	2
2	0	2	0	0	46837	2
2	0	2	0	0	46838	2
2	0	4	1	1	46839	2
2	0	2	1	1	46840	2
2	0	2	0	0	46841	2
2	0	2	0	0	46842	2
2	0	2	0	0	46843	2
2	0	2	0	0	46844	2
2	0	2	0	0	46845	2
2	0	2	0	0	46846	2
2	1	4	0	1	46847	1
2	0	2	3	3	46848	2
2	0	2	0	0	46849	2
2	0	2	0	0	46850	2
2	0	2	0	0	46851	2
2	0	2	0	0	46852	2
2	0	2	0	0	46853	2
2	0	2	0	0	46854	2
2	0	2	0	0	46855	2
2	0	2	0	0	46856	2
2	0	4	0	0	46857	2
2	0	2	0	0	46858	2
2	0	2	0	0	46859	2
2	0	4	0	0	46860	2
2	0	2	0	0	46861	2
2	0	4	8	8	46862	2
2	0	2	0	0	46863	2
2	0	2	0	0	46864	2
2	0	2	0	0	46865	2
2	0	2	0	0	46866	2
2	0	2	0	0	46867	2
2	0	2	0	0	46868	2
2	0	2	0	0	46869	2
2	0	2	0	0	46870	2
2	0	2	0	0	46871	2
2	0	2	0	0	46872	2
2	1	4	20	21	46873	1
2	0	2	0	0	46874	2
2	0	2	0	0	46875	2
2	1	4	2	3	46876	1
2	0	2	0	0	46877	2
4	0	2	1	1	46878	2
2	0	2	0	0	46879	2
2	0	2	0	0	46880	2
2	0	2	0	0	46881	2
2	0	2	0	0	46882	2
2	0	2	0	0	46883	2
2	0	2	0	0	46884	2
2	0	2	8	8	46885	2
2	0	2	0	0	46886	2
2	0	2	0	0	46887	2
2	0	2	0	0	46888	2
2	0	2	5	5	46889	2
2	0	2	0	0	46890	2
2	0	2	0	0	46891	2
2	0	2	10	10	46892	2
2	0	2	0	0	46893	2
2	0	2	0	0	46894	2
2	0	2	0	0	46895	2
2	0	2	0	0	46896	2
2	1	4	11	12	46897	0
2	0	2	0	0	46898	2
2	0	2	0	0	46899	2
2	0	4	10	10	46900	2
2	0	2	18	18	46901	2
2	0	2	0	0	46902	2
2	0	4	1202	1202	46903	2
2	0	2	0	0	46904	2
2	0	2	0	0	46905	2
2	0	4	606	606	46906	2
2	0	2	0	0	46907	2
2	0	2	0	0	46908	2
2	0	2	0	0	46909	2
2	1	2	0	1	46910	1
2	0	2	0	0	46911	2
2	0	2	0	0	46912	2
0	0	2	0	0	46913	2
0	0	2	0	0	46914	2
2	0	2	0	0	46915	2
2	0	2	0	0	46916	2
2	0	2	0	0	46917	2
2	0	2	0	0	46918	2
2	0	2	0	0	46919	2
2	0	2	0	0	46920	2
2	0	2	0	0	46921	2
2	0	2	0	0	46922	2
2	1	2	5	6	46923	0
2	1	4	292	293	46924	1
2	0	2	54	54	46925	2
2	0	4	468	468	46926	2
2	0	2	0	0	46927	2
2	0	2	0	0	46928	2
2	0	2	0	0	46929	2
2	4	2	10	14	46930	0
2	0	2	7	7	46931	2
2	1	2	0	1	46932	0
2	54	2	277	331	46933	1
2	0	2	1	1	46934	2
2	0	2	0	0	46935	2
2	0	2	0	0	46936	2
2	0	2	0	0	46937	2
2	6	2	0	6	46938	0
2	7	2	71	78	46939	1
2	0	2	1	1	46940	2
2	0	2	1	1	46941	2
2	1	2	3	4	46942	1
2	0	2	15	15	46943	2
2	3	2	0	3	46944	0
2	94	2	2	96	46945	0
2	0	2	449	449	46946	2
2	280	2	0	280	46947	0
2	22	2	4878	4900	46948	1
2	0	2	76	76	46949	2
2	0	2	0	0	46950	2
2	0	2	0	0	46951	2
2	0	2	0	0	46952	2
2	0	2	0	0	46953	2
2	0	2	0	0	46954	2
2	0	2	0	0	46955	2
2	0	2	0	0	46956	2
2	0	2	0	0	46957	2
2	0	2	0	0	46958	2
2	0	2	0	0	46959	2
2	0	2	0	0	46960	2
2	0	2	0	0	46961	2
2	0	2	0	0	46962	2
2	9	4	3957	3966	46963	0
2	0	2	0	0	46964	2
2	0	2	0	0	46965	2
2	5	4	5265	5270	46966	1
2	0	2	8	8	46967	2
4	1	2	6	7	46968	1
2	0	2	0	0	46969	2
2	0	4	87	87	46970	2
2	0	2	0	0	46971	2
2	0	2	0	0	46972	2
2	1	4	86	87	46973	1
2	0	2	1	1	46974	2
2	0	2	0	0	46975	2
2	0	2	0	0	46976	2
2	0	2	0	0	46977	2
2	0	2	1	1	46978	2
2	0	2	0	0	46979	2
2	0	4	1552	1552	46980	2
2	0	2	0	0	46981	2
2	0	2	0	0	46982	2
0	4	2	2	6	46983	0
0	13	2	0	13	46984	0
2	0	2	0	0	46985	2
2	0	2	0	0	46986	2
2	0	2	0	0	46987	2
2	0	2	0	0	46988	2
2	0	2	0	0	46989	2
2	0	2	0	0	46990	2
2	0	4	861	861	46991	2
2	0	2	3	3	46992	2
4	0	2	26	26	46993	2
2	0	2	0	0	46994	2
2	0	2	0	0	46995	2
2	0	2	0	0	46996	2
2	0	2	0	0	46997	2
2	0	2	0	0	46998	2
2	0	2	0	0	46999	2
4	0	2	4	4	47000	2
2	0	4	798	798	47001	2
2	0	2	0	0	47002	2
2	10	2	0	10	47003	0
2	2	4	1857	1859	47004	1
2	0	2	0	0	47005	2
2	0	2	0	0	47006	2
2	1	4	44	45	47007	0
2	0	2	34	34	47008	2
4	1	2	1	2	47009	0
2	0	2	0	0	47010	2
2	0	2	2	2	47011	2
2	0	2	0	0	47012	2
2	0	2	0	0	47013	2
2	0	2	0	0	47014	2
2	0	2	0	0	47015	2
2	0	2	1	1	47016	2
2	0	2	0	0	47017	2
2	2	2	0	2	47018	0
2	0	2	0	0	47019	2
2	0	2	0	0	47020	2
2	0	2	0	0	47021	2
2	0	2	0	0	47022	2
2	0	4	12	12	47023	2
2	0	2	0	0	47024	2
2	0	2	0	0	47025	2
2	0	4	7	7	47026	2
2	0	2	14	14	47027	2
2	0	2	0	0	47028	2
2	0	2	0	0	47029	2
2	0	2	0	0	47030	2
2	0	2	0	0	47031	2
2	0	2	0	0	47032	2
2	0	2	0	0	47033	2
2	0	2	20	20	47034	2
2	0	2	0	0	47035	2
2	0	4	2078	2078	47036	2
2	0	2	0	0	47037	2
2	0	2	0	0	47038	2
2	0	2	0	0	47039	2
2	0	2	0	0	47040	2
2	0	2	0	0	47041	2
2	0	2	0	0	47042	2
0	4	2	0	4	47043	0
0	1	2	0	1	47044	0
2	0	2	0	0	47045	2
2	0	2	0	0	47046	2
2	0	2	0	0	47047	2
2	0	2	0	0	47048	2
2	0	2	0	0	47049	2
2	0	2	1	1	47050	2
2	0	2	0	0	47051	2
2	0	2	0	0	47052	2
2	12	2	0	12	47053	0
2	7	4	6	13	47054	1
2	0	2	10	10	47055	2
2	0	4	64	64	47056	2
2	0	2	0	0	47057	2
2	0	2	0	0	47058	2
4	0	2	15	15	47059	2
2	0	2	0	0	47060	2
2	0	2	0	0	47061	2
2	0	2	0	0	47062	2
2	0	2	0	0	47063	2
2	0	2	0	0	47064	2
2	0	2	0	0	47065	2
4	0	4	0	0	47066	2
4	0	4	0	0	47067	2
2	0	2	0	0	47068	2
2	0	2	0	0	47069	2
2	0	2	0	0	47070	2
2	0	2	0	0	47071	2
2	0	2	0	0	47072	2
2	0	2	1	1	47073	2
2	0	2	0	0	47074	2
2	0	2	0	0	47075	2
2	0	2	0	0	47076	2
2	0	2	0	0	47077	2
2	0	2	0	0	47078	2
2	0	2	0	0	47079	2
2	0	2	0	0	47080	2
2	0	4	317	317	47081	2
2	0	2	0	0	47082	2
2	0	2	0	0	47083	2
2	0	4	319	319	47084	2
2	15	2	1	16	47085	0
0	1	2	0	1	47086	1
2	0	2	0	0	47087	2
2	0	2	0	0	47088	2
2	0	2	0	0	47089	2
2	0	2	0	0	47090	2
2	0	2	0	0	47091	2
2	0	2	0	0	47092	2
2	9	2	0	9	47093	0
2	0	2	0	0	47094	2
2	0	2	1	1	47095	2
2	0	2	0	0	47096	2
2	0	2	0	0	47097	2
0	4	2	0	4	47098	0
2	0	2	0	0	47099	2
2	0	2	0	0	47100	2
2	0	2	0	0	47101	2
2	0	2	0	0	47102	2
2	0	2	0	0	47103	2
2	0	2	0	0	47104	2
2	0	2	0	0	47105	2
2	0	2	0	0	47106	2
2	0	2	0	0	47107	2
2	0	2	0	0	47108	2
2	0	2	0	0	47109	2
2	0	2	0	0	47110	2
2	0	2	0	0	47111	2
2	0	2	0	0	47112	2
2	1	2	0	1	47113	0
2	0	2	2	2	47114	2
2	0	2	0	0	47115	2
2	0	2	0	0	47116	2
2	0	2	0	0	47117	2
2	0	2	0	0	47118	2
2	3	2	121	124	47119	1
2	0	2	4	4	47120	2
2	0	2	0	0	47121	2
2	0	2	20	20	47122	2
2	0	2	6	6	47123	2
0	0	2	31	31	47124	2
2	0	2	0	0	47125	2
2	0	2	0	0	47126	2
2	0	2	0	0	47127	2
2	0	2	8	8	47128	2
2	0	2	0	0	47129	2
2	0	2	0	0	47130	2
2	0	2	0	0	47131	2
2	0	2	0	0	47132	2
2	0	2	0	0	47133	2
2	0	2	0	0	47134	2
2	0	2	0	0	47135	2
2	0	2	0	0	47136	2
2	0	2	0	0	47137	2
2	0	2	0	0	47138	2
2	0	2	0	0	47139	2
2	0	2	0	0	47140	2
4	0	2	0	0	47141	2
0	0	4	0	0	47142	2
2	0	2	0	0	47143	2
2	0	2	0	0	47144	2
2	0	2	0	0	47145	2
2	0	2	0	0	47146	2
2	0	2	0	0	47147	2
2	0	2	0	0	47148	2
2	0	2	0	0	47149	2
2	0	2	0	0	47150	2
2	0	2	0	0	47151	2
2	0	2	0	0	47152	2
2	0	2	0	0	47153	2
2	0	2	0	0	47154	2
2	0	2	0	0	47155	2
2	0	2	0	0	47156	2
0	0	4	1557	1557	47157	2
0	71	0	1	72	47158	1
2	0	2	0	0	47159	2
2	0	2	0	0	47160	2
2	0	2	0	0	47161	2
2	0	2	0	0	47162	2
2	0	2	0	0	47163	2
2	0	2	0	0	47164	2
4	3	4	0	3	47165	1
4	3	4	0	3	47166	1
4	0	4	4	4	47167	2
4	0	4	0	0	47168	2
2	0	2	0	0	47169	2
2	1	2	0	1	47170	0
2	0	2	0	0	47171	2
2	0	2	0	0	47172	2
2	0	2	0	0	47173	2
2	0	2	0	0	47174	2
2	0	2	0	0	47175	2
2	0	2	0	0	47176	2
2	0	4	62	62	47177	2
2	0	2	0	0	47178	2
2	0	2	0	0	47179	2
2	0	4	9012	9012	47180	2
2	0	2	4	4	47181	2
0	0	4	2	2	47182	2
2	0	2	0	0	47183	2
2	0	2	0	0	47184	2
2	0	2	0	0	47185	2
2	0	2	0	0	47186	2
2	0	2	0	0	47187	2
2	0	2	0	0	47188	2
2	0	2	0	0	47189	2
2	0	2	0	0	47190	2
2	0	2	0	0	47191	2
2	0	2	0	0	47192	2
2	0	2	0	0	47193	2
2	0	2	0	0	47194	2
2	0	2	0	0	47195	2
2	0	2	0	0	47196	2
2	0	2	0	0	47197	2
2	0	2	0	0	47198	2
2	0	2	0	0	47199	2
2	0	2	0	0	47200	2
2	0	2	0	0	47201	2
2	1	2	0	1	47202	0
2	0	2	1	1	47203	2
2	0	2	0	0	47204	2
2	0	4	53	53	47205	2
2	0	2	0	0	47206	2
2	0	2	0	0	47207	2
4	1	2	3	4	47208	0
4	0	2	0	0	47209	2
2	4	4	4	8	47210	1
2	0	2	126	126	47211	2
2	0	2	0	0	47212	2
2	0	2	0	0	47213	2
2	0	2	0	0	47214	2
2	0	2	0	0	47215	2
2	0	2	0	0	47216	2
2	0	2	0	0	47217	2
2	0	2	0	0	47218	2
2	0	4	1867	1867	47219	2
2	0	2	0	0	47220	2
2	0	2	0	0	47221	2
2	0	4	699	699	47222	2
2	0	2	5	5	47223	2
2	1	2	0	1	47224	0
2	0	2	8	8	47225	2
2	0	2	0	0	47226	2
2	0	2	0	0	47227	2
2	0	2	0	0	47228	2
2	0	2	2	2	47229	2
2	0	2	0	0	47230	2
2	1	2	2	3	47231	1
2	0	2	0	0	47232	2
2	0	2	0	0	47233	2
2	0	2	0	0	47234	2
2	0	2	1	1	47235	2
2	0	2	0	0	47236	2
2	0	2	0	0	47237	2
2	0	2	0	0	47238	2
2	0	2	0	0	47239	2
2	0	2	0	0	47240	2
2	0	2	0	0	47241	2
2	0	2	0	0	47242	2
2	0	0	5	5	47243	2
2	0	2	0	0	47244	2
2	0	2	0	0	47245	2
2	0	0	5	5	47246	2
2	0	2	0	0	47247	2
4	0	4	0	0	47248	2
4	0	4	0	0	47249	2
2	0	2	0	0	47250	2
2	1	2	3	4	47251	1
2	0	2	0	0	47252	2
2	0	2	0	0	47253	2
2	0	2	0	0	47254	2
2	0	2	0	0	47255	2
2	0	2	0	0	47256	2
2	0	2	0	0	47257	2
2	0	2	0	0	47258	2
2	0	2	0	0	47259	2
2	0	2	0	0	47260	2
2	0	2	0	0	47261	2
2	0	2	0	0	47262	2
2	0	2	0	0	47263	2
2	0	2	4	4	47264	2
2	0	2	0	0	47265	2
2	0	2	0	0	47266	2
2	0	2	0	0	47267	2
2	0	2	4	4	47268	2
2	0	2	0	0	47269	2
2	0	2	0	0	47270	2
2	0	2	0	0	47271	2
2	0	2	0	0	47272	2
2	0	2	0	0	47273	2
2	0	2	0	0	47274	2
2	0	2	0	0	47275	2
2	0	2	0	0	47276	2
2	0	4	0	0	47277	2
2	0	2	0	0	47278	2
2	0	2	0	0	47279	2
2	0	4	0	0	47280	2
2	0	2	11	11	47281	2
2	0	4	62	62	47282	2
2	0	2	0	0	47283	2
2	0	2	0	0	47284	2
2	0	4	17	17	47285	2
2	6	2	0	6	47286	0
2	0	2	2	2	47287	2
4	0	2	0	0	47288	2
2	0	2	0	0	47289	2
2	0	4	79	79	47290	2
2	0	2	0	0	47291	2
2	0	2	0	0	47292	2
2	0	4	3	3	47293	2
2	0	2	0	0	47294	2
2	0	2	0	0	47295	2
2	0	2	0	0	47296	2
2	0	2	0	0	47297	2
2	0	2	0	0	47298	2
2	0	2	0	0	47299	2
2	0	2	0	0	47300	2
2	0	2	0	0	47301	2
2	0	2	0	0	47302	2
2	0	4	0	0	47303	2
2	0	2	0	0	47304	2
2	0	2	0	0	47305	2
2	0	4	0	0	47306	2
2	0	2	0	0	47307	2
2	0	2	3	3	47308	2
2	0	2	0	0	47309	2
2	0	2	0	0	47310	2
2	0	2	0	0	47311	2
2	0	2	1	1	47312	2
2	0	2	0	0	47313	2
0	8	4	86	94	47314	1
2	0	2	0	0	47315	2
2	0	2	7	7	47316	2
2	0	2	0	0	47317	2
2	0	2	0	0	47318	2
2	0	2	0	0	47319	2
2	0	2	0	0	47320	2
2	0	2	0	0	47321	2
2	0	2	0	0	47322	2
2	0	2	0	0	47323	2
2	0	2	0	0	47324	2
2	0	2	0	0	47325	2
2	0	2	0	0	47326	2
2	1	2	0	1	47327	1
2	0	2	4	4	47328	2
2	0	2	0	0	47329	2
2	0	2	0	0	47330	2
2	0	2	0	0	47331	2
2	0	2	0	0	47332	2
2	0	2	0	0	47333	2
2	0	2	0	0	47334	2
4	79	4	14	93	47335	1
4	58	4	11	69	47336	1
4	0	4	1	1	47337	2
2	0	2	0	0	47338	2
2	0	2	0	0	47339	2
2	2	4	113	115	47340	0
2	0	2	0	0	47341	2
2	0	2	0	0	47342	2
0	9	4	92	101	47343	0
2	0	2	0	0	47344	2
2	0	2	1	1	47345	2
2	0	2	0	0	47346	2
2	0	2	0	0	47347	2
2	0	2	0	0	47348	2
2	0	0	2	2	47349	2
2	0	2	0	0	47350	2
2	0	2	0	0	47351	2
2	0	0	6	6	47352	2
2	0	2	0	0	47353	2
4	0	2	0	0	47354	2
2	2	2	0	2	47355	0
2	1	2	19	20	47356	1
2	0	2	1	1	47357	2
2	0	2	0	0	47358	2
2	0	2	0	0	47359	2
2	0	2	3	3	47360	2
2	1	2	44	45	47361	0
2	0	2	0	0	47362	2
2	0	2	0	0	47363	2
2	0	2	0	0	47364	2
2	0	2	0	0	47365	2
2	0	2	0	0	47366	2
2	0	2	0	0	47367	2
2	0	2	0	0	47368	2
2	0	2	14	14	47369	2
2	0	2	0	0	47370	2
2	0	2	0	0	47371	2
2	1	2	2	3	47372	1
2	0	2	0	0	47373	2
2	0	2	0	0	47374	2
2	0	2	0	0	47375	2
2	0	2	0	0	47376	2
2	0	2	29	29	47377	2
2	0	2	0	0	47378	2
2	0	2	0	0	47379	2
2	0	2	9	9	47380	2
4	8	2	19	27	47381	0
2	0	2	0	0	47382	2
2	0	2	0	0	47383	2
2	19	2	8	27	47384	1
2	0	2	0	0	47385	2
2	0	2	0	0	47386	2
2	1	2	0	1	47387	1
2	0	2	1	1	47388	2
2	0	4	156	156	47389	2
2	0	2	0	0	47390	2
2	0	2	0	0	47391	2
2	0	4	4	4	47392	2
2	0	2	0	0	47393	2
2	0	2	0	0	47394	2
2	0	2	0	0	47395	2
2	0	2	0	0	47396	2
2	0	2	0	0	47397	2
2	0	2	0	0	47398	2
2	0	2	0	0	47399	2
2	0	2	0	0	47400	2
2	0	2	0	0	47401	2
2	0	2	0	0	47402	2
2	0	2	0	0	47403	2
2	0	2	0	0	47404	2
2	0	2	0	0	47405	2
2	0	2	0	0	47406	2
2	0	0	13	13	47407	2
2	0	2	0	0	47408	2
2	0	2	0	0	47409	2
0	234	4	6	240	47410	0
0	0	2	27	27	47411	2
2	0	2	0	0	47412	2
2	0	2	0	0	47413	2
2	0	2	0	0	47414	2
2	0	2	0	0	47415	2
2	0	2	0	0	47416	2
2	0	2	0	0	47417	2
2	0	2	0	0	47418	2
2	0	2	0	0	47419	2
2	0	2	0	0	47420	2
2	0	2	0	0	47421	2
2	0	2	0	0	47422	2
2	0	2	0	0	47423	2
2	0	2	0	0	47424	2
2	0	2	0	0	47425	2
2	0	2	0	0	47426	2
2	0	2	0	0	47427	2
2	0	2	0	0	47428	2
2	0	2	0	0	47429	2
2	0	2	0	0	47430	2
2	0	2	0	0	47431	2
2	0	2	0	0	47432	2
2	0	2	0	0	47433	2
2	0	2	0	0	47434	2
2	0	2	0	0	47435	2
2	0	0	2	2	47436	2
2	5	2	1	6	47437	0
2	0	2	0	0	47438	2
2	0	2	0	0	47439	2
2	0	2	0	0	47440	2
2	0	2	0	0	47441	2
2	0	2	0	0	47442	2
2	0	2	0	0	47443	2
0	0	4	2	2	47444	2
4	7	4	23	30	47445	1
2	1197	2	4	1201	47446	0
2	0	2	0	0	47447	2
2	0	2	0	0	47448	2
2	0	2	0	0	47449	2
2	0	2	0	0	47450	2
2	0	2	0	0	47451	2
2	0	2	0	0	47452	2
0	0	4	13	13	47453	2
2	334	4	12478	12812	47454	1
2	0	2	129	129	47455	2
2	1	2	12	13	47456	1
2	2	4	1093	1095	47457	0
2	185	4	2979	3164	47458	0
2	0	2	833	833	47459	2
4	4	2	1136	1140	47460	1
2	996	2	14	1010	47461	0
2	9	2	0	9	47462	0
2	11	2	80	91	47463	1
2	0	2	1	1	47464	2
2	0	2	0	0	47465	2
2	6	2	1	7	47466	0
2	0	2	12	12	47467	2
2	0	2	0	0	47468	2
2	0	2	0	0	47469	2
2	0	2	0	0	47470	2
2	0	2	0	0	47471	2
2	0	2	0	0	47472	2
2	0	2	0	0	47473	2
2	0	2	0	0	47474	2
2	0	0	6631	6631	47475	2
2	0	2	0	0	47476	2
2	0	2	0	0	47477	2
2	0	0	2312	2312	47478	2
2	0	2	0	0	47479	2
2	12	2	0	12	47480	0
2	5	2	63	68	47481	1
2	0	2	5	5	47482	2
2	0	2	0	0	47483	2
2	20	2	0	20	47484	0
2	0	2	85	85	47485	2
2	0	2	0	0	47486	2
2	1	2	0	1	47487	1
2	0	2	0	0	47488	2
2	0	2	0	0	47489	2
2	0	2	0	0	47490	2
2	0	2	0	0	47491	2
2	0	2	0	0	47492	2
2	0	2	0	0	47493	2
2	76	2	0	76	47494	0
2	4	2	182	186	47495	1
2	0	2	1	1	47496	2
2	0	2	0	0	47497	2
2	2	2	0	2	47498	1
2	0	2	82	82	47499	2
2	0	2	0	0	47500	2
2	0	4	7	7	47501	2
2	0	2	0	0	47502	2
2	0	2	0	0	47503	2
2	0	4	0	0	47504	2
2	0	2	0	0	47505	2
2	2	2	0	2	47506	0
2	1	2	0	1	47507	0
2	0	2	7	7	47508	2
2	1	2	7	8	47509	1
2	0	2	1	1	47510	2
2	0	2	0	0	47511	2
2	0	2	0	0	47512	2
2	0	2	5	5	47513	2
2	0	2	0	0	47514	2
2	0	2	0	0	47515	2
2	0	2	0	0	47516	2
2	0	2	0	0	47517	2
2	0	2	0	0	47518	2
2	0	2	0	0	47519	2
2	0	2	0	0	47520	2
2	0	2	0	0	47521	2
2	0	2	0	0	47522	2
2	0	2	0	0	47523	2
2	0	2	0	0	47524	2
2	0	2	0	0	47525	2
2	0	2	0	0	47526	2
2	0	2	0	0	47527	2
2	0	2	0	0	47528	2
2	0	4	5	5	47529	2
2	0	2	0	0	47530	2
2	0	2	0	0	47531	2
2	0	4	0	0	47532	2
2	0	2	0	0	47533	2
2	0	2	0	0	47534	2
2	0	2	0	0	47535	2
2	0	2	0	0	47536	2
2	0	2	3	3	47537	2
2	0	2	0	0	47538	2
2	0	2	0	0	47539	2
2	0	2	0	0	47540	2
2	0	2	0	0	47541	2
2	0	2	0	0	47542	2
2	0	2	0	0	47543	2
2	0	2	0	0	47544	2
2	0	2	0	0	47545	2
2	0	2	132	132	47546	2
2	0	2	0	0	47547	2
2	0	2	0	0	47548	2
2	0	2	0	0	47549	2
2	0	2	0	0	47550	2
2	0	2	0	0	47551	2
2	0	2	0	0	47552	2
2	0	2	0	0	47553	2
2	1	2	0	1	47554	0
2	17	2	133	150	47555	1
2	0	2	0	0	47556	2
2	0	2	0	0	47557	2
2	6	2	0	6	47558	0
2	0	2	2	2	47559	2
2	0	2	0	0	47560	2
2	0	2	0	0	47561	2
2	0	2	0	0	47562	2
2	0	2	0	0	47563	2
2	0	2	0	0	47564	2
2	0	2	0	0	47565	2
2	247	4	7023	7270	47566	1
2	3	2	346	349	47567	0
2	0	2	12	12	47568	2
2	402	4	187	589	47569	0
2	0	2	2525	2525	47570	2
2	0	2	0	0	47571	2
2	0	2	0	0	47572	2
2	0	2	0	0	47573	2
2	0	2	0	0	47574	2
2	0	2	0	0	47575	2
2	0	2	0	0	47576	2
2	0	2	0	0	47577	2
2	0	2	0	0	47578	2
2	0	2	0	0	47579	2
2	0	2	0	0	47580	2
2	0	2	0	0	47581	2
2	0	2	0	0	47582	2
2	35	2	0	35	47583	0
2	1	2	93	94	47584	1
2	0	2	4	4	47585	2
2	0	2	0	0	47586	2
2	3	2	11	14	47587	0
2	0	2	0	0	47588	2
2	0	2	0	0	47589	2
2	0	2	0	0	47590	2
2	0	2	0	0	47591	2
2	0	2	0	0	47592	2
2	0	2	0	0	47593	2
2	0	2	0	0	47594	2
2	0	2	0	0	47595	2
2	0	2	0	0	47596	2
2	0	2	0	0	47597	2
2	0	2	0	0	47598	2
2	0	2	0	0	47599	2
2	0	2	0	0	47600	2
2	0	2	0	0	47601	2
2	0	2	0	0	47602	2
2	0	2	0	0	47603	2
2	0	2	0	0	47604	2
2	0	2	0	0	47605	2
2	0	2	0	0	47606	2
0	0	4	0	0	47607	2
4	2697	2	93	2790	47608	0
4	1726	2	11	1737	47609	0
2	0	2	0	0	47610	2
2	0	4	1	1	47611	2
2	0	2	0	0	47612	2
2	0	2	0	0	47613	2
2	0	4	0	0	47614	2
2	0	2	0	0	47615	2
2	0	4	8	8	47616	2
2	0	2	0	0	47617	2
2	0	2	0	0	47618	2
2	0	4	2	2	47619	2
2	7	2	0	7	47620	0
2	28	2	505	533	47621	0
2	0	2	4	4	47622	2
2	0	2	1	1	47623	2
2	11	2	5	16	47624	0
2	0	2	71	71	47625	2
0	0	4	1	1	47626	2
2	0	2	0	0	47627	2
2	0	2	0	0	47628	2
2	0	2	0	0	47629	2
2	0	2	0	0	47630	2
2	0	2	0	0	47631	2
2	0	2	0	0	47632	2
2	0	2	0	0	47633	2
2	0	2	0	0	47634	2
2	0	2	2	2	47635	2
2	0	2	0	0	47636	2
2	0	2	0	0	47637	2
2	0	2	0	0	47638	2
2	0	2	0	0	47639	2
2	0	2	0	0	47640	2
2	0	2	0	0	47641	2
2	0	2	0	0	47642	2
2	0	2	0	0	47643	2
2	0	2	0	0	47644	2
2	0	2	0	0	47645	2
2	0	2	0	0	47646	2
2	0	2	1	1	47647	2
2	0	2	0	0	47648	2
2	0	2	0	0	47649	2
2	0	2	0	0	47650	2
2	0	2	0	0	47651	2
2	0	2	0	0	47652	2
2	0	2	0	0	47653	2
2	0	2	0	0	47654	2
2	0	2	0	0	47655	2
2	0	2	0	0	47656	2
2	0	2	0	0	47657	2
2	1	2	0	1	47658	0
2	0	2	1	1	47659	2
2	0	2	0	0	47660	2
2	0	2	16	16	47661	2
2	0	2	0	0	47662	2
2	0	2	0	0	47663	2
2	0	2	0	0	47664	2
2	0	2	0	0	47665	2
2	0	2	0	0	47666	2
2	0	2	0	0	47667	2
2	0	2	0	0	47668	2
2	0	2	0	0	47669	2
2	9	2	0	9	47670	0
2	0	2	0	0	47671	2
2	0	2	0	0	47672	2
2	0	2	0	0	47673	2
2	0	2	1	1	47674	2
2	0	2	0	0	47675	2
2	0	2	0	0	47676	2
2	0	2	0	0	47677	2
2	0	2	0	0	47678	2
2	0	2	0	0	47679	2
2	0	2	0	0	47680	2
2	0	2	0	0	47681	2
2	0	2	5	5	47682	2
2	0	2	0	0	47683	2
2	8	2	0	8	47684	0
2	8	2	37	45	47685	1
2	0	2	0	0	47686	2
2	0	2	0	0	47687	2
2	4	2	1	5	47688	0
2	0	2	14	14	47689	2
2	52	2	0	52	47690	0
2	1	2	2436	2437	47691	1
2	0	2	4	4	47692	2
2	0	2	0	0	47693	2
2	15	2	802	817	47694	1
2	0	2	49	49	47695	2
2	0	2	0	0	47696	2
2	1	2	0	1	47697	1
2	0	2	0	0	47698	2
2	0	2	0	0	47699	2
2	0	2	0	0	47700	2
2	0	2	0	0	47701	2
2	0	2	0	0	47702	2
2	0	2	0	0	47703	2
2	0	2	0	0	47704	2
2	0	2	0	0	47705	2
2	0	2	0	0	47706	2
2	0	2	0	0	47707	2
2	0	2	0	0	47708	2
2	0	2	0	0	47709	2
2	0	2	0	0	47710	2
2	0	2	0	0	47711	2
2	0	2	1	1	47712	2
2	0	2	0	0	47713	2
2	0	2	0	0	47714	2
2	0	2	0	0	47715	2
2	0	2	0	0	47716	2
2	0	2	0	0	47717	2
2	0	2	183	183	47718	2
2	0	2	0	0	47719	2
2	0	2	0	0	47720	2
2	1	2	0	1	47721	1
2	0	2	5	5	47722	2
4	19	2	16	35	47723	0
4	0	2	1	1	47724	2
2	0	2	0	0	47725	2
2	0	2	0	0	47726	2
2	0	2	0	0	47727	2
2	0	2	0	0	47728	2
2	0	2	1	1	47729	2
2	0	2	0	0	47730	2
2	0	2	0	0	47731	2
2	0	2	0	0	47732	2
2	0	2	0	0	47733	2
2	1	2	0	1	47734	0
2	0	2	9	9	47735	2
2	0	2	0	0	47736	2
2	0	2	0	0	47737	2
2	1	2	0	1	47738	1
2	0	2	1	1	47739	2
2	0	2	0	0	47740	2
2	17	2	60	77	47741	1
2	0	2	2	2	47742	2
2	0	2	0	0	47743	2
2	1	2	0	1	47744	0
2	0	2	4	4	47745	2
2	5	2	2	7	47746	0
2	0	2	13	13	47747	2
2	1	2	0	1	47748	0
2	0	2	7	7	47749	2
2	0	2	0	0	47750	2
2	0	2	0	0	47751	2
2	0	2	0	0	47752	2
2	0	2	1	1	47753	2
2	0	2	0	0	47754	2
2	0	2	0	0	47755	2
2	0	2	0	0	47756	2
2	0	2	0	0	47757	2
2	0	2	0	0	47758	2
2	0	2	0	0	47759	2
2	4	2	0	4	47760	0
2	2	2	165	167	47761	1
2	0	2	0	0	47762	2
2	0	2	0	0	47763	2
2	0	2	0	0	47764	2
2	0	2	236	236	47765	2
2	0	4	2	2	47766	2
2	0	2	0	0	47767	2
2	0	2	0	0	47768	2
2	0	2	0	0	47769	2
2	0	2	0	0	47770	2
2	0	2	1	1	47771	2
2	0	2	0	0	47772	2
2	0	2	0	0	47773	2
2	0	2	0	0	47774	2
2	0	2	0	0	47775	2
2	4	2	0	4	47776	0
2	0	2	0	0	47777	2
2	0	2	0	0	47778	2
2	0	2	0	0	47779	2
2	0	4	22	22	47780	2
2	0	2	0	0	47781	2
2	0	2	0	0	47782	2
2	0	4	5	5	47783	2
2	0	2	0	0	47784	2
2	0	2	0	0	47785	2
2	0	2	0	0	47786	2
2	0	2	0	0	47787	2
2	0	2	0	0	47788	2
2	0	2	0	0	47789	2
2	0	2	0	0	47790	2
2	0	2	0	0	47791	2
2	0	2	0	0	47792	2
2	0	2	0	0	47793	2
2	0	2	0	0	47794	2
2	0	2	0	0	47795	2
2	0	2	0	0	47796	2
2	21	2	0	21	47797	0
2	0	2	5	5	47798	2
2	0	2	9	9	47799	2
2	0	2	0	0	47800	2
2	0	2	19	19	47801	2
2	0	2	0	0	47802	2
2	0	2	0	0	47803	2
2	0	2	0	0	47804	2
2	0	2	3	3	47805	2
2	0	2	0	0	47806	2
2	0	2	8	8	47807	2
2	0	2	0	0	47808	2
2	0	2	0	0	47809	2
2	0	2	13	13	47810	2
2	0	2	0	0	47811	2
4	3	4	0	3	47812	0
4	3	4	0	3	47813	0
2	0	2	0	0	47814	2
2	1	2	0	1	47815	0
2	1	4	20	21	47816	1
2	0	2	0	0	47817	2
2	0	2	0	0	47818	2
2	0	4	3	3	47819	2
2	0	2	1	1	47820	2
2	131	2	3	134	47821	0
2	56	4	21306	21362	47822	1
2	3	2	36	39	47823	1
2	0	2	9	9	47824	2
2	57	4	11399	11456	47825	1
2	0	2	169	169	47826	2
2	4	2	2	6	47827	1
2	0	2	14	14	47828	2
2	3	2	79	82	47829	1
2	0	2	3	3	47830	2
2	0	2	0	0	47831	2
4	243	2	192	435	47832	0
4	144	2	4	148	47833	0
4	12	2	2447	2459	47834	0
2	0	2	0	0	47835	2
2	0	2	0	0	47836	2
2	0	2	1	1	47837	2
2	0	2	0	0	47838	2
2	0	2	1	1	47839	2
2	0	2	0	0	47840	2
2	0	2	0	0	47841	2
2	0	2	0	0	47842	2
2	0	2	0	0	47843	2
2	5	2	0	5	47844	0
2	0	2	2	2	47845	2
2	3	2	0	3	47846	0
2	0	2	36	36	47847	2
2	0	2	1	1	47848	2
2	0	2	0	0	47849	2
2	0	2	0	0	47850	2
2	0	2	3	3	47851	2
2	0	2	0	0	47852	2
2	0	2	0	0	47853	2
2	0	2	0	0	47854	2
2	0	2	0	0	47855	2
2	0	2	0	0	47856	2
2	0	2	0	0	47857	2
2	0	2	0	0	47858	2
2	0	2	0	0	47859	2
2	0	2	0	0	47860	2
2	0	2	0	0	47861	2
2	0	2	0	0	47862	2
2	5	2	0	5	47863	0
2	0	2	1	1	47864	2
2	0	2	0	0	47865	2
2	0	2	0	0	47866	2
2	0	2	0	0	47867	2
2	0	2	0	0	47868	2
2	0	2	1	1	47869	2
2	0	2	0	0	47870	2
2	0	2	0	0	47871	2
2	0	2	0	0	47872	2
2	0	2	0	0	47873	2
2	0	4	5901	5901	47874	2
2	0	2	0	0	47875	2
2	0	2	0	0	47876	2
2	0	4	42	42	47877	2
2	0	2	0	0	47878	2
2	0	2	0	0	47879	2
2	0	2	0	0	47880	2
2	0	2	0	0	47881	2
2	0	2	4	4	47882	2
2	0	2	1	1	47883	2
2	3	2	0	3	47884	0
2	0	4	8153	8153	47885	2
2	0	2	7	7	47886	2
2	0	2	0	0	47887	2
2	206	2	18913	19119	47888	1
2	427	2	1	428	47889	0
2	0	2	2054	2054	47890	2
2	0	2	0	0	47891	2
2	0	2	0	0	47892	2
2	0	2	0	0	47893	2
2	0	2	0	0	47894	2
2	0	2	0	0	47895	2
2	0	2	0	0	47896	2
2	0	2	0	0	47897	2
2	0	2	0	0	47898	2
2	0	2	0	0	47899	2
2	0	2	0	0	47900	2
2	0	2	0	0	47901	2
2	0	2	0	0	47902	2
2	0	2	0	0	47903	2
2	0	2	1	1	47904	2
2	0	2	0	0	47905	2
2	0	2	0	0	47906	2
2	0	2	0	0	47907	2
2	0	2	0	0	47908	2
2	14	2	0	14	47909	0
2	10	2	4204	4214	47910	1
2	0	2	13	13	47911	2
2	0	2	0	0	47912	2
2	34	2	51	85	47913	0
2	0	2	236	236	47914	2
2	0	2	0	0	47915	2
2	0	2	0	0	47916	2
2	0	2	0	0	47917	2
2	0	2	0	0	47918	2
2	0	2	0	0	47919	2
2	0	2	0	0	47920	2
2	0	2	0	0	47921	2
2	0	2	0	0	47922	2
2	0	2	0	0	47923	2
2	0	2	0	0	47924	2
2	0	2	0	0	47925	2
2	0	2	0	0	47926	2
2	107	2	0	107	47927	0
2	85	2	843	928	47928	1
2	0	2	44	44	47929	2
2	0	2	2	2	47930	2
2	80	2	9	89	47931	0
2	0	2	277	277	47932	2
2	0	2	0	0	47933	2
2	0	2	1	1	47934	2
2	0	2	0	0	47935	2
2	0	2	0	0	47936	2
2	0	2	0	0	47937	2
2	0	2	0	0	47938	2
2	0	2	0	0	47939	2
2	0	2	0	0	47940	2
2	0	2	0	0	47941	2
2	0	2	0	0	47942	2
2	0	2	0	0	47943	2
2	0	2	0	0	47944	2
2	0	2	0	0	47945	2
2	0	2	5	5	47946	2
2	0	2	0	0	47947	2
2	0	2	0	0	47948	2
2	0	2	0	0	47949	2
2	0	2	0	0	47950	2
2	0	2	0	0	47951	2
2	0	2	1	1	47952	2
2	0	2	0	0	47953	2
2	0	2	0	0	47954	2
2	0	2	0	0	47955	2
2	0	2	0	0	47956	2
2	0	2	0	0	47957	2
2	0	2	0	0	47958	2
2	0	2	0	0	47959	2
2	0	2	0	0	47960	2
2	0	2	0	0	47961	2
2	0	2	0	0	47962	2
0	0	2	0	0	47963	2
0	0	2	0	0	47964	2
0	0	2	0	0	47965	2
2	0	2	0	0	47966	2
2	0	2	0	0	47967	2
2	0	2	0	0	47968	2
2	0	2	0	0	47969	2
2	0	2	10	10	47970	2
2	0	2	0	0	47971	2
2	1	2	0	1	47972	0
2	2	2	39	41	47973	1
2	0	2	0	0	47974	2
2	0	2	0	0	47975	2
2	0	2	0	0	47976	2
2	0	2	3	3	47977	2
2	4	2	0	4	47978	0
2	0	2	3	3	47979	2
2	0	2	0	0	47980	2
2	0	2	0	0	47981	2
2	0	2	18	18	47982	2
2	0	2	126	126	47983	2
2	3	2	0	3	47984	0
2	5	2	46	51	47985	1
2	0	2	10	10	47986	2
2	0	2	0	0	47987	2
2	0	2	0	0	47988	2
2	0	2	0	0	47989	2
2	1948	2	4	1952	47990	0
2	293	2	6400	6693	47991	1
2	2	2	529	531	47992	1
2	1	2	3	4	47993	1
2	559	2	17	576	47994	0
2	0	2	1668	1668	47995	2
2	31	2	0	31	47996	0
2	6	2	278	284	47997	1
2	0	2	8	8	47998	2
2	0	2	0	0	47999	2
2	11	2	1	12	48000	0
2	0	2	73	73	48001	2
2	41	2	0	41	48002	0
2	56	4	18	74	48003	1
2	0	2	0	0	48004	2
2	0	2	0	0	48005	2
2	8	4	10	18	48006	0
2	0	2	0	0	48007	2
2	0	2	0	0	48008	2
2	0	2	0	0	48009	2
2	0	2	0	0	48010	2
2	0	2	0	0	48011	2
2	0	2	0	0	48012	2
2	0	2	0	0	48013	2
2	0	2	0	0	48014	2
2	0	2	0	0	48015	2
2	0	2	0	0	48016	2
2	0	2	0	0	48017	2
2	37	2	0	37	48018	0
2	23	2	176	199	48019	1
2	0	2	21	21	48020	2
2	0	2	0	0	48021	2
2	13	2	6	19	48022	1
2	0	2	118	118	48023	2
2	0	2	0	0	48024	2
2	2	2	0	2	48025	0
2	0	2	5	5	48026	2
2	0	2	1	1	48027	2
2	0	2	0	0	48028	2
0	4999	2	11	5010	48029	0
0	2841	2	1	2842	48030	0
2	1	2	0	1	48031	1
2	0	2	5	5	48032	2
2	0	2	327	327	48033	2
2	0	2	0	0	48034	2
2	0	2	0	0	48035	2
2	0	2	0	0	48036	2
2	0	2	3	3	48037	2
2	0	2	0	0	48038	2
2	0	2	4	4	48039	2
2	0	2	0	0	48040	2
2	0	2	0	0	48041	2
2	0	2	0	0	48042	2
2	0	2	0	0	48043	2
2	273	2	2	275	48044	0
2	0	2	0	0	48045	2
2	0	2	4	4	48046	2
2	0	2	0	0	48047	2
2	0	2	0	0	48048	2
2	0	2	0	0	48049	2
2	0	2	0	0	48050	2
2	7	4	1048	1055	48051	1
2	0	2	89	89	48052	2
2	0	2	0	0	48053	2
2	113	0	8	121	48054	1
2	0	2	672	672	48055	2
2	2	2	0	2	48056	0
2	2	2	0	2	48057	0
2	0	2	0	0	48058	2
2	0	2	0	0	48059	2
2	1	2	1	2	48060	0
4	8195	2	46	8241	48061	0
4	37	2	0	37	48062	0
2	5	2	671	676	48063	1
2	24	2	0	24	48064	0
2	0	2	257	257	48065	2
2	0	2	0	0	48066	2
2	0	2	0	0	48067	2
2	0	2	0	0	48068	2
2	0	2	0	0	48069	2
2	0	2	0	0	48070	2
2	0	2	0	0	48071	2
2	0	2	0	0	48072	2
2	0	2	0	0	48073	2
2	0	2	0	0	48074	2
2	0	2	0	0	48075	2
2	0	2	0	0	48076	2
2	0	2	0	0	48077	2
2	0	2	0	0	48078	2
2	0	2	0	0	48079	2
2	0	2	0	0	48080	2
2	0	2	0	0	48081	2
2	0	2	79	79	48082	2
2	0	2	0	0	48083	2
2	0	2	0	0	48084	2
2	0	2	17	17	48085	2
2	0	2	0	0	48086	2
2	0	2	0	0	48087	2
2	0	4	1	1	48088	2
2	0	2	0	0	48089	2
2	0	2	0	0	48090	2
2	0	4	0	0	48091	2
2	0	2	0	0	48092	2
0	30	2	6	36	48093	1
0	9	2	3	12	48094	1
2	0	2	0	0	48095	2
2	0	2	0	0	48096	2
2	0	2	0	0	48097	2
2	0	2	0	0	48098	2
2	0	2	0	0	48099	2
2	1	2	0	1	48100	0
2	0	2	34	34	48101	2
2	26	2	0	26	48102	0
2	0	2	210	210	48103	2
2	0	2	0	0	48104	2
2	0	2	0	0	48105	2
2	0	2	0	0	48106	2
2	0	2	0	0	48107	2
2	0	2	0	0	48108	2
2	0	2	1	1	48109	2
2	16	2	0	16	48110	0
2	0	2	0	0	48111	2
2	0	2	1563	1563	48112	2
2	0	2	9	9	48113	2
2	3	2	0	3	48114	0
2	0	2	26	26	48115	2
2	1	2	0	1	48116	0
2	0	2	143	143	48117	2
2	0	2	0	0	48118	2
2	0	2	0	0	48119	2
2	0	2	0	0	48120	2
2	0	2	0	0	48121	2
2	0	2	0	0	48122	2
2	13	2	111	124	48123	1
2	0	2	2	2	48124	2
2	0	2	111	111	48125	2
2	0	2	2	2	48126	2
2	1	2	4061	4062	48127	1
2	0	4	8	8	48128	2
2	0	2	0	0	48129	2
2	0	2	0	0	48130	2
2	1	4	1	2	48131	0
2	0	2	1	1	48132	2
4	1	2	1	2	48133	1
2	3	2	0	3	48134	0
2	0	2	0	0	48135	2
2	0	2	0	0	48136	2
2	0	2	0	0	48137	2
2	0	2	0	0	48138	2
2	0	2	0	0	48139	2
2	0	2	0	0	48140	2
2	0	2	0	0	48141	2
2	0	2	0	0	48142	2
2	0	2	0	0	48143	2
2	0	2	0	0	48144	2
2	0	2	0	0	48145	2
2	0	2	0	0	48146	2
2	0	2	0	0	48147	2
2	0	2	0	0	48148	2
2	0	2	0	0	48149	2
2	0	2	0	0	48150	2
2	0	2	0	0	48151	2
2	0	2	0	0	48152	2
2	0	2	0	0	48153	2
2	0	2	0	0	48154	2
2	0	2	0	0	48155	2
2	0	2	0	0	48156	2
2	0	2	0	0	48157	2
2	0	2	0	0	48158	2
2	0	2	0	0	48159	2
2	0	2	0	0	48160	2
2	0	2	0	0	48161	2
2	0	2	0	0	48162	2
2	0	2	0	0	48163	2
2	0	2	0	0	48164	2
2	0	4	816	816	48165	2
2	0	2	0	0	48166	2
2	0	2	0	0	48167	2
0	1967	2	13	1980	48168	0
0	552	2	3	555	48169	0
2	0	0	797	797	48170	2
2	0	2	3	3	48171	2
2	0	2	0	0	48172	2
2	0	2	42	42	48173	2
2	0	2	0	0	48174	2
2	0	2	0	0	48175	2
2	0	2	1	1	48176	2
2	0	2	0	0	48177	2
2	2	2	0	2	48178	0
2	1	2	33	34	48179	1
2	0	2	1	1	48180	2
2	0	2	0	0	48181	2
2	5	2	0	5	48182	1
2	0	2	10	10	48183	2
2	0	2	0	0	48184	2
0	7	0	3	10	48185	1
2	0	2	9	9	48186	2
2	0	2	0	0	48187	2
2	0	2	0	0	48188	2
2	0	2	0	0	48189	2
2	0	2	0	0	48190	2
2	0	2	0	0	48191	2
2	0	2	0	0	48192	2
2	0	2	0	0	48193	2
2	0	2	0	0	48194	2
2	0	2	0	0	48195	2
2	0	2	0	0	48196	2
2	33	2	0	33	48197	0
2	2	2	0	2	48198	0
2	1	2	16	17	48199	1
2	0	2	0	0	48200	2
2	0	2	0	0	48201	2
2	0	2	0	0	48202	2
2	0	2	4	4	48203	2
2	2	2	0	2	48204	0
2	0	2	32	32	48205	2
2	0	2	0	0	48206	2
2	0	2	0	0	48207	2
2	0	2	0	0	48208	2
2	0	2	0	0	48209	2
2	3	2	193	196	48210	1
2	0	2	6	6	48211	2
2	0	2	1	1	48212	2
2	11	2	1	12	48213	0
2	0	2	35	35	48214	2
2	0	2	0	0	48215	2
2	0	2	0	0	48216	2
2	0	2	0	0	48217	2
2	0	2	0	0	48218	2
2	0	2	0	0	48219	2
2	0	2	0	0	48220	2
2	270	2	0	270	48221	0
2	0	2	190	190	48222	2
2	0	2	1	1	48223	2
2	36	2	0	36	48224	0
2	0	2	241	241	48225	2
2	0	2	0	0	48226	2
2	0	2	1	1	48227	2
2	1	2	4	5	48228	1
2	0	2	39	39	48229	2
4	260	2	16	276	48230	0
2	5	2	1	6	48231	0
2	114	4	281	395	48232	1
2	0	2	6	6	48233	2
2	0	2	0	0	48234	2
2	15	4	59	74	48235	0
2	0	2	40	40	48236	2
2	0	2	0	0	48237	2
2	0	2	0	0	48238	2
2	0	2	0	0	48239	2
2	0	2	0	0	48240	2
2	0	2	0	0	48241	2
2	0	2	0	0	48242	2
2	0	2	0	0	48243	2
2	0	2	1	1	48244	2
2	0	2	0	0	48245	2
2	0	2	0	0	48246	2
2	0	2	0	0	48247	2
2	0	2	0	0	48248	2
2	86	2	0	86	48249	0
2	8	4	252	260	48250	1
2	0	2	103	103	48251	2
2	0	2	0	0	48252	2
2	13	4	0	13	48253	0
2	0	2	143	143	48254	2
2	0	2	0	0	48255	2
2	0	2	0	0	48256	2
2	0	2	0	0	48257	2
2	1	2	5	6	48258	1
2	0	2	0	0	48259	2
2	0	2	0	0	48260	2
2	0	2	9	9	48261	2
2	0	2	0	0	48262	2
2	0	2	0	0	48263	2
2	0	2	29	29	48264	2
2	0	2	0	0	48265	2
2	0	2	0	0	48266	2
2	0	2	6	6	48267	2
2	0	2	0	0	48268	2
2	0	2	0	0	48269	2
2	0	2	0	0	48270	2
2	0	2	0	0	48271	2
2	0	2	0	0	48272	2
2	0	2	0	0	48273	2
2	3	2	1	4	48274	1
2	0	2	0	0	48275	2
2	0	2	0	0	48276	2
2	0	2	0	0	48277	2
2	0	2	0	0	48278	2
2	8	4	37	45	48279	1
2	0	2	0	0	48280	2
2	0	2	0	0	48281	2
2	0	4	2	2	48282	2
2	0	2	7	7	48283	2
4	0	2	17	17	48284	2
2	0	2	0	0	48285	2
2	0	2	0	0	48286	2
2	1	2	7	8	48287	1
2	0	2	0	0	48288	2
2	0	2	0	0	48289	2
2	0	2	0	0	48290	2
2	0	2	2	2	48291	2
2	0	4	323	323	48292	2
2	0	2	0	0	48293	2
2	0	2	0	0	48294	2
2	0	4	156	156	48295	2
2	0	2	0	0	48296	2
2	0	2	0	0	48297	2
2	0	2	1	1	48298	2
2	0	2	0	0	48299	2
2	0	2	0	0	48300	2
2	1	2	0	1	48301	1
2	0	2	0	0	48302	2
2	4	2	0	4	48303	0
2	7	4	38481	38488	48304	1
2	0	2	2	2	48305	2
2	0	2	0	0	48306	2
2	2	4	18161	18163	48307	0
2	0	2	12	12	48308	2
2	26	2	0	26	48309	0
2	13	2	161	174	48310	1
2	0	2	24	24	48311	2
2	0	2	0	0	48312	2
2	7	2	3	10	48313	0
2	0	2	131	131	48314	2
2	28	0	7	35	48315	1
2	77	2	2	79	48316	0
2	0	2	17	17	48317	2
2	0	2	0	0	48318	2
2	7	2	0	7	48319	0
2	10	2	270	280	48320	1
2	0	2	4	4	48321	2
2	0	2	0	0	48322	2
2	6	2	14467	14473	48323	0
2	0	2	17	17	48324	2
2	0	2	0	0	48325	2
2	0	2	0	0	48326	2
2	0	2	0	0	48327	2
2	0	2	0	0	48328	2
2	0	2	0	0	48329	2
2	0	2	0	0	48330	2
2	1	2	0	1	48331	0
2	1	2	22	23	48332	1
2	0	2	0	0	48333	2
2	0	2	0	0	48334	2
2	0	2	0	0	48335	2
2	0	2	4	4	48336	2
2	0	2	0	0	48337	2
2	0	2	0	0	48338	2
2	0	2	1	1	48339	2
2	1	2	0	1	48340	1
2	0	2	0	0	48341	2
2	0	2	0	0	48342	2
2	52	2	0	52	48343	0
2	14	2	0	14	48344	0
2	0	2	96	96	48345	2
2	3	2	96	99	48346	1
2	0	2	6	6	48347	2
2	0	2	0	0	48348	2
0	0	2	0	0	48349	2
0	1	2	22	23	48350	0
0	0	2	0	0	48351	2
2	3	2	1693	1696	48352	0
2	27	2	1	28	48353	0
2	1	4	56	57	48354	1
2	0	2	0	0	48355	2
2	0	2	3	3	48356	2
2	0	2	0	0	48357	2
2	0	2	0	0	48358	2
2	0	2	0	0	48359	2
2	9	2	0	9	48360	0
2	1	2	59	60	48361	1
2	0	2	2	2	48362	2
2	0	2	0	0	48363	2
2	7	2	1	8	48364	0
2	0	2	21	21	48365	2
2	36	2	0	36	48366	0
2	0	2	493	493	48367	2
2	4	2	9360	9364	48368	1
2	8	2	0	8	48369	0
2	13	2	1	14	48370	0
2	0	2	28	28	48371	2
2	34	2	24	58	48372	1
2	0	2	1	1	48373	2
2	0	2	0	0	48374	2
0	7	2	3	10	48375	0
0	3	2	0	3	48376	0
2	0	2	0	0	48377	2
2	0	2	0	0	48378	2
2	0	2	0	0	48379	2
2	0	2	0	0	48380	2
2	0	2	0	0	48381	2
2	0	2	0	0	48382	2
2	0	2	0	0	48383	2
2	0	2	0	0	48384	2
2	6	2	28	34	48385	1
2	0	2	1	1	48386	2
2	0	2	0	0	48387	2
2	0	2	0	0	48388	2
2	0	2	0	0	48389	2
2	113	2	0	113	48390	0
2	29	2	423	452	48391	1
2	0	2	33	33	48392	2
2	0	2	0	0	48393	2
2	86	2	3	89	48394	0
2	0	2	0	0	48395	2
2	0	0	0	0	48396	2
2	0	2	0	0	48397	2
2	0	2	0	0	48398	2
2	0	0	0	0	48399	2
2	0	2	0	0	48400	2
0	182	2	3	185	48401	0
0	0	2	28	28	48402	2
0	0	2	0	0	48403	2
4	37	2	423	460	48404	0
4	4	2	3	7	48405	0
2	13	2	0	13	48406	0
2	12	2	0	12	48407	0
2	0	2	34	34	48408	2
2	8	2	129	137	48409	1
2	0	2	0	0	48410	2
2	0	2	0	0	48411	2
2	0	2	0	0	48412	2
2	0	2	1	1	48413	2
2	0	2	0	0	48414	2
2	0	2	0	0	48415	2
2	0	2	0	0	48416	2
2	0	2	0	0	48417	2
2	0	2	0	0	48418	2
2	0	2	0	0	48419	2
2	0	2	0	0	48420	2
2	0	2	0	0	48421	2
2	0	2	0	0	48422	2
2	0	2	0	0	48423	2
2	85	2	0	85	48424	0
2	10	2	31	41	48425	1
2	0	2	3	3	48426	2
2	0	2	0	0	48427	2
2	8	2	1	9	48428	0
2	0	2	0	0	48429	2
2	1	2	0	1	48430	0
2	0	4	38	38	48431	2
2	0	2	0	0	48432	2
2	0	2	0	0	48433	2
2	0	4	17	17	48434	2
2	0	2	2	2	48435	2
2	732	2	1	733	48436	0
2	69	2	5234	5303	48437	1
2	1	2	42	43	48438	1
2	0	2	5	5	48439	2
2	121	2	7	128	48440	1
2	0	2	690	690	48441	2
2	354	2	1	355	48442	0
2	202	2	8514	8716	48443	1
2	0	2	146	146	48444	2
2	0	2	1	1	48445	2
2	102	2	22	124	48446	0
2	0	2	613	613	48447	2
2	3	2	0	3	48448	0
2	2	2	232	234	48449	1
2	0	2	0	0	48450	2
2	0	2	0	0	48451	2
2	0	2	0	0	48452	2
2	0	2	20	20	48453	2
2	1	2	0	1	48454	0
2	1	2	6	7	48455	1
2	0	2	0	0	48456	2
2	0	2	0	0	48457	2
2	0	2	0	0	48458	2
2	0	2	0	0	48459	2
4	1	0	14104	14105	48460	1
0	116	2	31	147	48461	0
0	83	2	1	84	48462	0
2	0	2	0	0	48463	2
2	0	2	0	0	48464	2
2	0	2	0	0	48465	2
2	0	2	1	1	48466	2
2	0	2	0	0	48467	2
2	0	2	0	0	48468	2
2	12	2	0	12	48469	0
2	17	2	0	17	48470	0
2	0	2	36	36	48471	2
2	1	2	34	35	48472	1
2	0	2	2	2	48473	2
2	0	2	0	0	48474	2
2	0	2	3	3	48475	2
2	0	2	0	0	48476	2
2	0	2	1	1	48477	2
2	0	2	0	0	48478	2
2	0	2	5	5	48479	2
2	0	2	32	32	48480	2
2	0	2	0	0	48481	2
2	0	2	0	0	48482	2
2	0	2	0	0	48483	2
2	0	2	0	0	48484	2
2	0	2	0	0	48485	2
2	0	2	0	0	48486	2
2	0	2	0	0	48487	2
2	0	2	0	0	48488	2
2	0	2	0	0	48489	2
2	0	2	0	0	48490	2
2	0	2	57	57	48491	2
2	0	2	0	0	48492	2
2	21	2	0	21	48493	0
2	21	2	82	103	48494	1
2	0	2	0	0	48495	2
2	0	2	0	0	48496	2
2	23	2	0	23	48497	1
2	0	2	91	91	48498	2
2	143	2	0	143	48499	0
2	0	2	62	62	48500	2
2	0	2	0	0	48501	2
2	0	2	0	0	48502	2
2	1	2	0	1	48503	1
2	0	2	0	0	48504	2
2	0	2	0	0	48505	2
2	0	2	0	0	48506	2
2	0	2	0	0	48507	2
2	0	2	0	0	48508	2
2	0	2	0	0	48509	2
2	1	2	0	1	48510	0
2	0	2	2	2	48511	2
2	0	2	0	0	48512	2
2	0	2	0	0	48513	2
2	1	2	0	1	48514	0
2	0	2	0	0	48515	2
2	5	2	0	5	48516	0
2	33	2	47	80	48517	1
2	0	2	0	0	48518	2
2	0	2	0	0	48519	2
2	2	2	0	2	48520	1
2	0	2	5	5	48521	2
2	208	2	0	208	48522	0
2	0	2	49	49	48523	2
2	0	2	3	3	48524	2
2	4	2	0	4	48525	0
2	23	4	1604	1627	48526	1
2	0	2	3	3	48527	2
2	0	2	0	0	48528	2
2	9	4	1706	1715	48529	1
2	0	2	28	28	48530	2
2	0	2	0	0	48531	2
2	0	2	0	0	48532	2
2	0	2	0	0	48533	2
2	0	2	0	0	48534	2
2	0	2	0	0	48535	2
2	0	2	0	0	48536	2
2	0	2	0	0	48537	2
2	0	2	0	0	48538	2
2	0	2	0	0	48539	2
2	0	2	0	0	48540	2
2	0	2	0	0	48541	2
2	0	2	0	0	48542	2
2	0	2	0	0	48543	2
2	0	2	0	0	48544	2
2	0	2	0	0	48545	2
2	0	2	0	0	48546	2
2	0	2	0	0	48547	2
2	0	2	0	0	48548	2
2	57	2	0	57	48549	0
2	0	2	0	0	48550	2
2	0	2	0	0	48551	2
2	0	2	0	0	48552	2
2	0	2	1	1	48553	2
2	9	2	0	9	48554	0
2	0	2	90	90	48555	2
0	2	4	1	3	48556	1
0	4	4	0	4	48557	0
2	382	2	1	383	48558	0
2	205	2	1588	1793	48559	1
2	0	2	12	12	48560	2
2	0	2	3	3	48561	2
2	46	2	2	48	48562	1
2	0	2	143	143	48563	2
2	66	4	9391	9457	48564	1
2	0	2	21	21	48565	2
2	0	2	1	1	48566	2
2	1980	2	11	1991	48567	0
2	0	2	146	146	48568	2
2	27	4	8465	8492	48569	1
2	0	2	80	80	48570	2
2	0	2	0	0	48571	2
2	0	2	0	0	48572	2
0	1525	2	2	1527	48573	0
0	16391	2	505	16896	48574	0
0	8443	2	5	8448	48575	0
4	10	2	60	70	48576	0
4	5	2	2	7	48577	0
0	5	0	191	196	48578	1
0	2	0	2	4	48579	1
0	9	2	5	14	48580	0
0	2	2	0	2	48581	0
4	754	2	34	788	48582	0
4	69	2	0	69	48583	0
0	154	2	0	154	48584	0
4	1	4	2	3	48585	0
4	0	4	0	0	48586	2
4	2	4	24	26	48587	1
2	0	2	0	0	48588	2
2	0	2	0	0	48589	2
2	0	2	0	0	48590	2
2	0	2	0	0	48591	2
2	0	2	0	0	48592	2
2	0	2	0	0	48593	2
2	0	2	0	0	48594	2
2	1	2	0	1	48595	1
2	0	2	0	0	48596	2
2	0	2	0	0	48597	2
2	0	2	1	1	48598	2
2	0	2	0	0	48599	2
2	0	2	0	0	48600	2
2	0	2	0	0	48601	2
2	0	2	0	0	48602	2
2	0	2	0	0	48603	2
2	0	2	0	0	48604	2
2	0	2	0	0	48605	2
2	0	2	0	0	48606	2
2	0	2	0	0	48607	2
2	0	2	0	0	48608	2
2	0	2	0	0	48609	2
2	0	2	0	0	48610	2
2	0	2	0	0	48611	2
2	329	2	4	333	48612	0
2	0	2	0	0	48613	2
2	0	2	5	5	48614	2
2	0	2	0	0	48615	2
2	0	2	0	0	48616	2
0	199	2	2	201	48617	0
0	160	2	2	162	48618	0
2	0	2	0	0	48619	2
2	0	2	2	2	48620	2
2	814	2	1154	1968	48621	1
2	0	2	52	52	48622	2
2	0	2	1	1	48623	2
2	0	2	0	0	48624	2
2	0	2	0	0	48625	2
2	0	2	0	0	48626	2
2	0	2	0	0	48627	2
2	0	2	0	0	48628	2
2	0	2	0	0	48629	2
2	138	2	14	152	48630	0
2	0	2	225	225	48631	2
2	0	2	0	0	48632	2
2	0	2	0	0	48633	2
2	0	2	0	0	48634	2
2	0	2	0	0	48635	2
2	0	2	0	0	48636	2
2	0	2	0	0	48637	2
2	0	2	0	0	48638	2
2	0	2	0	0	48639	2
2	0	2	0	0	48640	2
2	0	2	0	0	48641	2
2	0	2	0	0	48642	2
2	0	2	0	0	48643	2
2	0	2	0	0	48644	2
2	0	2	0	0	48645	2
2	0	2	0	0	48646	2
2	0	2	0	0	48647	2
2	0	2	0	0	48648	2
2	0	2	0	0	48649	2
2	0	4	76	76	48650	2
2	0	2	0	0	48651	2
2	0	2	0	0	48652	2
2	1	4	10	11	48653	0
2	0	2	5	5	48654	2
2	32	4	11	43	48655	1
2	0	2	127	127	48656	2
2	46	2	0	46	48657	0
2	23	4	702	725	48658	1
2	1	2	11	12	48659	1
2	0	2	4	4	48660	2
2	0	2	0	0	48661	2
2	0	2	0	0	48662	2
2	0	2	0	0	48663	2
2	0	2	0	0	48664	2
2	0	2	0	0	48665	2
2	0	2	0	0	48666	2
0	1	4	3	4	48667	0
2	0	2	0	0	48668	2
2	0	2	1	1	48669	2
2	0	2	0	0	48670	2
2	0	2	0	0	48671	2
2	0	2	0	0	48672	2
2	0	2	0	0	48673	2
2	0	2	0	0	48674	2
2	0	2	0	0	48675	2
2	0	2	0	0	48676	2
2	0	2	0	0	48677	2
2	0	2	0	0	48678	2
2	0	2	0	0	48679	2
2	0	2	0	0	48680	2
2	0	2	0	0	48681	2
2	0	2	0	0	48682	2
2	0	2	0	0	48683	2
2	0	2	0	0	48684	2
2	0	2	4	4	48685	2
2	0	2	0	0	48686	2
2	0	2	0	0	48687	2
2	0	2	0	0	48688	2
2	0	2	12	12	48689	2
2	0	2	0	0	48690	2
2	0	2	0	0	48691	2
2	1	2	0	1	48692	1
2	0	2	2	2	48693	2
2	13	2	0	13	48694	0
2	44	2	74	118	48695	1
2	0	2	0	0	48696	2
2	0	2	1	1	48697	2
2	1	2	0	1	48698	1
2	0	4	1499	1499	48699	2
2	0	2	0	0	48700	2
2	0	2	0	0	48701	2
2	0	4	443	443	48702	2
2	0	2	0	0	48703	2
2	1	2	1	2	48704	0
2	0	2	0	0	48705	2
2	0	2	0	0	48706	2
2	0	2	0	0	48707	2
2	0	2	0	0	48708	2
2	0	2	0	0	48709	2
2	0	2	0	0	48710	2
2	2	4	39	41	48711	1
2	0	2	1	1	48712	2
2	0	2	0	0	48713	2
2	0	4	67	67	48714	2
2	0	2	0	0	48715	2
4	15	2	2	17	48716	0
2	0	2	0	0	48717	2
2	0	2	0	0	48718	2
2	0	2	0	0	48719	2
2	0	2	0	0	48720	2
2	0	2	0	0	48721	2
2	0	2	0	0	48722	2
2	0	2	0	0	48723	2
2	0	2	0	0	48724	2
2	0	4	0	0	48725	2
2	0	2	0	0	48726	2
2	0	2	0	0	48727	2
2	0	4	0	0	48728	2
2	0	2	0	0	48729	2
2	0	2	0	0	48730	2
2	0	2	0	0	48731	2
2	0	2	0	0	48732	2
2	0	2	0	0	48733	2
2	0	2	0	0	48734	2
2	4	2	0	4	48735	0
2	1	4	100	101	48736	0
2	0	2	0	0	48737	2
2	2	4	236	238	48738	1
2	0	2	0	0	48739	2
2	0	2	0	0	48740	2
2	1	2	0	1	48741	0
2	2	2	12	14	48742	1
2	0	2	0	0	48743	2
2	0	2	0	0	48744	2
2	1	2	0	1	48745	0
2	0	2	1	1	48746	2
0	0	0	4	4	48747	2
4	2	0	118	120	48748	0
4	2	4	16	18	48749	0
2	0	2	0	0	48750	2
2	0	2	0	0	48751	2
2	0	2	0	0	48752	2
2	0	2	0	0	48753	2
2	0	2	0	0	48754	2
2	0	2	0	0	48755	2
7	282	2	10	292	48756	0
4	13733	2	18	13751	48757	0
4	4755	2	3	4758	48758	0
4	0	2	0	0	48759	2
4	0	4	301	301	48760	2
4	0	4	4	4	48761	2
4	1	2	3	4	48762	1
4	0	2	0	0	48763	2
4	40	4	12	52	48764	0
4	16	4	1	17	48765	0
4	0	4	7	7	48766	2
4	0	4	3	3	48767	2
4	12	2	16	28	48768	0
4	2	2	1	3	48769	1
4	632	2	121555	122187	48770	0
4	308	7	44005	44313	48771	0
4	159	2	0	159	48772	0
4	3	2	0	3	48773	1
4	0	2	0	0	48774	2
0	4	2	0	4	48775	1
0	0	2	2	2	48776	2
0	7	2	0	7	48777	0
4	2	4	0	2	48778	1
4	0	4	0	0	48779	2
4	0	2	0	0	48780	2
4	0	4	0	0	48781	2
4	0	4	0	0	48782	2
4	0	4	476	476	48783	2
0	7	2	39	46	48784	1
0	0	0	0	0	48785	2
0	0	0	1	1	48786	2
0	2	2	30	32	48787	1
4	0	0	9426	9426	48788	2
4	0	0	12153	12153	48789	2
4	5	2	0	5	48790	0
4	1	2	0	1	48791	0
0	0	4	0	0	48792	2
4	0	2	0	0	48793	2
4	811	2	42	853	48794	0
4	0	2	1	1	48795	2
4	75	2	0	75	48796	0
0	9	4	3	12	48797	0
4	9	4	329	338	48798	0
4	0	0	13	13	48799	2
4	0	0	2	2	48800	2
0	17303	2	335	17638	48801	0
0	18137	2	1154	19291	48802	1
0	7045	2	14	7059	48803	0
2	0	2	0	0	48804	2
2	0	2	0	0	48805	2
2	0	2	0	0	48806	2
2	0	2	0	0	48807	2
2	0	2	0	0	48808	2
2	0	2	0	0	48809	2
2	0	2	0	0	48810	2
2	0	2	0	0	48811	2
2	0	2	4	4	48812	2
2	0	2	0	0	48813	2
2	0	2	0	0	48814	2
2	0	2	0	0	48815	2
2	0	2	0	0	48816	2
4	0	4	0	0	48817	2
4	0	4	0	0	48818	2
4	0	4	0	0	48819	2
4	0	4	0	0	48820	2
2	2	2	0	2	48821	0
2	0	2	4	4	48822	2
2	0	2	0	0	48823	2
2	0	2	0	0	48824	2
2	1	2	0	1	48825	1
2	0	2	2	2	48826	2
2	1	4	113	114	48827	1
2	0	2	0	0	48828	2
2	0	2	0	0	48829	2
2	0	4	1052	1052	48830	2
2	0	2	8	8	48831	2
4	595	2	4	599	48832	0
4	50	2	0	50	48833	0
4	0	4	5	5	48834	2
2	12	2	0	12	48835	0
2	36	2	275	311	48836	1
2	0	2	1	1	48837	2
2	0	2	0	0	48838	2
2	7	2	0	7	48839	0
2	0	2	42	42	48840	2
2	4	2	0	4	48841	0
2	0	2	6	6	48842	2
2	0	2	0	0	48843	2
2	0	2	0	0	48844	2
2	1	2	1	2	48845	1
2	0	2	0	0	48846	2
2	0	2	0	0	48847	2
2	1	2	29	30	48848	1
2	0	2	2	2	48849	2
2	0	2	0	0	48850	2
2	1	2	1	2	48851	1
2	0	2	5	5	48852	2
2	0	2	0	0	48853	2
2	0	2	2	2	48854	2
2	0	2	0	0	48855	2
2	0	2	0	0	48856	2
2	0	2	0	0	48857	2
2	0	2	0	0	48858	2
0	1	3	29	30	48859	0
0	0	3	29	29	48860	2
2	0	2	0	0	48861	2
2	0	2	0	0	48862	2
2	0	2	0	0	48863	2
2	0	2	0	0	48864	2
2	0	2	0	0	48865	2
2	0	2	0	0	48866	2
0	0	4	0	0	48867	2
2	0	2	1	1	48868	2
2	0	2	0	0	48869	2
2	0	2	0	0	48870	2
2	0	2	0	0	48871	2
2	0	2	0	0	48872	2
2	0	2	0	0	48873	2
2	0	2	0	0	48874	2
2	0	2	0	0	48875	2
2	0	2	0	0	48876	2
2	0	2	0	0	48877	2
2	0	2	0	0	48878	2
2	0	2	0	0	48879	2
2	0	2	0	0	48880	2
2	0	2	0	0	48881	2
2	0	0	1	1	48882	2
2	0	2	0	0	48883	2
2	0	2	0	0	48884	2
2	0	0	1	1	48885	2
2	0	2	0	0	48886	2
0	1	2	0	1	48887	1
2	0	0	2485	2485	48888	2
2	0	2	0	0	48889	2
2	0	2	0	0	48890	2
2	0	0	286	286	48891	2
2	0	2	0	0	48892	2
4	0	2	11	11	48893	2
0	0	4	4	4	48894	2
0	0	3	22228	22228	48895	2
0	0	3	22228	22228	48896	2
2	972	2	5	977	48897	0
2	401	4	9537	9938	48898	1
2	1	2	149	150	48899	1
2	0	2	13	13	48900	2
2	422	4	117	539	48901	0
2	0	2	1983	1983	48902	2
2	0	2	0	0	48903	2
2	0	2	0	0	48904	2
2	0	2	0	0	48905	2
2	0	2	0	0	48906	2
2	0	2	0	0	48907	2
2	0	2	0	0	48908	2
2	0	2	0	0	48909	2
2	0	2	0	0	48910	2
2	0	2	0	0	48911	2
2	0	2	0	0	48912	2
2	0	2	0	0	48913	2
2	0	2	0	0	48914	2
2	7	2	0	7	48915	0
2	17	4	777	794	48916	1
2	0	2	1	1	48917	2
2	0	2	0	0	48918	2
2	4	4	1225	1229	48919	0
2	0	2	12	12	48920	2
0	5	4	1	6	48921	0
2	0	2	0	0	48922	2
2	0	2	0	0	48923	2
2	0	2	0	0	48924	2
2	0	2	3	3	48925	2
2	0	2	0	0	48926	2
2	0	2	0	0	48927	2
2	0	2	0	0	48928	2
2	0	2	0	0	48929	2
2	0	2	0	0	48930	2
2	0	2	0	0	48931	2
2	0	2	0	0	48932	2
2	0	2	0	0	48933	2
2	0	2	0	0	48934	2
2	0	2	0	0	48935	2
2	1	4	47	48	48936	1
2	0	2	0	0	48937	2
2	0	2	0	0	48938	2
2	0	4	39	39	48939	2
2	0	2	0	0	48940	2
2	0	4	2	2	48941	2
2	0	2	0	0	48942	2
2	0	2	0	0	48943	2
2	0	4	0	0	48944	2
2	0	2	0	0	48945	2
2	0	2	0	0	48946	2
2	0	2	0	0	48947	2
2	0	2	0	0	48948	2
2	0	2	0	0	48949	2
2	0	2	0	0	48950	2
2	0	2	0	0	48951	2
2	0	2	0	0	48952	2
2	0	4	69	69	48953	2
2	0	2	0	0	48954	2
2	0	2	0	0	48955	2
2	0	4	4	4	48956	2
2	0	2	0	0	48957	2
2	0	2	0	0	48958	2
2	0	2	0	0	48959	2
2	0	2	0	0	48960	2
2	0	2	0	0	48961	2
2	0	2	39	39	48962	2
2	0	2	0	0	48963	2
4	320	2	2	322	48964	0
4	3050	2	39	3089	48965	0
0	0	4	220	220	48966	2
2	0	2	0	0	48967	2
2	0	2	0	0	48968	2
2	0	2	0	0	48969	2
2	0	2	0	0	48970	2
2	0	2	0	0	48971	2
2	0	2	0	0	48972	2
2	0	2	0	0	48973	2
2	0	2	0	0	48974	2
2	0	2	0	0	48975	2
2	0	2	0	0	48976	2
2	0	2	0	0	48977	2
2	0	2	0	0	48978	2
2	0	2	0	0	48979	2
2	0	2	1	1	48980	2
2	0	2	0	0	48981	2
2	0	2	0	0	48982	2
2	0	2	0	0	48983	2
2	0	2	0	0	48984	2
2	0	2	0	0	48985	2
2	1	2	0	1	48986	0
2	0	2	2	2	48987	2
2	0	2	0	0	48988	2
2	0	2	0	0	48989	2
2	0	2	0	0	48990	2
2	0	2	1	1	48991	2
2	0	2	0	0	48992	2
2	0	2	0	0	48993	2
2	0	0	24	24	48994	2
0	62	3	3300	3362	48995	0
0	3	3	3300	3303	48996	0
2	0	2	0	0	48997	2
2	0	2	0	0	48998	2
2	0	2	0	0	48999	2
2	0	2	0	0	49000	2
2	0	2	0	0	49001	2
2	0	2	0	0	49002	2
2	0	2	0	0	49003	2
2	0	4	0	0	49004	2
2	0	2	0	0	49005	2
2	0	2	0	0	49006	2
2	0	4	0	0	49007	2
2	0	4	0	0	49008	2
4	0	4	5	5	49009	2
0	0	4	0	0	49010	2
2	0	2	0	0	49011	2
2	0	2	0	0	49012	2
2	0	2	0	0	49013	2
2	0	2	0	0	49014	2
2	0	2	0	0	49015	2
2	0	2	0	0	49016	2
4	1	4	76	77	49017	1
5	86338	1	2317413	2403751	49018	0
2	14	2	0	14	49019	0
2	0	2	0	0	49020	2
2	0	2	0	0	49021	2
2	0	2	0	0	49022	2
2	0	2	0	0	49023	2
2	0	2	0	0	49024	2
2	0	2	0	0	49025	2
2	14	2	404	418	49026	1
2	0	2	6	6	49027	2
2	0	2	0	0	49028	2
2	11	2	4	15	49029	0
2	0	2	89	89	49030	2
2	0	2	0	0	49031	2
2	0	2	0	0	49032	2
2	0	2	0	0	49033	2
2	0	2	0	0	49034	2
2	0	2	0	0	49035	2
2	0	2	0	0	49036	2
2	0	2	0	0	49037	2
2	0	2	10	10	49038	2
2	0	2	0	0	49039	2
2	0	2	0	0	49040	2
2	0	2	1	1	49041	2
2	0	2	0	0	49042	2
2	0	2	0	0	49043	2
2	0	2	0	0	49044	2
2	0	2	0	0	49045	2
2	0	2	0	0	49046	2
2	0	2	0	0	49047	2
2	0	2	0	0	49048	2
2	0	2	0	0	49049	2
2	0	2	0	0	49050	2
2	0	2	0	0	49051	2
2	0	2	0	0	49052	2
2	0	2	0	0	49053	2
2	0	2	8	8	49054	2
2	5	2	0	5	49055	0
2	1	2	21	22	49056	1
2	0	2	0	0	49057	2
2	0	2	0	0	49058	2
2	0	2	0	0	49059	2
2	0	2	19	19	49060	2
2	1	2	0	1	49061	0
2	0	2	0	0	49062	2
2	0	2	1	1	49063	2
2	0	2	0	0	49064	2
2	0	2	0	0	49065	2
2	0	2	2	2	49066	2
2	0	2	0	0	49067	2
2	1	2	0	1	49068	0
2	4	2	6	10	49069	1
2	0	2	0	0	49070	2
2	0	2	0	0	49071	2
2	0	2	0	0	49072	2
2	0	2	4	4	49073	2
2	19	2	0	19	49074	0
2	0	2	880	880	49075	2
2	0	2	0	0	49076	2
2	0	2	0	0	49077	2
2	0	2	0	0	49078	2
2	0	2	0	0	49079	2
2	0	2	0	0	49080	2
2	0	2	0	0	49081	2
2	0	2	0	0	49082	2
2	0	2	0	0	49083	2
2	0	2	0	0	49084	2
2	0	2	0	0	49085	2
2	0	2	0	0	49086	2
2	0	2	0	0	49087	2
2	0	2	0	0	49088	2
2	0	2	0	0	49089	2
2	0	2	0	0	49090	2
2	0	4	54	54	49091	2
2	0	2	0	0	49092	2
2	0	2	0	0	49093	2
2	0	4	30	30	49094	2
2	0	2	0	0	49095	2
2	0	2	0	0	49096	2
2	0	2	0	0	49097	2
2	0	2	0	0	49098	2
2	0	2	0	0	49099	2
2	0	2	0	0	49100	2
2	0	2	0	0	49101	2
2	0	2	0	0	49102	2
2	0	2	0	0	49103	2
2	0	2	0	0	49104	2
2	0	2	0	0	49105	2
2	0	2	0	0	49106	2
2	0	2	0	0	49107	2
2	0	2	0	0	49108	2
2	0	4	29	29	49109	2
2	0	2	0	0	49110	2
2	0	2	0	0	49111	2
2	0	4	0	0	49112	2
2	0	2	0	0	49113	2
2	1	2	0	1	49114	1
2	0	2	13	13	49115	2
2	0	2	9	9	49116	2
2	0	2	0	0	49117	2
2	0	2	0	0	49118	2
2	0	2	0	0	49119	2
2	0	2	1	1	49120	2
2	0	2	0	0	49121	2
2	0	2	0	0	49122	2
2	0	2	0	0	49123	2
2	0	2	0	0	49124	2
2	0	2	0	0	49125	2
2	0	2	0	0	49126	2
4	64	4	2	66	49127	0
4	1	4	34	35	49128	0
2	0	2	1	1	49129	2
2	0	2	0	0	49130	2
2	0	2	7	7	49131	2
2	0	2	3	3	49132	2
2	0	2	0	0	49133	2
2	22	2	153	175	49134	0
2	0	2	0	0	49135	2
2	0	2	0	0	49136	2
2	0	2	0	0	49137	2
2	0	2	0	0	49138	2
2	0	2	0	0	49139	2
2	0	2	0	0	49140	2
2	0	2	1	1	49141	2
2	0	2	0	0	49142	2
2	0	2	0	0	49143	2
2	0	4	0	0	49144	2
2	0	2	0	0	49145	2
2	0	4	0	0	49146	2
2	0	2	0	0	49147	2
2	0	2	0	0	49148	2
2	0	2	0	0	49149	2
2	0	2	1	1	49150	2
2	0	2	0	0	49151	2
2	0	2	0	0	49152	2
2	0	2	0	0	49153	2
2	0	2	3	3	49154	2
4	64	4	5	69	49155	0
2	0	2	0	0	49156	2
2	0	2	0	0	49157	2
2	0	2	0	0	49158	2
2	0	2	0	0	49159	2
2	0	2	1	1	49160	2
2	0	2	0	0	49161	2
2	0	2	0	0	49162	2
2	0	2	0	0	49163	2
2	0	4	0	0	49164	2
2	0	2	0	0	49165	2
2	0	2	0	0	49166	2
2	0	2	0	0	49167	2
2	0	2	0	0	49168	2
2	0	2	0	0	49169	2
2	0	2	0	0	49170	2
2	0	2	0	0	49171	2
2	0	2	0	0	49172	2
2	0	2	0	0	49173	2
2	0	2	0	0	49174	2
2	0	2	0	0	49175	2
2	0	2	0	0	49176	2
2	0	2	0	0	49177	2
2	0	2	0	0	49178	2
2	0	2	0	0	49179	2
2	0	2	0	0	49180	2
2	0	2	0	0	49181	2
2	0	2	14	14	49182	2
2	0	2	0	0	49183	2
2	0	2	0	0	49184	2
2	1	2	0	1	49185	0
2	0	2	0	0	49186	2
2	0	2	0	0	49187	2
2	0	2	0	0	49188	2
2	0	2	0	0	49189	2
2	0	2	0	0	49190	2
2	0	2	0	0	49191	2
2	0	2	0	0	49192	2
2	0	2	0	0	49193	2
2	0	2	0	0	49194	2
2	0	2	0	0	49195	2
2	0	2	0	0	49196	2
2	0	2	0	0	49197	2
2	0	2	0	0	49198	2
2	0	2	0	0	49199	2
2	0	2	0	0	49200	2
2	0	2	13	13	49201	2
2	0	2	0	0	49202	2
2	0	2	0	0	49203	2
2	0	2	0	0	49204	2
2	0	2	0	0	49205	2
2	0	2	0	0	49206	2
2	0	2	0	0	49207	2
2	0	2	0	0	49208	2
2	0	2	0	0	49209	2
2	0	2	0	0	49210	2
2	0	2	0	0	49211	2
2	0	2	0	0	49212	2
2	0	2	0	0	49213	2
2	0	2	0	0	49214	2
2	0	2	0	0	49215	2
2	0	2	0	0	49216	2
2	0	4	140	140	49217	2
2	0	2	0	0	49218	2
2	0	2	0	0	49219	2
4	0	2	1	1	49220	2
4	0	2	0	0	49221	2
2	0	2	0	0	49222	2
2	0	2	0	0	49223	2
2	0	4	10	10	49224	2
2	0	2	19	19	49225	2
0	0	4	273	273	49226	2
2	0	2	0	0	49227	2
2	0	2	0	0	49228	2
2	0	2	0	0	49229	2
2	0	2	0	0	49230	2
2	0	2	0	0	49231	2
2	0	2	0	0	49232	2
2	0	2	0	0	49233	2
2	0	2	0	0	49234	2
2	0	2	0	0	49235	2
2	0	2	0	0	49236	2
2	0	2	0	0	49237	2
2	0	2	0	0	49238	2
2	0	2	0	0	49239	2
2	0	2	3	3	49240	2
2	0	2	0	0	49241	2
2	0	2	0	0	49242	2
2	0	2	0	0	49243	2
2	0	2	0	0	49244	2
2	0	2	0	0	49245	2
2	0	4	59	59	49246	2
2	0	2	0	0	49247	2
2	0	2	0	0	49248	2
2	0	4	0	0	49249	2
2	0	2	18	18	49250	2
2	0	2	0	0	49251	2
2	0	2	0	0	49252	2
2	0	2	0	0	49253	2
2	0	2	22	22	49254	2
2	0	2	0	0	49255	2
2	0	2	0	0	49256	2
2	0	2	0	0	49257	2
2	0	2	0	0	49258	2
2	0	2	0	0	49259	2
2	0	2	2	2	49260	2
2	0	2	0	0	49261	2
2	0	2	0	0	49262	2
2	0	2	0	0	49263	2
2	0	4	209	209	49264	2
2	0	2	0	0	49265	2
2	0	2	0	0	49266	2
2	0	4	126	126	49267	2
2	0	2	0	0	49268	2
2	0	2	0	0	49269	2
2	3	2	20	23	49270	1
2	0	2	0	0	49271	2
2	0	2	0	0	49272	2
2	0	2	3	3	49273	2
2	0	2	6	6	49274	2
2	0	2	0	0	49275	2
2	0	2	0	0	49276	2
2	0	2	1	1	49277	2
2	0	2	0	0	49278	2
2	0	2	3	3	49279	2
2	0	2	0	0	49280	2
2	0	2	0	0	49281	2
2	0	2	0	0	49282	2
2	0	2	0	0	49283	2
2	0	2	0	0	49284	2
2	0	2	0	0	49285	2
2	0	2	0	0	49286	2
2	0	2	0	0	49287	2
2	0	2	0	0	49288	2
2	0	4	5	5	49289	2
2	0	2	0	0	49290	2
2	0	2	0	0	49291	2
2	0	4	0	0	49292	2
2	0	2	0	0	49293	2
2	0	2	0	0	49294	2
2	0	2	0	0	49295	2
2	0	2	0	0	49296	2
2	0	2	0	0	49297	2
2	0	2	0	0	49298	2
2	0	2	0	0	49299	2
2	0	2	0	0	49300	2
2	0	2	0	0	49301	2
2	0	2	0	0	49302	2
2	0	2	0	0	49303	2
2	0	2	0	0	49304	2
2	0	2	0	0	49305	2
2	0	2	0	0	49306	2
2	1	2	0	1	49307	0
2	0	2	4	4	49308	2
2	0	2	0	0	49309	2
2	0	2	0	0	49310	2
2	1	2	18	19	49311	1
2	0	2	13	13	49312	2
2	0	4	15	15	49313	2
2	0	2	0	0	49314	2
2	0	2	0	0	49315	2
4	22	2	15	37	49316	0
4	0	4	2	2	49317	2
4	0	2	15	15	49318	2
2	1	4	2	3	49319	0
2	0	2	0	0	49320	2
2	0	2	0	0	49321	2
2	0	2	0	0	49322	2
2	0	2	0	0	49323	2
2	0	2	0	0	49324	2
2	0	2	0	0	49325	2
2	0	2	0	0	49326	2
2	0	2	0	0	49327	2
2	0	2	0	0	49328	2
2	0	2	0	0	49329	2
2	0	2	0	0	49330	2
2	0	2	0	0	49331	2
2	0	2	0	0	49332	2
2	0	2	0	0	49333	2
2	0	2	2	2	49334	2
2	0	2	0	0	49335	2
2	0	2	0	0	49336	2
2	0	2	0	0	49337	2
2	0	2	0	0	49338	2
2	0	2	0	0	49339	2
2	0	2	0	0	49340	2
2	0	2	0	0	49341	2
2	0	2	0	0	49342	2
2	0	2	0	0	49343	2
2	0	2	0	0	49344	2
2	0	2	0	0	49345	2
2	0	2	0	0	49346	2
2	0	2	0	0	49347	2
2	0	2	0	0	49348	2
2	0	2	0	0	49349	2
2	0	2	0	0	49350	2
2	0	2	0	0	49351	2
2	0	2	0	0	49352	2
2	0	2	0	0	49353	2
2	0	2	0	0	49354	2
2	0	2	0	0	49355	2
2	0	2	0	0	49356	2
2	0	2	0	0	49357	2
2	0	2	0	0	49358	2
2	0	2	0	0	49359	2
2	0	4	1	1	49360	2
2	0	2	0	0	49361	2
2	0	2	0	0	49362	2
2	0	4	0	0	49363	2
2	0	2	0	0	49364	2
4	7	2	0	7	49365	0
2	0	4	9	9	49366	2
2	0	2	0	0	49367	2
2	0	2	0	0	49368	2
2	0	2	0	0	49369	2
2	0	2	7	7	49370	2
2	0	2	0	0	49371	2
2	0	2	0	0	49372	2
2	0	2	0	0	49373	2
2	0	2	1	1	49374	2
2	0	2	0	0	49375	2
2	0	4	4	4	49376	2
2	0	2	0	0	49377	2
2	0	2	0	0	49378	2
2	0	4	0	0	49379	2
2	0	2	0	0	49380	2
0	0	4	2	2	49381	2
2	0	2	0	0	49382	2
2	0	2	0	0	49383	2
2	0	2	0	0	49384	2
2	0	2	0	0	49385	2
2	0	2	0	0	49386	2
2	0	2	0	0	49387	2
2	0	4	6	6	49388	2
2	0	2	0	0	49389	2
2	0	2	0	0	49390	2
2	0	2	1	1	49391	2
2	0	2	0	0	49392	2
2	0	2	0	0	49393	2
2	0	2	0	0	49394	2
2	0	2	0	0	49395	2
2	0	2	0	0	49396	2
2	0	2	7	7	49397	2
2	0	2	0	0	49398	2
2	0	2	0	0	49399	2
2	0	2	0	0	49400	2
2	0	2	0	0	49401	2
2	1	2	1	2	49402	1
2	0	2	4	4	49403	2
2	0	2	0	0	49404	2
2	0	2	48	48	49405	2
2	0	2	2	2	49406	2
2	0	2	0	0	49407	2
2	0	2	0	0	49408	2
2	0	4	0	0	49409	2
2	0	2	0	0	49410	2
2	0	2	0	0	49411	2
2	0	4	0	0	49412	2
2	0	2	0	0	49413	2
2	0	0	150	150	49414	2
2	0	2	0	0	49415	2
2	0	2	0	0	49416	2
2	1	0	52	53	49417	1
2	0	2	1	1	49418	2
2	0	2	0	0	49419	2
2	0	2	0	0	49420	2
2	0	2	0	0	49421	2
2	0	2	0	0	49422	2
2	0	2	0	0	49423	2
2	0	2	0	0	49424	2
2	0	2	0	0	49425	2
2	65	2	0	65	49426	0
2	21	2	148	169	49427	1
2	0	2	9	9	49428	2
2	0	2	0	0	49429	2
2	55	2	0	55	49430	0
2	0	2	318	318	49431	2
2	0	2	0	0	49432	2
2	0	4	0	0	49433	2
2	0	2	0	0	49434	2
2	0	2	0	0	49435	2
2	0	4	0	0	49436	2
2	0	2	0	0	49437	2
2	0	2	0	0	49438	2
2	0	4	333	333	49439	2
2	0	2	0	0	49440	2
2	0	2	0	0	49441	2
2	1	4	340	341	49442	0
2	0	2	4	4	49443	2
2	0	2	0	0	49444	2
2	0	2	0	0	49445	2
2	0	2	0	0	49446	2
2	0	2	0	0	49447	2
2	0	2	0	0	49448	2
2	0	2	0	0	49449	2
2	0	2	0	0	49450	2
2	0	4	111	111	49451	2
2	0	2	0	0	49452	2
2	0	2	0	0	49453	2
2	0	4	65	65	49454	2
2	0	2	0	0	49455	2
2	0	4	237	237	49456	2
2	0	2	0	0	49457	2
2	0	2	0	0	49458	2
2	0	0	348	348	49459	2
2	0	2	66	66	49460	2
2	0	2	0	0	49461	2
2	0	2	0	0	49462	2
2	0	0	0	0	49463	2
2	0	2	0	0	49464	2
2	0	2	0	0	49465	2
2	0	0	0	0	49466	2
2	0	2	2	2	49467	2
2	0	2	4	4	49468	2
2	0	2	0	0	49469	2
2	0	2	0	0	49470	2
2	0	2	0	0	49471	2
2	0	2	0	0	49472	2
2	0	2	0	0	49473	2
2	0	2	0	0	49474	2
2	0	2	0	0	49475	2
2	0	2	0	0	49476	2
2	0	2	0	0	49477	2
2	0	2	0	0	49478	2
2	0	2	0	0	49479	2
2	0	2	0	0	49480	2
2	0	2	0	0	49481	2
2	0	2	0	0	49482	2
2	0	2	0	0	49483	2
2	0	2	0	0	49484	2
2	0	2	0	0	49485	2
2	0	2	0	0	49486	2
2	0	2	0	0	49487	2
2	0	2	0	0	49488	2
2	0	2	0	0	49489	2
2	0	2	0	0	49490	2
2	0	2	0	0	49491	2
2	0	2	0	0	49492	2
2	0	2	0	0	49493	2
2	0	2	0	0	49494	2
2	0	2	0	0	49495	2
2	0	2	0	0	49496	2
2	57	2	0	57	49497	0
2	12	2	263	275	49498	1
2	0	2	11	11	49499	2
2	0	2	0	0	49500	2
0	112	2	28	140	49501	0
0	71	2	0	71	49502	0
2	19	2	6	25	49503	1
2	0	2	90	90	49504	2
2	0	2	0	0	49505	2
2	0	2	0	0	49506	2
2	0	2	0	0	49507	2
2	0	2	0	0	49508	2
2	0	2	0	0	49509	2
2	0	2	0	0	49510	2
2	6	2	0	6	49511	0
2	3	0	115	118	49512	1
2	0	2	1	1	49513	2
2	0	2	0	0	49514	2
2	2	0	82	84	49515	1
2	0	2	10	10	49516	2
2	1	2	0	1	49517	0
2	0	2	1	1	49518	2
2	0	2	0	0	49519	2
2	0	2	0	0	49520	2
2	0	2	0	0	49521	2
2	0	2	0	0	49522	2
2	0	2	0	0	49523	2
2	0	2	0	0	49524	2
2	0	2	0	0	49525	2
2	0	2	0	0	49526	2
2	0	2	0	0	49527	2
2	0	2	0	0	49528	2
2	0	2	26	26	49529	2
2	1	2	0	1	49530	0
2	0	2	0	0	49531	2
2	0	2	0	0	49532	2
2	0	2	0	0	49533	2
2	0	2	0	0	49534	2
2	0	2	0	0	49535	2
2	0	2	0	0	49536	2
2	0	2	0	0	49537	2
2	0	2	0	0	49538	2
2	0	2	0	0	49539	2
2	0	2	0	0	49540	2
2	0	2	0	0	49541	2
2	0	2	0	0	49542	2
2	0	2	0	0	49543	2
2	16	2	0	16	49544	0
2	14	2	281	295	49545	1
2	0	2	6	6	49546	2
2	0	2	0	0	49547	2
2	10	2	0	10	49548	1
2	0	2	71	71	49549	2
2	0	2	0	0	49550	2
2	0	2	0	0	49551	2
2	0	2	0	0	49552	2
2	0	2	0	0	49553	2
2	0	2	0	0	49554	2
2	0	2	0	0	49555	2
2	3	2	0	3	49556	0
2	4	2	10	14	49557	1
2	0	2	1	1	49558	2
2	0	2	0	0	49559	2
2	3	2	0	3	49560	0
2	0	2	5	5	49561	2
2	0	2	0	0	49562	2
2	0	2	0	0	49563	2
2	0	2	0	0	49564	2
2	0	2	0	0	49565	2
2	0	2	0	0	49566	2
2	0	2	0	0	49567	2
2	0	2	0	0	49568	2
2	0	2	5	5	49569	2
2	0	2	0	0	49570	2
2	0	2	0	0	49571	2
2	0	2	0	0	49572	2
2	0	2	2	2	49573	2
2	0	2	0	0	49574	2
2	0	2	9	9	49575	2
2	0	2	0	0	49576	2
2	0	2	0	0	49577	2
2	0	2	0	0	49578	2
2	0	2	0	0	49579	2
2	0	2	0	0	49580	2
2	0	2	0	0	49581	2
2	0	2	0	0	49582	2
2	0	2	2	2	49583	2
2	0	2	0	0	49584	2
2	0	2	0	0	49585	2
2	0	2	0	0	49586	2
2	0	2	0	0	49587	2
2	0	2	0	0	49588	2
2	1	2	3	4	49589	1
2	0	2	0	0	49590	2
2	0	2	0	0	49591	2
2	0	2	0	0	49592	2
2	0	2	0	0	49593	2
2	580	2	3	583	49594	0
2	337	2	2436	2773	49595	1
2	1	2	106	107	49596	1
2	0	2	4	4	49597	2
2	246	2	7	253	49598	0
2	0	2	1118	1118	49599	2
2	0	2	0	0	49600	2
2	0	2	0	0	49601	2
2	0	2	0	0	49602	2
2	0	2	0	0	49603	2
2	0	2	0	0	49604	2
2	0	2	0	0	49605	2
2	8	2	0	8	49606	0
2	0	2	90	90	49607	2
2	0	2	0	0	49608	2
2	0	2	0	0	49609	2
2	0	2	0	0	49610	2
2	0	2	5	5	49611	2
2	0	2	0	0	49612	2
2	0	2	0	0	49613	2
2	0	2	0	0	49614	2
2	0	2	0	0	49615	2
2	3	2	0	3	49616	0
2	18	2	281	299	49617	1
2	0	2	0	0	49618	2
2	0	2	0	0	49619	2
2	2	2	0	2	49620	0
2	0	2	2	2	49621	2
2	0	2	0	0	49622	2
2	0	2	6	6	49623	2
2	0	2	1	1	49624	2
2	0	2	0	0	49625	2
2	0	2	0	0	49626	2
2	0	2	0	0	49627	2
2	0	2	0	0	49628	2
2	0	2	0	0	49629	2
2	0	2	0	0	49630	2
2	0	2	0	0	49631	2
2	0	2	0	0	49632	2
2	0	2	0	0	49633	2
2	0	2	4	4	49634	2
2	0	2	0	0	49635	2
2	0	2	0	0	49636	2
2	2	2	0	2	49637	0
2	0	2	1	1	49638	2
2	0	2	0	0	49639	2
2	0	4	0	0	49640	2
2	0	2	0	0	49641	2
2	0	2	0	0	49642	2
2	0	4	0	0	49643	2
2	0	2	0	0	49644	2
2	0	2	0	0	49645	2
2	0	2	0	0	49646	2
2	0	2	0	0	49647	2
2	0	2	0	0	49648	2
2	0	2	0	0	49649	2
2	0	2	0	0	49650	2
2	0	2	0	0	49651	2
2	0	2	0	0	49652	2
2	0	2	0	0	49653	2
2	0	2	0	0	49654	2
2	0	2	0	0	49655	2
2	0	2	0	0	49656	2
2	0	2	0	0	49657	2
2	0	2	0	0	49658	2
2	0	2	0	0	49659	2
2	0	2	0	0	49660	2
2	1	2	0	1	49661	1
2	0	2	0	0	49662	2
2	0	2	0	0	49663	2
2	1	2	0	1	49664	1
2	0	2	0	0	49665	2
2	0	2	0	0	49666	2
2	0	2	0	0	49667	2
2	0	2	0	0	49668	2
2	2	2	0	2	49669	0
2	0	2	24	24	49670	2
2	0	2	1	1	49671	2
2	0	2	0	0	49672	2
2	1	2	0	1	49673	0
2	0	2	5	5	49674	2
2	0	2	0	0	49675	2
2	0	2	0	0	49676	2
2	0	2	0	0	49677	2
2	1	2	0	1	49678	0
2	1	2	6	7	49679	1
2	0	2	0	0	49680	2
2	0	2	0	0	49681	2
2	0	2	0	0	49682	2
2	12	2	0	12	49683	0
2	2	4	181	183	49684	1
2	0	2	3	3	49685	2
2	0	2	0	0	49686	2
2	6	4	100	106	49687	0
2	0	2	27	27	49688	2
2	0	2	0	0	49689	2
2	0	4	0	0	49690	2
2	0	2	0	0	49691	2
2	0	2	0	0	49692	2
2	0	2	0	0	49693	2
2	0	2	1	1	49694	2
2	0	2	0	0	49695	2
2	0	2	0	0	49696	2
2	0	2	0	0	49697	2
2	0	2	0	0	49698	2
2	0	2	0	0	49699	2
2	0	2	0	0	49700	2
2	0	2	0	0	49701	2
2	0	2	0	0	49702	2
2	0	2	0	0	49703	2
2	0	2	0	0	49704	2
2	0	2	0	0	49705	2
2	0	2	0	0	49706	2
2	0	2	0	0	49707	2
2	7	2	1	8	49708	1
2	0	2	0	0	49709	2
2	0	2	0	0	49710	2
2	1	2	99	100	49711	1
2	1	2	0	1	49712	0
2	0	2	3	3	49713	2
2	0	2	0	0	49714	2
2	0	4	20	20	49715	2
2	0	2	0	0	49716	2
2	0	2	0	0	49717	2
2	0	2	0	0	49718	2
2	0	2	0	0	49719	2
2	1	2	0	1	49720	0
2	6	2	20	26	49721	1
2	0	2	0	0	49722	2
2	0	2	0	0	49723	2
2	1	2	0	1	49724	0
2	0	2	2	2	49725	2
2	3	2	0	3	49726	0
2	1	2	15	16	49727	1
2	0	2	0	0	49728	2
2	0	2	0	0	49729	2
2	1	2	0	1	49730	1
2	0	2	1	1	49731	2
2	0	4	1	1	49732	2
2	0	2	0	0	49733	2
4	10	4	4	14	49734	0
4	5	4	0	5	49735	0
4	0	4	0	0	49736	2
4	2	4	0	2	49737	0
2	0	2	0	0	49738	2
2	0	2	0	0	49739	2
2	0	2	0	0	49740	2
2	0	2	0	0	49741	2
2	0	2	0	0	49742	2
2	0	2	0	0	49743	2
2	0	2	0	0	49744	2
2	0	2	0	0	49745	2
2	0	2	0	0	49746	2
2	0	2	0	0	49747	2
2	0	2	0	0	49748	2
2	0	2	0	0	49749	2
2	1	2	0	1	49750	1
2	0	2	0	0	49751	2
2	0	2	0	0	49752	2
2	0	2	3	3	49753	2
2	0	2	0	0	49754	2
2	0	2	0	0	49755	2
2	0	2	0	0	49756	2
2	0	2	0	0	49757	2
4	5	2	0	5	49758	0
2	0	2	0	0	49759	2
2	0	2	27	27	49760	2
2	0	2	0	0	49761	2
2	0	2	0	0	49762	2
2	0	2	0	0	49763	2
2	0	2	0	0	49764	2
2	0	2	0	0	49765	2
2	0	2	1	1	49766	2
2	0	2	0	0	49767	2
2	0	2	0	0	49768	2
4	0	2	0	0	49769	2
2	0	2	0	0	49770	2
2	0	4	1	1	49771	2
2	0	2	0	0	49772	2
2	0	2	0	0	49773	2
2	0	4	0	0	49774	2
2	0	2	0	0	49775	2
2	0	2	0	0	49776	2
2	0	2	0	0	49777	2
2	0	2	0	0	49778	2
2	0	2	0	0	49779	2
2	0	2	0	0	49780	2
2	0	2	0	0	49781	2
2	0	2	0	0	49782	2
2	0	2	0	0	49783	2
2	0	2	0	0	49784	2
2	0	2	0	0	49785	2
2	0	2	1	1	49786	2
2	0	2	0	0	49787	2
2	0	2	0	0	49788	2
2	0	2	0	0	49789	2
2	0	2	0	0	49790	2
2	0	2	0	0	49791	2
2	0	2	0	0	49792	2
2	0	2	0	0	49793	2
2	0	2	0	0	49794	2
2	0	2	0	0	49795	2
2	0	2	0	0	49796	2
2	0	2	0	0	49797	2
2	0	2	0	0	49798	2
2	0	2	0	0	49799	2
2	0	2	0	0	49800	2
2	0	2	0	0	49801	2
2	0	2	0	0	49802	2
2	0	2	0	0	49803	2
2	0	2	0	0	49804	2
2	3	2	0	3	49805	0
2	0	2	0	0	49806	2
2	0	2	0	0	49807	2
2	0	2	0	0	49808	2
2	0	2	0	0	49809	2
2	0	2	0	0	49810	2
2	0	2	0	0	49811	2
2	0	2	0	0	49812	2
2	0	2	0	0	49813	2
2	0	2	36	36	49814	2
2	0	2	0	0	49815	2
2	0	2	0	0	49816	2
2	0	2	0	0	49817	2
2	0	2	0	0	49818	2
2	0	2	6	6	49819	2
2	0	2	0	0	49820	2
2	0	2	0	0	49821	2
2	0	2	0	0	49822	2
2	0	2	0	0	49823	2
2	0	2	0	0	49824	2
2	0	2	0	0	49825	2
2	0	2	0	0	49826	2
2	0	2	0	0	49827	2
2	0	2	0	0	49828	2
2	1	2	0	1	49829	0
2	0	2	1	1	49830	2
2	0	2	0	0	49831	2
2	0	2	0	0	49832	2
2	0	2	0	0	49833	2
2	0	2	0	0	49834	2
2	0	2	0	0	49835	2
2	0	2	0	0	49836	2
2	0	2	0	0	49837	2
2	0	2	0	0	49838	2
2	0	2	0	0	49839	2
2	0	2	0	0	49840	2
2	0	2	0	0	49841	2
2	0	2	0	0	49842	2
2	0	2	0	0	49843	2
2	0	2	0	0	49844	2
2	0	2	0	0	49845	2
2	0	2	0	0	49846	2
2	0	2	0	0	49847	2
2	1	2	3	4	49848	1
2	0	2	0	0	49849	2
2	0	2	0	0	49850	2
2	0	2	0	0	49851	2
2	0	2	0	0	49852	2
2	37	2	16177	16214	49853	0
2	0	2	0	0	49854	2
2	0	2	0	0	49855	2
2	0	2	0	0	49856	2
2	0	2	0	0	49857	2
2	0	2	0	0	49858	2
2	0	2	0	0	49859	2
2	0	2	0	0	49860	2
2	0	2	0	0	49861	2
2	0	2	0	0	49862	2
2	0	2	0	0	49863	2
2	0	2	0	0	49864	2
2	0	2	0	0	49865	2
2	0	2	0	0	49866	2
2	0	2	0	0	49867	2
2	0	2	0	0	49868	2
2	0	2	0	0	49869	2
2	0	2	0	0	49870	2
2	0	2	0	0	49871	2
2	0	2	1	1	49872	2
2	0	2	0	0	49873	2
2	0	2	0	0	49874	2
2	1	2	0	1	49875	1
2	0	2	0	0	49876	2
2	148	2	6	154	49877	0
2	0	2	409	409	49878	2
2	81	2	1	82	49879	0
2	137	2	1426	1563	49880	1
2	0	2	52	52	49881	2
2	0	2	0	0	49882	2
2	184	2	3	187	49883	0
2	0	2	793	793	49884	2
0	0	2	149	149	49885	2
2	0	2	0	0	49886	2
2	0	2	0	0	49887	2
2	0	2	0	0	49888	2
2	0	2	0	0	49889	2
2	0	2	0	0	49890	2
2	0	2	0	0	49891	2
2	7	2	0	7	49892	0
2	0	2	80	80	49893	2
2	0	2	1	1	49894	2
2	6	2	0	6	49895	0
2	0	2	0	0	49896	2
2	0	2	0	0	49897	2
2	0	2	0	0	49898	2
2	0	2	0	0	49899	2
2	0	2	0	0	49900	2
2	0	2	0	0	49901	2
2	2	2	0	2	49902	0
2	0	2	46	46	49903	2
2	0	2	0	0	49904	2
2	0	2	0	0	49905	2
2	0	2	0	0	49906	2
2	0	2	3	3	49907	2
2	3	2	196	199	49908	1
2	0	2	1	1	49909	2
2	0	2	0	0	49910	2
2	0	2	0	0	49911	2
2	0	2	0	0	49912	2
2	0	2	0	0	49913	2
2	0	2	0	0	49914	2
2	0	2	0	0	49915	2
2	0	2	0	0	49916	2
2	0	2	0	0	49917	2
2	0	2	0	0	49918	2
4	0	2	0	0	49919	2
2	3	2	0	3	49920	0
2	0	2	21	21	49921	2
2	10	2	5	15	49922	1
2	0	2	0	0	49923	2
2	0	2	0	0	49924	2
2	0	2	0	0	49925	2
2	0	2	0	0	49926	2
2	0	2	0	0	49927	2
2	0	2	0	0	49928	2
2	1	2	0	1	49929	1
2	0	2	0	0	49930	2
2	0	2	0	0	49931	2
2	0	2	0	0	49932	2
2	0	2	0	0	49933	2
2	0	2	0	0	49934	2
2	0	2	0	0	49935	2
2	0	2	1	1	49936	2
2	0	2	0	0	49937	2
2	0	2	0	0	49938	2
2	0	2	0	0	49939	2
2	0	2	0	0	49940	2
2	0	2	0	0	49941	2
2	0	2	0	0	49942	2
2	2	2	0	2	49943	0
2	0	2	4	4	49944	2
2	0	2	4	4	49945	2
2	0	2	0	0	49946	2
2	5	2	0	5	49947	0
2	0	2	39	39	49948	2
2	0	2	0	0	49949	2
2	0	2	0	0	49950	2
2	0	2	0	0	49951	2
2	0	2	0	0	49952	2
2	0	2	0	0	49953	2
2	0	2	1	1	49954	2
2	0	2	0	0	49955	2
2	0	2	0	0	49956	2
2	0	2	0	0	49957	2
2	0	2	0	0	49958	2
2	0	2	0	0	49959	2
2	0	2	0	0	49960	2
2	0	2	0	0	49961	2
2	1	2	5	6	49962	1
2	0	2	0	0	49963	2
2	0	2	0	0	49964	2
2	0	2	0	0	49965	2
2	0	2	6	6	49966	2
2	8	2	0	8	49967	0
2	0	2	0	0	49968	2
2	1	2	12	13	49969	1
2	0	2	0	0	49970	2
2	0	2	0	0	49971	2
2	0	2	0	0	49972	2
2	0	2	0	0	49973	2
2	8	2	46	54	49974	1
2	0	2	6	6	49975	2
2	0	2	0	0	49976	2
2	4	2	0	4	49977	1
2	0	2	24	24	49978	2
2	0	2	0	0	49979	2
2	0	2	0	0	49980	2
2	0	2	0	0	49981	2
2	0	2	0	0	49982	2
2	0	2	0	0	49983	2
2	0	2	0	0	49984	2
2	0	2	0	0	49985	2
2	0	2	1	1	49986	2
2	0	2	0	0	49987	2
2	0	2	0	0	49988	2
2	0	2	0	0	49989	2
2	0	2	0	0	49990	2
2	9	2	0	9	49991	0
2	1	2	2	3	49992	1
2	0	2	10	10	49993	2
2	0	2	138	138	49994	2
2	0	2	0	0	49995	2
2	0	2	0	0	49996	2
2	0	2	0	0	49997	2
2	0	2	287	287	49998	2
2	0	2	0	0	49999	2
2	0	2	0	0	50000	2
2	0	2	0	0	50001	2
2	0	2	0	0	50002	2
2	0	2	0	0	50003	2
2	0	2	0	0	50004	2
2	0	2	0	0	50005	2
2	0	2	2	2	50006	2
2	0	2	0	0	50007	2
2	0	2	0	0	50008	2
2	0	2	0	0	50009	2
2	0	2	0	0	50010	2
2	0	2	0	0	50011	2
2	0	2	6	6	50012	2
2	0	2	0	0	50013	2
2	0	2	0	0	50014	2
2	0	2	0	0	50015	2
2	0	2	0	0	50016	2
2	0	2	0	0	50017	2
2	0	2	0	0	50018	2
2	0	2	0	0	50019	2
2	0	2	0	0	50020	2
2	0	2	0	0	50021	2
2	0	2	0	0	50022	2
2	0	2	0	0	50023	2
2	0	2	0	0	50024	2
2	0	2	0	0	50025	2
2	0	2	0	0	50026	2
2	0	2	0	0	50027	2
2	0	2	0	0	50028	2
2	0	2	0	0	50029	2
2	0	2	0	0	50030	2
2	0	2	0	0	50031	2
2	0	2	0	0	50032	2
2	0	2	1	1	50033	2
2	0	2	0	0	50034	2
2	0	2	0	0	50035	2
2	0	2	0	0	50036	2
2	0	2	0	0	50037	2
2	0	2	0	0	50038	2
2	0	4	593	593	50039	2
2	0	2	0	0	50040	2
2	0	2	0	0	50041	2
2	1	4	400	401	50042	0
2	0	2	0	0	50043	2
2	0	2	0	0	50044	2
2	0	4	26373	26373	50045	2
2	0	2	0	0	50046	2
2	0	2	0	0	50047	2
2	0	4	2691	2691	50048	2
2	0	2	0	0	50049	2
2	4	2	0	4	50050	0
2	1	2	31	32	50051	1
2	0	2	1	1	50052	2
2	0	2	0	0	50053	2
2	1	2	0	1	50054	0
2	0	2	5	5	50055	2
2	0	2	0	0	50056	2
2	0	4	2	2	50057	2
2	0	2	0	0	50058	2
2	0	2	0	0	50059	2
2	0	4	0	0	50060	2
2	0	2	0	0	50061	2
2	0	2	0	0	50062	2
2	0	2	0	0	50063	2
2	0	2	0	0	50064	2
2	0	2	0	0	50065	2
2	0	2	0	0	50066	2
2	0	2	0	0	50067	2
2	0	2	0	0	50068	2
2	0	2	2	2	50069	2
2	0	2	0	0	50070	2
2	0	2	0	0	50071	2
2	0	2	1	1	50072	2
2	0	2	0	0	50073	2
2	0	2	0	0	50074	2
2	3	2	35	38	50075	1
2	0	2	0	0	50076	2
2	0	2	0	0	50077	2
2	2	2	1	3	50078	1
2	0	2	1	1	50079	2
2	22	2	0	22	50080	0
2	82	2	615	697	50081	1
2	0	2	8	8	50082	2
2	0	2	1	1	50083	2
2	21	2	2	23	50084	1
2	0	2	51	51	50085	2
2	1	2	0	1	50086	0
2	9	2	8	17	50087	1
2	0	2	0	0	50088	2
2	0	2	0	0	50089	2
2	0	2	0	0	50090	2
2	0	2	3	3	50091	2
2	0	2	0	0	50092	2
2	0	2	0	0	50093	2
2	0	2	0	0	50094	2
2	0	2	0	0	50095	2
2	0	2	0	0	50096	2
2	0	2	0	0	50097	2
2	0	2	0	0	50098	2
2	1	2	2	3	50099	1
2	0	2	0	0	50100	2
2	0	2	0	0	50101	2
2	0	2	0	0	50102	2
2	0	2	1	1	50103	2
2	0	2	0	0	50104	2
2	0	2	0	0	50105	2
2	0	2	14	14	50106	2
2	1	2	0	1	50107	1
2	16	4	73	89	50108	1
2	0	2	1	1	50109	2
2	0	2	0	0	50110	2
2	4	4	187	191	50111	1
2	0	2	2	2	50112	2
2	4	2	1	5	50113	0
2	1	2	0	1	50114	0
2	10	2	6	16	50115	1
2	0	2	3	3	50116	2
2	0	2	0	0	50117	2
2	5	2	0	5	50118	0
2	0	2	12	12	50119	2
2	0	2	0	0	50120	2
2	0	2	0	0	50121	2
2	0	2	0	0	50122	2
2	0	2	0	0	50123	2
2	0	2	13	13	50124	2
2	0	2	0	0	50125	2
2	0	2	0	0	50126	2
2	0	2	0	0	50127	2
2	0	2	0	0	50128	2
2	0	2	0	0	50129	2
2	0	2	0	0	50130	2
2	0	2	0	0	50131	2
2	0	2	0	0	50132	2
2	0	2	0	0	50133	2
2	0	2	0	0	50134	2
2	0	2	0	0	50135	2
2	0	2	0	0	50136	2
2	0	2	0	0	50137	2
2	88	2	0	88	50138	0
2	0	2	17	17	50139	2
2	0	2	0	0	50140	2
2	0	2	0	0	50141	2
2	1	2	0	1	50142	1
2	0	2	0	0	50143	2
2	0	2	0	0	50144	2
2	0	2	0	0	50145	2
2	0	2	0	0	50146	2
2	152	2	0	152	50147	0
2	33	2	1143	1176	50148	1
2	0	2	88	88	50149	2
2	0	2	0	0	50150	2
2	33	2	5	38	50151	1
2	0	2	347	347	50152	2
2	0	2	0	0	50153	2
2	0	2	30	30	50154	2
2	0	2	0	0	50155	2
2	0	2	1	1	50156	2
2	0	2	5	5	50157	2
2	0	2	1	1	50158	2
2	0	2	0	0	50159	2
2	2	2	3	5	50160	1
2	0	2	1	1	50161	2
2	0	2	0	0	50162	2
2	0	2	0	0	50163	2
2	0	2	0	0	50164	2
2	0	2	0	0	50165	2
2	0	2	0	0	50166	2
2	0	2	0	0	50167	2
2	0	2	0	0	50168	2
2	0	2	0	0	50169	2
2	38	2	1	39	50170	0
2	52	2	1584	1636	50171	1
2	0	2	12	12	50172	2
2	0	2	0	0	50173	2
2	25	2	5	30	50174	1
2	0	2	81	81	50175	2
2	0	2	0	0	50176	2
2	0	2	6	6	50177	2
2	0	2	0	0	50178	2
2	0	2	0	0	50179	2
2	0	2	0	0	50180	2
2	0	2	0	0	50181	2
2	0	2	0	0	50182	2
2	0	2	0	0	50183	2
2	0	2	0	0	50184	2
2	1	2	2	3	50185	1
2	0	2	1	1	50186	2
2	0	2	0	0	50187	2
2	14	2	0	14	50188	0
2	2	4	591	593	50189	1
2	0	2	4	4	50190	2
2	0	2	0	0	50191	2
2	2	4	212	214	50192	0
2	0	2	35	35	50193	2
2	0	2	0	0	50194	2
2	0	2	3	3	50195	2
2	0	2	0	0	50196	2
2	0	2	0	0	50197	2
2	0	2	0	0	50198	2
2	0	2	1	1	50199	2
2	0	2	0	0	50200	2
2	0	2	0	0	50201	2
2	0	2	0	0	50202	2
2	1	2	34	35	50203	1
2	0	2	0	0	50204	2
2	0	2	1	1	50205	2
2	0	2	0	0	50206	2
2	0	2	0	0	50207	2
2	0	2	0	0	50208	2
2	0	2	0	0	50209	2
2	0	4	41	41	50210	2
2	0	2	0	0	50211	2
2	0	2	0	0	50212	2
2	0	4	1	1	50213	2
2	0	2	0	0	50214	2
2	2	2	0	2	50215	0
2	0	2	1	1	50216	2
2	0	2	0	0	50217	2
2	0	2	0	0	50218	2
2	0	2	76	76	50219	2
2	0	2	0	0	50220	2
2	0	2	0	0	50221	2
2	0	2	0	0	50222	2
2	0	2	0	0	50223	2
2	0	2	0	0	50224	2
2	0	2	0	0	50225	2
2	0	2	0	0	50226	2
2	2	2	0	2	50227	0
2	6	2	40	46	50228	1
2	0	2	2	2	50229	2
2	0	2	0	0	50230	2
2	5	2	0	5	50231	0
2	0	2	0	0	50232	2
2	0	2	0	0	50233	2
2	0	2	0	0	50234	2
2	0	2	0	0	50235	2
2	0	2	0	0	50236	2
2	0	2	0	0	50237	2
2	0	2	0	0	50238	2
2	0	2	0	0	50239	2
2	0	2	0	0	50240	2
2	0	2	0	0	50241	2
2	0	2	0	0	50242	2
2	0	2	0	0	50243	2
2	143	2	0	143	50244	0
2	0	2	999	999	50245	2
2	0	2	0	0	50246	2
2	0	2	9	9	50247	2
2	0	2	0	0	50248	2
2	0	2	0	0	50249	2
2	0	2	0	0	50250	2
2	0	2	0	0	50251	2
2	0	2	0	0	50252	2
2	0	2	2	2	50253	2
2	0	2	0	0	50254	2
2	0	2	0	0	50255	2
2	1	2	0	1	50256	1
2	0	2	1	1	50257	2
2	1	2	0	1	50258	0
2	0	2	37	37	50259	2
2	0	2	0	0	50260	2
2	0	2	0	0	50261	2
2	0	2	1	1	50262	2
2	0	2	1	1	50263	2
2	0	2	0	0	50264	2
2	0	2	0	0	50265	2
2	0	2	0	0	50266	2
2	0	2	0	0	50267	2
2	0	2	0	0	50268	2
2	0	2	0	0	50269	2
2	0	2	0	0	50270	2
2	0	2	17	17	50271	2
2	0	2	0	0	50272	2
2	0	2	0	0	50273	2
2	0	2	0	0	50274	2
2	0	2	1	1	50275	2
2	1	2	0	1	50276	0
2	0	2	2	2	50277	2
2	0	2	0	0	50278	2
2	0	2	0	0	50279	2
2	2	4	4	6	50280	1
2	0	2	0	0	50281	2
2	0	2	0	0	50282	2
2	0	4	0	0	50283	2
2	0	2	0	0	50284	2
2	14	2	0	14	50285	0
2	1	2	7	8	50286	1
2	0	2	1	1	50287	2
2	0	2	0	0	50288	2
2	42	2	1	43	50289	1
2	0	2	198	198	50290	2
2	0	2	0	0	50291	2
2	0	2	0	0	50292	2
2	0	2	2	2	50293	2
2	0	2	0	0	50294	2
2	0	2	0	0	50295	2
2	0	2	0	0	50296	2
2	0	2	0	0	50297	2
2	0	2	0	0	50298	2
2	0	2	0	0	50299	2
2	0	2	0	0	50300	2
2	0	2	0	0	50301	2
2	0	2	0	0	50302	2
2	0	2	0	0	50303	2
2	0	2	0	0	50304	2
2	0	2	0	0	50305	2
2	0	2	0	0	50306	2
2	0	2	0	0	50307	2
2	0	2	1	1	50308	2
2	0	2	0	0	50309	2
2	0	2	0	0	50310	2
2	0	2	1	1	50311	2
2	0	2	0	0	50312	2
2	0	2	0	0	50313	2
2	2	2	0	2	50314	0
2	0	2	0	0	50315	2
2	0	2	0	0	50316	2
2	0	2	0	0	50317	2
2	0	2	0	0	50318	2
2	0	2	0	0	50319	2
2	21	2	0	21	50320	0
2	4	2	72	76	50321	1
2	0	2	2	2	50322	2
2	0	2	0	0	50323	2
2	8	2	1	9	50324	0
2	0	2	14	14	50325	2
2	0	2	0	0	50326	2
2	0	2	0	0	50327	2
2	0	2	0	0	50328	2
2	0	2	0	0	50329	2
2	0	2	0	0	50330	2
2	0	2	0	0	50331	2
2	321	2	1	322	50332	0
2	29	2	2634	2663	50333	1
2	0	2	94	94	50334	2
2	0	2	15	15	50335	2
2	55	2	519	574	50336	0
2	0	2	551	551	50337	2
2	0	2	0	0	50338	2
2	0	2	0	0	50339	2
2	0	2	0	0	50340	2
2	0	2	0	0	50341	2
2	0	2	0	0	50342	2
2	0	2	0	0	50343	2
2	0	2	1	1	50344	2
2	3	2	0	3	50345	0
2	0	2	0	0	50346	2
2	0	2	0	0	50347	2
2	0	2	0	0	50348	2
2	0	2	0	0	50349	2
2	0	2	0	0	50350	2
2	0	2	1	1	50351	2
2	0	2	0	0	50352	2
2	0	2	0	0	50353	2
2	0	2	0	0	50354	2
2	0	2	0	0	50355	2
2	0	2	0	0	50356	2
2	0	2	0	0	50357	2
2	4	2	38	42	50358	1
2	0	2	2	2	50359	2
2	0	2	0	0	50360	2
2	0	2	0	0	50361	2
2	0	2	0	0	50362	2
2	0	2	0	0	50363	2
2	0	2	0	0	50364	2
2	1	2	9	10	50365	1
2	0	2	1	1	50366	2
2	0	2	0	0	50367	2
2	0	2	0	0	50368	2
2	0	2	2	2	50369	2
2	0	2	0	0	50370	2
2	0	2	1	1	50371	2
2	0	2	0	0	50372	2
2	0	2	0	0	50373	2
2	0	2	0	0	50374	2
2	0	2	0	0	50375	2
2	0	2	0	0	50376	2
2	0	2	0	0	50377	2
2	0	2	0	0	50378	2
2	0	2	0	0	50379	2
2	0	2	0	0	50380	2
2	0	2	0	0	50381	2
2	0	4	0	0	50382	2
2	0	2	0	0	50383	2
2	0	2	0	0	50384	2
2	0	4	0	0	50385	2
2	0	2	0	0	50386	2
2	0	2	0	0	50387	2
2	0	2	0	0	50388	2
2	0	2	0	0	50389	2
2	0	2	0	0	50390	2
2	0	2	0	0	50391	2
2	10	2	0	10	50392	0
2	2	2	39	41	50393	1
2	0	2	21	21	50394	2
2	0	2	0	0	50395	2
2	10	2	1	11	50396	0
2	0	2	61	61	50397	2
2	0	2	0	0	50398	2
2	2	2	17	19	50399	1
2	0	2	5	5	50400	2
2	0	2	0	0	50401	2
2	0	2	0	0	50402	2
2	0	2	2	2	50403	2
2	105	2	3	108	50404	0
2	80	2	497	577	50405	1
2	0	2	40	40	50406	2
2	0	2	2	2	50407	2
2	55	2	6	61	50408	0
2	0	2	258	258	50409	2
2	0	2	0	0	50410	2
2	0	2	2	2	50411	2
2	0	2	0	0	50412	2
2	0	2	0	0	50413	2
2	0	2	0	0	50414	2
2	0	2	0	0	50415	2
2	0	2	12	12	50416	2
4	16	2	0	16	50417	0
2	0	2	0	0	50418	2
2	0	2	0	0	50419	2
4	103	2	138	241	50420	0
4	6	2	2	8	50421	0
2	0	2	0	0	50422	2
2	0	2	1	1	50423	2
0	349	2	1	350	50424	0
0	398	2	2	400	50425	0
0	121	2	1	122	50426	0
0	5	2	0	5	50427	0
0	5	2	0	5	50428	0
2	49	2	0	49	50429	0
2	26	2	84	110	50430	1
2	0	2	9	9	50431	2
2	0	2	0	0	50432	2
2	33	2	0	33	50433	0
2	0	2	100	100	50434	2
2	0	2	0	0	50435	2
2	0	2	0	0	50436	2
2	0	2	0	0	50437	2
2	0	2	0	0	50438	2
2	0	2	0	0	50439	2
2	0	2	0	0	50440	2
2	0	2	0	0	50441	2
2	0	2	0	0	50442	2
2	0	2	0	0	50443	2
2	0	2	0	0	50444	2
2	0	2	0	0	50445	2
2	0	2	0	0	50446	2
2	0	2	0	0	50447	2
2	0	2	1	1	50448	2
2	4	2	0	4	50449	0
2	0	2	2	2	50450	2
2	0	2	0	0	50451	2
2	0	2	0	0	50452	2
2	0	2	0	0	50453	2
2	0	2	0	0	50454	2
2	0	2	0	0	50455	2
2	0	2	0	0	50456	2
2	0	2	0	0	50457	2
2	0	2	0	0	50458	2
2	0	2	0	0	50459	2
2	0	2	0	0	50460	2
2	0	2	0	0	50461	2
2	0	2	0	0	50462	2
2	0	2	0	0	50463	2
2	0	2	0	0	50464	2
2	1	2	0	1	50465	1
2	0	2	0	0	50466	2
2	0	2	0	0	50467	2
2	0	2	0	0	50468	2
2	0	2	0	0	50469	2
2	0	2	0	0	50470	2
2	0	2	0	0	50471	2
2	0	2	0	0	50472	2
2	0	2	0	0	50473	2
2	0	2	0	0	50474	2
2	0	2	0	0	50475	2
2	0	2	0	0	50476	2
2	0	2	0	0	50477	2
2	0	2	0	0	50478	2
2	0	2	0	0	50479	2
2	0	2	0	0	50480	2
2	0	2	0	0	50481	2
2	5	2	0	5	50482	0
2	1	2	15	16	50483	1
2	0	2	0	0	50484	2
2	0	2	0	0	50485	2
2	0	2	0	0	50486	2
2	0	2	0	0	50487	2
2	0	2	0	0	50488	2
2	0	2	0	0	50489	2
2	0	2	0	0	50490	2
2	0	2	0	0	50491	2
2	0	2	0	0	50492	2
2	27	2	3	30	50493	0
2	0	2	192	192	50494	2
2	0	2	0	0	50495	2
2	0	2	0	0	50496	2
2	0	2	0	0	50497	2
2	0	2	5	5	50498	2
2	2	2	0	2	50499	0
2	0	2	0	0	50500	2
2	0	2	0	0	50501	2
2	0	2	0	0	50502	2
2	0	2	0	0	50503	2
2	0	2	0	0	50504	2
2	0	2	0	0	50505	2
2	0	2	0	0	50506	2
2	0	2	0	0	50507	2
2	12	2	0	12	50508	0
2	0	2	1	1	50509	2
2	0	2	0	0	50510	2
2	0	2	0	0	50511	2
2	4	2	3	7	50512	1
2	0	2	0	0	50513	2
2	0	2	0	0	50514	2
2	1	2	1	2	50515	1
2	0	2	0	0	50516	2
2	0	2	0	0	50517	2
2	0	2	0	0	50518	2
2	0	2	0	0	50519	2
2	0	2	0	0	50520	2
2	0	2	0	0	50521	2
2	0	2	0	0	50522	2
2	0	2	0	0	50523	2
2	12	2	0	12	50524	0
2	0	2	0	0	50525	2
2	0	2	0	0	50526	2
2	0	2	0	0	50527	2
2	0	2	0	0	50528	2
2	0	2	0	0	50529	2
2	0	2	0	0	50530	2
2	0	2	5	5	50531	2
2	0	2	7	7	50532	2
2	0	2	0	0	50533	2
2	2	2	0	2	50534	1
2	0	2	20	20	50535	2
2	0	2	0	0	50536	2
2	0	2	1	1	50537	2
2	0	2	0	0	50538	2
2	0	2	0	0	50539	2
2	0	2	0	0	50540	2
2	4	2	0	4	50541	0
2	0	2	0	0	50542	2
2	0	2	0	0	50543	2
2	0	2	0	0	50544	2
2	0	2	0	0	50545	2
2	0	2	0	0	50546	2
2	0	2	0	0	50547	2
2	0	2	0	0	50548	2
2	0	2	3	3	50549	2
2	0	2	0	0	50550	2
2	1	2	18	19	50551	1
2	0	2	0	0	50552	2
2	0	2	0	0	50553	2
2	0	2	0	0	50554	2
2	0	2	0	0	50555	2
2	0	2	0	0	50556	2
2	0	2	0	0	50557	2
2	0	2	0	0	50558	2
2	0	2	0	0	50559	2
2	199	2	0	199	50560	0
2	0	2	426	426	50561	2
2	0	2	0	0	50562	2
2	0	2	0	0	50563	2
2	2	2	0	2	50564	1
2	0	2	68	68	50565	2
2	0	2	0	0	50566	2
2	0	2	0	0	50567	2
2	0	2	0	0	50568	2
2	0	2	0	0	50569	2
2	0	2	0	0	50570	2
2	0	2	0	0	50571	2
2	0	2	63	63	50572	2
2	0	2	2	2	50573	2
7	18	7	1	19	50574	0
2	0	2	0	0	50575	2
2	2	2	0	2	50576	1
2	0	2	0	0	50577	2
2	0	2	0	0	50578	2
2	0	2	0	0	50579	2
2	0	2	0	0	50580	2
2	0	2	0	0	50581	2
2	4	2	1	5	50582	1
2	0	2	0	0	50583	2
2	0	2	0	0	50584	2
2	0	2	0	0	50585	2
2	0	2	0	0	50586	2
2	0	2	0	0	50587	2
2	0	2	0	0	50588	2
2	0	2	0	0	50589	2
2	0	2	0	0	50590	2
2	0	2	0	0	50591	2
2	0	2	1	1	50592	2
2	1	2	0	1	50593	0
2	0	2	0	0	50594	2
2	0	2	0	0	50595	2
2	0	2	0	0	50596	2
2	2	2	4	6	50597	1
2	0	2	0	0	50598	2
2	0	2	0	0	50599	2
2	0	2	0	0	50600	2
2	0	2	1	1	50601	2
2	0	2	0	0	50602	2
2	0	2	0	0	50603	2
2	0	2	0	0	50604	2
2	0	2	0	0	50605	2
2	0	2	0	0	50606	2
2	0	2	0	0	50607	2
2	0	2	0	0	50608	2
2	0	2	0	0	50609	2
2	0	2	0	0	50610	2
2	12	2	0	12	50611	0
2	1	2	11	12	50612	1
2	0	2	1	1	50613	2
2	0	2	1	1	50614	2
2	2	2	0	2	50615	1
2	0	2	14	14	50616	2
2	0	2	0	0	50617	2
2	0	2	0	0	50618	2
2	0	2	0	0	50619	2
2	0	2	0	0	50620	2
2	0	2	0	0	50621	2
2	0	2	0	0	50622	2
2	0	2	0	0	50623	2
2	0	2	0	0	50624	2
2	0	2	0	0	50625	2
2	0	2	5	5	50626	2
2	0	2	0	0	50627	2
2	0	2	0	0	50628	2
2	0	2	0	0	50629	2
2	0	2	0	0	50630	2
2	0	2	0	0	50631	2
2	0	2	0	0	50632	2
2	0	2	0	0	50633	2
2	0	2	0	0	50634	2
2	0	2	0	0	50635	2
2	0	2	0	0	50636	2
2	0	2	0	0	50637	2
2	0	2	0	0	50638	2
2	0	2	0	0	50639	2
2	0	2	0	0	50640	2
2	0	2	0	0	50641	2
2	0	2	2	2	50642	2
2	0	2	0	0	50643	2
2	0	2	0	0	50644	2
2	0	2	0	0	50645	2
2	0	2	0	0	50646	2
2	17	2	2	19	50647	1
2	0	2	48	48	50648	2
2	89	2	2	91	50649	0
2	41	2	576	617	50650	1
2	0	2	6	6	50651	2
2	0	2	0	0	50652	2
2	0	2	0	0	50653	2
2	0	2	0	0	50654	2
2	0	2	0	0	50655	2
2	0	2	0	0	50656	2
2	0	2	0	0	50657	2
2	0	2	0	0	50658	2
2	0	2	0	0	50659	2
2	0	2	0	0	50660	2
2	0	2	0	0	50661	2
2	0	2	0	0	50662	2
2	0	2	0	0	50663	2
2	0	2	0	0	50664	2
2	0	2	0	0	50665	2
2	0	2	0	0	50666	2
2	0	2	0	0	50667	2
2	0	2	0	0	50668	2
2	0	2	0	0	50669	2
2	0	2	0	0	50670	2
2	1	2	0	1	50671	0
2	0	2	0	0	50672	2
2	0	2	0	0	50673	2
2	0	2	0	0	50674	2
2	0	2	0	0	50675	2
2	0	2	0	0	50676	2
2	0	2	0	0	50677	2
2	0	2	2	2	50678	2
2	0	2	0	0	50679	2
2	0	2	0	0	50680	2
2	0	2	0	0	50681	2
2	0	2	0	0	50682	2
2	0	2	0	0	50683	2
2	0	2	0	0	50684	2
2	0	2	0	0	50685	2
2	0	2	0	0	50686	2
2	0	2	0	0	50687	2
2	0	2	0	0	50688	2
2	0	2	0	0	50689	2
2	0	2	1	1	50690	2
2	0	2	0	0	50691	2
2	0	2	0	0	50692	2
2	0	2	0	0	50693	2
2	0	2	0	0	50694	2
2	0	2	0	0	50695	2
2	0	2	0	0	50696	2
2	0	2	0	0	50697	2
2	0	2	0	0	50698	2
2	0	2	0	0	50699	2
2	0	2	0	0	50700	2
2	0	2	0	0	50701	2
2	0	2	0	0	50702	2
2	0	2	0	0	50703	2
2	0	2	0	0	50704	2
2	0	2	0	0	50705	2
2	0	2	0	0	50706	2
2	0	2	0	0	50707	2
2	0	2	0	0	50708	2
2	0	2	0	0	50709	2
2	0	2	0	0	50710	2
2	0	2	0	0	50711	2
2	0	2	1	1	50712	2
2	10	2	0	10	50713	0
2	0	2	0	0	50714	2
2	0	2	0	0	50715	2
2	0	2	0	0	50716	2
2	0	2	0	0	50717	2
2	0	2	0	0	50718	2
2	0	2	0	0	50719	2
2	0	2	94	94	50720	2
2	0	2	1	1	50721	2
2	0	2	0	0	50722	2
2	0	2	1	1	50723	2
2	0	2	0	0	50724	2
2	1	2	0	1	50725	0
2	0	2	1	1	50726	2
2	0	2	0	0	50727	2
2	0	2	0	0	50728	2
2	2	2	0	2	50729	0
2	0	2	95	95	50730	2
2	0	2	0	0	50731	2
2	0	2	0	0	50732	2
2	0	2	0	0	50733	2
2	0	2	0	0	50734	2
2	1	2	2	3	50735	1
2	0	2	0	0	50736	2
2	0	2	0	0	50737	2
2	0	2	0	0	50738	2
2	0	2	0	0	50739	2
4	0	2	0	0	50740	2
2	2	2	0	2	50741	0
2	0	2	5	5	50742	2
2	0	2	214	214	50743	2
2	0	2	0	0	50744	2
2	0	2	0	0	50745	2
2	0	2	0	0	50746	2
2	0	2	0	0	50747	2
2	0	2	0	0	50748	2
2	0	2	0	0	50749	2
2	0	2	0	0	50750	2
2	0	2	0	0	50751	2
2	0	2	0	0	50752	2
2	0	2	0	0	50753	2
2	0	2	0	0	50754	2
2	0	2	0	0	50755	2
2	0	2	0	0	50756	2
2	0	2	0	0	50757	2
2	0	2	0	0	50758	2
2	0	2	0	0	50759	2
2	0	2	0	0	50760	2
2	0	2	0	0	50761	2
2	0	2	0	0	50762	2
2	0	2	0	0	50763	2
2	0	2	0	0	50764	2
2	0	2	0	0	50765	2
2	0	2	0	0	50766	2
2	0	2	0	0	50767	2
2	0	2	0	0	50768	2
2	0	2	1	1	50769	2
2	0	2	0	0	50770	2
2	0	2	0	0	50771	2
2	0	2	0	0	50772	2
2	0	2	0	0	50773	2
2	0	2	0	0	50774	2
2	1	4	23	24	50775	1
2	0	2	0	0	50776	2
2	0	2	0	0	50777	2
2	0	4	4	4	50778	2
2	0	2	0	0	50779	2
2	3	2	0	3	50780	0
2	7	2	25	32	50781	1
2	0	2	2	2	50782	2
2	0	2	0	0	50783	2
2	1	2	0	1	50784	1
2	0	2	10	10	50785	2
2	8	2	0	8	50786	0
2	3	2	3	6	50787	1
2	0	2	2	2	50788	2
2	0	2	0	0	50789	2
2	1	2	0	1	50790	1
2	0	2	8	8	50791	2
2	0	2	0	0	50792	2
2	0	2	0	0	50793	2
2	0	2	0	0	50794	2
2	0	2	0	0	50795	2
2	0	2	1	1	50796	2
2	0	2	0	0	50797	2
2	0	2	0	0	50798	2
2	0	2	0	0	50799	2
2	0	2	0	0	50800	2
2	0	2	0	0	50801	2
2	0	2	0	0	50802	2
2	0	2	0	0	50803	2
2	0	2	0	0	50804	2
2	0	2	0	0	50805	2
2	0	2	0	0	50806	2
2	0	2	0	0	50807	2
2	0	2	1	1	50808	2
2	0	2	0	0	50809	2
2	0	2	0	0	50810	2
2	0	2	0	0	50811	2
2	0	2	0	0	50812	2
2	0	2	0	0	50813	2
2	0	2	0	0	50814	2
2	0	2	0	0	50815	2
2	0	2	0	0	50816	2
2	0	2	0	0	50817	2
2	0	2	0	0	50818	2
2	0	2	0	0	50819	2
2	0	2	0	0	50820	2
2	0	2	0	0	50821	2
2	0	2	0	0	50822	2
2	0	2	0	0	50823	2
2	0	2	0	0	50824	2
2	0	2	0	0	50825	2
2	0	2	0	0	50826	2
2	0	2	0	0	50827	2
2	0	2	0	0	50828	2
2	0	2	0	0	50829	2
2	0	2	0	0	50830	2
2	0	2	0	0	50831	2
2	0	2	0	0	50832	2
2	0	2	0	0	50833	2
2	1	2	0	1	50834	0
2	0	2	110	110	50835	2
2	0	2	0	0	50836	2
2	0	2	0	0	50837	2
2	0	2	9	9	50838	2
2	0	2	0	0	50839	2
2	1	2	0	1	50840	0
2	0	2	0	0	50841	2
2	0	2	0	0	50842	2
2	0	2	0	0	50843	2
0	3	2	2	5	50844	1
0	0	2	0	0	50845	2
2	0	2	0	0	50846	2
2	0	2	0	0	50847	2
2	73	2	0	73	50848	0
2	1	2	0	1	50849	0
2	1	2	7	8	50850	1
2	0	2	0	0	50851	2
2	0	2	0	0	50852	2
2	0	2	0	0	50853	2
2	0	2	1	1	50854	2
2	0	2	0	0	50855	2
2	0	2	0	0	50856	2
2	0	2	0	0	50857	2
2	0	2	0	0	50858	2
2	0	2	0	0	50859	2
2	0	2	0	0	50860	2
2	0	2	0	0	50861	2
2	0	2	0	0	50862	2
2	0	2	0	0	50863	2
2	0	2	0	0	50864	2
2	0	2	0	0	50865	2
2	0	2	0	0	50866	2
4	14598	2	110	14708	50867	0
4	2632	2	9	2641	50868	0
2	0	2	23	23	50869	2
2	0	2	0	0	50870	2
2	0	2	0	0	50871	2
2	0	2	0	0	50872	2
2	0	2	0	0	50873	2
2	0	2	0	0	50874	2
2	0	2	0	0	50875	2
2	0	2	0	0	50876	2
2	0	2	0	0	50877	2
2	0	2	0	0	50878	2
2	0	2	0	0	50879	2
2	0	2	0	0	50880	2
2	0	2	0	0	50881	2
2	0	2	0	0	50882	2
2	0	2	0	0	50883	2
2	0	2	0	0	50884	2
2	0	2	0	0	50885	2
2	0	2	0	0	50886	2
2	0	2	0	0	50887	2
2	0	2	0	0	50888	2
2	0	2	0	0	50889	2
2	0	2	0	0	50890	2
2	0	2	1	1	50891	2
2	0	2	0	0	50892	2
2	0	2	0	0	50893	2
2	0	2	0	0	50894	2
2	0	2	0	0	50895	2
2	1	2	0	1	50896	0
2	0	2	1	1	50897	2
2	1	2	0	1	50898	0
2	0	2	1	1	50899	2
2	0	2	0	0	50900	2
2	0	2	0	0	50901	2
2	1	2	0	1	50902	0
2	1	2	17	18	50903	1
2	0	2	0	0	50904	2
2	0	2	0	0	50905	2
2	0	2	0	0	50906	2
2	0	2	1	1	50907	2
2	1	2	4	5	50908	1
2	0	2	0	0	50909	2
2	0	2	0	0	50910	2
2	2	2	3	5	50911	0
2	0	2	2	2	50912	2
2	139	2	0	139	50913	0
2	0	2	3	3	50914	2
2	0	2	1	1	50915	2
2	29	2	0	29	50916	0
2	1	2	87	88	50917	1
2	0	2	20	20	50918	2
2	0	2	0	0	50919	2
2	29	2	2	31	50920	0
2	0	2	163	163	50921	2
2	0	2	0	0	50922	2
2	0	2	0	0	50923	2
2	0	2	0	0	50924	2
2	0	2	0	0	50925	2
2	0	2	0	0	50926	2
2	0	2	0	0	50927	2
2	0	2	0	0	50928	2
2	0	2	0	0	50929	2
2	0	2	0	0	50930	2
2	0	2	0	0	50931	2
2	0	2	0	0	50932	2
2	0	2	0	0	50933	2
2	0	2	0	0	50934	2
2	0	2	0	0	50935	2
2	0	2	0	0	50936	2
2	0	2	0	0	50937	2
2	0	2	0	0	50938	2
2	0	2	0	0	50939	2
2	0	2	0	0	50940	2
2	0	2	0	0	50941	2
2	0	2	0	0	50942	2
2	0	2	0	0	50943	2
2	0	2	0	0	50944	2
2	0	2	50	50	50945	2
2	0	2	0	0	50946	2
2	0	2	2	2	50947	2
2	47	2	1	48	50948	0
2	0	2	446	446	50949	2
2	0	2	0	0	50950	2
2	0	2	0	0	50951	2
2	0	2	0	0	50952	2
2	0	2	0	0	50953	2
2	0	2	0	0	50954	2
2	0	2	0	0	50955	2
2	0	2	0	0	50956	2
2	0	2	0	0	50957	2
2	0	2	0	0	50958	2
2	0	2	1	1	50959	2
2	0	2	0	0	50960	2
2	0	2	0	0	50961	2
2	18	2	0	18	50962	0
2	7	2	0	7	50963	0
2	0	2	14	14	50964	2
2	0	2	0	0	50965	2
2	0	2	0	0	50966	2
2	0	2	0	0	50967	2
2	0	2	0	0	50968	2
2	0	2	0	0	50969	2
2	0	2	8	8	50970	2
2	0	2	0	0	50971	2
2	0	2	0	0	50972	2
2	2	2	0	2	50973	1
2	0	2	4	4	50974	2
2	17	4	14154	14171	50975	1
2	1	2	9	10	50976	1
2	0	2	0	0	50977	2
2	13	4	8562	8575	50978	0
2	0	2	67	67	50979	2
2	376	2	1	377	50980	0
2	19	2	1003	1022	50981	1
2	0	2	42	42	50982	2
2	0	2	0	0	50983	2
2	0	2	0	0	50984	2
2	0	2	6	6	50985	2
2	0	2	0	0	50986	2
2	0	2	0	0	50987	2
0	5	2	1	6	50988	0
0	8	2	0	8	50989	0
2	0	2	0	0	50990	2
2	0	2	1	1	50991	2
2	10	2	0	10	50992	0
2	4	2	98	102	50993	1
2	0	2	0	0	50994	2
2	0	2	0	0	50995	2
2	8	2	0	8	50996	0
2	0	2	22	22	50997	2
2	0	2	0	0	50998	2
2	0	2	0	0	50999	2
2	0	2	1	1	51000	2
2	0	2	0	0	51001	2
2	0	2	13	13	51002	2
2	0	2	0	0	51003	2
2	0	2	0	0	51004	2
2	0	2	0	0	51005	2
2	0	2	0	0	51006	2
2	1	2	0	1	51007	0
2	0	2	0	0	51008	2
2	0	2	0	0	51009	2
2	0	2	0	0	51010	2
2	0	2	0	0	51011	2
2	0	2	0	0	51012	2
2	0	2	0	0	51013	2
2	2	2	3	5	51014	1
2	0	2	0	0	51015	2
2	0	2	0	0	51016	2
2	2	2	0	2	51017	0
2	0	2	1	1	51018	2
2	6	2	0	6	51019	0
2	0	2	199	199	51020	2
2	0	2	0	0	51021	2
2	0	2	0	0	51022	2
2	1	2	0	1	51023	1
2	0	2	5	5	51024	2
2	1	2	0	1	51025	0
2	0	2	5	5	51026	2
2	0	2	0	0	51027	2
2	0	2	0	0	51028	2
2	0	2	1	1	51029	2
2	0	2	10	10	51030	2
2	0	2	0	0	51031	2
2	0	2	0	0	51032	2
2	0	2	0	0	51033	2
2	0	2	0	0	51034	2
2	0	2	0	0	51035	2
2	0	2	0	0	51036	2
2	0	2	0	0	51037	2
2	0	2	0	0	51038	2
2	0	2	0	0	51039	2
2	1	2	0	1	51040	0
2	11	2	34	45	51041	1
2	0	2	1	1	51042	2
2	0	2	0	0	51043	2
2	3	2	0	3	51044	0
2	0	2	0	0	51045	2
2	0	2	0	0	51046	2
2	0	2	0	0	51047	2
2	0	2	0	0	51048	2
2	0	2	0	0	51049	2
2	6	2	1	7	51050	1
2	0	2	0	0	51051	2
2	0	2	0	0	51052	2
2	0	2	0	0	51053	2
2	0	2	10	10	51054	2
2	11	2	0	11	51055	0
2	54	2	74	128	51056	1
2	0	2	0	0	51057	2
2	0	2	0	0	51058	2
2	17	2	6	23	51059	1
2	0	2	9	9	51060	2
2	0	2	0	0	51061	2
2	4	2	23	27	51062	1
2	0	2	0	0	51063	2
2	0	2	0	0	51064	2
2	0	2	0	0	51065	2
2	0	2	11	11	51066	2
2	1	2	3	4	51067	0
2	5	2	0	5	51068	0
2	0	2	0	0	51069	2
2	0	2	3	3	51070	2
2	0	2	0	0	51071	2
2	0	2	0	0	51072	2
2	0	2	0	0	51073	2
2	0	2	0	0	51074	2
2	0	2	0	0	51075	2
2	0	2	1	1	51076	2
2	0	2	0	0	51077	2
2	0	2	0	0	51078	2
2	0	2	0	0	51079	2
2	0	2	0	0	51080	2
4	0	2	0	0	51081	2
2	7	4	20	27	51082	1
2	0	2	2	2	51083	2
2	0	2	0	0	51084	2
2	2	4	3	5	51085	1
2	0	2	5	5	51086	2
2	0	2	0	0	51087	2
2	0	2	0	0	51088	2
2	0	2	2	2	51089	2
2	0	2	0	0	51090	2
2	0	2	0	0	51091	2
2	0	2	0	0	51092	2
2	0	2	0	0	51093	2
2	0	2	0	0	51094	2
2	0	2	0	0	51095	2
2	0	2	0	0	51096	2
2	0	2	0	0	51097	2
2	0	2	22	22	51098	2
2	0	2	0	0	51099	2
2	0	2	0	0	51100	2
2	0	2	1	1	51101	2
2	0	2	1	1	51102	2
2	2	2	0	2	51103	0
2	0	2	7	7	51104	2
2	0	2	0	0	51105	2
2	0	2	0	0	51106	2
2	0	4	51	51	51107	2
2	0	2	0	0	51108	2
2	0	2	0	0	51109	2
2	0	4	22	22	51110	2
2	0	2	0	0	51111	2
4	0	2	1	1	51112	2
2	0	2	0	0	51113	2
2	0	2	0	0	51114	2
2	0	2	0	0	51115	2
2	0	2	0	0	51116	2
2	0	2	0	0	51117	2
2	0	2	0	0	51118	2
2	7	2	0	7	51119	0
2	0	2	51	51	51120	2
2	0	2	0	0	51121	2
2	0	2	0	0	51122	2
2	1	2	0	1	51123	0
2	0	2	0	0	51124	2
2	1	2	0	1	51125	0
2	1	2	19	20	51126	1
2	0	2	0	0	51127	2
2	0	2	0	0	51128	2
2	0	2	1	1	51129	2
2	1	2	1	2	51130	1
2	0	2	0	0	51131	2
2	0	2	0	0	51132	2
2	0	2	0	0	51133	2
2	0	2	0	0	51134	2
2	0	2	0	0	51135	2
2	0	2	0	0	51136	2
2	0	2	0	0	51137	2
2	0	2	2	2	51138	2
2	0	2	0	0	51139	2
2	0	2	0	0	51140	2
2	0	2	0	0	51141	2
2	0	2	0	0	51142	2
2	1	2	0	1	51143	0
2	52	2	8	60	51144	1
2	0	2	0	0	51145	2
2	0	2	0	0	51146	2
2	0	2	0	0	51147	2
2	1	2	0	1	51148	0
2	0	2	1	1	51149	2
4	0	2	0	0	51150	2
2	53	2	1	54	51151	0
2	44	2	789	833	51152	1
2	0	2	4	4	51153	2
2	0	2	0	0	51154	2
2	20	2	3566	3586	51155	0
2	0	2	85	85	51156	2
2	0	2	0	0	51157	2
2	0	2	0	0	51158	2
2	0	2	0	0	51159	2
2	0	2	0	0	51160	2
2	0	2	0	0	51161	2
2	0	2	0	0	51162	2
2	3	2	0	3	51163	0
2	1	2	26	27	51164	1
2	0	2	2	2	51165	2
2	0	2	0	0	51166	2
0	261	2	1	262	51167	0
0	304	2	0	304	51168	0
2	5	2	0	5	51169	0
2	0	2	18	18	51170	2
2	0	2	0	0	51171	2
2	0	2	0	0	51172	2
2	0	2	0	0	51173	2
2	0	2	0	0	51174	2
2	0	2	0	0	51175	2
2	0	2	0	0	51176	2
2	0	2	0	0	51177	2
2	0	2	0	0	51178	2
2	0	2	0	0	51179	2
2	0	2	0	0	51180	2
2	0	2	0	0	51181	2
2	0	2	0	0	51182	2
2	0	2	0	0	51183	2
2	0	2	0	0	51184	2
2	0	2	0	0	51185	2
2	0	2	0	0	51186	2
2	0	2	0	0	51187	2
2	0	2	0	0	51188	2
2	0	2	0	0	51189	2
2	0	4	2839	2839	51190	2
2	0	2	0	0	51191	2
2	0	2	0	0	51192	2
2	0	4	6363	6363	51193	2
2	0	2	0	0	51194	2
2	20	2	0	20	51195	0
2	35	4	272	307	51196	1
2	0	2	2	2	51197	2
2	0	2	0	0	51198	2
2	9	4	1290	1299	51199	0
2	0	2	68	68	51200	2
2	0	2	0	0	51201	2
2	0	2	0	0	51202	2
2	0	2	0	0	51203	2
2	0	2	0	0	51204	2
2	0	2	0	0	51205	2
2	0	2	0	0	51206	2
4	0	4	1	1	51207	2
4	0	4	0	0	51208	2
2	0	2	0	0	51209	2
2	0	2	0	0	51210	2
2	0	2	0	0	51211	2
2	0	2	0	0	51212	2
2	0	2	0	0	51213	2
2	0	2	0	0	51214	2
2	0	2	0	0	51215	2
2	1	2	5	6	51216	1
2	0	2	0	0	51217	2
2	0	2	0	0	51218	2
2	1	2	0	1	51219	1
2	0	2	0	0	51220	2
2	0	2	0	0	51221	2
2	0	2	0	0	51222	2
2	0	2	0	0	51223	2
2	0	2	0	0	51224	2
2	0	2	0	0	51225	2
2	0	2	0	0	51226	2
2	0	2	0	0	51227	2
2	0	2	0	0	51228	2
2	0	2	0	0	51229	2
2	0	2	0	0	51230	2
2	0	2	0	0	51231	2
2	0	2	0	0	51232	2
2	0	2	0	0	51233	2
2	0	2	0	0	51234	2
2	0	2	0	0	51235	2
2	0	2	0	0	51236	2
2	0	2	0	0	51237	2
2	0	2	0	0	51238	2
2	0	2	0	0	51239	2
2	0	2	0	0	51240	2
2	0	2	0	0	51241	2
2	0	2	0	0	51242	2
2	0	2	0	0	51243	2
2	0	2	0	0	51244	2
2	0	2	0	0	51245	2
2	0	2	0	0	51246	2
2	0	2	0	0	51247	2
2	0	2	0	0	51248	2
2	0	2	0	0	51249	2
2	0	2	0	0	51250	2
2	0	4	6	6	51251	2
2	0	2	0	0	51252	2
2	0	2	0	0	51253	2
2	0	4	0	0	51254	2
2	0	2	0	0	51255	2
2	0	2	0	0	51256	2
2	0	2	0	0	51257	2
2	0	2	0	0	51258	2
2	0	2	0	0	51259	2
2	0	2	0	0	51260	2
2	0	2	0	0	51261	2
2	0	2	0	0	51262	2
2	0	2	0	0	51263	2
2	0	2	0	0	51264	2
2	0	2	0	0	51265	2
2	0	2	0	0	51266	2
2	0	2	0	0	51267	2
2	3	2	0	3	51268	0
2	0	2	8	8	51269	2
2	0	2	0	0	51270	2
2	0	2	0	0	51271	2
2	1	2	0	1	51272	1
2	0	2	8	8	51273	2
2	61	2	0	61	51274	0
2	3	2	710	713	51275	1
2	0	2	3	3	51276	2
2	0	2	0	0	51277	2
2	41	2	2	43	51278	0
2	0	2	282	282	51279	2
4	0	2	1	1	51280	2
2	1	2	0	1	51281	0
2	0	2	3	3	51282	2
2	0	2	0	0	51283	2
2	0	2	0	0	51284	2
2	0	2	0	0	51285	2
2	0	2	1	1	51286	2
2	0	4	2	2	51287	2
2	0	2	2	2	51288	2
2	0	4	33	33	51289	2
4	1	4	22	23	51290	1
4	0	4	38	38	51291	2
2	0	2	3	3	51292	2
2	0	2	0	0	51293	2
2	0	2	0	0	51294	2
2	0	2	0	0	51295	2
2	7	0	83	90	51296	0
4	0	2	4	4	51297	2
2	0	2	0	0	51298	2
2	3	2	5	8	51299	1
2	0	2	0	0	51300	2
2	0	2	0	0	51301	2
2	0	2	0	0	51302	2
2	0	2	2	2	51303	2
2	0	2	0	0	51304	2
2	0	2	0	0	51305	2
2	0	2	0	0	51306	2
2	0	2	0	0	51307	2
2	0	2	0	0	51308	2
2	0	2	0	0	51309	2
2	0	2	0	0	51310	2
2	0	2	0	0	51311	2
2	0	2	0	0	51312	2
2	0	2	0	0	51313	2
2	0	2	2	2	51314	2
2	0	2	0	0	51315	2
2	0	2	0	0	51316	2
2	0	2	1	1	51317	2
2	0	2	0	0	51318	2
2	0	2	0	0	51319	2
2	0	2	0	0	51320	2
2	0	2	0	0	51321	2
2	0	2	0	0	51322	2
2	0	2	0	0	51323	2
2	0	2	0	0	51324	2
2	0	2	0	0	51325	2
2	0	2	0	0	51326	2
2	0	2	0	0	51327	2
2	1	2	0	1	51328	0
2	1	2	0	1	51329	1
2	0	2	0	0	51330	2
2	0	2	0	0	51331	2
2	0	2	0	0	51332	2
2	0	2	0	0	51333	2
2	1	2	0	1	51334	0
2	0	2	0	0	51335	2
2	0	2	0	0	51336	2
2	0	2	0	0	51337	2
2	0	2	0	0	51338	2
2	0	2	0	0	51339	2
2	0	2	0	0	51340	2
2	0	2	0	0	51341	2
2	0	2	0	0	51342	2
2	0	2	0	0	51343	2
2	0	2	0	0	51344	2
2	0	2	0	0	51345	2
2	0	2	0	0	51346	2
2	0	2	0	0	51347	2
2	0	2	0	0	51348	2
2	0	2	0	0	51349	2
2	0	2	0	0	51350	2
2	0	2	0	0	51351	2
2	0	2	0	0	51352	2
2	8	2	11	19	51353	1
2	0	2	1	1	51354	2
2	0	2	0	0	51355	2
2	3	2	1	4	51356	0
2	0	2	6	6	51357	2
2	0	2	0	0	51358	2
2	0	2	4	4	51359	2
2	0	2	0	0	51360	2
2	0	2	0	0	51361	2
2	0	2	0	0	51362	2
2	0	2	1	1	51363	2
2	0	2	0	0	51364	2
2	0	2	0	0	51365	2
2	0	2	0	0	51366	2
2	0	2	0	0	51367	2
2	0	2	0	0	51368	2
2	0	2	0	0	51369	2
2	0	2	0	0	51370	2
2	0	2	0	0	51371	2
2	0	2	0	0	51372	2
2	0	2	0	0	51373	2
2	0	2	0	0	51374	2
2	0	2	0	0	51375	2
2	0	2	0	0	51376	2
2	0	2	0	0	51377	2
2	0	2	0	0	51378	2
2	0	2	0	0	51379	2
2	0	2	0	0	51380	2
2	0	2	0	0	51381	2
2	0	2	0	0	51382	2
2	1	2	2	3	51383	1
2	0	2	0	0	51384	2
2	0	2	0	0	51385	2
2	0	2	0	0	51386	2
2	0	2	0	0	51387	2
2	2	2	0	2	51388	0
2	0	2	114	114	51389	2
2	0	2	0	0	51390	2
2	0	2	0	0	51391	2
2	0	2	0	0	51392	2
2	0	2	1	1	51393	2
2	71	2	0	71	51394	0
2	3	2	639	642	51395	1
2	0	2	1	1	51396	2
2	0	2	1	1	51397	2
2	5	2	8	13	51398	0
2	0	2	5	5	51399	2
2	0	2	0	0	51400	2
2	0	2	0	0	51401	2
2	0	2	0	0	51402	2
2	0	2	0	0	51403	2
2	0	2	0	0	51404	2
2	0	2	0	0	51405	2
2	0	2	0	0	51406	2
2	0	2	0	0	51407	2
2	0	2	1	1	51408	2
2	0	2	0	0	51409	2
2	0	2	0	0	51410	2
2	0	2	0	0	51411	2
2	0	2	0	0	51412	2
2	0	2	0	0	51413	2
2	0	2	0	0	51414	2
2	0	2	0	0	51415	2
2	0	2	0	0	51416	2
2	0	2	0	0	51417	2
2	1	2	0	1	51418	0
2	1	2	25	26	51419	1
2	0	2	0	0	51420	2
2	0	2	0	0	51421	2
2	0	2	0	0	51422	2
2	0	2	2	2	51423	2
2	1	2	0	1	51424	0
2	4	2	3	7	51425	1
2	0	2	0	0	51426	2
2	0	2	0	0	51427	2
2	3	2	0	3	51428	1
2	0	2	11	11	51429	2
2	2	2	0	2	51430	0
2	0	2	8	8	51431	2
2	0	2	0	0	51432	2
2	0	2	0	0	51433	2
2	0	2	0	0	51434	2
2	0	2	3	3	51435	2
2	2	2	0	2	51436	0
2	0	2	28	28	51437	2
2	0	2	0	0	51438	2
2	0	2	0	0	51439	2
2	0	2	0	0	51440	2
2	0	2	0	0	51441	2
2	0	2	0	0	51442	2
2	0	2	6	6	51443	2
2	0	2	0	0	51444	2
2	0	2	0	0	51445	2
2	0	2	0	0	51446	2
2	0	2	2	2	51447	2
2	0	2	1	1	51448	2
2	0	2	0	0	51449	2
2	0	2	0	0	51450	2
2	1	2	20	21	51451	1
2	0	2	0	0	51452	2
2	0	2	0	0	51453	2
2	0	2	0	0	51454	2
2	0	2	0	0	51455	2
2	4	2	0	4	51456	0
2	0	2	0	0	51457	2
2	0	2	0	0	51458	2
2	5	2	0	5	51459	0
2	11	2	274	285	51460	1
2	0	2	14	14	51461	2
2	0	2	0	0	51462	2
2	4	2	0	4	51463	1
2	0	2	56	56	51464	2
2	1	2	0	1	51465	0
2	7	2	105	112	51466	1
2	0	2	1	1	51467	2
2	0	2	0	0	51468	2
2	2	2	0	2	51469	1
2	0	2	20	20	51470	2
2	1	2	0	1	51471	0
2	0	2	0	0	51472	2
2	0	2	0	0	51473	2
2	0	2	0	0	51474	2
2	1	2	0	1	51475	1
2	0	2	0	0	51476	2
2	0	2	0	0	51477	2
2	0	2	0	0	51478	2
2	0	2	0	0	51479	2
2	11	2	1	12	51480	0
2	12	2	487	499	51481	1
2	0	2	1	1	51482	2
2	0	2	0	0	51483	2
2	4	2	12	16	51484	0
2	0	2	36	36	51485	2
2	0	2	0	0	51486	2
2	0	2	0	0	51487	2
2	0	2	11	11	51488	2
2	0	2	0	0	51489	2
2	0	2	0	0	51490	2
2	0	2	0	0	51491	2
2	0	2	3	3	51492	2
2	7	2	226	233	51493	1
2	0	2	0	0	51494	2
2	0	2	0	0	51495	2
2	0	2	0	0	51496	2
2	0	2	1	1	51497	2
2	5	2	0	5	51498	0
2	0	2	106	106	51499	2
2	0	2	2	2	51500	2
2	0	2	0	0	51501	2
2	4	2	3	7	51502	0
2	0	2	22	22	51503	2
2	2	2	0	2	51504	0
2	2	2	0	2	51505	1
2	0	2	9	9	51506	2
2	1	2	23	24	51507	1
2	0	2	0	0	51508	2
2	0	2	0	0	51509	2
2	0	2	0	0	51510	2
2	0	2	0	0	51511	2
2	0	2	0	0	51512	2
2	0	2	0	0	51513	2
2	0	2	0	0	51514	2
2	0	2	0	0	51515	2
2	0	2	0	0	51516	2
2	0	2	0	0	51517	2
2	0	2	0	0	51518	2
2	0	2	0	0	51519	2
2	0	2	0	0	51520	2
2	0	2	0	0	51521	2
2	0	2	0	0	51522	2
2	0	2	1	1	51523	2
2	0	2	0	0	51524	2
2	0	2	0	0	51525	2
2	0	2	0	0	51526	2
2	0	2	0	0	51527	2
2	0	2	0	0	51528	2
2	0	2	0	0	51529	2
2	0	2	0	0	51530	2
2	1	2	0	1	51531	1
2	0	2	22	22	51532	2
2	3	2	0	3	51533	0
2	2	2	11	13	51534	1
2	0	2	2	2	51535	2
2	0	2	0	0	51536	2
2	0	2	0	0	51537	2
2	0	2	0	0	51538	2
2	0	2	0	0	51539	2
2	0	2	0	0	51540	2
2	0	2	0	0	51541	2
2	0	2	0	0	51542	2
2	0	2	0	0	51543	2
2	0	2	0	0	51544	2
2	0	2	0	0	51545	2
2	0	2	0	0	51546	2
2	0	2	0	0	51547	2
2	0	2	0	0	51548	2
2	0	2	0	0	51549	2
2	0	2	0	0	51550	2
2	0	2	0	0	51551	2
2	0	2	0	0	51552	2
2	0	2	0	0	51553	2
2	0	2	0	0	51554	2
2	0	2	0	0	51555	2
2	0	2	0	0	51556	2
2	0	2	0	0	51557	2
2	0	2	0	0	51558	2
2	0	2	0	0	51559	2
2	0	2	0	0	51560	2
2	0	2	0	0	51561	2
2	3	2	0	3	51562	0
2	17	2	2	19	51563	1
2	0	2	1	1	51564	2
2	0	2	0	0	51565	2
2	1	2	0	1	51566	1
2	0	2	1	1	51567	2
2	0	2	0	0	51568	2
2	0	2	0	0	51569	2
2	0	2	0	0	51570	2
2	0	2	2	2	51571	2
2	0	2	0	0	51572	2
2	0	2	0	0	51573	2
2	0	2	0	0	51574	2
2	0	2	13	13	51575	2
2	0	2	0	0	51576	2
2	0	2	0	0	51577	2
2	1	2	0	1	51578	0
2	0	2	2	2	51579	2
2	0	2	0	0	51580	2
2	0	2	0	0	51581	2
2	0	2	0	0	51582	2
2	0	2	0	0	51583	2
2	0	2	0	0	51584	2
2	0	2	0	0	51585	2
2	0	2	0	0	51586	2
2	0	2	0	0	51587	2
2	0	2	0	0	51588	2
2	0	2	0	0	51589	2
2	0	2	0	0	51590	2
2	0	2	0	0	51591	2
2	0	2	0	0	51592	2
2	0	2	0	0	51593	2
2	0	2	0	0	51594	2
2	0	2	0	0	51595	2
2	0	2	0	0	51596	2
2	0	2	0	0	51597	2
2	0	2	0	0	51598	2
2	0	2	0	0	51599	2
2	0	2	0	0	51600	2
2	0	2	0	0	51601	2
2	0	2	0	0	51602	2
2	0	2	0	0	51603	2
2	0	2	0	0	51604	2
2	0	2	0	0	51605	2
2	0	2	0	0	51606	2
2	0	2	0	0	51607	2
2	0	2	0	0	51608	2
2	0	2	0	0	51609	2
2	0	2	0	0	51610	2
2	0	2	0	0	51611	2
2	0	2	0	0	51612	2
2	34	4	83	117	51613	1
2	0	2	0	0	51614	2
2	0	2	0	0	51615	2
2	0	2	0	0	51616	2
2	0	2	0	0	51617	2
2	0	2	0	0	51618	2
2	0	2	0	0	51619	2
2	0	2	0	0	51620	2
2	0	2	0	0	51621	2
2	0	4	3	3	51622	2
2	0	2	1	1	51623	2
2	0	2	0	0	51624	2
2	0	2	0	0	51625	2
2	0	2	1	1	51626	2
2	0	2	0	0	51627	2
2	0	2	0	0	51628	2
2	0	2	0	0	51629	2
2	0	2	0	0	51630	2
2	1	2	0	1	51631	0
2	0	2	26	26	51632	2
2	0	2	0	0	51633	2
2	0	2	0	0	51634	2
2	0	2	1	1	51635	2
2	0	2	2	2	51636	2
2	0	2	0	0	51637	2
2	0	2	0	0	51638	2
2	0	2	0	0	51639	2
2	0	2	0	0	51640	2
2	0	2	0	0	51641	2
2	0	2	0	0	51642	2
2	8	2	0	8	51643	0
2	0	2	13	13	51644	2
2	0	2	2	2	51645	2
2	0	2	0	0	51646	2
2	4	2	0	4	51647	0
2	0	2	0	0	51648	2
2	0	2	0	0	51649	2
2	0	2	0	0	51650	2
2	0	2	0	0	51651	2
2	0	2	0	0	51652	2
2	0	2	0	0	51653	2
2	0	2	0	0	51654	2
2	0	2	0	0	51655	2
2	0	2	0	0	51656	2
2	0	2	0	0	51657	2
2	0	2	0	0	51658	2
2	0	2	0	0	51659	2
2	2	2	0	2	51660	0
2	2	2	17	19	51661	1
2	0	2	0	0	51662	2
2	0	2	0	0	51663	2
2	0	2	1	1	51664	2
2	0	2	1	1	51665	2
2	0	2	0	0	51666	2
2	0	2	0	0	51667	2
2	0	2	0	0	51668	2
2	0	2	0	0	51669	2
2	0	2	0	0	51670	2
2	0	2	0	0	51671	2
2	0	2	0	0	51672	2
2	1	0	17	18	51673	1
2	0	2	0	0	51674	2
2	0	2	0	0	51675	2
2	0	0	4	4	51676	2
2	0	2	3	3	51677	2
2	0	2	0	0	51678	2
2	1	2	24	25	51679	1
2	0	2	0	0	51680	2
2	0	2	0	0	51681	2
2	0	2	44	44	51682	2
2	0	2	0	0	51683	2
2	45	2	739	784	51684	0
2	28	2	0	28	51685	0
2	0	2	122	122	51686	2
2	0	4	1074	1074	51687	2
2	0	2	0	0	51688	2
2	0	2	0	0	51689	2
2	0	2	0	0	51690	2
2	0	2	0	0	51691	2
2	0	2	0	0	51692	2
2	0	2	0	0	51693	2
2	0	2	0	0	51694	2
2	0	2	0	0	51695	2
2	0	2	0	0	51696	2
2	0	2	0	0	51697	2
2	0	2	0	0	51698	2
2	0	2	0	0	51699	2
2	0	2	0	0	51700	2
2	0	2	0	0	51701	2
2	0	2	0	0	51702	2
2	0	2	0	0	51703	2
2	0	2	0	0	51704	2
2	0	2	0	0	51705	2
2	0	2	0	0	51706	2
2	0	2	0	0	51707	2
2	0	2	0	0	51708	2
2	0	2	0	0	51709	2
2	0	2	0	0	51710	2
2	0	2	0	0	51711	2
4	0	2	0	0	51712	2
2	0	2	0	0	51713	2
2	2	2	2	4	51714	1
2	0	2	0	0	51715	2
2	0	2	0	0	51716	2
2	0	2	1	1	51717	2
2	0	2	1	1	51718	2
2	1	2	0	1	51719	0
2	0	2	1	1	51720	2
2	0	2	0	0	51721	2
2	1	2	0	1	51722	0
2	0	2	4	4	51723	2
2	0	2	0	0	51724	2
2	0	2	0	0	51725	2
2	0	2	0	0	51726	2
2	0	2	0	0	51727	2
2	0	2	0	0	51728	2
2	0	2	0	0	51729	2
2	0	2	0	0	51730	2
2	0	2	0	0	51731	2
2	0	2	0	0	51732	2
2	0	2	0	0	51733	2
2	0	2	0	0	51734	2
2	1	2	0	1	51735	0
2	0	2	2	2	51736	2
2	0	2	0	0	51737	2
2	0	2	0	0	51738	2
2	0	2	0	0	51739	2
2	0	2	0	0	51740	2
2	0	2	0	0	51741	2
2	0	2	0	0	51742	2
2	0	2	0	0	51743	2
2	1	2	0	1	51744	1
2	0	2	1	1	51745	2
2	1	2	0	1	51746	1
2	0	2	0	0	51747	2
2	0	2	0	0	51748	2
2	0	2	0	0	51749	2
2	0	2	0	0	51750	2
2	0	2	0	0	51751	2
2	0	2	0	0	51752	2
2	0	2	0	0	51753	2
2	0	2	0	0	51754	2
2	0	2	0	0	51755	2
2	0	2	0	0	51756	2
2	0	2	2	2	51757	2
2	0	2	0	0	51758	2
2	0	2	0	0	51759	2
2	0	2	0	0	51760	2
2	0	2	0	0	51761	2
2	0	2	0	0	51762	2
2	0	2	0	0	51763	2
2	0	2	0	0	51764	2
2	0	2	0	0	51765	2
2	0	2	80	80	51766	2
2	0	2	0	0	51767	2
2	0	4	0	0	51768	2
2	0	2	0	0	51769	2
2	0	2	0	0	51770	2
2	0	4	0	0	51771	2
2	0	2	0	0	51772	2
2	0	2	0	0	51773	2
2	0	2	0	0	51774	2
2	0	2	0	0	51775	2
2	0	2	0	0	51776	2
2	0	2	1	1	51777	2
2	0	2	0	0	51778	2
2	0	2	0	0	51779	2
2	0	2	0	0	51780	2
2	0	2	0	0	51781	2
2	0	2	0	0	51782	2
2	0	2	0	0	51783	2
2	0	2	0	0	51784	2
4	0	2	0	0	51785	2
2	0	2	0	0	51786	2
2	0	4	1	1	51787	2
2	0	2	0	0	51788	2
2	0	2	0	0	51789	2
2	0	4	0	0	51790	2
2	0	2	0	0	51791	2
2	1	2	0	1	51792	0
2	0	2	10	10	51793	2
2	0	2	0	0	51794	2
2	0	2	0	0	51795	2
2	0	2	0	0	51796	2
2	0	2	5	5	51797	2
2	0	2	0	0	51798	2
2	4	4	765	769	51799	1
2	0	2	1	1	51800	2
2	0	2	0	0	51801	2
2	1	4	0	1	51802	0
2	0	2	5	5	51803	2
2	6	2	21	27	51804	1
2	0	2	1	1	51805	2
2	0	2	0	0	51806	2
2	0	2	13	13	51807	2
2	289	2	0	289	51808	0
2	3	2	0	3	51809	0
2	0	2	10	10	51810	2
0	0	2	3	3	51811	2
2	0	2	0	0	51812	2
2	0	2	0	0	51813	2
2	0	2	0	0	51814	2
2	0	2	0	0	51815	2
2	1	2	0	1	51816	0
2	0	2	3	3	51817	2
2	0	2	0	0	51818	2
2	0	2	0	0	51819	2
2	0	2	0	0	51820	2
2	0	2	1	1	51821	2
2	0	2	0	0	51822	2
2	0	2	0	0	51823	2
2	1	2	0	1	51824	1
2	0	2	0	0	51825	2
2	0	2	0	0	51826	2
2	0	2	0	0	51827	2
2	0	2	0	0	51828	2
2	0	2	0	0	51829	2
2	0	2	0	0	51830	2
2	0	2	0	0	51831	2
2	0	2	0	0	51832	2
2	27	2	0	27	51833	0
2	0	2	148	148	51834	2
2	0	2	0	0	51835	2
2	0	2	1	1	51836	2
2	0	2	0	0	51837	2
2	0	2	7	7	51838	2
2	1	2	0	1	51839	0
2	0	2	1	1	51840	2
2	0	2	0	0	51841	2
2	0	2	0	0	51842	2
2	0	2	0	0	51843	2
2	0	2	3	3	51844	2
2	18	2	0	18	51845	0
2	1	2	19	20	51846	0
2	0	2	0	0	51847	2
2	0	2	0	0	51848	2
2	4	2	0	4	51849	0
2	1	2	2	3	51850	1
2	0	2	1	1	51851	2
2	0	2	0	0	51852	2
2	4	2	0	4	51853	0
2	0	2	0	0	51854	2
2	2	2	0	2	51855	1
2	0	2	1	1	51856	2
2	1	2	11	12	51857	1
2	0	2	1	1	51858	2
2	0	2	0	0	51859	2
2	0	2	0	0	51860	2
2	0	2	0	0	51861	2
2	0	2	0	0	51862	2
2	0	2	0	0	51863	2
2	0	2	0	0	51864	2
2	0	2	0	0	51865	2
2	0	2	0	0	51866	2
2	1	2	0	1	51867	1
2	0	2	0	0	51868	2
2	0	2	0	0	51869	2
2	0	2	0	0	51870	2
2	0	2	0	0	51871	2
2	0	2	0	0	51872	2
2	0	2	0	0	51873	2
2	0	2	0	0	51874	2
2	0	2	0	0	51875	2
2	0	2	0	0	51876	2
2	0	2	0	0	51877	2
2	29	2	0	29	51878	0
2	0	2	0	0	51879	2
2	0	2	0	0	51880	2
2	0	2	0	0	51881	2
2	0	2	0	0	51882	2
2	0	2	0	0	51883	2
2	0	2	0	0	51884	2
2	18	2	82	100	51885	1
2	0	2	5	5	51886	2
2	0	2	0	0	51887	2
2	18	2	0	18	51888	0
2	0	2	55	55	51889	2
2	1	2	0	1	51890	0
2	0	2	0	0	51891	2
2	0	2	0	0	51892	2
2	0	2	0	0	51893	2
2	0	2	0	0	51894	2
2	0	2	0	0	51895	2
2	0	2	0	0	51896	2
2	1	2	67	68	51897	1
2	0	2	0	0	51898	2
2	0	2	0	0	51899	2
2	3	2	12	15	51900	0
2	0	2	8	8	51901	2
2	38	2	0	38	51902	0
2	60	2	120	180	51903	1
2	0	2	23	23	51904	2
2	0	2	0	0	51905	2
2	56	2	4	60	51906	1
2	1	2	0	1	51907	0
2	2	2	0	2	51908	0
2	0	2	0	0	51909	2
2	0	4	6	6	51910	2
2	0	2	0	0	51911	2
2	0	2	0	0	51912	2
2	0	4	14	14	51913	2
2	0	2	0	0	51914	2
2	1	2	0	1	51915	0
2	0	2	0	0	51916	2
2	0	2	0	0	51917	2
2	0	2	0	0	51918	2
2	0	2	0	0	51919	2
2	0	2	0	0	51920	2
2	0	2	0	0	51921	2
2	2	2	25	27	51922	1
2	0	2	0	0	51923	2
2	0	2	0	0	51924	2
2	0	2	1	1	51925	2
2	0	2	6	6	51926	2
2	0	2	0	0	51927	2
2	0	2	0	0	51928	2
2	0	2	0	0	51929	2
2	0	2	5	5	51930	2
4	2	2	1	3	51931	1
4	0	4	1	1	51932	2
4	0	4	0	0	51933	2
4	0	4	0	0	51934	2
4	0	4	0	0	51935	2
4	0	4	0	0	51936	2
4	710	2	120	830	51937	0
4	32	2	4	36	51938	0
2	10	2	0	10	51939	0
2	7	2	30	37	51940	1
2	0	2	8	8	51941	2
2	0	2	0	0	51942	2
2	7	2	0	7	51943	0
2	0	2	0	0	51944	2
2	2	2	0	2	51945	1
2	0	2	1	1	51946	2
2	0	2	0	0	51947	2
2	0	2	0	0	51948	2
2	0	2	0	0	51949	2
2	1	2	0	1	51950	0
2	0	2	0	0	51951	2
2	0	2	0	0	51952	2
2	0	2	0	0	51953	2
2	0	2	0	0	51954	2
2	5	2	0	5	51955	0
2	1	2	46	47	51956	1
2	0	2	1	1	51957	2
2	0	2	0	0	51958	2
2	1	2	0	1	51959	0
2	0	2	1	1	51960	2
2	1	2	0	1	51961	0
2	21	2	31	52	51962	1
2	0	2	1	1	51963	2
2	0	2	0	0	51964	2
2	2	2	0	2	51965	0
2	0	2	10	10	51966	2
2	0	2	0	0	51967	2
2	3	2	3	6	51968	1
2	0	2	0	0	51969	2
2	0	2	0	0	51970	2
2	2	2	0	2	51971	1
2	0	2	6	6	51972	2
2	0	2	0	0	51973	2
2	0	2	0	0	51974	2
2	0	2	0	0	51975	2
2	0	2	0	0	51976	2
2	0	2	0	0	51977	2
2	0	2	0	0	51978	2
2	1	2	0	1	51979	0
2	0	2	0	0	51980	2
2	0	2	0	0	51981	2
2	0	2	0	0	51982	2
2	0	2	0	0	51983	2
2	0	2	0	0	51984	2
2	0	2	0	0	51985	2
2	0	2	0	0	51986	2
2	0	2	0	0	51987	2
2	0	2	0	0	51988	2
2	0	2	0	0	51989	2
2	0	2	0	0	51990	2
2	0	2	0	0	51991	2
2	0	2	0	0	51992	2
2	0	2	0	0	51993	2
2	0	2	0	0	51994	2
2	0	2	0	0	51995	2
2	0	2	0	0	51996	2
2	0	2	0	0	51997	2
2	0	2	0	0	51998	2
2	0	2	0	0	51999	2
2	0	2	0	0	52000	2
2	0	2	0	0	52001	2
2	0	2	0	0	52002	2
2	0	2	0	0	52003	2
2	0	2	0	0	52004	2
2	0	2	0	0	52005	2
2	0	2	0	0	52006	2
2	0	2	0	0	52007	2
2	0	2	0	0	52008	2
2	0	2	0	0	52009	2
2	0	2	0	0	52010	2
2	0	2	0	0	52011	2
2	0	2	0	0	52012	2
2	0	2	0	0	52013	2
2	0	2	0	0	52014	2
2	0	2	0	0	52015	2
2	0	2	0	0	52016	2
2	0	2	0	0	52017	2
2	0	2	0	0	52018	2
2	0	2	0	0	52019	2
2	0	2	0	0	52020	2
2	9	2	0	9	52021	0
2	0	2	0	0	52022	2
2	0	2	0	0	52023	2
2	0	2	0	0	52024	2
2	0	2	0	0	52025	2
2	0	2	0	0	52026	2
2	0	2	0	0	52027	2
2	22	2	0	22	52028	0
2	0	2	4	4	52029	2
2	0	2	0	0	52030	2
2	7	2	105	112	52031	1
2	0	2	3	3	52032	2
2	0	2	0	0	52033	2
2	7	2	0	7	52034	0
2	0	2	26	26	52035	2
2	1	2	0	1	52036	0
2	2	2	18	20	52037	1
2	0	2	6	6	52038	2
2	0	2	0	0	52039	2
2	1	2	0	1	52040	1
2	0	2	10	10	52041	2
2	2	2	0	2	52042	0
2	0	2	3	3	52043	2
2	0	2	0	0	52044	2
2	0	2	0	0	52045	2
2	2	2	0	2	52046	0
2	0	2	0	0	52047	2
2	0	2	0	0	52048	2
2	0	2	0	0	52049	2
2	0	2	0	0	52050	2
2	0	2	0	0	52051	2
2	0	2	0	0	52052	2
2	0	2	0	0	52053	2
2	0	2	0	0	52054	2
2	0	2	0	0	52055	2
2	0	2	0	0	52056	2
4	0	2	0	0	52057	2
2	0	2	0	0	52058	2
2	0	2	0	0	52059	2
2	0	2	0	0	52060	2
2	0	2	0	0	52061	2
2	0	2	0	0	52062	2
2	0	2	0	0	52063	2
2	0	2	1	1	52064	2
2	0	2	0	0	52065	2
2	0	2	0	0	52066	2
2	0	2	0	0	52067	2
2	0	2	0	0	52068	2
2	0	2	0	0	52069	2
2	0	2	0	0	52070	2
2	1	2	2	3	52071	1
2	0	2	1	1	52072	2
2	145	2	0	145	52073	0
2	0	2	0	0	52074	2
2	0	2	0	0	52075	2
2	0	2	0	0	52076	2
2	0	2	0	0	52077	2
2	0	2	0	0	52078	2
2	0	2	0	0	52079	2
2	0	2	0	0	52080	2
2	0	2	0	0	52081	2
2	0	2	0	0	52082	2
2	0	2	0	0	52083	2
2	0	4	37	37	52084	2
2	0	2	0	0	52085	2
2	0	2	0	0	52086	2
2	0	4	2	2	52087	2
2	0	2	0	0	52088	2
2	0	2	0	0	52089	2
2	0	2	0	0	52090	2
2	0	2	0	0	52091	2
2	0	2	0	0	52092	2
2	0	2	0	0	52093	2
2	0	2	0	0	52094	2
2	0	2	0	0	52095	2
2	0	2	0	0	52096	2
2	0	2	0	0	52097	2
2	0	2	0	0	52098	2
2	0	2	0	0	52099	2
2	96	2	0	96	52100	0
2	1	2	25	26	52101	1
2	0	2	0	0	52102	2
2	0	2	0	0	52103	2
2	0	2	0	0	52104	2
2	0	2	0	0	52105	2
2	0	2	0	0	52106	2
2	0	2	0	0	52107	2
2	0	2	0	0	52108	2
2	0	2	0	0	52109	2
2	0	2	4	4	52110	2
2	0	2	0	0	52111	2
2	0	2	0	0	52112	2
4	0	2	0	0	52113	2
2	0	2	0	0	52114	2
2	0	2	3	3	52115	2
2	0	2	0	0	52116	2
2	0	2	0	0	52117	2
2	0	2	3	3	52118	2
2	0	2	0	0	52119	2
2	0	2	0	0	52120	2
2	0	2	0	0	52121	2
2	0	2	0	0	52122	2
2	0	2	0	0	52123	2
2	0	2	0	0	52124	2
2	0	2	0	0	52125	2
2	0	2	0	0	52126	2
2	0	2	0	0	52127	2
2	0	2	0	0	52128	2
2	0	2	1	1	52129	2
2	0	2	0	0	52130	2
2	0	2	0	0	52131	2
2	1	2	0	1	52132	1
2	0	2	0	0	52133	2
2	0	2	0	0	52134	2
2	0	2	0	0	52135	2
2	0	2	0	0	52136	2
2	0	2	0	0	52137	2
2	0	2	0	0	52138	2
2	0	2	0	0	52139	2
2	0	2	0	0	52140	2
2	3	2	0	3	52141	0
2	0	2	8	8	52142	2
2	0	2	0	0	52143	2
2	0	2	0	0	52144	2
2	0	2	0	0	52145	2
2	0	2	0	0	52146	2
2	0	2	0	0	52147	2
2	3	2	0	3	52148	0
2	0	2	28	28	52149	2
2	3	2	0	3	52150	0
2	2	2	6	8	52151	1
2	0	2	1	1	52152	2
2	0	2	0	0	52153	2
2	0	2	0	0	52154	2
2	0	2	0	0	52155	2
2	0	2	0	0	52156	2
2	0	2	0	0	52157	2
2	0	2	0	0	52158	2
2	0	4	0	0	52159	2
2	0	2	0	0	52160	2
2	0	2	0	0	52161	2
2	0	2	0	0	52162	2
2	0	2	0	0	52163	2
2	1	2	0	1	52164	0
2	0	4	0	0	52165	2
2	0	2	0	0	52166	2
2	0	4	31	31	52167	2
2	0	2	1	1	52168	2
2	0	2	0	0	52169	2
2	4	2	0	4	52170	0
2	15	2	63	78	52171	1
2	0	2	0	0	52172	2
2	0	2	1	1	52173	2
4	0	2	0	0	52174	2
2	0	2	2	2	52175	2
2	0	2	6	6	52176	2
2	0	2	0	0	52177	2
2	0	2	0	0	52178	2
2	0	2	0	0	52179	2
2	0	2	0	0	52180	2
2	0	2	0	0	52181	2
2	0	2	0	0	52182	2
2	0	2	0	0	52183	2
2	0	2	2	2	52184	2
2	0	2	0	0	52185	2
2	0	2	0	0	52186	2
2	1	2	1	2	52187	1
2	0	2	0	0	52188	2
2	0	2	0	0	52189	2
2	0	2	0	0	52190	2
2	0	2	0	0	52191	2
2	0	2	0	0	52192	2
2	0	2	0	0	52193	2
2	0	2	0	0	52194	2
2	0	2	0	0	52195	2
2	0	2	0	0	52196	2
2	0	2	0	0	52197	2
2	0	2	0	0	52198	2
2	0	2	1	1	52199	2
2	0	2	0	0	52200	2
2	0	2	0	0	52201	2
2	0	2	0	0	52202	2
2	0	2	0	0	52203	2
2	0	2	0	0	52204	2
2	0	2	0	0	52205	2
2	0	2	0	0	52206	2
2	0	2	0	0	52207	2
2	0	2	0	0	52208	2
2	0	2	0	0	52209	2
2	0	2	0	0	52210	2
2	0	2	0	0	52211	2
2	0	2	0	0	52212	2
2	53	2	0	53	52213	0
2	5	2	102	107	52214	1
2	0	2	0	0	52215	2
2	0	2	0	0	52216	2
2	2	2	0	2	52217	1
2	0	2	32	32	52218	2
2	4	2	1	5	52219	0
2	0	2	0	0	52220	2
2	0	2	2	2	52221	2
2	0	2	0	0	52222	2
2	0	2	0	0	52223	2
2	0	2	0	0	52224	2
2	0	2	0	0	52225	2
2	1	2	61	62	52226	1
2	0	2	2	2	52227	2
2	0	2	0	0	52228	2
2	2	2	0	2	52229	1
2	0	2	15	15	52230	2
2	0	2	0	0	52231	2
2	0	2	0	0	52232	2
2	0	2	0	0	52233	2
2	0	2	0	0	52234	2
2	0	2	0	0	52235	2
2	0	2	0	0	52236	2
2	0	2	0	0	52237	2
2	0	4	2	2	52238	2
2	0	2	0	0	52239	2
2	0	2	0	0	52240	2
2	0	4	0	0	52241	2
2	0	2	0	0	52242	2
2	50	2	2011	2061	52243	1
2	33	2	0	33	52244	0
2	0	2	187	187	52245	2
2	0	2	0	0	52246	2
2	0	2	2	2	52247	2
2	0	2	0	0	52248	2
2	0	2	0	0	52249	2
2	0	2	1	1	52250	2
2	0	2	0	0	52251	2
2	338	2	1	339	52252	0
2	157	2	10834	10991	52253	1
2	0	2	6	6	52254	2
2	0	2	0	0	52255	2
2	53	2	11	64	52256	0
2	0	2	368	368	52257	2
4	289	2	2	291	52258	0
4	349	2	1	350	52259	0
2	3	2	0	3	52260	0
2	0	2	1	1	52261	2
2	0	2	0	0	52262	2
2	0	2	0	0	52263	2
2	0	2	0	0	52264	2
2	0	2	0	0	52265	2
2	0	2	0	0	52266	2
2	0	2	0	0	52267	2
2	0	2	0	0	52268	2
2	0	2	0	0	52269	2
2	0	2	2	2	52270	2
2	0	2	0	0	52271	2
2	0	2	0	0	52272	2
2	0	2	0	0	52273	2
2	0	2	0	0	52274	2
2	0	2	2	2	52275	2
2	0	2	1	1	52276	2
2	0	2	0	0	52277	2
2	0	2	2	2	52278	2
2	0	2	0	0	52279	2
2	0	2	0	0	52280	2
2	0	2	0	0	52281	2
2	0	2	1	1	52282	2
2	0	2	0	0	52283	2
2	0	2	1	1	52284	2
2	0	2	0	0	52285	2
2	0	2	0	0	52286	2
2	0	2	0	0	52287	2
2	0	2	0	0	52288	2
2	0	2	0	0	52289	2
2	0	4	6	6	52290	2
2	0	2	0	0	52291	2
2	0	2	0	0	52292	2
2	0	4	0	0	52293	2
2	0	2	0	0	52294	2
2	2	2	0	2	52295	0
2	3	2	16	19	52296	1
2	0	2	0	0	52297	2
2	0	2	0	0	52298	2
2	0	2	4499	4499	52299	2
2	0	2	1	1	52300	2
2	0	2	0	0	52301	2
2	7	2	23	30	52302	1
2	0	2	0	0	52303	2
2	0	2	0	0	52304	2
2	3	2	0	3	52305	1
2	1	2	0	1	52306	0
2	0	2	1	1	52307	2
2	0	2	22	22	52308	2
2	0	2	0	0	52309	2
2	0	2	0	0	52310	2
2	0	2	0	0	52311	2
2	0	2	0	0	52312	2
2	0	2	0	0	52313	2
2	0	2	0	0	52314	2
2	0	2	0	0	52315	2
2	0	2	1	1	52316	2
2	0	2	0	0	52317	2
2	0	2	0	0	52318	2
2	0	2	0	0	52319	2
2	0	4	77	77	52320	2
2	0	2	0	0	52321	2
2	0	2	0	0	52322	2
2	0	4	1	1	52323	2
2	0	2	0	0	52324	2
2	0	2	0	0	52325	2
2	0	2	0	0	52326	2
2	0	2	0	0	52327	2
2	0	2	0	0	52328	2
2	0	2	0	0	52329	2
2	0	2	0	0	52330	2
2	0	2	0	0	52331	2
2	0	2	0	0	52332	2
2	0	2	0	0	52333	2
2	0	2	0	0	52334	2
2	0	2	0	0	52335	2
2	0	2	0	0	52336	2
2	0	2	0	0	52337	2
2	0	2	0	0	52338	2
2	0	2	0	0	52339	2
2	0	2	0	0	52340	2
2	0	2	0	0	52341	2
2	0	2	0	0	52342	2
2	0	2	0	0	52343	2
2	0	2	0	0	52344	2
2	0	2	0	0	52345	2
2	0	2	0	0	52346	2
2	0	2	0	0	52347	2
2	0	2	0	0	52348	2
2	0	2	0	0	52349	2
2	0	2	1	1	52350	2
2	0	2	0	0	52351	2
2	0	2	0	0	52352	2
2	0	2	0	0	52353	2
2	0	2	0	0	52354	2
4	0	4	2	2	52355	2
4	0	4	0	0	52356	2
4	2	0	239	241	52357	1
4	6	0	161	167	52358	1
2	0	2	0	0	52359	2
2	0	2	0	0	52360	2
2	0	2	0	0	52361	2
2	0	2	0	0	52362	2
2	0	2	8	8	52363	2
2	0	2	0	0	52364	2
2	0	2	0	0	52365	2
2	0	2	5	5	52366	2
2	0	2	0	0	52367	2
2	0	2	0	0	52368	2
2	0	2	0	0	52369	2
2	0	2	0	0	52370	2
2	466	2	0	466	52371	0
2	0	2	2	2	52372	2
2	0	2	1	1	52373	2
2	0	2	0	0	52374	2
2	0	4	4	4	52375	2
2	0	2	0	0	52376	2
2	0	2	0	0	52377	2
2	0	4	0	0	52378	2
2	0	2	0	0	52379	2
2	0	2	0	0	52380	2
2	4	4	13	17	52381	1
2	0	2	0	0	52382	2
2	0	2	0	0	52383	2
2	0	4	5	5	52384	2
2	0	2	0	0	52385	2
2	0	2	0	0	52386	2
2	0	2	0	0	52387	2
2	0	2	2	2	52388	2
2	0	2	0	0	52389	2
2	0	4	0	0	52390	2
2	0	2	0	0	52391	2
2	0	4	0	0	52392	2
2	0	2	0	0	52393	2
2	0	2	0	0	52394	2
2	3	2	0	3	52395	0
2	1	2	0	1	52396	0
2	0	2	2	2	52397	2
2	0	2	1	1	52398	2
2	0	2	0	0	52399	2
2	0	2	0	0	52400	2
2	0	2	0	0	52401	2
2	4	2	0	4	52402	0
2	8	2	62	70	52403	1
2	0	2	6	6	52404	2
2	0	2	1	1	52405	2
2	5	2	0	5	52406	1
2	0	2	6	6	52407	2
2	0	2	0	0	52408	2
2	0	2	0	0	52409	2
2	0	2	0	0	52410	2
2	0	2	0	0	52411	2
2	0	2	0	0	52412	2
2	0	2	0	0	52413	2
2	0	2	0	0	52414	2
2	0	2	0	0	52415	2
2	0	2	0	0	52416	2
2	0	2	0	0	52417	2
2	0	2	0	0	52418	2
2	0	2	0	0	52419	2
2	0	2	0	0	52420	2
2	0	2	0	0	52421	2
2	0	2	0	0	52422	2
2	0	2	0	0	52423	2
2	0	2	0	0	52424	2
2	0	2	0	0	52425	2
2	0	2	0	0	52426	2
2	0	2	0	0	52427	2
2	0	2	0	0	52428	2
2	0	2	0	0	52429	2
2	0	2	0	0	52430	2
2	0	2	0	0	52431	2
2	0	2	0	0	52432	2
2	0	2	0	0	52433	2
2	0	2	0	0	52434	2
2	0	2	0	0	52435	2
2	0	2	0	0	52436	2
2	0	2	0	0	52437	2
2	21	2	0	21	52438	0
2	8	4	5693	5701	52439	0
2	0	2	6	6	52440	2
2	0	2	0	0	52441	2
2	10	4	5202	5212	52442	0
2	0	2	77	77	52443	2
2	0	2	0	0	52444	2
2	0	2	1	1	52445	2
2	0	2	0	0	52446	2
2	0	2	0	0	52447	2
2	0	2	0	0	52448	2
2	0	2	0	0	52449	2
2	0	2	0	0	52450	2
2	0	2	22	22	52451	2
2	0	2	0	0	52452	2
2	0	2	0	0	52453	2
2	0	2	6	6	52454	2
2	0	2	0	0	52455	2
2	19	2	0	19	52456	0
2	0	2	0	0	52457	2
2	0	2	0	0	52458	2
2	0	2	0	0	52459	2
2	0	2	0	0	52460	2
2	0	2	0	0	52461	2
2	0	2	0	0	52462	2
4	2944	2	22	2966	52463	0
4	292	2	6	298	52464	0
2	0	2	0	0	52465	2
2	0	2	0	0	52466	2
2	1	2	0	1	52467	0
2	0	2	0	0	52468	2
2	0	2	0	0	52469	2
2	0	2	0	0	52470	2
2	0	2	0	0	52471	2
2	0	2	0	0	52472	2
2	0	2	0	0	52473	2
2	6	2	11	17	52474	1
2	0	2	2	2	52475	2
2	0	2	0	0	52476	2
2	2	2	0	2	52477	0
2	0	2	6	6	52478	2
2	0	2	0	0	52479	2
2	0	2	0	0	52480	2
2	1	2	0	1	52481	1
2	0	2	0	0	52482	2
2	0	2	0	0	52483	2
2	0	2	0	0	52484	2
2	0	2	0	0	52485	2
2	0	2	0	0	52486	2
2	0	2	0	0	52487	2
2	0	2	0	0	52488	2
2	0	2	0	0	52489	2
2	0	2	0	0	52490	2
2	0	2	0	0	52491	2
2	0	2	0	0	52492	2
2	0	2	0	0	52493	2
2	0	2	0	0	52494	2
2	0	2	0	0	52495	2
2	0	2	0	0	52496	2
2	0	2	0	0	52497	2
2	0	4	150	150	52498	2
2	0	2	0	0	52499	2
2	0	2	0	0	52500	2
2	0	4	52	52	52501	2
2	0	2	0	0	52502	2
2	26	2	1	27	52503	0
2	0	2	7	7	52504	2
2	0	2	0	0	52505	2
2	1	2	0	1	52506	1
2	1	2	1	2	52507	1
2	0	2	0	0	52508	2
2	0	2	0	0	52509	2
2	0	2	0	0	52510	2
2	6	2	10482	10488	52511	0
2	67	2	2	69	52512	0
2	0	2	444	444	52513	2
2	164	2	1	165	52514	0
2	2	2	5375	5377	52515	1
2	0	2	46	46	52516	2
2	0	2	2	2	52517	2
2	106	2	268	374	52518	0
2	0	2	1408	1408	52519	2
2	1	2	0	1	52520	0
2	1	2	140	141	52521	1
2	0	2	0	0	52522	2
2	0	2	0	0	52523	2
2	4	2	6	10	52524	1
2	0	2	22	22	52525	2
2	0	2	0	0	52526	2
2	0	2	0	0	52527	2
2	0	2	0	0	52528	2
2	330	2	9506	9836	52529	0
2	204	2	0	204	52530	0
2	0	2	1076	1076	52531	2
2	16	2	0	16	52532	0
2	0	2	55	55	52533	2
2	0	2	2	2	52534	2
2	0	2	0	0	52535	2
2	6	2	3	9	52536	0
2	0	2	43	43	52537	2
2	0	2	0	0	52538	2
2	0	2	0	0	52539	2
2	0	2	0	0	52540	2
2	0	2	0	0	52541	2
2	0	2	0	0	52542	2
2	0	2	0	0	52543	2
2	0	2	0	0	52544	2
2	0	2	0	0	52545	2
2	0	2	0	0	52546	2
2	0	2	0	0	52547	2
2	0	2	0	0	52548	2
2	0	2	0	0	52549	2
2	0	2	0	0	52550	2
2	0	2	0	0	52551	2
2	0	2	0	0	52552	2
2	0	2	0	0	52553	2
2	0	2	0	0	52554	2
2	0	2	0	0	52555	2
2	0	2	0	0	52556	2
2	0	4	0	0	52557	2
2	0	2	1	1	52558	2
2	0	4	1	1	52559	2
2	0	2	0	0	52560	2
2	0	2	0	0	52561	2
2	51	2	0	51	52562	0
2	0	2	486	486	52563	2
2	0	2	1	1	52564	2
2	0	2	0	0	52565	2
2	5	2	0	5	52566	0
2	0	2	19	19	52567	2
2	0	2	0	0	52568	2
2	0	2	0	0	52569	2
2	0	2	0	0	52570	2
2	0	2	0	0	52571	2
2	0	2	0	0	52572	2
2	0	2	0	0	52573	2
2	0	2	0	0	52574	2
2	0	0	6	6	52575	2
2	0	2	0	0	52576	2
2	0	2	0	0	52577	2
2	0	2	0	0	52578	2
2	0	2	0	0	52579	2
2	0	2	0	0	52580	2
2	0	2	0	0	52581	2
2	0	2	0	0	52582	2
2	0	2	0	0	52583	2
2	0	2	0	0	52584	2
2	0	2	0	0	52585	2
2	0	2	0	0	52586	2
2	0	2	0	0	52587	2
2	0	2	0	0	52588	2
2	0	2	0	0	52589	2
2	0	2	0	0	52590	2
2	0	2	0	0	52591	2
2	0	2	0	0	52592	2
2	0	2	0	0	52593	2
2	0	2	0	0	52594	2
2	0	2	0	0	52595	2
2	0	2	1	1	52596	2
2	0	2	0	0	52597	2
2	0	2	0	0	52598	2
2	0	2	0	0	52599	2
2	0	2	0	0	52600	2
2	0	2	0	0	52601	2
2	0	2	0	0	52602	2
2	0	2	0	0	52603	2
2	0	2	0	0	52604	2
2	0	2	0	0	52605	2
2	0	2	0	0	52606	2
2	0	2	0	0	52607	2
2	0	2	0	0	52608	2
2	0	2	0	0	52609	2
2	0	2	0	0	52610	2
2	0	2	0	0	52611	2
2	0	2	0	0	52612	2
2	11	2	0	11	52613	0
2	2	2	7	9	52614	1
2	0	2	0	0	52615	2
2	0	2	0	0	52616	2
2	1	2	0	1	52617	0
2	0	2	0	0	52618	2
2	3	4	284	287	52619	1
2	0	2	0	0	52620	2
2	0	2	0	0	52621	2
2	0	4	281	281	52622	2
2	0	2	1	1	52623	2
2	0	2	0	0	52624	2
2	0	0	0	0	52625	2
2	0	2	1	1	52626	2
2	0	2	0	0	52627	2
2	0	2	0	0	52628	2
2	0	2	0	0	52629	2
2	0	2	0	0	52630	2
2	0	2	0	0	52631	2
2	0	2	1	1	52632	2
2	0	2	0	0	52633	2
2	0	2	0	0	52634	2
2	0	2	0	0	52635	2
2	0	2	0	0	52636	2
2	0	2	0	0	52637	2
2	0	2	0	0	52638	2
2	0	2	0	0	52639	2
2	0	2	0	0	52640	2
2	0	2	0	0	52641	2
2	0	2	0	0	52642	2
2	0	2	0	0	52643	2
2	0	2	0	0	52644	2
2	0	2	0	0	52645	2
2	0	2	0	0	52646	2
2	0	2	0	0	52647	2
2	0	2	0	0	52648	2
2	0	2	0	0	52649	2
2	0	2	0	0	52650	2
2	0	2	0	0	52651	2
2	0	2	0	0	52652	2
2	0	2	0	0	52653	2
2	1	2	0	1	52654	0
2	0	2	30	30	52655	2
2	0	2	0	0	52656	2
2	0	2	0	0	52657	2
2	2	2	0	2	52658	1
2	0	2	9	9	52659	2
2	0	2	0	0	52660	2
2	0	2	0	0	52661	2
2	0	2	0	0	52662	2
2	0	2	0	0	52663	2
2	0	2	0	0	52664	2
2	0	2	0	0	52665	2
4	1	2	0	1	52666	1
2	7	2	0	7	52667	0
2	0	2	0	0	52668	2
2	0	2	0	0	52669	2
2	0	2	0	0	52670	2
2	0	2	0	0	52671	2
2	0	2	0	0	52672	2
2	3	2	0	3	52673	0
2	5	2	18	23	52674	1
2	0	2	0	0	52675	2
2	0	2	0	0	52676	2
2	0	2	1	1	52677	2
2	0	2	7	7	52678	2
2	0	2	0	0	52679	2
2	0	2	0	0	52680	2
2	0	2	0	0	52681	2
2	0	2	0	0	52682	2
4	0	4	0	0	52683	2
4	0	4	0	0	52684	2
2	74	2	0	74	52685	0
2	0	2	6	6	52686	2
2	0	2	2	2	52687	2
2	121	2	1	122	52688	0
2	92	2	0	92	52689	0
2	36	2	529	565	52690	1
2	0	2	5	5	52691	2
2	0	2	2	2	52692	2
2	22	2	10	32	52693	0
2	0	2	57	57	52694	2
2	0	2	0	0	52695	2
2	0	2	0	0	52696	2
2	0	2	0	0	52697	2
2	0	2	0	0	52698	2
2	0	2	0	0	52699	2
2	0	2	0	0	52700	2
2	0	2	0	0	52701	2
2	0	2	0	0	52702	2
2	0	2	0	0	52703	2
2	0	2	0	0	52704	2
2	0	2	0	0	52705	2
2	0	2	0	0	52706	2
2	0	2	0	0	52707	2
2	0	2	0	0	52708	2
2	0	2	0	0	52709	2
2	0	2	0	0	52710	2
2	0	2	0	0	52711	2
2	0	2	0	0	52712	2
2	0	2	0	0	52713	2
2	22	2	0	22	52714	0
2	0	2	1	1	52715	2
2	0	2	1	1	52716	2
2	112	4	11674	11786	52717	0
2	1	2	5	6	52718	1
2	0	2	0	0	52719	2
2	8	4	2915	2923	52720	0
2	0	2	64	64	52721	2
2	846	2	2	848	52722	0
2	157	4	15554	15711	52723	1
2	0	2	4	4	52724	2
2	0	2	0	0	52725	2
2	186	4	392	578	52726	0
2	0	2	1349	1349	52727	2
2	15	2	0	15	52728	0
2	11	2	0	11	52729	1
2	0	2	1	1	52730	2
2	0	2	0	0	52731	2
2	6	2	0	6	52732	0
2	1	2	210	211	52733	1
2	0	2	1	1	52734	2
2	1	2	1	2	52735	1
2	2	2	8	10	52736	1
2	0	2	21	21	52737	2
2	0	2	5	5	52738	2
2	31	2	0	31	52739	0
2	3	2	445	448	52740	1
2	0	2	4	4	52741	2
2	0	2	0	0	52742	2
2	11	2	2	13	52743	0
2	0	2	17	17	52744	2
4	0	2	1	1	52745	2
2	0	2	0	0	52746	2
2	0	2	0	0	52747	2
2	0	2	0	0	52748	2
2	0	2	0	0	52749	2
2	0	2	0	0	52750	2
2	0	2	0	0	52751	2
2	68	2	0	68	52752	0
2	19	2	176	195	52753	1
2	0	2	10	10	52754	2
2	0	2	0	0	52755	2
2	20	2	0	20	52756	0
2	0	2	122	122	52757	2
2	0	2	0	0	52758	2
2	0	2	0	0	52759	2
2	0	2	0	0	52760	2
2	0	2	0	0	52761	2
2	0	2	0	0	52762	2
2	0	2	0	0	52763	2
2	0	2	0	0	52764	2
2	0	4	0	0	52765	2
2	0	2	0	0	52766	2
2	0	2	0	0	52767	2
2	0	4	0	0	52768	2
2	0	2	0	0	52769	2
2	0	2	0	0	52770	2
2	0	2	0	0	52771	2
2	0	2	0	0	52772	2
2	0	2	0	0	52773	2
2	0	2	0	0	52774	2
2	0	2	0	0	52775	2
2	0	2	0	0	52776	2
2	0	2	0	0	52777	2
2	0	2	0	0	52778	2
2	0	2	0	0	52779	2
2	0	2	0	0	52780	2
2	0	2	0	0	52781	2
2	0	2	0	0	52782	2
2	0	2	0	0	52783	2
2	0	2	0	0	52784	2
2	0	2	0	0	52785	2
2	0	2	0	0	52786	2
2	0	2	0	0	52787	2
2	0	2	0	0	52788	2
2	0	2	0	0	52789	2
2	0	2	0	0	52790	2
2	0	2	0	0	52791	2
2	9	2	4	13	52792	0
2	11	2	2	13	52793	0
2	0	2	28	28	52794	2
2	0	2	0	0	52795	2
2	0	2	0	0	52796	2
2	0	2	0	0	52797	2
2	0	2	0	0	52798	2
2	0	2	0	0	52799	2
2	0	2	0	0	52800	2
2	80	2	2	82	52801	0
2	279	2	422	701	52802	1
2	0	2	34	34	52803	2
2	0	2	4	4	52804	2
2	212	2	8	220	52805	0
2	0	2	464	464	52806	2
0	0	2	12	12	52807	2
2	1	2	0	1	52808	0
2	0	2	6	6	52809	2
2	0	2	0	0	52810	2
2	0	2	0	0	52811	2
2	0	2	0	0	52812	2
2	1	2	1	2	52813	1
2	0	2	0	0	52814	2
2	0	2	0	0	52815	2
2	0	2	0	0	52816	2
2	0	2	0	0	52817	2
2	0	2	0	0	52818	2
2	0	2	0	0	52819	2
2	0	2	0	0	52820	2
2	0	2	0	0	52821	2
2	0	2	0	0	52822	2
2	0	2	0	0	52823	2
2	0	2	0	0	52824	2
2	0	2	0	0	52825	2
2	0	2	0	0	52826	2
2	1	2	0	1	52827	1
2	0	2	0	0	52828	2
2	0	2	0	0	52829	2
2	0	2	0	0	52830	2
2	0	2	0	0	52831	2
2	0	2	0	0	52832	2
2	1	2	1	2	52833	0
2	0	2	0	0	52834	2
2	228	2	1	229	52835	0
2	245	2	3321	3566	52836	1
2	0	2	22	22	52837	2
2	0	2	1	1	52838	2
2	67	2	2	69	52839	0
2	0	2	235	235	52840	2
2	0	2	0	0	52841	2
2	0	2	0	0	52842	2
2	0	2	0	0	52843	2
2	0	2	0	0	52844	2
2	0	2	0	0	52845	2
2	0	2	0	0	52846	2
2	0	2	0	0	52847	2
2	0	2	0	0	52848	2
2	0	2	0	0	52849	2
4	0	2	0	0	52850	2
2	0	2	0	0	52851	2
2	0	2	8	8	52852	2
2	0	2	0	0	52853	2
2	0	2	0	0	52854	2
4	0	2	0	0	52855	2
2	0	2	0	0	52856	2
2	0	2	0	0	52857	2
2	0	2	0	0	52858	2
2	0	2	0	0	52859	2
2	0	2	0	0	52860	2
2	0	2	0	0	52861	2
2	1	2	0	1	52862	0
2	0	2	0	0	52863	2
2	0	2	0	0	52864	2
2	0	2	0	0	52865	2
2	0	2	0	0	52866	2
2	0	2	0	0	52867	2
2	0	2	0	0	52868	2
2	3	2	9	12	52869	1
2	0	2	0	0	52870	2
2	0	2	0	0	52871	2
2	4	2	1	5	52872	0
2	0	2	14	14	52873	2
2	0	2	0	0	52874	2
2	0	2	0	0	52875	2
2	2	2	0	2	52876	0
2	0	2	0	0	52877	2
2	0	2	108	108	52878	2
2	3	2	0	3	52879	0
2	0	2	0	0	52880	2
2	2	2	0	2	52881	0
2	1	2	138	139	52882	1
2	0	2	0	0	52883	2
2	0	2	0	0	52884	2
2	2	2	0	2	52885	0
2	0	2	0	0	52886	2
2	2	2	2	4	52887	0
2	0	2	0	0	52888	2
2	0	2	0	0	52889	2
2	0	2	0	0	52890	2
2	0	2	0	0	52891	2
2	0	2	0	0	52892	2
2	0	2	0	0	52893	2
2	0	2	0	0	52894	2
2	0	2	0	0	52895	2
2	0	2	0	0	52896	2
2	0	2	0	0	52897	2
2	0	2	0	0	52898	2
2	0	2	0	0	52899	2
2	0	2	0	0	52900	2
2	0	2	0	0	52901	2
2	0	2	0	0	52902	2
2	0	2	2	2	52903	2
2	0	2	0	0	52904	2
2	0	2	0	0	52905	2
2	0	2	0	0	52906	2
2	0	2	0	0	52907	2
2	0	2	0	0	52908	2
2	0	2	3	3	52909	2
2	0	2	0	0	52910	2
2	0	2	0	0	52911	2
2	0	2	0	0	52912	2
2	0	2	0	0	52913	2
2	0	2	0	0	52914	2
2	4	2	24	28	52915	1
2	0	2	3	3	52916	2
2	0	2	1	1	52917	2
2	0	2	0	0	52918	2
2	0	2	4	4	52919	2
2	11	2	1	12	52920	0
2	0	2	10	10	52921	2
2	0	2	0	0	52922	2
2	0	2	0	0	52923	2
2	0	2	2	2	52924	2
2	0	2	0	0	52925	2
2	0	2	0	0	52926	2
2	0	2	0	0	52927	2
2	0	2	0	0	52928	2
2	0	2	0	0	52929	2
2	0	2	0	0	52930	2
2	0	2	0	0	52931	2
2	0	2	0	0	52932	2
2	0	2	0	0	52933	2
2	0	2	0	0	52934	2
2	0	2	0	0	52935	2
2	0	2	0	0	52936	2
2	0	2	0	0	52937	2
2	0	2	0	0	52938	2
2	0	2	0	0	52939	2
2	0	2	0	0	52940	2
2	0	2	0	0	52941	2
2	0	2	0	0	52942	2
2	0	2	0	0	52943	2
2	0	2	0	0	52944	2
2	0	2	0	0	52945	2
2	0	2	0	0	52946	2
2	0	2	0	0	52947	2
2	0	2	0	0	52948	2
2	0	2	0	0	52949	2
2	0	2	0	0	52950	2
2	0	2	0	0	52951	2
2	0	2	0	0	52952	2
2	0	2	0	0	52953	2
2	0	2	0	0	52954	2
2	0	2	0	0	52955	2
2	0	2	0	0	52956	2
2	0	2	0	0	52957	2
2	0	2	0	0	52958	2
2	0	2	0	0	52959	2
2	0	2	0	0	52960	2
2	0	2	0	0	52961	2
2	0	2	0	0	52962	2
2	0	2	0	0	52963	2
2	0	2	0	0	52964	2
2	0	2	0	0	52965	2
2	0	2	0	0	52966	2
2	0	2	0	0	52967	2
2	0	2	0	0	52968	2
2	0	2	0	0	52969	2
0	37	2	0	37	52970	0
2	3	2	599	602	52971	1
2	0	2	0	0	52972	2
2	0	2	0	0	52973	2
4	0	0	63	63	52974	2
0	62	2	0	62	52975	0
0	77	2	2	79	52976	0
0	29	2	0	29	52977	0
2	0	2	0	0	52978	2
2	0	2	0	0	52979	2
2	0	2	0	0	52980	2
2	0	2	0	0	52981	2
2	0	2	0	0	52982	2
2	0	2	0	0	52983	2
2	0	2	0	0	52984	2
2	0	2	0	0	52985	2
2	0	2	0	0	52986	2
2	0	2	0	0	52987	2
2	0	2	0	0	52988	2
2	0	2	0	0	52989	2
2	0	2	0	0	52990	2
2	0	4	0	0	52991	2
2	0	2	0	0	52992	2
2	0	2	0	0	52993	2
2	0	4	0	0	52994	2
2	0	2	0	0	52995	2
2	9	2	11	20	52996	1
2	6	2	2	8	52997	0
2	0	2	13	13	52998	2
2	0	2	2	2	52999	2
2	1	2	0	1	53000	0
2	3	2	6	9	53001	1
2	0	2	0	0	53002	2
2	0	2	0	0	53003	2
2	3	2	0	3	53004	0
2	0	2	0	0	53005	2
2	0	2	0	0	53006	2
2	0	2	0	0	53007	2
2	0	2	0	0	53008	2
2	0	2	0	0	53009	2
2	0	2	0	0	53010	2
2	0	2	0	0	53011	2
2	4	2	0	4	53012	0
2	6	2	3	9	53013	1
2	0	2	0	0	53014	2
2	0	2	0	0	53015	2
2	4	2	0	4	53016	0
2	0	2	1	1	53017	2
2	306	2	1	307	53018	0
2	0	2	60	60	53019	2
2	0	2	1	1	53020	2
2	0	2	0	0	53021	2
2	0	2	0	0	53022	2
2	0	2	0	0	53023	2
2	0	2	0	0	53024	2
2	0	2	0	0	53025	2
2	0	2	0	0	53026	2
2	5	2	0	5	53027	0
2	1	2	43	44	53028	1
2	0	2	0	0	53029	2
2	0	2	0	0	53030	2
2	0	2	0	0	53031	2
2	0	2	6	6	53032	2
2	0	2	0	0	53033	2
2	0	2	0	0	53034	2
2	0	2	0	0	53035	2
2	0	2	0	0	53036	2
2	0	2	0	0	53037	2
2	0	2	0	0	53038	2
2	0	2	0	0	53039	2
2	0	2	0	0	53040	2
2	0	2	0	0	53041	2
2	0	2	0	0	53042	2
2	0	2	0	0	53043	2
2	0	2	0	0	53044	2
2	0	2	0	0	53045	2
2	0	2	0	0	53046	2
2	0	2	0	0	53047	2
2	0	2	0	0	53048	2
2	0	2	0	0	53049	2
2	0	2	0	0	53050	2
2	0	2	0	0	53051	2
2	5	2	4	9	53052	1
2	0	2	0	0	53053	2
2	0	2	0	0	53054	2
2	0	2	0	0	53055	2
2	0	2	1	1	53056	2
2	0	2	0	0	53057	2
2	1	2	0	1	53058	1
2	0	2	9	9	53059	2
2	0	2	0	0	53060	2
2	0	2	0	0	53061	2
2	0	2	0	0	53062	2
2	0	2	0	0	53063	2
2	0	2	0	0	53064	2
2	0	2	0	0	53065	2
2	0	2	0	0	53066	2
2	0	2	0	0	53067	2
2	0	2	2	2	53068	2
2	2	2	0	2	53069	0
2	0	2	1	1	53070	2
2	0	2	0	0	53071	2
2	0	2	0	0	53072	2
2	0	2	0	0	53073	2
2	0	2	0	0	53074	2
2	0	2	0	0	53075	2
2	0	2	0	0	53076	2
2	0	2	0	0	53077	2
2	0	2	0	0	53078	2
2	0	2	0	0	53079	2
2	0	2	0	0	53080	2
2	0	2	0	0	53081	2
2	0	2	0	0	53082	2
2	0	2	0	0	53083	2
2	0	2	0	0	53084	2
2	0	2	0	0	53085	2
2	0	2	0	0	53086	2
2	56	2	0	56	53087	0
2	0	2	0	0	53088	2
2	0	2	0	0	53089	2
2	0	2	0	0	53090	2
2	0	2	0	0	53091	2
2	0	2	0	0	53092	2
2	0	2	0	0	53093	2
2	62	2	1179	1241	53094	1
2	0	2	3	3	53095	2
2	0	2	0	0	53096	2
2	22	2	1	23	53097	1
2	0	2	66	66	53098	2
2	0	2	0	0	53099	2
2	0	2	0	0	53100	2
2	0	2	0	0	53101	2
2	0	2	0	0	53102	2
2	0	2	0	0	53103	2
2	0	2	24	24	53104	2
2	0	2	0	0	53105	2
2	0	2	1	1	53106	2
2	0	4	3	3	53107	2
2	0	2	1	1	53108	2
2	0	2	0	0	53109	2
2	1	4	169	170	53110	1
2	0	2	0	0	53111	2
2	0	2	0	0	53112	2
2	0	2	0	0	53113	2
2	0	2	0	0	53114	2
2	0	2	0	0	53115	2
2	0	2	0	0	53116	2
2	0	2	0	0	53117	2
2	0	2	0	0	53118	2
2	0	2	0	0	53119	2
2	0	2	0	0	53120	2
2	0	2	0	0	53121	2
2	0	2	0	0	53122	2
2	0	2	0	0	53123	2
2	0	2	1	1	53124	2
2	0	2	0	0	53125	2
2	0	2	0	0	53126	2
2	0	2	0	0	53127	2
2	0	2	0	0	53128	2
2	0	2	0	0	53129	2
2	0	2	0	0	53130	2
2	0	2	0	0	53131	2
2	0	2	0	0	53132	2
2	0	2	0	0	53133	2
2	0	2	0	0	53134	2
2	13	2	0	13	53135	0
2	0	2	0	0	53136	2
2	0	2	0	0	53137	2
4	115	2	0	115	53138	0
4	13	2	0	13	53139	0
2	0	2	0	0	53140	2
2	0	2	0	0	53141	2
2	0	2	0	0	53142	2
2	0	2	0	0	53143	2
2	0	2	0	0	53144	2
2	0	2	0	0	53145	2
2	0	2	0	0	53146	2
2	0	2	0	0	53147	2
2	0	2	0	0	53148	2
2	0	2	0	0	53149	2
2	0	2	0	0	53150	2
2	0	2	0	0	53151	2
2	0	2	0	0	53152	2
2	0	2	0	0	53153	2
2	0	2	0	0	53154	2
2	0	4	0	0	53155	2
2	0	2	0	0	53156	2
2	0	2	0	0	53157	2
2	0	4	0	0	53158	2
2	0	2	0	0	53159	2
2	41	2	0	41	53160	0
2	0	2	0	0	53161	2
2	0	2	0	0	53162	2
2	0	2	53	53	53163	2
2	2	2	0	2	53164	0
2	2	2	6	8	53165	1
2	0	2	0	0	53166	2
2	0	2	0	0	53167	2
2	2	2	0	2	53168	0
2	0	2	0	0	53169	2
2	0	2	0	0	53170	2
2	0	2	1	1	53171	2
2	0	2	0	0	53172	2
2	0	2	0	0	53173	2
2	0	2	0	0	53174	2
2	0	2	1	1	53175	2
2	0	2	0	0	53176	2
2	0	2	0	0	53177	2
2	0	2	0	0	53178	2
2	0	2	0	0	53179	2
2	0	2	0	0	53180	2
2	0	2	0	0	53181	2
2	1	2	0	1	53182	0
2	0	2	0	0	53183	2
2	0	2	0	0	53184	2
2	0	2	0	0	53185	2
2	0	2	0	0	53186	2
2	0	2	0	0	53187	2
2	0	2	0	0	53188	2
2	0	2	0	0	53189	2
2	0	2	0	0	53190	2
4	0	2	0	0	53191	2
2	160	2	2	162	53192	0
2	0	2	0	0	53193	2
2	2	2	2	4	53194	1
2	0	2	0	0	53195	2
2	0	2	0	0	53196	2
2	1	2	0	1	53197	0
2	0	2	0	0	53198	2
2	0	2	0	0	53199	2
2	1	2	1	2	53200	1
2	0	2	0	0	53201	2
2	0	2	0	0	53202	2
2	0	2	0	0	53203	2
2	0	2	0	0	53204	2
2	1	2	0	1	53205	0
2	0	2	3	3	53206	2
2	0	2	0	0	53207	2
2	1	2	4222	4223	53208	0
2	0	2	0	0	53209	2
2	0	2	0	0	53210	2
2	0	2	1210	1210	53211	2
2	0	2	0	0	53212	2
2	27	2	353	380	53213	1
2	0	2	51	51	53214	2
2	0	2	1	1	53215	2
2	68	2	7	75	53216	0
2	0	2	432	432	53217	2
2	2	2	0	2	53218	0
2	2	2	2	4	53219	1
2	0	2	1	1	53220	2
2	0	2	0	0	53221	2
2	1	2	0	1	53222	1
2	0	2	7	7	53223	2
2	0	2	251	251	53224	2
2	0	2	0	0	53225	2
2	0	2	0	0	53226	2
2	0	2	0	0	53227	2
2	0	2	0	0	53228	2
2	0	2	0	0	53229	2
2	0	2	0	0	53230	2
2	0	2	0	0	53231	2
2	0	2	0	0	53232	2
2	0	2	0	0	53233	2
2	0	2	0	0	53234	2
2	0	2	0	0	53235	2
2	0	2	0	0	53236	2
2	10	2	0	10	53237	0
2	6	2	60	66	53238	1
2	0	2	0	0	53239	2
2	0	2	0	0	53240	2
2	0	2	0	0	53241	2
2	0	2	0	0	53242	2
2	0	2	0	0	53243	2
2	0	2	0	0	53244	2
2	0	2	0	0	53245	2
2	0	2	0	0	53246	2
2	0	2	0	0	53247	2
2	0	2	0	0	53248	2
2	0	2	0	0	53249	2
2	0	2	0	0	53250	2
2	0	2	0	0	53251	2
2	0	2	0	0	53252	2
2	0	2	0	0	53253	2
2	0	2	0	0	53254	2
2	0	2	0	0	53255	2
2	0	2	0	0	53256	2
2	0	2	0	0	53257	2
2	0	2	0	0	53258	2
2	0	2	0	0	53259	2
2	0	2	0	0	53260	2
2	0	2	0	0	53261	2
2	0	2	0	0	53262	2
2	2	2	0	2	53263	0
2	0	2	0	0	53264	2
2	0	2	0	0	53265	2
2	0	2	0	0	53266	2
2	0	2	0	0	53267	2
2	0	2	0	0	53268	2
2	0	2	0	0	53269	2
4	0	2	0	0	53270	2
2	4	2	1524	1528	53271	0
2	0	2	0	0	53272	2
2	0	2	0	0	53273	2
2	3	2	389	392	53274	0
2	0	2	0	0	53275	2
4	2	2	2	4	53276	0
2	11	2	0	11	53277	0
2	8	2	3	11	53278	1
2	0	2	0	0	53279	2
2	0	2	0	0	53280	2
0	418	2	22	440	53281	0
0	174	2	3	177	53282	0
2	1	2	1	2	53283	1
2	0	2	1	1	53284	2
2	0	2	2	2	53285	2
2	0	2	0	0	53286	2
2	0	2	0	0	53287	2
2	0	2	0	0	53288	2
2	0	2	0	0	53289	2
2	18	2	0	18	53290	1
2	0	2	34	34	53291	2
2	0	2	0	0	53292	2
4	3	2	4	7	53293	0
4	0	2	0	0	53294	2
2	0	2	0	0	53295	2
2	0	2	0	0	53296	2
2	0	4	3	3	53297	2
2	0	2	0	0	53298	2
2	0	2	0	0	53299	2
2	0	2	0	0	53300	2
2	0	2	3	3	53301	2
2	0	2	1	1	53302	2
2	0	2	2	2	53303	2
2	0	2	0	0	53304	2
2	0	2	0	0	53305	2
2	500	4	3	503	53306	0
2	0	2	2	2	53307	2
2	0	2	0	0	53308	2
2	0	2	0	0	53309	2
2	0	2	0	0	53310	2
2	0	2	0	0	53311	2
2	0	2	0	0	53312	2
2	0	2	0	0	53313	2
2	0	2	0	0	53314	2
2	0	2	0	0	53315	2
2	0	2	0	0	53316	2
2	0	2	0	0	53317	2
2	0	2	0	0	53318	2
2	0	2	0	0	53319	2
2	0	2	0	0	53320	2
2	0	2	0	0	53321	2
2	0	2	0	0	53322	2
2	0	2	0	0	53323	2
2	0	2	0	0	53324	2
2	0	2	0	0	53325	2
2	0	2	0	0	53326	2
2	0	2	0	0	53327	2
2	0	2	0	0	53328	2
2	0	2	0	0	53329	2
2	0	2	0	0	53330	2
2	0	2	0	0	53331	2
2	0	2	0	0	53332	2
2	0	2	0	0	53333	2
2	0	2	0	0	53334	2
2	0	4	46	46	53335	2
2	0	2	0	0	53336	2
2	0	2	0	0	53337	2
2	0	4	234	234	53338	2
2	0	2	0	0	53339	2
0	1	4	24	25	53340	0
2	0	2	0	0	53341	2
2	0	2	0	0	53342	2
2	0	2	0	0	53343	2
2	0	2	0	0	53344	2
2	0	2	0	0	53345	2
2	0	2	0	0	53346	2
2	0	2	0	0	53347	2
2	0	2	0	0	53348	2
2	0	2	0	0	53349	2
2	0	2	0	0	53350	2
2	0	2	0	0	53351	2
2	0	2	0	0	53352	2
2	0	2	0	0	53353	2
2	0	2	0	0	53354	2
2	0	2	0	0	53355	2
2	0	2	0	0	53356	2
2	0	2	0	0	53357	2
2	0	2	0	0	53358	2
2	0	2	0	0	53359	2
2	0	4	1491	1491	53360	2
2	0	2	0	0	53361	2
2	0	2	0	0	53362	2
2	1	2	0	1	53363	0
2	1	2	20	21	53364	1
2	0	2	0	0	53365	2
2	0	2	0	0	53366	2
2	1	2	0	1	53367	1
2	0	2	1	1	53368	2
2	0	2	0	0	53369	2
2	0	2	0	0	53370	2
2	0	2	0	0	53371	2
2	0	4	1	1	53372	2
2	0	2	0	0	53373	2
2	4	2	2	6	53374	0
2	0	2	12	12	53375	2
2	1	2	0	1	53376	0
2	0	4	156	156	53377	2
2	0	2	0	0	53378	2
2	0	2	0	0	53379	2
2	0	4	55	55	53380	2
2	0	2	4	4	53381	2
2	0	2	0	0	53382	2
2	0	2	0	0	53383	2
2	0	2	0	0	53384	2
2	0	2	0	0	53385	2
2	0	2	0	0	53386	2
2	0	2	0	0	53387	2
0	3	4	77	80	53388	0
2	0	2	0	0	53389	2
2	0	2	0	0	53390	2
2	0	2	0	0	53391	2
2	0	2	0	0	53392	2
2	0	2	0	0	53393	2
2	0	2	0	0	53394	2
2	0	0	761	761	53395	2
2	0	2	1	1	53396	2
0	0	4	6390	6390	53397	2
2	0	2	0	0	53398	2
2	0	2	3	3	53399	2
2	0	2	0	0	53400	2
2	0	2	0	0	53401	2
2	0	2	0	0	53402	2
2	0	2	0	0	53403	2
2	0	2	0	0	53404	2
2	0	2	0	0	53405	2
2	0	2	0	0	53406	2
2	0	2	0	0	53407	2
2	0	2	331	331	53408	2
2	0	2	1	1	53409	2
2	0	2	0	0	53410	2
2	0	2	0	0	53411	2
2	0	2	0	0	53412	2
2	0	2	0	0	53413	2
2	0	2	0	0	53414	2
2	0	2	0	0	53415	2
2	3	4	644	647	53416	0
2	0	2	1	1	53417	2
2	3	2	16	19	53418	1
2	0	2	0	0	53419	2
2	0	2	0	0	53420	2
2	0	2	0	0	53421	2
2	0	2	1	1	53422	2
2	0	2	0	0	53423	2
2	0	2	0	0	53424	2
2	0	2	0	0	53425	2
2	0	2	0	0	53426	2
2	0	2	0	0	53427	2
2	0	2	0	0	53428	2
2	0	2	0	0	53429	2
2	0	2	0	0	53430	2
2	0	2	0	0	53431	2
2	0	2	0	0	53432	2
2	0	2	0	0	53433	2
2	0	2	0	0	53434	2
2	7	2	0	7	53435	0
2	0	2	0	0	53436	2
2	0	2	0	0	53437	2
2	0	2	0	0	53438	2
2	0	2	0	0	53439	2
2	0	2	0	0	53440	2
2	0	2	0	0	53441	2
2	0	2	0	0	53442	2
2	0	2	0	0	53443	2
2	0	2	0	0	53444	2
2	0	2	0	0	53445	2
2	0	2	0	0	53446	2
2	0	2	0	0	53447	2
2	4	4	2301	2305	53448	1
2	0	2	5	5	53449	2
2	0	2	0	0	53450	2
2	9	4	142	151	53451	0
2	50	2	24	74	53452	0
0	0	4	0	0	53453	2
2	0	2	0	0	53454	2
2	0	2	0	0	53455	2
2	0	2	0	0	53456	2
2	0	2	0	0	53457	2
2	0	2	0	0	53458	2
2	0	2	0	0	53459	2
4	64	4	3	67	53460	0
2	2	2	0	2	53461	0
2	0	2	0	0	53462	2
2	0	2	1	1	53463	2
2	0	2	0	0	53464	2
2	3	4	42	45	53465	1
2	0	2	1	1	53466	2
2	0	2	0	0	53467	2
0	0	4	0	0	53468	2
0	0	4	0	0	53469	2
2	0	2	0	0	53470	2
2	0	2	2	2	53471	2
2	0	2	0	0	53472	2
2	0	2	0	0	53473	2
2	0	2	0	0	53474	2
2	2	2	1	3	53475	0
2	10	4	1193	1203	53476	1
2	0	2	0	0	53477	2
2	0	2	0	0	53478	2
2	0	2	43	43	53479	2
2	0	2	0	0	53480	2
2	0	2	1	1	53481	2
2	0	2	0	0	53482	2
2	0	2	0	0	53483	2
2	0	2	0	0	53484	2
2	0	2	0	0	53485	2
2	0	2	0	0	53486	2
2	0	2	0	0	53487	2
2	0	2	0	0	53488	2
2	0	2	0	0	53489	2
2	0	2	0	0	53490	2
2	0	2	0	0	53491	2
2	0	4	88	88	53492	2
2	0	2	0	0	53493	2
2	0	2	0	0	53494	2
2	0	2	0	0	53495	2
2	0	2	0	0	53496	2
2	0	2	0	0	53497	2
2	0	2	0	0	53498	2
2	0	2	0	0	53499	2
2	0	2	0	0	53500	2
2	0	4	3	3	53501	2
2	0	2	0	0	53502	2
2	0	2	0	0	53503	2
2	0	4	0	0	53504	2
2	0	2	0	0	53505	2
2	0	2	0	0	53506	2
2	0	4	1021	1021	53507	2
2	0	2	0	0	53508	2
2	0	2	0	0	53509	2
0	0	0	132	132	53510	2
2	0	2	0	0	53511	2
2	0	2	0	0	53512	2
2	0	2	8	8	53513	2
2	0	2	0	0	53514	2
2	0	2	0	0	53515	2
2	0	2	0	0	53516	2
2	0	2	1	1	53517	2
2	0	2	1	1	53518	2
2	0	2	0	0	53519	2
2	0	2	0	0	53520	2
2	0	2	4	4	53521	2
2	0	2	0	0	53522	2
2	0	2	0	0	53523	2
2	0	2	0	0	53524	2
2	0	2	0	0	53525	2
2	0	2	0	0	53526	2
2	0	2	0	0	53527	2
2	0	2	0	0	53528	2
2	18	2	3909	3927	53529	1
2	62	2	2	64	53530	0
2	0	2	223	223	53531	2
2	0	2	0	0	53532	2
2	1	2	2	3	53533	1
2	0	2	0	0	53534	2
2	0	2	0	0	53535	2
2	0	2	0	0	53536	2
2	0	2	0	0	53537	2
2	0	2	0	0	53538	2
2	0	2	0	0	53539	2
2	0	2	0	0	53540	2
2	0	2	0	0	53541	2
2	0	2	0	0	53542	2
2	0	2	0	0	53543	2
0	809	4	526	1335	53544	0
0	3	4	526	529	53545	0
2	0	2	0	0	53546	2
2	0	2	0	0	53547	2
2	0	2	0	0	53548	2
2	0	2	0	0	53549	2
2	0	2	0	0	53550	2
2	0	2	0	0	53551	2
4	0	4	0	0	53552	2
4	0	4	0	0	53553	2
2	0	2	0	0	53554	2
2	0	2	0	0	53555	2
2	0	2	0	0	53556	2
2	0	2	0	0	53557	2
2	0	2	0	0	53558	2
2	0	2	0	0	53559	2
4	1	4	2	3	53560	1
4	0	4	1	1	53561	2
2	0	2	0	0	53562	2
2	0	2	0	0	53563	2
2	0	2	0	0	53564	2
2	0	2	0	0	53565	2
2	0	2	0	0	53566	2
2	0	2	0	0	53567	2
2	1	2	12	13	53568	0
2	0	2	0	0	53569	2
2	0	2	1	1	53570	2
0	172	4	0	172	53571	0
2	0	2	0	0	53572	2
2	0	0	26	26	53573	2
2	0	2	0	0	53574	2
2	0	2	0	0	53575	2
2	0	2	0	0	53576	2
2	0	2	0	0	53577	2
2	0	2	0	0	53578	2
2	0	2	0	0	53579	2
2	0	2	0	0	53580	2
2	0	2	0	0	53581	2
2	6	2	0	6	53582	0
2	0	2	0	0	53583	2
2	0	2	0	0	53584	2
2	0	2	0	0	53585	2
2	0	2	0	0	53586	2
2	0	2	0	0	53587	2
2	0	2	0	0	53588	2
2	2	2	0	2	53589	0
2	0	2	0	0	53590	2
2	0	2	0	0	53591	2
2	0	2	0	0	53592	2
2	0	2	0	0	53593	2
2	0	2	0	0	53594	2
2	0	2	0	0	53595	2
2	0	2	3	3	53596	2
2	0	2	0	0	53597	2
2	0	2	0	0	53598	2
2	0	2	1	1	53599	2
2	0	2	0	0	53600	2
2	0	4	3549	3549	53601	2
2	0	2	0	0	53602	2
2	0	2	0	0	53603	2
2	0	4	480	480	53604	2
2	0	2	2	2	53605	2
2	0	2	2	2	53606	2
4	84	2	13	97	53607	0
2	0	2	0	0	53608	2
2	0	2	0	0	53609	2
2	0	2	0	0	53610	2
2	0	2	0	0	53611	2
2	0	2	0	0	53612	2
2	0	2	0	0	53613	2
2	0	0	0	0	53614	2
2	0	2	0	0	53615	2
2	0	2	0	0	53616	2
2	0	2	0	0	53617	2
2	0	2	0	0	53618	2
2	0	2	0	0	53619	2
2	0	2	0	0	53620	2
2	0	2	0	0	53621	2
2	0	2	0	0	53622	2
2	0	2	0	0	53623	2
2	0	2	0	0	53624	2
2	0	2	0	0	53625	2
2	0	2	0	0	53626	2
2	0	2	0	0	53627	2
2	0	2	0	0	53628	2
2	0	4	9	9	53629	2
2	0	2	0	0	53630	2
2	0	2	0	0	53631	2
2	0	4	0	0	53632	2
2	0	2	0	0	53633	2
4	149	2	0	149	53634	0
2	0	2	0	0	53635	2
2	0	2	0	0	53636	2
2	0	2	0	0	53637	2
2	0	2	0	0	53638	2
2	0	2	0	0	53639	2
2	0	2	0	0	53640	2
2	0	2	0	0	53641	2
2	0	2	0	0	53642	2
2	0	4	59	59	53643	2
2	0	2	0	0	53644	2
2	0	2	0	0	53645	2
2	1	2	0	1	53646	0
2	1	2	0	1	53647	1
2	0	2	1	1	53648	2
2	0	2	12	12	53649	2
2	0	2	0	0	53650	2
2	0	2	0	0	53651	2
4	4	2	2	6	53652	0
2	0	4	25	25	53653	2
2	0	2	0	0	53654	2
2	0	2	0	0	53655	2
2	0	2	0	0	53656	2
2	0	2	0	0	53657	2
2	0	2	1	1	53658	2
2	0	2	0	0	53659	2
2	0	2	0	0	53660	2
2	0	2	0	0	53661	2
2	0	2	0	0	53662	2
2	0	2	0	0	53663	2
2	0	2	1	1	53664	2
2	0	2	0	0	53665	2
2	0	2	0	0	53666	2
0	2	4	0	2	53667	1
0	0	4	0	0	53668	2
2	0	2	0	0	53669	2
2	0	4	0	0	53670	2
2	0	2	0	0	53671	2
2	0	2	0	0	53672	2
2	0	4	0	0	53673	2
2	0	2	0	0	53674	2
2	0	2	0	0	53675	2
2	0	2	0	0	53676	2
2	0	2	0	0	53677	2
2	0	2	0	0	53678	2
2	0	2	0	0	53679	2
2	0	2	0	0	53680	2
2	0	2	0	0	53681	2
2	0	2	0	0	53682	2
2	0	0	5	5	53683	2
2	0	2	0	0	53684	2
2	0	2	0	0	53685	2
4	0	2	0	0	53686	2
4	0	2	0	0	53687	2
2	0	0	3	3	53688	2
2	0	2	0	0	53689	2
2	0	2	0	0	53690	2
2	0	2	0	0	53691	2
2	0	2	0	0	53692	2
2	2	4	1447	1449	53693	1
2	0	2	0	0	53694	2
2	0	2	0	0	53695	2
2	3	4	426	429	53696	1
2	0	2	6	6	53697	2
4	0	2	1	1	53698	2
2	2	2	0	2	53699	0
2	0	2	0	0	53700	2
2	0	2	0	0	53701	2
2	0	2	0	0	53702	2
2	0	2	66	66	53703	2
2	0	2	0	0	53704	2
2	1	4	68	69	53705	1
2	0	2	0	0	53706	2
2	0	2	0	0	53707	2
0	0	2	2	2	53708	2
0	0	2	0	0	53709	2
2	2	4	4	6	53710	0
2	0	2	17	17	53711	2
4	5	2	1	6	53712	0
2	0	2	0	0	53713	2
2	0	2	1	1	53714	2
2	0	2	0	0	53715	2
2	0	2	0	0	53716	2
2	0	2	0	0	53717	2
2	0	2	15	15	53718	2
0	6	2	5	11	53719	0
0	441	0	1	442	53720	0
0	3	0	1	4	53721	0
0	0	4	0	0	53722	2
0	0	4	0	0	53723	2
2	0	2	0	0	53724	2
2	0	2	3	3	53725	2
2	0	2	0	0	53726	2
2	0	2	0	0	53727	2
2	0	2	0	0	53728	2
2	0	2	0	0	53729	2
2	1	2	0	1	53730	0
2	1	2	4	5	53731	1
2	0	2	0	0	53732	2
2	0	2	0	0	53733	2
2	0	2	1	1	53734	2
2	0	2	2	2	53735	2
2	0	2	0	0	53736	2
2	0	2	0	0	53737	2
2	0	2	0	0	53738	2
2	0	2	0	0	53739	2
2	0	2	0	0	53740	2
2	0	2	0	0	53741	2
2	0	2	0	0	53742	2
2	0	2	0	0	53743	2
2	0	2	0	0	53744	2
2	0	2	0	0	53745	2
2	0	2	0	0	53746	2
2	0	2	0	0	53747	2
2	0	2	0	0	53748	2
2	0	2	0	0	53749	2
2	0	2	0	0	53750	2
2	0	2	0	0	53751	2
2	0	2	0	0	53752	2
2	0	2	0	0	53753	2
2	0	2	0	0	53754	2
2	0	2	0	0	53755	2
2	0	2	0	0	53756	2
2	0	2	0	0	53757	2
2	0	2	0	0	53758	2
2	0	2	0	0	53759	2
2	0	2	0	0	53760	2
2	0	2	0	0	53761	2
2	0	2	0	0	53762	2
2	1	2	0	1	53763	1
2	0	4	12	12	53764	2
2	0	2	0	0	53765	2
2	0	2	0	0	53766	2
2	1	4	0	1	53767	1
2	0	2	0	0	53768	2
4	1	2	1	2	53769	0
2	0	2	0	0	53770	2
2	0	0	0	0	53771	2
2	0	2	0	0	53772	2
2	0	2	0	0	53773	2
2	0	0	0	0	53774	2
2	0	2	2	2	53775	2
2	0	2	0	0	53776	2
2	0	2	0	0	53777	2
2	0	2	0	0	53778	2
2	0	2	0	0	53779	2
2	0	2	0	0	53780	2
2	0	2	0	0	53781	2
2	0	2	0	0	53782	2
2	0	2	0	0	53783	2
2	0	2	0	0	53784	2
2	0	2	0	0	53785	2
2	0	2	0	0	53786	2
2	0	2	0	0	53787	2
2	0	2	0	0	53788	2
2	0	2	6	6	53789	2
2	0	2	1	1	53790	2
2	0	2	0	0	53791	2
2	0	2	1	1	53792	2
2	0	2	1	1	53793	2
2	0	2	0	0	53794	2
2	0	2	0	0	53795	2
2	0	2	0	0	53796	2
2	1	2	51	52	53797	1
2	0	2	0	0	53798	2
2	0	2	0	0	53799	2
2	0	2	0	0	53800	2
2	0	2	0	0	53801	2
2	0	2	0	0	53802	2
2	0	2	0	0	53803	2
2	0	2	0	0	53804	2
2	0	2	0	0	53805	2
2	0	2	0	0	53806	2
2	0	2	0	0	53807	2
2	0	2	0	0	53808	2
2	0	2	0	0	53809	2
2	0	2	0	0	53810	2
2	0	2	0	0	53811	2
2	0	2	0	0	53812	2
2	0	2	0	0	53813	2
2	0	2	0	0	53814	2
2	0	2	0	0	53815	2
2	0	2	0	0	53816	2
2	0	2	0	0	53817	2
2	0	2	0	0	53818	2
2	0	2	1	1	53819	2
2	0	2	0	0	53820	2
2	0	2	0	0	53821	2
2	0	2	0	0	53822	2
2	0	4	3	3	53823	2
2	0	2	0	0	53824	2
2	0	2	0	0	53825	2
2	0	2	0	0	53826	2
2	0	2	0	0	53827	2
2	0	2	0	0	53828	2
2	0	2	0	0	53829	2
2	0	2	0	0	53830	2
2	1	2	0	1	53831	0
2	6	4	9	15	53832	1
2	0	2	0	0	53833	2
2	0	2	0	0	53834	2
2	0	4	0	0	53835	2
2	0	2	2	2	53836	2
2	0	2	0	0	53837	2
2	0	2	0	0	53838	2
2	0	2	0	0	53839	2
2	0	2	0	0	53840	2
2	0	2	0	0	53841	2
2	0	2	0	0	53842	2
2	0	2	0	0	53843	2
2	0	2	0	0	53844	2
2	0	2	0	0	53845	2
2	0	2	0	0	53846	2
2	0	2	0	0	53847	2
4	2	2	0	2	53848	0
0	0	4	23	23	53849	2
4	349	2	10	359	53850	0
4	1	2	1	2	53851	0
4	3339	2	764	4103	53852	0
4	95	4	1	96	53853	1
4	72	4	0	72	53854	1
0	8	2	3	11	53855	0
0	4	2	0	4	53856	0
4	20	2	1	21	53857	0
0	7045	2	9	7054	53858	1
0	943	2	0	943	53859	1
0	1512	4	1867	3379	53860	0
4	311	4	1675	1986	53861	0
4	1	2	17	18	53862	0
4	0	2	0	0	53863	2
4	13	2	2	15	53864	0
4	21	2	0	21	53865	0
0	40	0	736	776	53866	0
0	17	2	119	136	53867	0
0	4	2	0	4	53868	0
4	11173	2	18	11191	53869	0
4	15	2	0	15	53870	0
4	1	2	0	1	53871	1
0	0	4	1	1	53872	2
0	0	4	4	4	53873	2
0	0	2	11	11	53874	2
0	0	2	0	0	53875	2
4	403	2	63	466	53876	0
4	162	2	2	164	53877	0
4	198	2	0	198	53878	0
4	1	4	1	2	53879	1
4	0	4	0	0	53880	2
4	0	2	2	2	53881	2
4	0	2	0	0	53882	2
4	0	2	0	0	53883	2
4	0	2	0	0	53884	2
4	29	4	27489	27518	53885	0
4	17	4	0	17	53886	1
4	46	4	0	46	53887	1
4	2	2	0	2	53888	0
4	0	0	453	453	53889	2
4	70	4	0	70	53890	1
4	1	4	0	1	53891	1
4	0	2	1	1	53892	2
4	0	2	0	0	53893	2
4	0	0	30	30	53894	2
4	926	2	4	930	53895	0
4	264	2	1	265	53896	0
4	4	4	65	69	53897	1
4	9	4	36	45	53898	1
4	16	2	6	22	53899	0
2	0	2	0	0	53900	2
2	0	2	0	0	53901	2
2	0	2	0	0	53902	2
2	0	2	0	0	53903	2
2	0	2	0	0	53904	2
2	0	2	0	0	53905	2
2	0	2	0	0	53906	2
2	0	2	0	0	53907	2
2	0	2	0	0	53908	2
2	0	2	0	0	53909	2
2	0	2	0	0	53910	2
2	0	2	0	0	53911	2
2	0	2	0	0	53912	2
2	0	2	0	0	53913	2
2	0	2	0	0	53914	2
2	0	2	0	0	53915	2
2	0	2	0	0	53916	2
2	0	2	0	0	53917	2
2	3	2	0	3	53918	1
2	0	2	1	1	53919	2
2	0	2	0	0	53920	2
2	0	2	11	11	53921	2
2	0	2	1	1	53922	2
2	0	2	0	0	53923	2
2	0	2	0	0	53924	2
2	0	2	0	0	53925	2
2	0	2	0	0	53926	2
2	0	2	0	0	53927	2
2	0	2	0	0	53928	2
2	0	2	0	0	53929	2
2	53	4	135	188	53930	1
2	182	4	9	191	53931	0
2	0	2	0	0	53932	2
2	0	2	0	0	53933	2
2	0	2	0	0	53934	2
2	0	2	0	0	53935	2
2	0	2	0	0	53936	2
2	0	2	0	0	53937	2
2	0	2	0	0	53938	2
2	1	2	0	1	53939	0
2	0	2	1	1	53940	2
2	0	2	0	0	53941	2
2	0	2	0	0	53942	2
2	0	2	0	0	53943	2
2	0	2	0	0	53944	2
2	0	2	0	0	53945	2
2	0	2	1	1	53946	2
2	0	2	0	0	53947	2
2	0	2	0	0	53948	2
2	0	2	0	0	53949	2
2	0	2	0	0	53950	2
2	21	2	0	21	53951	0
2	9	2	86	95	53952	1
2	0	2	10	10	53953	2
2	0	2	0	0	53954	2
2	6	2	3	9	53955	0
2	0	2	33	33	53956	2
2	0	2	0	0	53957	2
2	4	2	2	6	53958	1
2	0	2	6	6	53959	2
2	5	2	1	6	53960	0
2	3	2	58	61	53961	1
2	0	2	0	0	53962	2
2	0	2	0	0	53963	2
2	0	2	0	0	53964	2
2	0	2	0	0	53965	2
2	0	2	0	0	53966	2
2	0	2	0	0	53967	2
2	0	2	0	0	53968	2
4	1	2	0	1	53969	1
2	0	4	67	67	53970	2
2	0	2	0	0	53971	2
2	0	2	0	0	53972	2
2	1	2	0	1	53973	1
2	1	0	3	4	53974	0
2	0	2	0	0	53975	2
2	0	2	0	0	53976	2
2	0	0	0	0	53977	2
2	0	2	0	0	53978	2
2	0	2	0	0	53979	2
2	0	2	0	0	53980	2
2	0	2	0	0	53981	2
2	0	2	0	0	53982	2
2	0	2	0	0	53983	2
2	0	2	0	0	53984	2
2	0	2	0	0	53985	2
2	0	2	0	0	53986	2
2	0	2	0	0	53987	2
2	0	2	0	0	53988	2
2	0	2	0	0	53989	2
2	0	2	0	0	53990	2
0	61	4	0	61	53991	0
2	0	2	0	0	53992	2
2	0	2	0	0	53993	2
2	0	2	0	0	53994	2
2	0	2	0	0	53995	2
2	0	2	0	0	53996	2
2	0	2	0	0	53997	2
2	0	2	0	0	53998	2
2	0	2	1	1	53999	2
2	0	2	0	0	54000	2
2	0	2	0	0	54001	2
2	0	2	0	0	54002	2
2	0	2	0	0	54003	2
2	14	2	0	14	54004	0
2	0	2	66	66	54005	2
2	0	2	0	0	54006	2
2	0	2	0	0	54007	2
2	0	2	3	3	54008	2
2	0	2	7	7	54009	2
2	0	2	0	0	54010	2
2	0	2	0	0	54011	2
2	0	2	0	0	54012	2
2	0	2	0	0	54013	2
2	0	2	0	0	54014	2
2	0	2	0	0	54015	2
2	0	2	0	0	54016	2
2	0	2	0	0	54017	2
2	0	2	0	0	54018	2
2	0	2	0	0	54019	2
2	0	2	0	0	54020	2
2	0	2	0	0	54021	2
2	1	2	0	1	54022	0
2	3	2	0	3	54023	0
2	1	2	17	18	54024	1
2	0	2	1	1	54025	2
2	0	2	0	0	54026	2
2	3	4	2	5	54027	0
2	0	2	13	13	54028	2
2	0	2	0	0	54029	2
2	0	2	0	0	54030	2
2	0	2	0	0	54031	2
2	0	2	0	0	54032	2
2	0	2	0	0	54033	2
2	0	2	0	0	54034	2
0	0	4	0	0	54035	2
0	0	4	0	0	54036	2
2	0	2	0	0	54037	2
2	0	2	0	0	54038	2
2	0	2	0	0	54039	2
2	0	2	0	0	54040	2
2	0	2	0	0	54041	2
2	0	2	0	0	54042	2
2	0	2	0	0	54043	2
2	0	2	0	0	54044	2
2	0	2	0	0	54045	2
2	0	2	0	0	54046	2
4	0	2	0	0	54047	2
4	0	2	0	0	54048	2
2	0	2	0	0	54049	2
2	0	2	0	0	54050	2
2	0	2	0	0	54051	2
2	0	2	0	0	54052	2
2	0	2	0	0	54053	2
2	0	2	0	0	54054	2
2	0	2	0	0	54055	2
2	0	2	0	0	54056	2
2	0	2	0	0	54057	2
2	0	2	0	0	54058	2
2	0	2	0	0	54059	2
2	0	2	0	0	54060	2
2	0	2	0	0	54061	2
2	0	4	59	59	54062	2
2	0	2	0	0	54063	2
2	0	2	0	0	54064	2
2	0	4	56	56	54065	2
2	0	4	90	90	54066	2
2	0	2	0	0	54067	2
2	0	2	0	0	54068	2
2	0	2	0	0	54069	2
2	0	2	0	0	54070	2
2	0	2	0	0	54071	2
2	0	2	0	0	54072	2
2	0	2	0	0	54073	2
2	0	2	0	0	54074	2
2	0	2	0	0	54075	2
2	0	2	0	0	54076	2
2	0	2	0	0	54077	2
2	0	2	0	0	54078	2
2	0	2	0	0	54079	2
2	0	2	0	0	54080	2
2	0	2	0	0	54081	2
2	0	2	0	0	54082	2
2	0	4	76	76	54083	2
2	0	2	0	0	54084	2
2	0	2	0	0	54085	2
2	0	4	1	1	54086	2
2	0	2	0	0	54087	2
2	0	2	0	0	54088	2
2	0	2	16	16	54089	2
2	0	2	0	0	54090	2
2	0	2	0	0	54091	2
2	1	2	3	4	54092	1
2	0	2	0	0	54093	2
2	0	2	0	0	54094	2
2	0	2	0	0	54095	2
2	0	2	0	0	54096	2
2	0	2	0	0	54097	2
2	0	2	0	0	54098	2
2	0	2	0	0	54099	2
2	0	2	0	0	54100	2
2	0	2	0	0	54101	2
2	0	2	0	0	54102	2
2	0	2	0	0	54103	2
2	0	2	0	0	54104	2
2	0	2	0	0	54105	2
2	0	2	0	0	54106	2
2	0	4	46	46	54107	2
2	0	2	0	0	54108	2
2	0	2	0	0	54109	2
2	0	4	3	3	54110	2
2	0	2	0	0	54111	2
4	7	2	0	7	54112	0
4	0	2	0	0	54113	2
2	0	2	0	0	54114	2
2	0	2	0	0	54115	2
2	0	2	0	0	54116	2
2	0	2	0	0	54117	2
2	0	2	0	0	54118	2
2	0	2	0	0	54119	2
2	1	2	0	1	54120	1
2	0	2	0	0	54121	2
2	0	2	1	1	54122	2
2	0	2	0	0	54123	2
2	0	2	0	0	54124	2
2	0	2	0	0	54125	2
2	0	2	0	0	54126	2
2	0	2	0	0	54127	2
2	0	2	0	0	54128	2
2	0	2	0	0	54129	2
2	0	2	0	0	54130	2
4	0	2	0	0	54131	2
2	0	2	0	0	54132	2
2	0	2	0	0	54133	2
2	0	2	0	0	54134	2
2	0	2	0	0	54135	2
2	0	2	0	0	54136	2
2	57	4	13	70	54137	1
2	0	2	2	2	54138	2
2	0	2	0	0	54139	2
2	8	4	4	12	54140	0
2	0	2	1	1	54141	2
2	0	2	0	0	54142	2
2	0	2	0	0	54143	2
2	0	4	244	244	54144	2
2	0	2	0	0	54145	2
2	0	2	0	0	54146	2
2	0	4	46	46	54147	2
2	0	2	0	0	54148	2
2	0	2	0	0	54149	2
2	0	2	0	0	54150	2
2	0	2	0	0	54151	2
2	52	2	1	53	54152	0
2	0	2	0	0	54153	2
2	0	2	0	0	54154	2
2	0	2	0	0	54155	2
2	0	2	0	0	54156	2
2	0	2	0	0	54157	2
2	0	2	0	0	54158	2
2	0	2	0	0	54159	2
2	0	2	0	0	54160	2
2	0	2	0	0	54161	2
2	0	2	0	0	54162	2
2	0	2	0	0	54163	2
2	0	2	0	0	54164	2
2	0	2	0	0	54165	2
2	0	2	0	0	54166	2
2	0	2	0	0	54167	2
2	0	2	0	0	54168	2
2	0	2	0	0	54169	2
2	0	2	0	0	54170	2
2	22	4	854	876	54171	1
2	0	2	6	6	54172	2
2	0	2	3	3	54173	2
2	9	2	8	17	54174	1
2	0	2	28	28	54175	2
2	2	2	0	2	54176	0
2	4	2	215	219	54177	1
2	0	2	3	3	54178	2
2	0	2	0	0	54179	2
2	3	4	2	5	54180	1
2	0	2	21	21	54181	2
2	22	2	0	22	54182	0
2	1	4	1261	1262	54183	1
2	0	2	2	2	54184	2
2	0	2	0	0	54185	2
2	1	4	396	397	54186	0
2	0	2	63	63	54187	2
2	92	2	2	94	54188	0
2	0	2	0	0	54189	2
2	0	2	0	0	54190	2
2	0	2	0	0	54191	2
2	0	2	0	0	54192	2
2	0	2	0	0	54193	2
2	0	2	0	0	54194	2
2	1	2	26	27	54195	1
2	0	2	1	1	54196	2
2	20	4	43	63	54197	0
0	0	4	2	2	54198	2
0	0	4	0	0	54199	2
2	0	4	3753	3753	54200	2
2	0	2	0	0	54201	2
2	0	2	0	0	54202	2
2	0	4	989	989	54203	2
2	0	2	178	178	54204	2
4	960	4	31	991	54205	0
0	19	4	269	288	54206	0
2	1	2	0	1	54207	0
2	10	2	0	10	54208	0
2	2	2	52	54	54209	1
2	0	2	3	3	54210	2
2	0	2	0	0	54211	2
2	2	2	2	4	54212	1
2	0	2	42	42	54213	2
2	1	2	0	1	54214	1
2	0	2	1	1	54215	2
2	1	2	0	1	54216	0
2	0	4	7	7	54217	2
2	0	2	0	0	54218	2
2	0	2	0	0	54219	2
2	0	2	0	0	54220	2
2	0	2	0	0	54221	2
2	0	2	0	0	54222	2
2	0	2	0	0	54223	2
2	0	2	0	0	54224	2
2	0	2	0	0	54225	2
2	0	2	0	0	54226	2
2	0	2	0	0	54227	2
2	0	2	0	0	54228	2
2	0	2	0	0	54229	2
2	0	2	0	0	54230	2
2	0	2	0	0	54231	2
2	0	2	0	0	54232	2
2	0	2	0	0	54233	2
2	0	2	0	0	54234	2
2	0	2	0	0	54235	2
2	0	2	0	0	54236	2
2	0	2	0	0	54237	2
2	0	2	0	0	54238	2
2	0	2	0	0	54239	2
2	0	2	0	0	54240	2
2	0	2	0	0	54241	2
2	0	2	0	0	54242	2
2	0	2	0	0	54243	2
2	0	2	0	0	54244	2
2	0	2	0	0	54245	2
2	0	2	0	0	54246	2
2	0	2	0	0	54247	2
2	0	2	0	0	54248	2
2	0	2	0	0	54249	2
2	0	2	0	0	54250	2
2	0	2	0	0	54251	2
2	0	2	0	0	54252	2
2	0	2	0	0	54253	2
2	0	2	0	0	54254	2
2	0	2	0	0	54255	2
2	0	2	0	0	54256	2
2	0	2	0	0	54257	2
2	0	2	0	0	54258	2
2	0	2	0	0	54259	2
2	0	2	0	0	54260	2
2	0	2	0	0	54261	2
2	0	2	0	0	54262	2
2	0	2	0	0	54263	2
2	0	2	0	0	54264	2
2	0	2	0	0	54265	2
2	0	2	0	0	54266	2
2	0	2	0	0	54267	2
0	0	0	0	0	54268	2
0	0	4	0	0	54269	2
2	0	2	0	0	54270	2
2	0	2	0	0	54271	2
2	0	2	0	0	54272	2
2	0	2	0	0	54273	2
2	0	2	0	0	54274	2
2	0	2	0	0	54275	2
2	0	2	0	0	54276	2
2	0	2	3	3	54277	2
2	0	2	0	0	54278	2
2	0	2	0	0	54279	2
2	0	2	0	0	54280	2
2	0	2	1	1	54281	2
0	0	4	0	0	54282	2
2	22	0	677	699	54283	0
2	0	2	0	0	54284	2
2	0	2	0	0	54285	2
2	0	0	190	190	54286	2
2	0	2	29	29	54287	2
0	0	4	1	1	54288	2
2	0	2	0	0	54289	2
2	0	2	0	0	54290	2
2	0	2	0	0	54291	2
2	0	2	0	0	54292	2
2	0	2	0	0	54293	2
2	0	2	0	0	54294	2
2	0	2	0	0	54295	2
2	0	2	2	2	54296	2
2	1	2	0	1	54297	0
2	16	2	21	37	54298	1
2	0	2	0	0	54299	2
2	0	2	0	0	54300	2
2	0	4	10	10	54301	2
2	0	2	1	1	54302	2
0	3	4	240	243	54303	0
4	0	4	0	0	54304	2
2	0	2	0	0	54305	2
2	0	2	0	0	54306	2
2	0	2	0	0	54307	2
2	0	2	0	0	54308	2
2	0	2	0	0	54309	2
2	0	2	0	0	54310	2
2	0	2	0	0	54311	2
4	0	4	1	1	54312	2
2	0	2	0	0	54313	2
2	0	2	0	0	54314	2
2	0	2	0	0	54315	2
2	0	2	0	0	54316	2
2	0	2	0	0	54317	2
2	0	2	0	0	54318	2
2	0	2	0	0	54319	2
2	0	2	0	0	54320	2
0	0	4	2	2	54321	2
2	0	2	0	0	54322	2
2	0	2	0	0	54323	2
2	0	2	0	0	54324	2
2	0	2	0	0	54325	2
2	0	2	0	0	54326	2
2	0	2	0	0	54327	2
2	0	2	0	0	54328	2
2	0	2	0	0	54329	2
2	0	2	0	0	54330	2
2	0	2	0	0	54331	2
2	0	2	0	0	54332	2
2	0	2	0	0	54333	2
2	0	2	0	0	54334	2
2	2	2	13	15	54335	1
2	0	2	0	0	54336	2
2	0	2	0	0	54337	2
2	0	2	0	0	54338	2
2	0	2	0	0	54339	2
2	0	2	3	3	54340	2
2	1	2	0	1	54341	0
2	0	2	32	32	54342	2
2	0	2	0	0	54343	2
2	0	2	0	0	54344	2
2	0	2	0	0	54345	2
2	0	4	5	5	54346	2
2	0	2	0	0	54347	2
2	0	2	0	0	54348	2
2	0	2	0	0	54349	2
2	0	2	0	0	54350	2
2	0	2	0	0	54351	2
2	0	2	0	0	54352	2
0	2	4	235	237	54353	0
4	76	4	40	116	54354	1
4	12	4	11	23	54355	1
0	104	4	56	160	54356	1
2	0	2	0	0	54357	2
2	0	2	0	0	54358	2
2	0	2	0	0	54359	2
2	0	2	0	0	54360	2
2	0	2	0	0	54361	2
2	0	2	0	0	54362	2
2	0	2	0	0	54363	2
2	0	2	0	0	54364	2
2	0	2	0	0	54365	2
2	0	2	1	1	54366	2
2	0	2	0	0	54367	2
2	0	2	2	2	54368	2
2	0	2	0	0	54369	2
2	0	2	0	0	54370	2
2	0	2	2	2	54371	2
2	0	2	0	0	54372	2
2	0	2	0	0	54373	2
2	0	2	0	0	54374	2
2	0	2	0	0	54375	2
2	0	2	0	0	54376	2
2	0	2	0	0	54377	2
2	0	2	0	0	54378	2
2	0	2	0	0	54379	2
2	0	0	888	888	54380	2
2	0	2	0	0	54381	2
2	0	2	0	0	54382	2
4	496	2	1429	1925	54383	0
4	24	2	81	105	54384	1
2	0	0	394	394	54385	2
2	0	2	0	0	54386	2
2	0	2	0	0	54387	2
2	0	2	0	0	54388	2
2	0	2	0	0	54389	2
2	0	2	0	0	54390	2
2	0	2	0	0	54391	2
2	0	2	0	0	54392	2
2	0	2	0	0	54393	2
2	2	2	0	2	54394	1
2	0	2	0	0	54395	2
2	0	2	0	0	54396	2
2	0	2	0	0	54397	2
2	0	2	0	0	54398	2
2	247	2	0	247	54399	0
2	1	2	1314	1315	54400	1
2	0	2	229	229	54401	2
2	0	2	0	0	54402	2
0	2178	2	84	2262	54403	0
0	531	2	3	534	54404	0
2	30	2	0	30	54405	0
2	44	4	591	635	54406	1
2	0	2	0	0	54407	2
2	0	2	0	0	54408	2
2	0	2	0	0	54409	2
2	0	2	0	0	54410	2
2	0	2	0	0	54411	2
2	0	2	0	0	54412	2
2	0	2	0	0	54413	2
2	0	2	0	0	54414	2
2	0	2	0	0	54415	2
2	0	2	0	0	54416	2
2	0	2	0	0	54417	2
2	0	2	0	0	54418	2
2	0	2	0	0	54419	2
2	0	2	0	0	54420	2
2	0	2	0	0	54421	2
2	0	2	0	0	54422	2
2	0	0	0	0	54423	2
2	0	2	0	0	54424	2
2	0	0	0	0	54425	2
2	0	2	0	0	54426	2
2	0	2	0	0	54427	2
2	0	2	0	0	54428	2
2	0	2	0	0	54429	2
2	0	2	0	0	54430	2
2	0	2	0	0	54431	2
2	0	2	0	0	54432	2
2	0	2	0	0	54433	2
2	0	2	0	0	54434	2
2	0	2	0	0	54435	2
2	0	2	0	0	54436	2
2	0	2	0	0	54437	2
2	0	2	0	0	54438	2
2	0	2	0	0	54439	2
2	0	2	0	0	54440	2
2	0	2	1	1	54441	2
2	0	2	0	0	54442	2
2	0	2	0	0	54443	2
0	37	2	1	38	54444	0
0	77	2	0	77	54445	0
2	0	2	0	0	54446	2
2	0	2	0	0	54447	2
2	0	2	0	0	54448	2
2	0	2	0	0	54449	2
2	0	4	631	631	54450	2
2	0	2	0	0	54451	2
2	0	2	0	0	54452	2
2	0	2	0	0	54453	2
2	0	2	0	0	54454	2
2	0	4	30	30	54455	2
2	0	2	1	1	54456	2
2	0	2	2	2	54457	2
2	6	2	0	6	54458	0
2	2	2	14	16	54459	1
2	0	2	0	0	54460	2
2	0	2	0	0	54461	2
2	1	2	0	1	54462	1
2	0	2	4	4	54463	2
2	0	2	0	0	54464	2
2	0	2	5	5	54465	2
2	0	2	0	0	54466	2
2	0	2	0	0	54467	2
0	2	2	0	2	54468	0
0	0	2	0	0	54469	2
2	0	2	0	0	54470	2
2	0	2	0	0	54471	2
2	0	2	0	0	54472	2
2	0	2	0	0	54473	2
2	0	2	0	0	54474	2
2	0	2	0	0	54475	2
2	0	2	0	0	54476	2
2	0	2	0	0	54477	2
2	0	2	0	0	54478	2
2	1	2	16	17	54479	0
2	0	2	0	0	54480	2
2	0	2	0	0	54481	2
2	0	2	0	0	54482	2
2	0	2	0	0	54483	2
2	1	2	0	1	54484	0
2	0	2	0	0	54485	2
2	0	2	1	1	54486	2
2	0	2	13	13	54487	2
2	0	2	0	0	54488	2
2	0	2	0	0	54489	2
2	0	2	0	0	54490	2
2	4	2	47	51	54491	1
2	0	2	1	1	54492	2
2	0	2	0	0	54493	2
2	3	2	3	6	54494	1
2	0	2	14	14	54495	2
2	880	2	2	882	54496	0
2	0	2	0	0	54497	2
2	1	4	0	1	54498	1
2	0	2	428	428	54499	2
2	0	2	14	14	54500	2
2	198	2	6	204	54501	1
2	1	4	176	177	54502	1
2	0	2	0	0	54503	2
2	0	2	0	0	54504	2
4	9	2	0	9	54505	0
0	2	3	26	28	54506	1
0	0	3	26	26	54507	2
2	0	2	0	0	54508	2
2	0	2	0	0	54509	2
2	0	2	0	0	54510	2
2	0	2	0	0	54511	2
2	0	2	0	0	54512	2
2	0	2	0	0	54513	2
2	140	2	1	141	54514	0
2	20	2	4243	4263	54515	1
2	0	2	5	5	54516	2
2	0	2	16	16	54517	2
2	6	2	25	31	54518	0
2	0	2	201	201	54519	2
2	0	2	0	0	54520	2
2	0	2	0	0	54521	2
2	0	2	0	0	54522	2
2	0	2	0	0	54523	2
2	0	2	0	0	54524	2
2	0	2	0	0	54525	2
2	0	2	1	1	54526	2
2	117	2	5	122	54527	0
2	29	2	31852	31881	54528	1
2	0	2	2	2	54529	2
2	0	2	1	1	54530	2
2	118	2	185	303	54531	1
2	0	2	724	724	54532	2
2	1	2	1	2	54533	0
2	0	4	229	229	54534	2
2	0	2	3	3	54535	2
2	0	2	0	0	54536	2
2	1	4	19	20	54537	1
2	0	2	20	20	54538	2
4	14	4	0	14	54539	0
4	7	4	0	7	54540	0
2	0	0	12	12	54541	2
2	0	2	0	0	54542	2
2	0	2	0	0	54543	2
2	0	0	0	0	54544	2
2	0	2	107	107	54545	2
2	2	2	0	2	54546	0
2	0	2	6	6	54547	2
2	0	2	0	0	54548	2
2	0	2	0	0	54549	2
2	1	2	0	1	54550	1
2	0	2	7	7	54551	2
2	0	2	0	0	54552	2
2	0	2	0	0	54553	2
2	0	2	0	0	54554	2
2	0	2	0	0	54555	2
2	0	2	0	0	54556	2
2	0	2	0	0	54557	2
2	0	2	0	0	54558	2
2	10	2	20	30	54559	1
2	0	2	0	0	54560	2
2	0	2	0	0	54561	2
2	0	2	6	6	54562	2
2	0	2	0	0	54563	2
2	126	2	2	128	54564	0
4	2267	2	20	2287	54565	0
4	1215	2	6	1221	54566	0
2	63	2	530	593	54567	1
2	0	2	73	73	54568	2
2	0	2	24	24	54569	2
2	1	2	0	1	54570	1
2	1	2	1	2	54571	0
2	0	2	4	4	54572	2
2	0	2	0	0	54573	2
2	0	2	0	0	54574	2
2	0	2	0	0	54575	2
2	0	2	1	1	54576	2
2	49	4	74	123	54577	1
2	0	2	0	0	54578	2
2	0	2	0	0	54579	2
2	4	4	3	7	54580	1
2	0	2	1	1	54581	2
2	0	2	0	0	54582	2
2	0	2	0	0	54583	2
2	0	2	0	0	54584	2
2	0	2	0	0	54585	2
2	0	2	0	0	54586	2
2	0	2	0	0	54587	2
2	0	2	0	0	54588	2
2	0	4	4	4	54589	2
2	0	2	0	0	54590	2
2	0	2	0	0	54591	2
2	0	4	7	7	54592	2
2	0	2	0	0	54593	2
2	0	2	0	0	54594	2
2	0	0	2267	2267	54595	2
2	0	2	0	0	54596	2
2	0	2	0	0	54597	2
2	0	0	644	644	54598	2
2	0	2	0	0	54599	2
0	0	4	12	12	54600	2
2	20	2	0	20	54601	0
2	68	2	941	1009	54602	1
2	0	2	10	10	54603	2
2	0	2	0	0	54604	2
2	31	2	4	35	54605	0
2	0	2	71	71	54606	2
2	0	2	0	0	54607	2
2	0	2	0	0	54608	2
2	0	2	0	0	54609	2
2	0	2	0	0	54610	2
2	0	2	0	0	54611	2
2	0	2	0	0	54612	2
2	1	2	0	1	54613	0
2	0	2	0	0	54614	2
2	0	2	1	1	54615	2
2	0	2	0	0	54616	2
2	0	2	0	0	54617	2
2	0	2	1	1	54618	2
2	0	0	277	277	54619	2
2	0	2	1	1	54620	2
2	0	2	0	0	54621	2
2	0	2	5	5	54622	2
2	0	2	1	1	54623	2
2	0	2	0	0	54624	2
2	0	2	4	4	54625	2
2	0	2	0	0	54626	2
4	2613	2	5	2618	54627	0
4	1099	2	4	1103	54628	0
2	0	2	0	0	54629	2
2	1	2	6	7	54630	1
2	0	2	0	0	54631	2
2	0	2	0	0	54632	2
2	0	2	0	0	54633	2
2	0	2	0	0	54634	2
2	0	2	0	0	54635	2
2	0	2	0	0	54636	2
2	0	4	16	16	54637	2
2	0	2	0	0	54638	2
2	0	2	0	0	54639	2
2	0	4	9	9	54640	2
2	0	2	0	0	54641	2
2	1	2	25070	25071	54642	1
2	0	2	0	0	54643	2
2	0	2	0	0	54644	2
2	0	2	330	330	54645	2
2	0	2	0	0	54646	2
2	0	2	0	0	54647	2
2	1	2	0	1	54648	0
2	0	2	1	1	54649	2
2	1	2	0	1	54650	0
2	0	2	5	5	54651	2
2	0	2	0	0	54652	2
2	0	2	0	0	54653	2
2	0	2	0	0	54654	2
2	0	2	0	0	54655	2
2	0	2	0	0	54656	2
2	0	2	0	0	54657	2
2	0	2	0	0	54658	2
0	0	4	16	16	54659	2
2	0	2	0	0	54660	2
2	0	2	0	0	54661	2
2	0	2	0	0	54662	2
2	0	2	1	1	54663	2
2	0	2	0	0	54664	2
2	0	2	0	0	54665	2
2	0	2	0	0	54666	2
2	0	2	0	0	54667	2
2	0	2	0	0	54668	2
2	0	2	0	0	54669	2
2	0	2	0	0	54670	2
2	0	2	0	0	54671	2
2	0	2	0	0	54672	2
2	0	2	0	0	54673	2
2	0	2	0	0	54674	2
2	1	2	15	16	54675	1
2	0	2	0	0	54676	2
2	0	2	0	0	54677	2
2	0	2	0	0	54678	2
0	0	4	2	2	54679	2
2	0	2	0	0	54680	2
2	0	2	0	0	54681	2
2	0	2	0	0	54682	2
2	0	2	0	0	54683	2
2	0	2	0	0	54684	2
2	0	2	0	0	54685	2
2	0	2	0	0	54686	2
2	0	2	0	0	54687	2
2	0	4	142	142	54688	2
2	0	2	3	3	54689	2
2	0	2	0	0	54690	2
2	825	2	3	828	54691	0
2	0	4	18	18	54692	2
2	0	2	0	0	54693	2
2	0	2	0	0	54694	2
2	0	4	5	5	54695	2
2	527	2	49	576	54696	1
2	0	2	18	18	54697	2
2	0	2	3	3	54698	2
2	114	2	11	125	54699	1
2	177	2	12	189	54700	0
2	17	2	9	26	54701	0
2	0	2	0	0	54702	2
2	0	2	0	0	54703	2
2	0	2	0	0	54704	2
2	0	2	0	0	54705	2
2	0	2	0	0	54706	2
2	0	2	0	0	54707	2
2	0	2	0	0	54708	2
2	0	4	1	1	54709	2
2	0	2	0	0	54710	2
2	0	2	0	0	54711	2
2	0	4	0	0	54712	2
2	0	2	1	1	54713	2
0	1	3	14	15	54714	1
0	0	3	14	14	54715	2
2	0	2	0	0	54716	2
2	0	2	0	0	54717	2
2	0	2	0	0	54718	2
2	0	2	0	0	54719	2
2	0	2	0	0	54720	2
2	0	2	0	0	54721	2
2	0	2	0	0	54722	2
2	0	2	0	0	54723	2
2	0	4	0	0	54724	2
2	0	2	0	0	54725	2
2	0	2	0	0	54726	2
2	0	4	0	0	54727	2
2	0	2	0	0	54728	2
2	1	2	1	2	54729	1
2	0	2	0	0	54730	2
2	0	2	0	0	54731	2
2	0	2	0	0	54732	2
2	0	2	0	0	54733	2
0	64	3	747	811	54734	0
0	1	3	747	748	54735	0
4	23	4	57	80	54736	1
2	7	2	401	408	54737	1
0	7	4	867	874	54738	0
2	0	2	0	0	54739	2
2	0	2	0	0	54740	2
2	0	2	0	0	54741	2
2	0	2	0	0	54742	2
2	0	2	0	0	54743	2
2	0	2	0	0	54744	2
2	0	2	0	0	54745	2
0	0	0	46	46	54746	2
2	0	2	0	0	54747	2
2	0	2	1	1	54748	2
2	0	2	0	0	54749	2
2	0	2	0	0	54750	2
2	0	2	0	0	54751	2
2	0	2	0	0	54752	2
2	1	2	0	1	54753	1
2	0	2	0	0	54754	2
2	0	2	0	0	54755	2
2	0	2	731	731	54756	2
2	0	2	29	29	54757	2
0	2	4	0	2	54758	0
0	0	4	0	0	54759	2
2	0	2	0	0	54760	2
2	0	2	0	0	54761	2
2	0	2	0	0	54762	2
2	0	2	0	0	54763	2
2	0	2	0	0	54764	2
2	0	2	1	1	54765	2
2	126	2	1	127	54766	0
2	451	2	0	451	54767	0
2	51	2	16107	16158	54768	1
2	0	2	0	0	54769	2
2	0	2	0	0	54770	2
2	33	2	4	37	54771	1
2	0	2	261	261	54772	2
2	197	4	308	505	54773	1
2	0	2	30	30	54774	2
2	0	2	0	0	54775	2
2	90	2	1471	1561	54776	0
2	0	2	116	116	54777	2
2	7	2	0	7	54778	0
2	2	2	134	136	54779	1
2	0	2	0	0	54780	2
2	0	2	0	0	54781	2
2	2	2	0	2	54782	1
2	0	2	0	0	54783	2
2	0	2	0	0	54784	2
2	0	2	0	0	54785	2
2	0	2	0	0	54786	2
2	0	2	0	0	54787	2
2	0	2	0	0	54788	2
2	0	2	0	0	54789	2
2	0	2	0	0	54790	2
2	0	4	84	84	54791	2
2	0	2	0	0	54792	2
2	0	2	0	0	54793	2
2	0	4	7	7	54794	2
2	0	2	0	0	54795	2
2	0	2	0	0	54796	2
2	0	2	0	0	54797	2
2	0	2	0	0	54798	2
2	0	2	0	0	54799	2
2	0	2	0	0	54800	2
2	0	2	0	0	54801	2
0	0	4	114	114	54802	2
2	0	2	0	0	54803	2
2	0	4	109	109	54804	2
2	0	2	0	0	54805	2
2	0	2	0	0	54806	2
2	0	4	44	44	54807	2
2	0	2	1	1	54808	2
4	0	4	340	340	54809	2
4	0	4	340	340	54810	2
2	0	2	0	0	54811	2
2	0	2	0	0	54812	2
2	0	2	0	0	54813	2
2	0	2	0	0	54814	2
2	0	2	0	0	54815	2
2	0	2	0	0	54816	2
2	0	2	0	0	54817	2
2	0	2	0	0	54818	2
2	0	2	0	0	54819	2
2	0	2	0	0	54820	2
2	0	2	0	0	54821	2
2	0	2	0	0	54822	2
4	5	4	16	21	54823	0
2	2	2	0	2	54824	0
2	1	2	360	361	54825	1
2	0	2	0	0	54826	2
2	0	2	0	0	54827	2
2	2	2	0	2	54828	1
2	0	2	4	4	54829	2
2	0	2	0	0	54830	2
2	0	2	0	0	54831	2
2	0	2	0	0	54832	2
2	0	2	0	0	54833	2
2	0	2	0	0	54834	2
2	0	2	0	0	54835	2
2	0	2	0	0	54836	2
2	0	2	0	0	54837	2
2	0	2	0	0	54838	2
2	0	2	0	0	54839	2
2	0	2	0	0	54840	2
2	0	2	0	0	54841	2
2	0	2	0	0	54842	2
2	4	2	18	22	54843	1
2	0	2	0	0	54844	2
2	0	2	0	0	54845	2
2	1	2	1	2	54846	1
2	0	2	5	5	54847	2
2	113	2	0	113	54848	0
2	3	2	265	268	54849	1
2	0	2	4	4	54850	2
2	0	2	0	0	54851	2
2	8	2	1	9	54852	0
2	0	2	76	76	54853	2
2	5	2	0	5	54854	0
2	0	2	0	0	54855	2
2	0	2	0	0	54856	2
2	1	2	0	1	54857	0
2	0	2	0	0	54858	2
2	0	2	0	0	54859	2
2	0	2	0	0	54860	2
2	1	2	202	203	54861	1
2	0	2	0	0	54862	2
2	0	2	0	0	54863	2
2	2	2	1	3	54864	1
2	0	2	5	5	54865	2
2	0	2	0	0	54866	2
2	0	0	665	665	54867	2
2	0	2	0	0	54868	2
2	0	2	0	0	54869	2
2	0	0	286	286	54870	2
2	0	2	0	0	54871	2
2	0	2	0	0	54872	2
2	0	2	0	0	54873	2
2	0	2	0	0	54874	2
2	0	2	0	0	54875	2
2	0	2	0	0	54876	2
2	0	2	0	0	54877	2
2	0	2	0	0	54878	2
2	0	2	0	0	54879	2
2	0	2	0	0	54880	2
2	0	2	0	0	54881	2
2	0	2	0	0	54882	2
2	0	2	0	0	54883	2
2	22	2	1	23	54884	0
2	1	2	380	381	54885	1
2	0	2	0	0	54886	2
2	0	2	0	0	54887	2
2	1	2	0	1	54888	1
2	0	2	6	6	54889	2
2	0	2	0	0	54890	2
2	0	2	0	0	54891	2
2	0	2	0	0	54892	2
2	0	2	0	0	54893	2
2	0	2	0	0	54894	2
2	0	2	0	0	54895	2
2	0	2	0	0	54896	2
2	0	2	3	3	54897	2
2	0	2	0	0	54898	2
2	0	2	0	0	54899	2
2	0	2	0	0	54900	2
2	0	2	0	0	54901	2
2	0	2	0	0	54902	2
2	0	2	0	0	54903	2
2	0	2	0	0	54904	2
2	0	2	0	0	54905	2
2	0	2	0	0	54906	2
2	0	2	0	0	54907	2
2	0	2	0	0	54908	2
2	0	2	0	0	54909	2
2	0	2	0	0	54910	2
2	0	2	0	0	54911	2
2	0	2	0	0	54912	2
2	0	2	0	0	54913	2
2	0	2	0	0	54914	2
2	0	2	2	2	54915	2
2	0	2	0	0	54916	2
2	0	2	0	0	54917	2
2	0	2	258	258	54918	2
2	0	2	0	0	54919	2
4	0	2	0	0	54920	2
2	0	2	0	0	54921	2
2	0	2	2	2	54922	2
2	0	2	0	0	54923	2
2	0	2	0	0	54924	2
2	0	2	0	0	54925	2
2	0	2	0	0	54926	2
2	0	2	0	0	54927	2
2	0	2	0	0	54928	2
2	0	2	0	0	54929	2
2	0	2	0	0	54930	2
2	0	2	0	0	54931	2
2	0	2	0	0	54932	2
2	0	2	0	0	54933	2
2	0	2	2	2	54934	2
2	0	2	0	0	54935	2
2	0	2	0	0	54936	2
2	0	2	0	0	54937	2
2	0	2	0	0	54938	2
2	4	2	0	4	54939	0
2	11	2	80	91	54940	1
2	0	2	0	0	54941	2
2	0	2	0	0	54942	2
2	0	2	0	0	54943	2
2	0	2	3	3	54944	2
2	0	2	0	0	54945	2
2	1	2	10	11	54946	1
2	0	2	0	0	54947	2
2	0	2	0	0	54948	2
2	0	2	0	0	54949	2
2	0	2	4	4	54950	2
2	0	2	0	0	54951	2
2	0	2	7	7	54952	2
2	0	2	0	0	54953	2
2	0	2	0	0	54954	2
2	0	2	2	2	54955	2
2	0	2	3	3	54956	2
0	2	4	92	94	54957	0
2	0	2	0	0	54958	2
2	0	4	0	0	54959	2
2	0	2	0	0	54960	2
2	0	4	9	9	54961	2
2	0	2	0	0	54962	2
2	0	2	0	0	54963	2
4	3	4	0	3	54964	0
4	0	4	0	0	54965	2
4	4	4	9	13	54966	0
2	0	2	0	0	54967	2
2	0	2	2	2	54968	2
2	0	2	0	0	54969	2
2	0	2	0	0	54970	2
2	0	2	0	0	54971	2
2	0	2	0	0	54972	2
2	134	2	0	134	54973	0
2	63	2	1621	1684	54974	1
2	0	2	11	11	54975	2
2	0	2	0	0	54976	2
2	18	2	1	19	54977	0
2	0	2	0	0	54978	2
2	0	2	0	0	54979	2
2	0	2	0	0	54980	2
2	0	2	0	0	54981	2
2	0	2	0	0	54982	2
2	0	2	0	0	54983	2
0	0	4	1	1	54984	2
0	0	4	1	1	54985	2
2	0	2	0	0	54986	2
2	0	2	0	0	54987	2
2	0	2	0	0	54988	2
2	0	2	0	0	54989	2
2	0	2	0	0	54990	2
2	0	2	0	0	54991	2
2	0	2	0	0	54992	2
2	0	2	0	0	54993	2
2	0	2	0	0	54994	2
2	1	2	0	1	54995	0
2	0	2	0	0	54996	2
2	0	2	0	0	54997	2
2	0	2	0	0	54998	2
2	0	2	0	0	54999	2
2	0	2	0	0	55000	2
2	0	2	0	0	55001	2
2	0	2	0	0	55002	2
2	0	2	1	1	55003	2
2	0	2	0	0	55004	2
2	0	2	0	0	55005	2
2	0	2	0	0	55006	2
2	0	2	0	0	55007	2
2	0	2	0	0	55008	2
2	0	2	0	0	55009	2
2	0	2	0	0	55010	2
2	0	2	0	0	55011	2
2	0	2	0	0	55012	2
2	0	2	0	0	55013	2
2	0	2	0	0	55014	2
2	0	2	0	0	55015	2
2	0	2	0	0	55016	2
2	0	2	0	0	55017	2
2	0	2	0	0	55018	2
2	0	2	0	0	55019	2
2	0	2	0	0	55020	2
2	0	2	0	0	55021	2
2	0	2	0	0	55022	2
2	0	2	0	0	55023	2
2	0	2	0	0	55024	2
2	0	2	0	0	55025	2
2	0	2	0	0	55026	2
2	0	2	0	0	55027	2
2	0	2	0	0	55028	2
2	0	2	0	0	55029	2
2	0	2	0	0	55030	2
2	0	2	0	0	55031	2
2	0	2	0	0	55032	2
2	0	2	0	0	55033	2
2	0	2	0	0	55034	2
2	0	2	0	0	55035	2
2	0	2	0	0	55036	2
2	0	2	0	0	55037	2
2	0	2	0	0	55038	2
2	0	2	0	0	55039	2
2	4	2	0	4	55040	0
2	0	2	0	0	55041	2
2	0	2	11	11	55042	2
2	0	2	11	11	55043	2
2	0	2	0	0	55044	2
2	0	2	1	1	55045	2
2	0	2	0	0	55046	2
2	0	4	0	0	55047	2
2	0	2	0	0	55048	2
2	0	2	0	0	55049	2
2	0	4	0	0	55050	2
2	0	2	0	0	55051	2
2	0	2	0	0	55052	2
2	0	2	0	0	55053	2
2	0	2	0	0	55054	2
2	0	2	0	0	55055	2
2	0	2	0	0	55056	2
2	0	2	0	0	55057	2
2	0	2	0	0	55058	2
2	0	2	0	0	55059	2
2	0	2	0	0	55060	2
2	0	2	0	0	55061	2
2	0	2	0	0	55062	2
2	0	2	0	0	55063	2
4	234	2	11	245	55064	0
4	14	2	0	14	55065	0
2	0	2	0	0	55066	2
2	0	2	0	0	55067	2
2	0	2	0	0	55068	2
2	0	2	0	0	55069	2
2	0	2	0	0	55070	2
2	0	2	0	0	55071	2
2	0	2	0	0	55072	2
2	0	2	0	0	55073	2
2	0	2	0	0	55074	2
2	0	2	0	0	55075	2
2	0	2	0	0	55076	2
2	0	2	0	0	55077	2
4	11	2	0	11	55078	0
2	0	2	0	0	55079	2
2	0	2	0	0	55080	2
2	0	2	0	0	55081	2
2	0	2	0	0	55082	2
2	0	2	0	0	55083	2
2	0	2	0	0	55084	2
2	0	2	0	0	55085	2
2	0	2	0	0	55086	2
2	0	2	0	0	55087	2
2	0	2	0	0	55088	2
2	0	2	0	0	55089	2
2	0	2	0	0	55090	2
2	0	2	0	0	55091	2
2	0	2	0	0	55092	2
2	0	2	0	0	55093	2
2	0	2	0	0	55094	2
2	0	2	0	0	55095	2
2	0	2	0	0	55096	2
2	0	2	0	0	55097	2
2	0	2	0	0	55098	2
2	0	2	0	0	55099	2
2	0	2	0	0	55100	2
2	0	2	0	0	55101	2
2	0	2	0	0	55102	2
2	0	2	0	0	55103	2
2	0	2	0	0	55104	2
2	0	2	0	0	55105	2
2	0	2	3	3	55106	2
2	1	2	0	1	55107	0
2	0	2	0	0	55108	2
2	0	2	0	0	55109	2
2	0	2	0	0	55110	2
2	0	2	0	0	55111	2
2	0	2	0	0	55112	2
2	0	2	0	0	55113	2
2	0	2	0	0	55114	2
2	0	2	0	0	55115	2
2	0	2	0	0	55116	2
2	0	2	0	0	55117	2
2	0	2	0	0	55118	2
2	0	2	0	0	55119	2
2	0	2	2	2	55120	2
2	0	2	1	1	55121	2
2	0	2	13	13	55122	2
2	0	2	311	311	55123	2
2	0	2	0	0	55124	2
2	0	2	0	0	55125	2
2	0	2	2	2	55126	2
2	0	2	0	0	55127	2
2	0	2	0	0	55128	2
2	0	2	0	0	55129	2
2	0	2	0	0	55130	2
2	3	2	11	14	55131	1
2	0	2	0	0	55132	2
2	0	2	0	0	55133	2
2	0	2	3	3	55134	2
2	0	2	2	2	55135	2
2	0	2	0	0	55136	2
2	0	2	0	0	55137	2
2	0	2	0	0	55138	2
2	0	2	0	0	55139	2
2	0	2	0	0	55140	2
2	0	2	0	0	55141	2
2	0	2	0	0	55142	2
2	0	2	0	0	55143	2
2	0	2	0	0	55144	2
2	0	2	0	0	55145	2
2	0	2	2	2	55146	2
2	0	2	0	0	55147	2
2	0	2	0	0	55148	2
2	0	2	0	0	55149	2
2	0	2	1	1	55150	2
2	0	2	0	0	55151	2
2	0	2	3	3	55152	2
2	0	2	0	0	55153	2
2	0	2	0	0	55154	2
2	0	2	0	0	55155	2
2	0	2	0	0	55156	2
2	0	2	0	0	55157	2
2	0	2	0	0	55158	2
2	0	2	0	0	55159	2
2	0	2	0	0	55160	2
2	0	2	0	0	55161	2
2	0	2	0	0	55162	2
2	0	2	0	0	55163	2
2	0	2	0	0	55164	2
2	0	2	0	0	55165	2
2	0	2	0	0	55166	2
2	0	2	0	0	55167	2
2	0	2	0	0	55168	2
2	0	2	0	0	55169	2
2	0	2	0	0	55170	2
2	0	2	0	0	55171	2
2	0	2	0	0	55172	2
2	0	2	0	0	55173	2
2	0	2	0	0	55174	2
2	0	2	0	0	55175	2
2	0	2	0	0	55176	2
2	0	2	0	0	55177	2
2	0	2	0	0	55178	2
2	0	2	0	0	55179	2
2	0	2	0	0	55180	2
2	0	2	0	0	55181	2
2	0	2	0	0	55182	2
2	0	2	0	0	55183	2
2	0	2	0	0	55184	2
2	0	2	0	0	55185	2
2	0	2	0	0	55186	2
2	0	2	0	0	55187	2
2	0	2	0	0	55188	2
2	0	2	0	0	55189	2
2	0	2	0	0	55190	2
2	0	2	0	0	55191	2
2	0	2	0	0	55192	2
2	0	2	0	0	55193	2
2	0	2	0	0	55194	2
2	0	2	0	0	55195	2
2	0	2	0	0	55196	2
2	0	2	0	0	55197	2
2	0	2	0	0	55198	2
2	0	2	0	0	55199	2
2	0	2	0	0	55200	2
2	0	2	0	0	55201	2
2	0	2	2	2	55202	2
2	0	2	0	0	55203	2
2	0	2	0	0	55204	2
2	0	2	0	0	55205	2
2	0	2	0	0	55206	2
2	0	2	0	0	55207	2
2	0	2	0	0	55208	2
2	0	2	0	0	55209	2
2	0	2	0	0	55210	2
2	0	2	0	0	55211	2
2	0	2	0	0	55212	2
2	23	2	0	23	55213	0
2	5	2	210	215	55214	1
2	0	2	5	5	55215	2
2	0	2	1	1	55216	2
2	8	2	0	8	55217	0
2	0	2	50	50	55218	2
2	0	2	0	0	55219	2
2	0	2	0	0	55220	2
2	0	2	0	0	55221	2
2	0	2	0	0	55222	2
2	0	2	0	0	55223	2
2	0	2	0	0	55224	2
2	1	2	0	1	55225	0
2	0	2	22	22	55226	2
2	0	2	0	0	55227	2
2	0	2	0	0	55228	2
2	0	2	0	0	55229	2
2	0	2	3	3	55230	2
2	0	2	0	0	55231	2
2	0	2	0	0	55232	2
2	0	2	0	0	55233	2
2	0	2	0	0	55234	2
2	0	2	0	0	55235	2
2	0	2	0	0	55236	2
2	0	2	0	0	55237	2
2	0	2	0	0	55238	2
2	0	4	3	3	55239	2
2	0	2	0	0	55240	2
2	0	2	0	0	55241	2
2	0	4	10	10	55242	2
2	0	2	0	0	55243	2
2	0	2	0	0	55244	2
2	1	2	0	1	55245	0
2	0	2	3	3	55246	2
2	0	2	0	0	55247	2
2	0	2	0	0	55248	2
2	0	2	0	0	55249	2
2	0	2	0	0	55250	2
2	0	2	0	0	55251	2
2	0	2	0	0	55252	2
2	0	2	0	0	55253	2
2	0	2	0	0	55254	2
2	0	2	0	0	55255	2
2	0	2	0	0	55256	2
2	0	2	0	0	55257	2
2	0	2	2	2	55258	2
2	0	2	0	0	55259	2
2	0	2	0	0	55260	2
2	0	2	0	0	55261	2
2	0	2	0	0	55262	2
2	0	2	0	0	55263	2
2	0	2	0	0	55264	2
2	0	2	0	0	55265	2
2	0	2	0	0	55266	2
2	0	2	0	0	55267	2
2	0	2	0	0	55268	2
2	0	2	0	0	55269	2
2	0	2	0	0	55270	2
2	0	2	0	0	55271	2
2	0	2	0	0	55272	2
2	0	2	0	0	55273	2
2	0	2	0	0	55274	2
2	0	2	0	0	55275	2
2	0	2	0	0	55276	2
2	0	2	5	5	55277	2
2	0	2	0	0	55278	2
2	0	2	0	0	55279	2
2	0	2	0	0	55280	2
2	0	2	0	0	55281	2
2	0	2	0	0	55282	2
2	0	2	0	0	55283	2
2	0	2	0	0	55284	2
2	0	2	0	0	55285	2
2	0	2	0	0	55286	2
2	0	2	0	0	55287	2
2	0	2	0	0	55288	2
2	0	2	0	0	55289	2
2	0	2	0	0	55290	2
4	0	4	0	0	55291	2
4	0	4	0	0	55292	2
2	0	2	0	0	55293	2
2	0	2	0	0	55294	2
2	0	2	0	0	55295	2
2	0	2	0	0	55296	2
2	0	2	0	0	55297	2
2	0	2	0	0	55298	2
2	0	2	0	0	55299	2
2	0	2	7	7	55300	2
2	0	2	0	0	55301	2
2	0	2	0	0	55302	2
2	0	2	1	1	55303	2
2	0	2	0	0	55304	2
2	0	2	0	0	55305	2
2	1	2	1	2	55306	0
2	0	2	0	0	55307	2
2	0	2	2	2	55308	2
2	24	2	0	24	55309	0
2	0	2	68	68	55310	2
2	8	2	2436	2444	55311	1
2	0	2	0	0	55312	2
2	7	2	12	19	55313	1
2	0	2	1	1	55314	2
2	0	2	0	0	55315	2
2	1	2	0	1	55316	1
2	0	2	4	4	55317	2
2	0	2	0	0	55318	2
2	0	2	0	0	55319	2
2	0	4	171	171	55320	2
2	0	2	0	0	55321	2
2	0	2	0	0	55322	2
2	4	4	412	416	55323	1
2	0	2	98	98	55324	2
2	0	2	0	0	55325	2
2	0	2	8	8	55326	2
2	0	2	0	0	55327	2
2	0	2	0	0	55328	2
2	0	2	0	0	55329	2
2	0	2	1	1	55330	2
2	0	2	0	0	55331	2
2	0	2	0	0	55332	2
2	0	2	0	0	55333	2
2	0	2	0	0	55334	2
2	0	2	0	0	55335	2
2	0	2	0	0	55336	2
2	0	2	0	0	55337	2
2	0	2	0	0	55338	2
2	0	2	0	0	55339	2
2	0	2	0	0	55340	2
2	0	2	0	0	55341	2
2	0	2	0	0	55342	2
2	0	2	0	0	55343	2
2	0	2	0	0	55344	2
2	0	2	1	1	55345	2
2	0	2	0	0	55346	2
2	0	2	0	0	55347	2
2	0	2	0	0	55348	2
2	0	2	0	0	55349	2
2	1	2	4	5	55350	1
2	0	2	0	0	55351	2
2	0	2	0	0	55352	2
2	0	2	0	0	55353	2
2	0	2	0	0	55354	2
2	0	2	0	0	55355	2
2	0	2	1	1	55356	2
2	0	2	0	0	55357	2
2	0	2	0	0	55358	2
2	0	2	0	0	55359	2
2	0	2	0	0	55360	2
2	0	2	0	0	55361	2
2	0	2	1	1	55362	2
2	0	2	0	0	55363	2
2	0	2	0	0	55364	2
2	0	2	0	0	55365	2
2	0	2	0	0	55366	2
2	0	2	0	0	55367	2
2	0	4	0	0	55368	2
2	0	2	0	0	55369	2
2	0	2	0	0	55370	2
2	0	4	0	0	55371	2
2	0	2	0	0	55372	2
2	0	2	0	0	55373	2
2	0	2	0	0	55374	2
2	0	2	0	0	55375	2
2	0	2	0	0	55376	2
2	0	2	0	0	55377	2
2	0	2	0	0	55378	2
2	0	2	0	0	55379	2
2	0	2	0	0	55380	2
2	0	2	0	0	55381	2
2	0	2	0	0	55382	2
2	0	2	0	0	55383	2
2	0	2	0	0	55384	2
2	0	2	0	0	55385	2
2	0	2	0	0	55386	2
2	0	2	0	0	55387	2
2	0	2	0	0	55388	2
2	0	2	0	0	55389	2
2	0	2	0	0	55390	2
2	0	2	0	0	55391	2
2	0	2	0	0	55392	2
2	0	2	0	0	55393	2
2	0	2	0	0	55394	2
2	0	2	0	0	55395	2
2	0	2	0	0	55396	2
2	0	2	0	0	55397	2
2	0	2	0	0	55398	2
2	0	2	0	0	55399	2
2	0	2	0	0	55400	2
2	130	2	0	130	55401	0
2	0	4	2	2	55402	2
2	0	2	0	0	55403	2
2	0	2	0	0	55404	2
2	0	2	0	0	55405	2
2	0	4	2	2	55406	2
2	19	2	3	22	55407	1
2	0	2	33	33	55408	2
2	0	2	1	1	55409	2
2	26	2	0	26	55410	0
0	0	2	0	0	55411	2
0	1	2	1	2	55412	0
0	1	2	0	1	55413	0
2	0	2	0	0	55414	2
2	0	2	0	0	55415	2
2	0	2	0	0	55416	2
2	0	2	0	0	55417	2
2	0	2	0	0	55418	2
2	0	2	0	0	55419	2
2	0	2	0	0	55420	2
2	0	4	3	3	55421	2
2	0	2	0	0	55422	2
2	0	4	66	66	55423	2
2	0	2	0	0	55424	2
2	0	2	0	0	55425	2
2	0	4	0	0	55426	2
2	0	2	0	0	55427	2
2	0	2	0	0	55428	2
2	0	2	0	0	55429	2
2	0	2	0	0	55430	2
2	0	2	0	0	55431	2
2	0	2	0	0	55432	2
2	0	2	0	0	55433	2
2	0	2	0	0	55434	2
2	3	2	0	3	55435	1
2	0	4	55	55	55436	2
2	0	2	0	0	55437	2
2	0	2	0	0	55438	2
2	1	4	6	7	55439	1
2	0	2	7	7	55440	2
2	0	2	1	1	55441	2
2	0	2	0	0	55442	2
2	0	2	0	0	55443	2
2	0	2	0	0	55444	2
2	0	2	0	0	55445	2
2	0	2	0	0	55446	2
2	0	2	4	4	55447	2
2	0	2	0	0	55448	2
2	0	2	0	0	55449	2
2	0	2	0	0	55450	2
2	0	2	0	0	55451	2
2	0	2	0	0	55452	2
2	0	2	0	0	55453	2
2	0	2	0	0	55454	2
2	0	2	0	0	55455	2
2	0	2	0	0	55456	2
2	0	2	0	0	55457	2
2	289	2	6	295	55458	0
2	0	2	0	0	55459	2
2	0	2	0	0	55460	2
2	0	2	0	0	55461	2
2	0	2	2	2	55462	2
2	0	2	0	0	55463	2
2	0	2	0	0	55464	2
2	0	2	0	0	55465	2
2	0	2	0	0	55466	2
2	0	2	0	0	55467	2
2	0	2	0	0	55468	2
2	0	2	0	0	55469	2
2	0	2	0	0	55470	2
2	0	2	0	0	55471	2
2	0	2	0	0	55472	2
2	0	2	0	0	55473	2
2	0	2	0	0	55474	2
2	0	2	0	0	55475	2
2	0	2	0	0	55476	2
2	0	2	0	0	55477	2
2	0	2	0	0	55478	2
2	0	2	0	0	55479	2
2	0	2	0	0	55480	2
2	0	2	0	0	55481	2
2	0	2	2	2	55482	2
2	1	2	0	1	55483	0
2	0	2	17	17	55484	2
2	0	2	0	0	55485	2
2	0	2	0	0	55486	2
2	1	2	0	1	55487	0
2	0	2	4	4	55488	2
2	0	2	0	0	55489	2
2	0	2	0	0	55490	2
2	5	2	17	22	55491	1
2	0	2	0	0	55492	2
2	0	2	0	0	55493	2
2	1	2	0	1	55494	0
2	0	2	4	4	55495	2
2	0	2	2	2	55496	2
2	0	2	0	0	55497	2
2	0	2	0	0	55498	2
0	453	2	0	453	55499	0
0	61	2	1	62	55500	0
2	0	2	0	0	55501	2
2	0	2	5	5	55502	2
2	0	2	0	0	55503	2
2	0	2	0	0	55504	2
2	0	2	1	1	55505	2
2	0	2	0	0	55506	2
2	0	2	0	0	55507	2
2	0	2	0	0	55508	2
2	0	2	0	0	55509	2
2	0	2	4	4	55510	2
2	0	2	0	0	55511	2
2	0	2	0	0	55512	2
2	0	2	0	0	55513	2
2	0	2	0	0	55514	2
2	0	2	0	0	55515	2
2	0	2	0	0	55516	2
2	0	2	0	0	55517	2
2	0	2	0	0	55518	2
2	0	2	0	0	55519	2
2	0	2	0	0	55520	2
2	0	2	0	0	55521	2
2	0	2	0	0	55522	2
2	0	2	0	0	55523	2
2	0	2	0	0	55524	2
2	0	2	0	0	55525	2
2	0	2	0	0	55526	2
2	0	2	0	0	55527	2
2	0	2	0	0	55528	2
2	0	2	0	0	55529	2
2	2	0	83	85	55530	0
2	0	2	0	0	55531	2
2	0	2	0	0	55532	2
2	0	0	66	66	55533	2
2	0	2	17	17	55534	2
2	0	2	0	0	55535	2
2	0	2	0	0	55536	2
2	0	2	0	0	55537	2
2	0	2	0	0	55538	2
2	0	2	0	0	55539	2
2	0	2	0	0	55540	2
2	121	2	0	121	55541	0
2	4	2	458	462	55542	1
2	0	2	53	53	55543	2
2	0	2	0	0	55544	2
2	16	2	0	16	55545	0
2	0	2	126	126	55546	2
2	0	2	0	0	55547	2
2	0	2	0	0	55548	2
2	0	2	0	0	55549	2
2	0	2	0	0	55550	2
2	0	2	0	0	55551	2
2	0	2	0	0	55552	2
2	97	2	0	97	55553	0
2	34	2	1442	1476	55554	1
2	0	2	45	45	55555	2
2	0	2	0	0	55556	2
2	75	2	0	75	55557	1
2	0	2	338	338	55558	2
0	9	2	0	9	55559	0
0	8	2	1442	1450	55560	0
0	0	2	0	0	55561	2
2	0	2	0	0	55562	2
2	0	2	0	0	55563	2
2	0	0	578	578	55564	2
2	3	2	21	24	55565	1
2	0	2	0	0	55566	2
2	0	2	0	0	55567	2
2	0	2	0	0	55568	2
2	0	2	0	0	55569	2
2	0	2	0	0	55570	2
2	0	2	0	0	55571	2
2	1	2	0	1	55572	0
2	0	2	0	0	55573	2
2	0	2	0	0	55574	2
2	0	2	0	0	55575	2
2	0	2	0	0	55576	2
0	0	2	0	0	55577	2
2	0	2	0	0	55578	2
2	0	2	0	0	55579	2
2	0	2	0	0	55580	2
2	0	2	0	0	55581	2
2	0	2	0	0	55582	2
2	0	2	0	0	55583	2
2	0	2	0	0	55584	2
2	0	2	0	0	55585	2
2	0	2	0	0	55586	2
2	1	2	0	1	55587	1
2	0	2	0	0	55588	2
2	0	2	0	0	55589	2
2	0	2	0	0	55590	2
2	0	2	0	0	55591	2
2	1	2	84	85	55592	1
2	0	2	0	0	55593	2
2	0	2	0	0	55594	2
2	0	2	7	7	55595	2
2	1	2	0	1	55596	0
2	0	2	0	0	55597	2
2	0	2	0	0	55598	2
2	0	2	0	0	55599	2
2	0	2	0	0	55600	2
2	0	2	0	0	55601	2
2	0	2	0	0	55602	2
2	0	2	0	0	55603	2
2	1	2	14	15	55604	1
2	0	2	0	0	55605	2
2	0	2	0	0	55606	2
2	0	2	5	5	55607	2
2	0	2	0	0	55608	2
2	0	2	0	0	55609	2
2	0	2	0	0	55610	2
2	0	2	0	0	55611	2
2	0	2	0	0	55612	2
2	0	2	0	0	55613	2
2	0	2	0	0	55614	2
2	0	2	0	0	55615	2
2	0	2	0	0	55616	2
2	0	2	0	0	55617	2
2	0	2	0	0	55618	2
2	0	2	0	0	55619	2
2	0	2	0	0	55620	2
2	0	2	0	0	55621	2
2	0	2	9	9	55622	2
2	0	4	460	460	55623	2
2	41	2	2	43	55624	0
2	0	2	0	0	55625	2
2	2	2	0	2	55626	1
2	0	2	1	1	55627	2
2	0	2	0	0	55628	2
2	0	2	5	5	55629	2
2	0	2	0	0	55630	2
2	0	2	0	0	55631	2
2	0	2	0	0	55632	2
2	0	2	0	0	55633	2
2	0	2	0	0	55634	2
2	0	2	0	0	55635	2
2	0	2	0	0	55636	2
2	0	2	0	0	55637	2
2	0	4	761	761	55638	2
2	0	2	0	0	55639	2
2	0	2	0	0	55640	2
2	0	4	241	241	55641	2
2	0	2	1	1	55642	2
2	0	2	0	0	55643	2
2	0	2	0	0	55644	2
2	0	2	0	0	55645	2
2	0	2	0	0	55646	2
2	0	2	0	0	55647	2
2	0	2	0	0	55648	2
2	0	2	0	0	55649	2
2	0	2	0	0	55650	2
2	0	2	0	0	55651	2
2	0	2	0	0	55652	2
2	0	2	0	0	55653	2
2	0	2	0	0	55654	2
2	5	2	889	894	55655	1
2	0	2	0	0	55656	2
2	0	2	0	0	55657	2
2	21	2	23	44	55658	1
2	0	2	103	103	55659	2
2	5	2	1	6	55660	0
2	0	2	0	0	55661	2
2	0	2	0	0	55662	2
2	0	2	0	0	55663	2
2	0	2	1	1	55664	2
2	0	2	0	0	55665	2
2	0	2	0	0	55666	2
2	0	4	317	317	55667	2
2	0	2	7	7	55668	2
2	0	2	0	0	55669	2
2	0	4	54	54	55670	2
2	0	2	3	3	55671	2
2	0	2	0	0	55672	2
2	0	2	0	0	55673	2
2	0	2	0	0	55674	2
2	0	2	0	0	55675	2
2	0	2	0	0	55676	2
2	0	2	0	0	55677	2
2	104	2	1	105	55678	0
2	0	2	0	0	55679	2
2	0	2	0	0	55680	2
2	0	2	0	0	55681	2
2	0	2	0	0	55682	2
2	0	2	0	0	55683	2
2	0	2	0	0	55684	2
2	0	2	0	0	55685	2
2	0	2	0	0	55686	2
0	0	4	2	2	55687	2
2	0	2	0	0	55688	2
2	0	2	0	0	55689	2
2	0	2	0	0	55690	2
2	0	2	0	0	55691	2
2	0	2	0	0	55692	2
2	0	2	0	0	55693	2
2	0	2	0	0	55694	2
2	0	4	17	17	55695	2
2	0	2	0	0	55696	2
2	0	2	0	0	55697	2
2	0	4	0	0	55698	2
2	0	2	0	0	55699	2
2	10	2	1025	1035	55700	0
2	3	2	0	3	55701	0
2	0	2	62	62	55702	2
2	0	2	0	0	55703	2
2	0	2	0	0	55704	2
2	0	2	0	0	55705	2
2	0	2	0	0	55706	2
2	0	2	0	0	55707	2
2	0	2	0	0	55708	2
2	0	2	0	0	55709	2
2	0	2	0	0	55710	2
2	0	2	0	0	55711	2
2	0	2	0	0	55712	2
2	0	2	0	0	55713	2
2	0	2	0	0	55714	2
2	0	2	0	0	55715	2
2	0	2	0	0	55716	2
2	0	2	0	0	55717	2
2	0	2	0	0	55718	2
2	0	2	0	0	55719	2
2	0	2	0	0	55720	2
2	0	2	0	0	55721	2
2	0	4	1354	1354	55722	2
2	0	2	0	0	55723	2
2	0	2	0	0	55724	2
2	0	4	177	177	55725	2
2	0	2	0	0	55726	2
2	0	2	0	0	55727	2
2	0	2	3	3	55728	2
2	1	2	0	1	55729	0
2	1	2	2	3	55730	1
2	0	2	0	0	55731	2
2	0	2	0	0	55732	2
2	458	2	1	459	55733	0
2	0	2	168	168	55734	2
2	0	2	8	8	55735	2
2	45	2	0	45	55736	0
2	1	2	352	353	55737	1
2	0	2	6	6	55738	2
2	0	2	0	0	55739	2
2	5	2	0	5	55740	0
2	0	2	78	78	55741	2
2	0	2	0	0	55742	2
2	0	4	0	0	55743	2
2	0	2	0	0	55744	2
2	0	2	0	0	55745	2
2	0	2	0	0	55746	2
2	0	2	0	0	55747	2
2	4	2	0	4	55748	0
2	1	2	16	17	55749	1
2	0	2	2	2	55750	2
2	0	2	0	0	55751	2
2	1	2	4	5	55752	1
2	0	2	7	7	55753	2
2	0	2	0	0	55754	2
2	2	2	10	12	55755	1
2	0	2	0	0	55756	2
2	0	2	0	0	55757	2
2	0	2	0	0	55758	2
2	0	2	4	4	55759	2
2	4	2	1	5	55760	0
2	9	4	858	867	55761	1
2	0	2	0	0	55762	2
2	0	2	0	0	55763	2
2	10	4	474	484	55764	0
2	0	2	33	33	55765	2
2	0	2	0	0	55766	2
2	4	2	8	12	55767	0
2	6	2	4	10	55768	0
2	0	2	39	39	55769	2
2	0	2	0	0	55770	2
2	0	2	0	0	55771	2
2	0	2	0	0	55772	2
2	0	2	0	0	55773	2
2	0	2	0	0	55774	2
2	0	2	0	0	55775	2
2	1	2	0	1	55776	0
2	0	2	0	0	55777	2
2	0	2	0	0	55778	2
2	0	2	2	2	55779	2
2	0	2	0	0	55780	2
2	0	2	0	0	55781	2
2	0	2	0	0	55782	2
2	0	4	300	300	55783	2
2	0	2	0	0	55784	2
2	0	2	0	0	55785	2
2	0	2	0	0	55786	2
2	0	2	0	0	55787	2
2	0	2	0	0	55788	2
2	0	2	0	0	55789	2
2	0	2	0	0	55790	2
2	0	2	0	0	55791	2
2	0	2	0	0	55792	2
2	0	2	0	0	55793	2
2	0	2	0	0	55794	2
2	0	2	0	0	55795	2
2	0	2	0	0	55796	2
2	0	2	0	0	55797	2
2	0	2	0	0	55798	2
2	0	2	0	0	55799	2
2	0	2	0	0	55800	2
2	0	2	0	0	55801	2
2	0	2	0	0	55802	2
2	0	2	0	0	55803	2
2	0	2	0	0	55804	2
2	0	2	0	0	55805	2
2	0	2	0	0	55806	2
2	0	2	0	0	55807	2
2	0	2	0	0	55808	2
2	0	2	0	0	55809	2
2	0	2	1	1	55810	2
2	0	2	1	1	55811	2
2	0	2	0	0	55812	2
2	1	2	0	1	55813	1
2	0	2	0	0	55814	2
2	0	2	0	0	55815	2
2	0	2	0	0	55816	2
2	0	2	0	0	55817	2
2	0	2	0	0	55818	2
2	0	2	0	0	55819	2
2	0	2	0	0	55820	2
2	88	2	2447	2535	55821	1
2	54	2	0	54	55822	0
2	0	2	293	293	55823	2
2	0	2	0	0	55824	2
2	0	2	0	0	55825	2
2	0	2	0	0	55826	2
2	0	2	0	0	55827	2
2	0	2	0	0	55828	2
2	0	2	0	0	55829	2
2	0	2	0	0	55830	2
2	0	2	0	0	55831	2
2	0	2	0	0	55832	2
2	0	2	0	0	55833	2
2	0	2	0	0	55834	2
2	0	2	0	0	55835	2
2	0	2	0	0	55836	2
2	0	2	0	0	55837	2
2	0	2	0	0	55838	2
2	0	2	0	0	55839	2
2	0	2	0	0	55840	2
2	0	2	0	0	55841	2
2	0	2	0	0	55842	2
2	0	2	0	0	55843	2
2	0	2	0	0	55844	2
2	0	2	0	0	55845	2
2	1	2	1	2	55846	0
2	0	2	0	0	55847	2
4	9	4	2	11	55848	1
4	0	4	0	0	55849	2
2	0	2	0	0	55850	2
2	0	2	0	0	55851	2
2	0	2	0	0	55852	2
2	0	2	0	0	55853	2
2	0	2	0	0	55854	2
2	0	2	0	0	55855	2
2	0	2	1	1	55856	2
2	0	2	0	0	55857	2
2	0	2	0	0	55858	2
2	1	2	2	3	55859	1
2	0	2	0	0	55860	2
2	0	2	0	0	55861	2
2	0	2	5	5	55862	2
2	11	2	0	11	55863	0
2	1	2	96	97	55864	1
2	0	2	0	0	55865	2
2	0	2	0	0	55866	2
2	3	2	0	3	55867	0
2	0	2	18	18	55868	2
2	0	2	0	0	55869	2
2	0	2	0	0	55870	2
2	0	2	0	0	55871	2
2	0	2	0	0	55872	2
2	0	2	0	0	55873	2
2	0	2	0	0	55874	2
2	0	2	0	0	55875	2
2	0	0	7	7	55876	2
2	0	2	0	0	55877	2
2	0	2	0	0	55878	2
2	0	0	0	0	55879	2
2	0	2	0	0	55880	2
2	0	2	0	0	55881	2
2	0	2	0	0	55882	2
2	0	2	0	0	55883	2
2	0	2	0	0	55884	2
2	0	2	0	0	55885	2
2	0	2	0	0	55886	2
2	0	2	0	0	55887	2
2	0	2	0	0	55888	2
2	0	2	0	0	55889	2
2	0	2	0	0	55890	2
2	0	2	0	0	55891	2
2	0	2	0	0	55892	2
2	0	2	0	0	55893	2
2	0	2	0	0	55894	2
2	0	2	0	0	55895	2
2	0	2	0	0	55896	2
2	0	2	0	0	55897	2
2	0	2	0	0	55898	2
2	0	2	0	0	55899	2
2	0	2	11	11	55900	2
2	0	2	0	0	55901	2
2	0	2	0	0	55902	2
2	1	2	10	11	55903	0
2	0	2	2	2	55904	2
2	0	2	0	0	55905	2
2	0	2	0	0	55906	2
2	0	2	0	0	55907	2
2	0	2	0	0	55908	2
2	0	2	0	0	55909	2
2	0	2	0	0	55910	2
2	0	2	0	0	55911	2
2	0	2	0	0	55912	2
2	0	2	0	0	55913	2
2	1	2	0	1	55914	0
2	0	2	0	0	55915	2
2	0	2	0	0	55916	2
2	0	2	0	0	55917	2
2	0	2	0	0	55918	2
2	0	2	0	0	55919	2
2	0	2	0	0	55920	2
2	0	2	0	0	55921	2
2	0	2	0	0	55922	2
2	0	2	0	0	55923	2
2	0	2	0	0	55924	2
2	0	2	0	0	55925	2
2	0	2	0	0	55926	2
2	0	2	0	0	55927	2
2	0	2	0	0	55928	2
2	0	2	0	0	55929	2
2	0	2	0	0	55930	2
2	0	2	0	0	55931	2
2	5	2	93	98	55932	1
2	0	2	0	0	55933	2
2	0	2	0	0	55934	2
2	1	2	10	11	55935	1
2	0	2	20	20	55936	2
2	0	2	0	0	55937	2
2	0	2	0	0	55938	2
2	0	2	0	0	55939	2
2	0	2	0	0	55940	2
2	0	2	0	0	55941	2
2	0	2	0	0	55942	2
2	0	2	0	0	55943	2
2	0	2	0	0	55944	2
2	0	2	0	0	55945	2
2	0	2	0	0	55946	2
2	0	2	0	0	55947	2
2	0	2	0	0	55948	2
2	0	2	0	0	55949	2
2	0	2	0	0	55950	2
2	0	2	0	0	55951	2
2	0	2	0	0	55952	2
2	0	2	0	0	55953	2
2	0	2	0	0	55954	2
2	3	2	0	3	55955	0
2	0	4	326	326	55956	2
2	0	2	0	0	55957	2
2	0	2	0	0	55958	2
2	2	4	248	250	55959	1
2	0	2	4	4	55960	2
2	0	2	0	0	55961	2
2	0	2	0	0	55962	2
2	0	2	0	0	55963	2
2	0	2	0	0	55964	2
2	0	2	0	0	55965	2
2	0	2	0	0	55966	2
2	0	2	0	0	55967	2
2	0	2	0	0	55968	2
2	0	2	0	0	55969	2
2	0	2	0	0	55970	2
2	0	2	0	0	55971	2
2	0	2	0	0	55972	2
2	0	2	0	0	55973	2
2	0	2	0	0	55974	2
2	0	2	0	0	55975	2
2	2	2	0	2	55976	0
2	0	2	0	0	55977	2
2	0	0	119	119	55978	2
2	0	2	0	0	55979	2
2	0	2	0	0	55980	2
2	0	0	59	59	55981	2
2	0	2	0	0	55982	2
2	0	2	639	639	55983	2
2	0	2	0	0	55984	2
2	0	2	0	0	55985	2
2	0	2	2041	2041	55986	2
2	0	2	1	1	55987	2
2	0	2	0	0	55988	2
2	1	2	0	1	55989	1
2	0	2	2	2	55990	2
2	3	2	3	6	55991	1
2	0	2	0	0	55992	2
2	0	2	0	0	55993	2
2	1	2	1	2	55994	1
2	0	2	1	1	55995	2
2	0	2	0	0	55996	2
2	0	2	0	0	55997	2
2	0	2	0	0	55998	2
2	0	2	0	0	55999	2
2	0	2	0	0	56000	2
2	0	2	7	7	56001	2
2	0	2	0	0	56002	2
2	0	2	0	0	56003	2
2	1	2	0	1	56004	1
2	0	2	4	4	56005	2
2	3	2	0	3	56006	0
2	0	2	0	0	56007	2
2	0	2	0	0	56008	2
2	21	2	0	21	56009	0
2	5	2	263	268	56010	1
2	0	2	3	3	56011	2
2	0	2	0	0	56012	2
2	7	2	16	23	56013	1
2	0	2	37	37	56014	2
4	20	4	3	23	56015	0
2	4	2	0	4	56016	0
2	1	2	33	34	56017	1
2	0	2	1	1	56018	2
2	0	2	0	0	56019	2
2	0	2	0	0	56020	2
2	0	2	10	10	56021	2
2	1	2	0	1	56022	0
2	1	2	4	5	56023	1
2	0	2	0	0	56024	2
2	0	2	0	0	56025	2
2	0	2	0	0	56026	2
2	0	2	0	0	56027	2
2	24	2	0	24	56028	0
2	4	2	1531	1535	56029	1
2	0	2	12	12	56030	2
2	0	2	0	0	56031	2
2	5	2	0	5	56032	1
2	0	2	111	111	56033	2
2	0	2	0	0	56034	2
2	0	2	0	0	56035	2
2	0	2	1	1	56036	2
2	0	2	0	0	56037	2
2	0	2	0	0	56038	2
2	0	2	0	0	56039	2
2	0	2	0	0	56040	2
2	0	2	60	60	56041	2
2	3	2	793	796	56042	0
4	6	4	2	8	56043	1
4	0	4	2	2	56044	2
2	0	2	0	0	56045	2
2	0	2	0	0	56046	2
2	0	2	0	0	56047	2
2	0	2	0	0	56048	2
2	0	2	0	0	56049	2
2	0	2	0	0	56050	2
2	0	2	0	0	56051	2
0	303	2	4	307	56052	1
0	77	2	2	79	56053	0
2	0	2	0	0	56054	2
2	0	2	0	0	56055	2
2	10	2	0	10	56056	0
2	0	2	0	0	56057	2
2	0	2	0	0	56058	2
2	0	2	0	0	56059	2
2	0	2	0	0	56060	2
2	0	2	0	0	56061	2
2	0	2	0	0	56062	2
2	0	2	0	0	56063	2
2	0	2	0	0	56064	2
2	0	2	0	0	56065	2
2	0	2	9	9	56066	2
2	0	2	0	0	56067	2
2	0	2	0	0	56068	2
2	0	2	24	24	56069	2
2	0	2	0	0	56070	2
2	0	2	0	0	56071	2
2	0	0	88	88	56072	2
2	0	2	0	0	56073	2
2	0	2	0	0	56074	2
2	0	0	56	56	56075	2
2	0	2	0	0	56076	2
2	0	2	18	18	56077	2
2	0	2	1	1	56078	2
4	1563	2	9	1572	56079	0
4	4981	2	24	5005	56080	0
2	1	2	0	1	56081	0
2	0	2	0	0	56082	2
2	0	2	0	0	56083	2
4	104	4	6	110	56084	0
4	3	4	0	3	56085	0
2	0	2	0	0	56086	2
2	0	2	0	0	56087	2
2	0	2	0	0	56088	2
2	0	2	0	0	56089	2
2	0	2	0	0	56090	2
2	0	2	0	0	56091	2
2	0	2	0	0	56092	2
2	0	2	0	0	56093	2
2	0	2	0	0	56094	2
2	0	2	0	0	56095	2
2	1	2	2	3	56096	1
2	0	2	0	0	56097	2
2	0	2	0	0	56098	2
2	0	2	0	0	56099	2
2	0	2	0	0	56100	2
2	0	2	0	0	56101	2
2	0	2	1	1	56102	2
2	0	2	0	0	56103	2
2	0	2	0	0	56104	2
2	0	2	0	0	56105	2
2	0	2	0	0	56106	2
2	8	2	0	8	56107	0
2	1	2	70	71	56108	1
2	0	2	0	0	56109	2
2	0	2	0	0	56110	2
2	2	2	0	2	56111	1
2	0	2	29	29	56112	2
2	0	2	0	0	56113	2
2	0	2	0	0	56114	2
2	0	2	0	0	56115	2
2	0	2	0	0	56116	2
2	0	2	0	0	56117	2
2	0	2	0	0	56118	2
2	0	2	0	0	56119	2
2	0	2	0	0	56120	2
2	0	2	0	0	56121	2
2	0	2	0	0	56122	2
2	0	2	0	0	56123	2
2	0	2	4	4	56124	2
2	0	2	0	0	56125	2
2	0	2	0	0	56126	2
2	2	2	0	2	56127	1
2	0	2	0	0	56128	2
2	4	2	0	4	56129	0
2	0	2	2	2	56130	2
2	0	2	0	0	56131	2
2	0	2	0	0	56132	2
2	0	2	0	0	56133	2
2	0	2	0	0	56134	2
2	0	2	0	0	56135	2
2	0	2	0	0	56136	2
2	0	2	0	0	56137	2
2	3	2	10	13	56138	1
2	0	2	0	0	56139	2
2	0	2	0	0	56140	2
0	0	4	2480	2480	56141	2
2	0	2	0	0	56142	2
2	0	0	0	0	56143	2
2	0	2	0	0	56144	2
2	0	2	0	0	56145	2
2	0	0	7	7	56146	2
2	0	2	0	0	56147	2
2	1	2	0	1	56148	0
2	1	2	10	11	56149	1
2	0	2	0	0	56150	2
2	0	2	0	0	56151	2
2	1	2	0	1	56152	1
2	0	2	1	1	56153	2
2	11	2	0	11	56154	0
2	2	2	0	2	56155	1
2	0	2	7	7	56156	2
2	1	2	12	13	56157	1
2	0	2	0	0	56158	2
2	0	2	0	0	56159	2
2	0	2	0	0	56160	2
2	0	2	0	0	56161	2
2	0	2	0	0	56162	2
2	0	2	0	0	56163	2
2	0	2	0	0	56164	2
2	0	2	0	0	56165	2
2	25	2	0	25	56166	0
2	0	2	5	5	56167	2
2	0	2	0	0	56168	2
2	0	2	0	0	56169	2
2	0	2	0	0	56170	2
2	0	2	0	0	56171	2
2	0	2	0	0	56172	2
2	0	2	0	0	56173	2
2	0	2	0	0	56174	2
2	0	2	0	0	56175	2
2	0	2	1	1	56176	2
2	0	2	0	0	56177	2
2	0	2	0	0	56178	2
2	0	2	2	2	56179	2
2	0	2	0	0	56180	2
2	0	2	0	0	56181	2
2	0	2	0	0	56182	2
2	0	2	0	0	56183	2
2	0	2	0	0	56184	2
2	0	2	0	0	56185	2
2	0	2	0	0	56186	2
2	0	2	0	0	56187	2
2	0	4	4	4	56188	2
2	0	2	0	0	56189	2
2	0	2	0	0	56190	2
2	0	4	6	6	56191	2
2	0	2	2	2	56192	2
2	0	2	0	0	56193	2
2	0	2	0	0	56194	2
2	0	2	0	0	56195	2
2	0	2	0	0	56196	2
2	0	2	0	0	56197	2
2	0	2	0	0	56198	2
2	0	2	0	0	56199	2
2	0	0	8	8	56200	2
2	0	2	0	0	56201	2
2	0	2	0	0	56202	2
2	0	0	0	0	56203	2
2	0	2	1	1	56204	2
2	0	2	0	0	56205	2
2	0	2	0	0	56206	2
2	0	2	0	0	56207	2
2	0	2	0	0	56208	2
2	0	2	24	24	56209	2
2	0	2	0	0	56210	2
2	0	2	0	0	56211	2
2	0	2	0	0	56212	2
2	0	2	0	0	56213	2
2	42	2	1	43	56214	0
2	1	2	0	1	56215	1
2	0	2	0	0	56216	2
2	9	2	0	9	56217	0
2	7	4	3323	3330	56218	1
2	0	2	4	4	56219	2
2	0	2	0	0	56220	2
0	30	2	24	54	56221	0
0	45	2	0	45	56222	0
2	12	4	976	988	56223	0
2	0	2	77	77	56224	2
2	0	2	1	1	56225	2
2	0	2	0	0	56226	2
2	1	2	1	2	56227	0
2	1	2	0	1	56228	0
2	0	2	22	22	56229	2
2	0	2	3	3	56230	2
2	0	2	0	0	56231	2
2	0	2	0	0	56232	2
2	0	2	14	14	56233	2
2	0	2	0	0	56234	2
2	0	2	0	0	56235	2
2	0	2	0	0	56236	2
2	0	2	0	0	56237	2
2	0	2	0	0	56238	2
2	0	2	0	0	56239	2
2	123	2	0	123	56240	0
2	0	2	0	0	56241	2
2	0	2	0	0	56242	2
2	0	2	0	0	56243	2
2	0	2	0	0	56244	2
2	0	2	0	0	56245	2
2	0	2	0	0	56246	2
2	8	2	0	8	56247	0
2	2	2	120	122	56248	1
2	0	2	0	0	56249	2
2	0	2	0	0	56250	2
2	0	2	0	0	56251	2
2	0	2	8	8	56252	2
2	74	2	1	75	56253	0
2	45	2	295	340	56254	1
2	0	2	28	28	56255	2
2	0	2	0	0	56256	2
2	18	2	0	18	56257	1
2	0	2	114	114	56258	2
2	59	2	879	938	56259	1
2	0	2	45	45	56260	2
2	0	2	1	1	56261	2
2	44	2	7	51	56262	1
2	1	2	306	307	56263	1
2	4	2	0	4	56264	0
2	0	2	14	14	56265	2
2	0	2	0	0	56266	2
2	0	2	0	0	56267	2
2	1	2	1	2	56268	1
2	0	2	1	1	56269	2
2	0	2	0	0	56270	2
2	2	2	3	5	56271	1
2	0	2	0	0	56272	2
2	0	2	0	0	56273	2
0	329	2	1	330	56274	1
0	259	2	0	259	56275	0
2	0	2	0	0	56276	2
2	0	2	0	0	56277	2
2	1	2	0	1	56278	1
2	1	2	33	34	56279	1
2	0	2	0	0	56280	2
2	0	2	0	0	56281	2
2	1	2	2	3	56282	1
2	0	2	8	8	56283	2
2	0	2	0	0	56284	2
2	0	2	0	0	56285	2
2	0	2	0	0	56286	2
2	22	2	1	23	56287	0
2	5	2	566	571	56288	1
2	0	2	9	9	56289	2
2	0	2	0	0	56290	2
2	5	2	2	7	56291	1
2	0	2	39	39	56292	2
2	834	2	1	835	56293	0
2	57	2	7792	7849	56294	1
2	0	2	8	8	56295	2
2	0	2	0	0	56296	2
2	43	2	6	49	56297	0
2	0	2	429	429	56298	2
2	306	2	0	306	56299	0
2	0	2	10	10	56300	2
2	0	2	17	17	56301	2
2	0	2	0	0	56302	2
2	0	2	1	1	56303	2
2	0	2	0	0	56304	2
2	0	2	0	0	56305	2
2	0	2	0	0	56306	2
2	0	2	0	0	56307	2
2	0	2	0	0	56308	2
2	0	2	0	0	56309	2
2	0	2	0	0	56310	2
2	0	2	0	0	56311	2
2	0	2	0	0	56312	2
2	0	2	0	0	56313	2
2	0	2	0	0	56314	2
2	0	2	0	0	56315	2
2	0	2	0	0	56316	2
2	0	2	0	0	56317	2
2	0	2	0	0	56318	2
2	0	2	0	0	56319	2
2	0	2	0	0	56320	2
2	0	2	0	0	56321	2
2	0	2	1	1	56322	2
2	0	2	0	0	56323	2
2	0	2	0	0	56324	2
2	0	2	0	0	56325	2
2	0	2	4	4	56326	2
2	0	2	0	0	56327	2
2	0	2	0	0	56328	2
2	0	2	0	0	56329	2
2	0	2	0	0	56330	2
2	0	2	0	0	56331	2
2	0	2	0	0	56332	2
2	0	2	0	0	56333	2
2	0	2	0	0	56334	2
2	0	4	54	54	56335	2
2	0	2	0	0	56336	2
2	0	2	0	0	56337	2
2	0	4	7	7	56338	2
2	1	2	18	19	56339	1
2	41	2	0	41	56340	0
2	3	2	576	579	56341	1
2	0	2	1	1	56342	2
2	0	2	0	0	56343	2
2	7	2	0	7	56344	1
2	0	2	40	40	56345	2
2	6	2	1457	1463	56346	1
2	40	2	0	40	56347	0
2	0	2	149	149	56348	2
2	8	2	0	8	56349	0
2	0	2	255	255	56350	2
2	0	2	1	1	56351	2
2	0	2	0	0	56352	2
2	4	2	0	4	56353	0
2	0	2	39	39	56354	2
2	0	2	0	0	56355	2
2	1	4	36	37	56356	1
2	0	2	0	0	56357	2
2	0	2	0	0	56358	2
2	0	4	19	19	56359	2
2	0	2	1	1	56360	2
2	0	2	23	23	56361	2
2	0	2	0	0	56362	2
2	0	2	1	1	56363	2
2	0	2	14	14	56364	2
2	2	4	150	152	56365	0
2	1	2	1	2	56366	0
2	25	0	274	299	56367	1
2	0	2	0	0	56368	2
2	0	2	0	0	56369	2
2	12	0	346	358	56370	0
2	0	2	604	604	56371	2
0	0	4	0	0	56372	2
0	16	2	0	16	56373	0
0	5	4	0	5	56374	0
0	0	2	0	0	56375	2
4	2	4	80	82	56376	0
2	2	2	15	17	56377	1
2	0	2	45	45	56378	2
0	2	4	1	3	56379	1
4	23616	2	131	23747	56380	0
4	1580	2	330	1910	56381	0
4	57	4	204197	204254	56382	1
4	8	4	98993	99001	56383	0
4	0	4	393	393	56384	2
4	0	4	167	167	56385	2
2	11976	5	63903	75879	56386	0
4	0	4	732	732	56387	2
4	0	0	417	417	56388	2
2	0	2	15	15	56389	2
2	0	2	45	45	56390	2
4	0	4	393	393	56391	2
4	0	4	167	167	56392	2
4	20036	1	208062	228098	56393	0
4	0	4	4	4	56394	2
4	0	4	12	12	56395	2
4	18	2	0	18	56396	0
4	3	2	0	3	56397	0
4	11	2	0	11	56398	0
4	1	2	3	4	56399	0
4	0	2	0	0	56400	2
4	11	4	13700	13711	56401	1
4	3250	4	13513	16763	56402	1
0	2141	2	69	2210	56403	0
0	2253	2	2	2255	56404	0
0	781	2	0	781	56405	0
4	674	4	33606	34280	56406	1
4	0	0	4	4	56407	2
4	0	0	0	0	56408	2
4	1	4	257	258	56409	1
4	3	4	92	95	56410	1
2	12583	2	479	13062	56411	0
2	152371	3	1759	154130	56412	0
0	276	2	795	1071	56413	0
0	1	2	879	880	56414	1
0	0	2	7	7	56415	2
4	38	2	33	71	56416	0
4	33	2	2	35	56417	0
2	0	2	0	0	56418	2
2	0	2	0	0	56419	2
2	0	2	0	0	56420	2
2	0	2	0	0	56421	2
2	0	2	0	0	56422	2
2	0	2	0	0	56423	2
2	0	2	0	0	56424	2
2	0	2	0	0	56425	2
2	0	2	0	0	56426	2
2	0	2	0	0	56427	2
2	0	2	0	0	56428	2
2	0	2	0	0	56429	2
2	0	2	0	0	56430	2
2	0	2	0	0	56431	2
2	0	2	0	0	56432	2
2	0	2	0	0	56433	2
2	0	2	0	0	56434	2
2	0	2	0	0	56435	2
2	0	2	0	0	56436	2
2	0	2	28	28	56437	2
2	0	2	0	0	56438	2
2	0	2	0	0	56439	2
2	0	2	1	1	56440	2
2	0	2	0	0	56441	2
2	0	2	0	0	56442	2
2	0	2	0	0	56443	2
2	0	2	0	0	56444	2
2	0	2	0	0	56445	2
2	0	2	0	0	56446	2
2	0	2	0	0	56447	2
2	4	2	0	4	56448	0
2	0	2	0	0	56449	2
2	0	2	0	0	56450	2
2	0	2	0	0	56451	2
2	0	2	0	0	56452	2
2	0	2	0	0	56453	2
2	0	2	0	0	56454	2
2	0	4	348	348	56455	2
2	0	2	1	1	56456	2
2	0	2	0	0	56457	2
4	12	2	18	30	56458	0
2	0	2	0	0	56459	2
2	0	2	0	0	56460	2
2	0	2	0	0	56461	2
2	0	2	1	1	56462	2
2	0	2	0	0	56463	2
2	0	2	0	0	56464	2
2	0	2	0	0	56465	2
2	0	2	0	0	56466	2
2	0	2	0	0	56467	2
2	0	2	0	0	56468	2
2	0	2	0	0	56469	2
2	0	2	0	0	56470	2
2	0	2	0	0	56471	2
2	0	2	0	0	56472	2
2	0	2	0	0	56473	2
2	0	2	0	0	56474	2
2	0	2	0	0	56475	2
2	0	2	0	0	56476	2
2	0	2	1	1	56477	2
0	0	4	18	18	56478	2
2	0	2	0	0	56479	2
2	0	2	0	0	56480	2
2	0	2	0	0	56481	2
2	0	2	0	0	56482	2
2	0	2	0	0	56483	2
2	0	2	0	0	56484	2
2	0	2	0	0	56485	2
2	0	4	0	0	56486	2
2	0	2	0	0	56487	2
2	0	2	0	0	56488	2
2	0	4	0	0	56489	2
2	0	2	0	0	56490	2
4	0	2	0	0	56491	2
2	30	2	0	30	56492	0
2	0	2	0	0	56493	2
2	0	2	0	0	56494	2
2	0	2	0	0	56495	2
2	0	2	0	0	56496	2
2	0	2	0	0	56497	2
2	0	2	0	0	56498	2
2	0	2	0	0	56499	2
2	0	2	0	0	56500	2
2	0	2	0	0	56501	2
2	0	2	0	0	56502	2
2	0	2	0	0	56503	2
2	0	2	0	0	56504	2
2	0	2	0	0	56505	2
2	0	2	0	0	56506	2
2	0	2	0	0	56507	2
2	0	2	0	0	56508	2
2	0	2	0	0	56509	2
2	0	2	0	0	56510	2
2	6	4	750	756	56511	1
2	0	2	11	11	56512	2
2	0	2	0	0	56513	2
2	20	4	143	163	56514	0
2	0	2	46	46	56515	2
2	0	2	0	0	56516	2
2	0	2	0	0	56517	2
2	0	2	0	0	56518	2
2	0	2	0	0	56519	2
2	0	2	0	0	56520	2
2	0	2	0	0	56521	2
2	0	2	0	0	56522	2
2	0	2	0	0	56523	2
2	0	2	0	0	56524	2
2	0	2	0	0	56525	2
2	0	2	0	0	56526	2
2	0	2	0	0	56527	2
2	0	2	0	0	56528	2
2	0	2	0	0	56529	2
2	0	2	0	0	56530	2
2	0	2	0	0	56531	2
2	0	2	0	0	56532	2
2	0	2	0	0	56533	2
2	0	2	0	0	56534	2
2	0	2	0	0	56535	2
2	0	2	0	0	56536	2
2	0	2	0	0	56537	2
2	0	2	0	0	56538	2
2	0	2	0	0	56539	2
0	0	4	20	20	56540	2
2	0	4	403	403	56541	2
2	0	2	0	0	56542	2
2	0	2	0	0	56543	2
2	0	4	193	193	56544	2
2	0	2	28	28	56545	2
4	0	2	2	2	56546	2
2	0	2	0	0	56547	2
2	0	2	0	0	56548	2
2	0	2	0	0	56549	2
2	0	2	0	0	56550	2
2	0	2	0	0	56551	2
2	0	2	0	0	56552	2
2	0	2	0	0	56553	2
2	0	2	0	0	56554	2
2	0	2	0	0	56555	2
2	0	2	0	0	56556	2
2	0	2	0	0	56557	2
2	0	2	8	8	56558	2
2	0	2	0	0	56559	2
2	0	2	4	4	56560	2
2	0	2	0	0	56561	2
2	0	2	0	0	56562	2
2	0	2	0	0	56563	2
2	0	2	0	0	56564	2
2	0	2	0	0	56565	2
2	0	2	0	0	56566	2
2	0	2	0	0	56567	2
2	0	2	0	0	56568	2
2	0	2	0	0	56569	2
2	0	2	0	0	56570	2
2	268	2	5	273	56571	0
2	84	4	2707	2791	56572	1
2	0	2	36	36	56573	2
2	0	2	8	8	56574	2
4	0	2	68	68	56575	2
2	0	2	0	0	56576	2
2	0	2	0	0	56577	2
2	0	2	0	0	56578	2
2	0	2	0	0	56579	2
2	0	2	0	0	56580	2
2	0	2	0	0	56581	2
4	0	4	136	136	56582	2
2	69	4	276	345	56583	0
2	0	2	300	300	56584	2
2	0	2	0	0	56585	2
2	0	2	0	0	56586	2
2	0	2	0	0	56587	2
2	0	2	0	0	56588	2
2	0	2	0	0	56589	2
2	0	2	0	0	56590	2
2	0	2	0	0	56591	2
2	0	2	0	0	56592	2
2	0	2	0	0	56593	2
2	0	2	0	0	56594	2
2	0	2	0	0	56595	2
2	0	2	0	0	56596	2
2	0	2	0	0	56597	2
2	0	2	0	0	56598	2
2	0	2	0	0	56599	2
2	0	2	0	0	56600	2
2	0	2	0	0	56601	2
2	6	2	0	6	56602	0
2	0	2	0	0	56603	2
2	0	2	11	11	56604	2
2	0	2	0	0	56605	2
2	0	2	0	0	56606	2
2	0	2	0	0	56607	2
2	0	2	0	0	56608	2
4	0	2	7	7	56609	2
2	0	2	0	0	56610	2
2	0	2	0	0	56611	2
2	0	2	0	0	56612	2
2	0	2	0	0	56613	2
2	0	2	0	0	56614	2
2	0	2	0	0	56615	2
2	0	2	0	0	56616	2
2	0	2	1	1	56617	2
2	0	2	0	0	56618	2
2	0	2	0	0	56619	2
2	0	2	0	0	56620	2
2	0	2	0	0	56621	2
2	0	2	0	0	56622	2
2	0	2	0	0	56623	2
2	0	2	0	0	56624	2
2	0	2	0	0	56625	2
2	0	2	0	0	56626	2
2	0	2	0	0	56627	2
2	2	4	403	405	56628	1
2	0	2	1	1	56629	2
2	0	2	1	1	56630	2
2	8	4	73	81	56631	0
2	0	2	9	9	56632	2
4	80	4	4	84	56633	0
2	0	2	0	0	56634	2
2	0	2	0	0	56635	2
2	0	2	0	0	56636	2
2	0	2	0	0	56637	2
2	0	2	0	0	56638	2
2	0	2	0	0	56639	2
2	0	2	0	0	56640	2
2	0	4	31	31	56641	2
2	0	2	0	0	56642	2
2	0	2	0	0	56643	2
2	0	4	0	0	56644	2
2	0	2	0	0	56645	2
2	0	2	0	0	56646	2
2	0	2	0	0	56647	2
2	0	2	0	0	56648	2
2	0	2	0	0	56649	2
2	0	2	0	0	56650	2
2	0	2	0	0	56651	2
2	0	2	0	0	56652	2
2	0	2	0	0	56653	2
2	0	2	0	0	56654	2
2	0	2	0	0	56655	2
2	0	2	0	0	56656	2
2	0	2	0	0	56657	2
2	3	4	505	508	56658	0
2	0	2	11	11	56659	2
2	0	2	15	15	56660	2
2	0	2	0	0	56661	2
2	0	2	0	0	56662	2
2	0	2	0	0	56663	2
2	0	2	0	0	56664	2
2	0	2	0	0	56665	2
2	0	2	0	0	56666	2
2	0	2	0	0	56667	2
2	0	2	0	0	56668	2
2	0	2	0	0	56669	2
2	0	2	2	2	56670	2
2	0	2	0	0	56671	2
2	0	2	0	0	56672	2
2	1	2	0	1	56673	0
2	24	2	0	24	56674	0
2	0	2	0	0	56675	2
2	0	2	0	0	56676	2
2	0	2	0	0	56677	2
2	0	2	0	0	56678	2
2	0	2	0	0	56679	2
2	0	2	0	0	56680	2
2	0	2	3	3	56681	2
2	0	2	1	1	56682	2
2	0	4	82	82	56683	2
2	0	2	14	14	56684	2
2	0	2	0	0	56685	2
2	0	4	460	460	56686	2
2	0	2	0	0	56687	2
2	0	2	0	0	56688	2
0	20	2	0	20	56689	0
0	34	2	0	34	56690	1
2	1	4	1066	1067	56691	0
2	0	2	0	0	56692	2
2	0	2	0	0	56693	2
2	0	2	0	0	56694	2
2	0	2	0	0	56695	2
2	0	2	0	0	56696	2
2	0	2	0	0	56697	2
2	0	2	0	0	56698	2
2	0	2	0	0	56699	2
2	0	2	0	0	56700	2
2	0	2	0	0	56701	2
2	0	2	0	0	56702	2
2	0	2	0	0	56703	2
2	0	2	0	0	56704	2
2	0	2	2	2	56705	2
2	0	2	0	0	56706	2
2	0	2	0	0	56707	2
2	0	2	1	1	56708	2
2	0	2	0	0	56709	2
2	0	2	0	0	56710	2
2	0	2	0	0	56711	2
2	0	2	0	0	56712	2
2	0	2	0	0	56713	2
2	0	2	0	0	56714	2
2	0	2	0	0	56715	2
2	0	2	0	0	56716	2
0	0	0	0	0	56717	2
2	0	4	168	168	56718	2
2	0	2	0	0	56719	2
2	0	2	0	0	56720	2
0	0	4	2	2	56721	2
2	0	2	0	0	56722	2
2	0	2	0	0	56723	2
2	0	2	0	0	56724	2
2	0	2	0	0	56725	2
2	0	2	0	0	56726	2
2	0	2	0	0	56727	2
2	0	2	0	0	56728	2
2	0	4	10160	10160	56729	2
2	0	2	0	0	56730	2
2	0	2	0	0	56731	2
4	12	2	0	12	56732	0
2	0	4	6523	6523	56733	2
2	0	2	0	0	56734	2
2	0	2	0	0	56735	2
2	0	2	0	0	56736	2
2	0	2	0	0	56737	2
2	0	2	0	0	56738	2
2	0	2	0	0	56739	2
2	0	2	0	0	56740	2
2	2	2	0	2	56741	0
2	0	2	23	23	56742	2
2	0	2	2	2	56743	2
2	0	2	0	0	56744	2
2	1	2	1	2	56745	1
2	0	2	5	5	56746	2
2	0	2	0	0	56747	2
2	0	2	1	1	56748	2
2	0	2	0	0	56749	2
2	0	2	0	0	56750	2
2	0	2	0	0	56751	2
2	0	2	0	0	56752	2
2	0	2	0	0	56753	2
2	0	2	0	0	56754	2
2	0	2	0	0	56755	2
2	0	2	0	0	56756	2
2	0	2	0	0	56757	2
2	0	2	0	0	56758	2
2	0	2	0	0	56759	2
2	0	2	0	0	56760	2
2	0	2	0	0	56761	2
2	0	2	0	0	56762	2
2	0	2	0	0	56763	2
2	0	2	0	0	56764	2
2	0	4	19	19	56765	2
2	0	2	0	0	56766	2
2	0	2	0	0	56767	2
2	0	4	1	1	56768	2
2	0	2	0	0	56769	2
4	0	2	0	0	56770	2
0	0	4	0	0	56771	2
4	0	4	88	88	56772	2
2	0	2	0	0	56773	2
2	0	2	0	0	56774	2
2	0	2	0	0	56775	2
2	0	2	0	0	56776	2
2	0	2	0	0	56777	2
2	0	2	0	0	56778	2
2	0	2	0	0	56779	2
2	0	4	9441	9441	56780	2
2	0	2	0	0	56781	2
2	0	2	0	0	56782	2
2	0	4	2454	2454	56783	2
0	7	0	35	42	56784	1
2	0	2	0	0	56785	2
2	0	4	2	2	56786	2
2	0	2	0	0	56787	2
2	0	2	0	0	56788	2
2	0	4	1	1	56789	2
2	0	2	0	0	56790	2
2	0	2	0	0	56791	2
2	0	4	4554	4554	56792	2
2	0	2	0	0	56793	2
2	0	2	0	0	56794	2
2	0	4	2627	2627	56795	2
2	0	2	321	321	56796	2
4	33	2	0	33	56797	0
2	0	2	0	0	56798	2
2	0	2	0	0	56799	2
2	0	2	0	0	56800	2
2	0	2	0	0	56801	2
2	0	2	0	0	56802	2
2	0	2	0	0	56803	2
2	0	2	0	0	56804	2
2	0	2	0	0	56805	2
2	0	2	0	0	56806	2
2	0	2	0	0	56807	2
2	0	2	0	0	56808	2
2	0	2	0	0	56809	2
0	12	0	0	12	56810	0
2	0	2	2	2	56811	2
2	0	2	4	4	56812	2
2	0	2	0	0	56813	2
2	0	2	22	22	56814	2
2	0	2	0	0	56815	2
2	0	2	0	0	56816	2
2	0	2	0	0	56817	2
2	0	2	0	0	56818	2
2	0	2	0	0	56819	2
2	0	2	0	0	56820	2
2	0	2	0	0	56821	2
2	0	2	0	0	56822	2
2	0	2	0	0	56823	2
2	0	2	0	0	56824	2
2	0	2	0	0	56825	2
2	0	2	0	0	56826	2
2	0	2	0	0	56827	2
2	0	2	0	0	56828	2
2	0	2	0	0	56829	2
2	0	2	1	1	56830	2
2	0	2	0	0	56831	2
2	0	2	0	0	56832	2
2	0	2	0	0	56833	2
2	0	4	0	0	56834	2
2	0	2	0	0	56835	2
2	0	2	0	0	56836	2
2	0	4	2	2	56837	2
2	0	2	0	0	56838	2
2	0	2	0	0	56839	2
2	0	2	0	0	56840	2
2	0	2	0	0	56841	2
2	0	2	0	0	56842	2
2	2	2	17	19	56843	1
2	0	2	1	1	56844	2
2	0	2	0	0	56845	2
2	0	2	3	3	56846	2
2	0	2	4	4	56847	2
2	0	2	0	0	56848	2
2	0	2	0	0	56849	2
2	0	2	0	0	56850	2
2	0	2	0	0	56851	2
2	0	2	0	0	56852	2
2	0	2	0	0	56853	2
2	0	2	0	0	56854	2
2	4	4	32	36	56855	1
2	0	2	0	0	56856	2
2	0	2	0	0	56857	2
2	0	4	0	0	56858	2
2	0	2	0	0	56859	2
2	0	2	0	0	56860	2
2	0	2	6	6	56861	2
2	0	2	0	0	56862	2
2	0	2	0	0	56863	2
2	0	2	0	0	56864	2
2	0	2	0	0	56865	2
2	0	2	0	0	56866	2
2	0	2	0	0	56867	2
2	0	2	0	0	56868	2
2	0	2	0	0	56869	2
2	0	2	0	0	56870	2
2	0	2	0	0	56871	2
2	1	2	0	1	56872	0
2	0	2	14	14	56873	2
2	0	2	0	0	56874	2
2	0	2	0	0	56875	2
2	0	2	0	0	56876	2
2	0	2	4	4	56877	2
2	0	2	0	0	56878	2
2	0	2	0	0	56879	2
2	0	2	0	0	56880	2
2	0	2	0	0	56881	2
2	0	2	0	0	56882	2
2	0	2	0	0	56883	2
2	0	4	446	446	56884	2
2	0	2	0	0	56885	2
2	0	2	0	0	56886	2
4	2836	2	11	2847	56887	0
2	0	4	161	161	56888	2
2	0	2	1	1	56889	2
4	690	2	2	692	56890	0
2	0	2	0	0	56891	2
2	0	2	1	1	56892	2
2	0	2	0	0	56893	2
2	0	2	0	0	56894	2
2	0	2	0	0	56895	2
2	0	2	0	0	56896	2
2	3	2	0	3	56897	0
2	0	2	0	0	56898	2
2	0	2	0	0	56899	2
2	0	2	0	0	56900	2
2	0	2	0	0	56901	2
2	0	2	0	0	56902	2
2	0	2	0	0	56903	2
2	0	2	0	0	56904	2
2	0	2	4	4	56905	2
2	0	2	0	0	56906	2
2	0	2	0	0	56907	2
2	0	2	0	0	56908	2
2	0	2	0	0	56909	2
2	0	2	0	0	56910	2
2	0	2	0	0	56911	2
2	0	2	0	0	56912	2
2	0	2	0	0	56913	2
2	0	2	0	0	56914	2
2	0	2	0	0	56915	2
2	0	2	0	0	56916	2
2	0	2	0	0	56917	2
2	0	2	0	0	56918	2
2	0	2	0	0	56919	2
2	0	2	0	0	56920	2
2	0	2	0	0	56921	2
2	0	2	0	0	56922	2
2	0	2	0	0	56923	2
2	0	2	0	0	56924	2
2	0	2	0	0	56925	2
2	0	2	0	0	56926	2
2	0	2	0	0	56927	2
2	0	2	0	0	56928	2
2	0	2	0	0	56929	2
2	0	2	0	0	56930	2
2	0	2	0	0	56931	2
2	0	2	0	0	56932	2
2	0	2	0	0	56933	2
2	0	2	0	0	56934	2
2	1	2	1	2	56935	1
2	0	2	0	0	56936	2
2	0	2	0	0	56937	2
2	0	2	0	0	56938	2
2	0	2	0	0	56939	2
2	0	2	1	1	56940	2
2	0	2	0	0	56941	2
2	0	2	0	0	56942	2
2	0	2	0	0	56943	2
2	1	2	1	2	56944	1
2	0	2	0	0	56945	2
2	0	2	0	0	56946	2
2	2	2	18	20	56947	1
2	0	2	0	0	56948	2
2	0	2	0	0	56949	2
2	2	2	1	3	56950	0
2	0	2	7	7	56951	2
2	0	2	1	1	56952	2
2	0	2	0	0	56953	2
2	8	4	12434	12442	56954	0
2	0	2	50	50	56955	2
2	0	2	0	0	56956	2
2	0	4	14	14	56957	2
2	0	2	0	0	56958	2
2	0	2	0	0	56959	2
2	0	4	14	14	56960	2
2	0	2	0	0	56961	2
2	52	2	1	53	56962	0
2	0	2	0	0	56963	2
2	0	2	0	0	56964	2
2	0	2	0	0	56965	2
2	0	2	0	0	56966	2
2	0	2	0	0	56967	2
2	0	2	0	0	56968	2
2	8	0	52	60	56969	0
2	1	0	54	55	56970	1
2	0	2	3	3	56971	2
2	0	2	0	0	56972	2
2	4	2	0	4	56973	1
2	0	2	8	8	56974	2
2	0	2	0	0	56975	2
2	0	2	0	0	56976	2
2	0	2	0	0	56977	2
2	0	2	0	0	56978	2
2	0	2	0	0	56979	2
2	0	2	0	0	56980	2
2	0	2	0	0	56981	2
2	0	0	84	84	56982	2
2	0	2	0	0	56983	2
2	0	2	0	0	56984	2
2	0	0	69	69	56985	2
2	0	2	0	0	56986	2
2	0	2	0	0	56987	2
2	0	2	0	0	56988	2
2	0	2	0	0	56989	2
2	0	2	0	0	56990	2
2	0	2	0	0	56991	2
2	0	2	0	0	56992	2
2	1	2	0	1	56993	0
2	0	2	0	0	56994	2
2	0	2	0	0	56995	2
2	0	2	0	0	56996	2
2	0	2	0	0	56997	2
2	0	2	0	0	56998	2
2	0	2	0	0	56999	2
2	0	2	0	0	57000	2
2	0	2	0	0	57001	2
2	0	2	0	0	57002	2
2	13	2	33	46	57003	1
2	0	2	0	0	57004	2
2	0	2	0	0	57005	2
2	0	2	0	0	57006	2
2	0	2	0	0	57007	2
2	0	2	0	0	57008	2
2	0	4	1	1	57009	2
2	0	2	0	0	57010	2
2	0	2	0	0	57011	2
2	0	4	0	0	57012	2
2	0	2	0	0	57013	2
2	0	2	0	0	57014	2
2	0	2	0	0	57015	2
2	0	2	0	0	57016	2
2	0	2	0	0	57017	2
2	0	2	0	0	57018	2
2	0	2	0	0	57019	2
2	0	2	0	0	57020	2
2	0	2	0	0	57021	2
2	0	2	0	0	57022	2
2	0	2	0	0	57023	2
2	0	2	0	0	57024	2
2	0	2	0	0	57025	2
2	0	2	0	0	57026	2
2	0	2	0	0	57027	2
2	0	2	0	0	57028	2
2	0	2	0	0	57029	2
2	0	2	0	0	57030	2
2	0	2	0	0	57031	2
2	0	0	2	2	57032	2
2	0	2	2	2	57033	2
0	0	4	339	339	57034	2
2	1	2	0	1	57035	0
2	0	2	8	8	57036	2
2	0	2	0	0	57037	2
2	0	2	0	0	57038	2
2	0	2	0	0	57039	2
2	0	2	7	7	57040	2
2	0	2	0	0	57041	2
2	0	2	0	0	57042	2
2	0	2	0	0	57043	2
2	0	2	0	0	57044	2
2	0	2	1	1	57045	2
2	0	2	0	0	57046	2
2	0	2	0	0	57047	2
2	0	2	0	0	57048	2
2	0	2	0	0	57049	2
2	0	2	0	0	57050	2
2	0	2	0	0	57051	2
2	0	2	0	0	57052	2
2	2	2	0	2	57053	0
2	5	2	22	27	57054	1
2	0	2	0	0	57055	2
2	0	2	0	0	57056	2
2	1	2	0	1	57057	1
2	0	4	17406	17406	57058	2
2	0	2	0	0	57059	2
2	0	2	0	0	57060	2
2	0	2	0	0	57061	2
2	0	2	0	0	57062	2
2	0	2	0	0	57063	2
2	0	2	0	0	57064	2
2	0	2	0	0	57065	2
2	0	2	0	0	57066	2
2	0	2	0	0	57067	2
2	0	2	0	0	57068	2
2	0	2	0	0	57069	2
2	0	2	0	0	57070	2
4	90	2	0	90	57071	0
4	56	2	0	56	57072	0
2	0	2	0	0	57073	2
2	0	2	0	0	57074	2
2	0	2	0	0	57075	2
2	0	2	0	0	57076	2
2	0	2	0	0	57077	2
2	0	2	0	0	57078	2
2	0	2	0	0	57079	2
2	0	2	0	0	57080	2
2	0	2	0	0	57081	2
2	0	2	0	0	57082	2
2	0	2	0	0	57083	2
2	0	2	0	0	57084	2
2	0	2	0	0	57085	2
4	0	4	263	263	57086	2
2	0	2	0	0	57087	2
2	0	2	0	0	57088	2
2	0	2	0	0	57089	2
2	0	2	0	0	57090	2
2	0	2	0	0	57091	2
2	0	2	0	0	57092	2
2	0	2	0	0	57093	2
2	0	2	0	0	57094	2
2	0	2	0	0	57095	2
2	0	2	0	0	57096	2
2	0	2	0	0	57097	2
2	0	2	0	0	57098	2
2	0	2	0	0	57099	2
2	0	2	0	0	57100	2
2	0	2	0	0	57101	2
2	0	2	0	0	57102	2
2	0	2	0	0	57103	2
2	0	2	0	0	57104	2
2	0	2	0	0	57105	2
2	0	2	0	0	57106	2
2	0	2	0	0	57107	2
2	0	2	0	0	57108	2
2	0	2	0	0	57109	2
2	0	2	0	0	57110	2
2	0	2	0	0	57111	2
2	0	2	0	0	57112	2
2	0	2	0	0	57113	2
2	0	2	0	0	57114	2
2	0	2	0	0	57115	2
4	0	4	0	0	57116	2
2	1	2	0	1	57117	0
2	1	2	20	21	57118	1
2	0	2	0	0	57119	2
2	0	2	0	0	57120	2
2	0	2	2	2	57121	2
2	0	2	2	2	57122	2
0	0	4	8	8	57123	2
2	3	4	16697	16700	57124	1
2	0	2	0	0	57125	2
2	0	2	0	0	57126	2
0	2	2	56	58	57127	0
0	2	2	56	58	57128	1
2	0	4	5949	5949	57129	2
2	0	4	16	16	57130	2
2	0	2	0	0	57131	2
2	0	4	3	3	57132	2
2	0	2	0	0	57133	2
2	0	2	0	0	57134	2
0	2	2	0	2	57135	0
2	0	2	0	0	57136	2
0	5	4	1	6	57137	0
0	9	4	0	9	57138	0
2	0	2	0	0	57139	2
2	0	2	0	0	57140	2
2	0	2	0	0	57141	2
2	0	2	0	0	57142	2
2	0	2	0	0	57143	2
2	0	2	0	0	57144	2
2	0	2	0	0	57145	2
2	0	2	0	0	57146	2
2	0	2	1	1	57147	2
2	0	2	0	0	57148	2
2	0	2	1	1	57149	2
2	0	2	0	0	57150	2
2	0	2	0	0	57151	2
2	5	2	0	5	57152	0
2	6	2	88	94	57153	1
2	0	2	1	1	57154	2
2	0	2	0	0	57155	2
2	2	2	0	2	57156	1
2	0	2	3	3	57157	2
2	2	2	0	2	57158	0
2	0	2	0	0	57159	2
2	0	2	0	0	57160	2
2	0	2	0	0	57161	2
2	0	2	0	0	57162	2
2	0	2	0	0	57163	2
2	0	2	0	0	57164	2
2	1	2	42	43	57165	1
2	0	2	0	0	57166	2
2	0	2	0	0	57167	2
2	0	2	2	2	57168	2
2	0	2	0	0	57169	2
2	1	0	27	28	57170	1
2	0	2	0	0	57171	2
2	0	2	0	0	57172	2
2	0	0	2	2	57173	2
2	0	2	3	3	57174	2
4	0	2	1	1	57175	2
2	0	2	0	0	57176	2
2	0	2	0	0	57177	2
2	0	0	0	0	57178	2
2	0	2	948	948	57179	2
2	0	2	0	0	57180	2
2	0	2	0	0	57181	2
2	0	2	0	0	57182	2
2	0	2	0	0	57183	2
2	0	2	0	0	57184	2
2	0	2	0	0	57185	2
4	0	4	0	0	57186	2
4	0	4	0	0	57187	2
4	0	4	0	0	57188	2
4	0	4	0	0	57189	2
4	97	4	39	136	57190	1
4	18	4	11	29	57191	1
2	0	2	0	0	57192	2
2	0	4	84	84	57193	2
2	0	2	0	0	57194	2
2	0	2	0	0	57195	2
2	0	4	64	64	57196	2
2	0	2	0	0	57197	2
2	0	2	0	0	57198	2
2	0	2	0	0	57199	2
2	0	2	1	1	57200	2
2	0	2	0	0	57201	2
2	0	2	0	0	57202	2
2	0	2	0	0	57203	2
2	0	2	0	0	57204	2
2	0	4	610	610	57205	2
2	0	2	0	0	57206	2
2	0	2	0	0	57207	2
2	0	4	257	257	57208	2
2	0	2	0	0	57209	2
2	1	2	0	1	57210	0
0	0	4	124	124	57211	2
2	0	2	4	4	57212	2
2	0	2	1	1	57213	2
2	0	2	0	0	57214	2
2	0	2	3	3	57215	2
2	0	4	13	13	57216	2
2	0	2	0	0	57217	2
2	0	2	0	0	57218	2
2	0	2	0	0	57219	2
2	0	2	0	0	57220	2
2	0	2	0	0	57221	2
2	0	2	0	0	57222	2
4	10	4	355	365	57223	1
4	0	4	244	244	57224	2
2	0	2	0	0	57225	2
2	0	2	0	0	57226	2
2	0	2	0	0	57227	2
2	0	2	0	0	57228	2
2	0	2	0	0	57229	2
2	0	2	0	0	57230	2
2	0	2	0	0	57231	2
2	0	2	2	2	57232	2
2	0	2	0	0	57233	2
2	0	2	0	0	57234	2
2	0	2	32	32	57235	2
2	0	2	0	0	57236	2
2	0	2	0	0	57237	2
2	0	2	0	0	57238	2
2	0	2	0	0	57239	2
2	0	2	0	0	57240	2
2	0	2	0	0	57241	2
2	0	2	0	0	57242	2
2	0	2	0	0	57243	2
2	0	2	0	0	57244	2
2	0	2	0	0	57245	2
2	0	2	0	0	57246	2
2	0	2	0	0	57247	2
2	0	2	0	0	57248	2
2	468	2	453	921	57249	1
2	1573	2	245	1818	57250	0
2	0	2	8795	8795	57251	2
2	0	2	0	0	57252	2
2	0	4	521	521	57253	2
2	0	2	0	0	57254	2
2	0	2	0	0	57255	2
2	0	4	67	67	57256	2
2	0	2	1	1	57257	2
2	0	2	0	0	57258	2
2	0	2	14	14	57259	2
2	0	2	0	0	57260	2
2	0	2	0	0	57261	2
2	0	2	0	0	57262	2
2	0	2	0	0	57263	2
2	0	2	0	0	57264	2
2	1	2	28	29	57265	1
2	0	2	0	0	57266	2
2	0	2	0	0	57267	2
2	1	2	0	1	57268	1
2	0	2	3	3	57269	2
2	0	2	0	0	57270	2
2	0	2	0	0	57271	2
2	0	2	0	0	57272	2
2	0	2	0	0	57273	2
2	0	2	0	0	57274	2
2	0	2	0	0	57275	2
2	1	2	0	1	57276	1
2	0	2	5	5	57277	2
2	0	2	0	0	57278	2
2	0	2	0	0	57279	2
2	0	2	0	0	57280	2
2	0	2	1	1	57281	2
2	61	2	1	62	57282	0
2	0	2	0	0	57283	2
2	0	4	0	0	57284	2
2	0	2	0	0	57285	2
2	0	2	0	0	57286	2
2	0	2	0	0	57287	2
2	0	2	0	0	57288	2
2	0	2	0	0	57289	2
2	0	2	0	0	57290	2
2	0	2	0	0	57291	2
2	0	2	0	0	57292	2
2	0	2	0	0	57293	2
2	0	2	0	0	57294	2
2	0	2	0	0	57295	2
2	0	2	0	0	57296	2
2	0	2	0	0	57297	2
2	0	2	0	0	57298	2
2	0	2	0	0	57299	2
2	0	2	0	0	57300	2
2	172	4	659	831	57301	0
2	0	2	39	39	57302	2
2	0	2	0	0	57303	2
2	0	2	0	0	57304	2
2	0	2	0	0	57305	2
2	42	4	247	289	57306	0
2	0	2	184	184	57307	2
4	0	2	88	88	57308	2
2	0	2	0	0	57309	2
2	0	2	0	0	57310	2
2	0	2	0	0	57311	2
2	0	2	0	0	57312	2
2	0	2	0	0	57313	2
2	0	2	0	0	57314	2
2	0	2	0	0	57315	2
2	0	2	0	0	57316	2
2	0	2	0	0	57317	2
2	8	4	87	95	57318	1
2	0	2	0	0	57319	2
2	0	2	0	0	57320	2
2	1	4	4	5	57321	0
2	0	2	16	16	57322	2
2	0	4	0	0	57323	2
2	0	2	0	0	57324	2
2	0	2	0	0	57325	2
2	0	4	5	5	57326	2
2	0	2	0	0	57327	2
2	0	2	0	0	57328	2
2	0	2	0	0	57329	2
2	0	2	2	2	57330	2
2	0	2	0	0	57331	2
2	0	2	12	12	57332	2
2	0	2	0	0	57333	2
2	0	2	0	0	57334	2
2	0	2	18	18	57335	2
2	0	2	0	0	57336	2
2	0	2	0	0	57337	2
2	0	2	0	0	57338	2
2	0	2	0	0	57339	2
2	2	2	0	2	57340	0
2	0	2	0	0	57341	2
2	0	2	0	0	57342	2
2	0	2	0	0	57343	2
2	0	2	0	0	57344	2
2	0	2	0	0	57345	2
2	0	2	0	0	57346	2
2	9	2	110	119	57347	1
2	0	2	0	0	57348	2
2	0	2	0	0	57349	2
2	1	2	0	1	57350	0
2	0	2	4	4	57351	2
2	263	4	9	272	57352	1
2	0	2	0	0	57353	2
2	0	2	0	0	57354	2
2	0	4	2	2	57355	2
2	15	2	3	18	57356	0
4	4	2	0	4	57357	0
0	0	4	7	7	57358	2
2	88	2	1	89	57359	0
2	48	4	1690	1738	57360	1
2	1	2	8	9	57361	1
2	0	2	1	1	57362	2
0	0	4	2	2	57363	2
2	0	2	0	0	57364	2
2	0	2	0	0	57365	2
2	0	2	0	0	57366	2
2	0	2	0	0	57367	2
2	0	2	0	0	57368	2
2	0	2	0	0	57369	2
0	0	4	40	40	57370	2
0	0	4	2	2	57371	2
2	0	2	0	0	57372	2
2	76	2	0	76	57373	0
2	0	2	0	0	57374	2
2	0	2	0	0	57375	2
2	0	2	0	0	57376	2
2	0	2	0	0	57377	2
2	0	2	0	0	57378	2
2	0	2	0	0	57379	2
2	4	2	147	151	57380	1
2	0	2	49	49	57381	2
2	0	2	1	1	57382	2
2	8	2	0	8	57383	0
2	0	2	36	36	57384	2
2	0	2	0	0	57385	2
2	0	2	0	0	57386	2
2	0	2	0	0	57387	2
2	0	2	0	0	57388	2
2	0	2	0	0	57389	2
4	0	4	0	0	57390	2
2	0	2	17	17	57391	2
2	0	2	0	0	57392	2
2	0	2	0	0	57393	2
2	0	2	0	0	57394	2
2	0	2	0	0	57395	2
2	0	2	0	0	57396	2
2	0	2	0	0	57397	2
2	0	2	0	0	57398	2
2	0	2	0	0	57399	2
2	0	2	0	0	57400	2
2	0	2	0	0	57401	2
2	0	2	0	0	57402	2
2	0	2	0	0	57403	2
4	0	2	0	0	57404	2
2	1	2	2	3	57405	0
2	0	2	0	0	57406	2
2	0	2	0	0	57407	2
2	0	2	0	0	57408	2
2	0	2	0	0	57409	2
2	0	2	0	0	57410	2
2	0	2	0	0	57411	2
2	0	2	0	0	57412	2
2	0	2	0	0	57413	2
2	0	2	0	0	57414	2
2	0	2	0	0	57415	2
2	0	2	0	0	57416	2
2	0	2	0	0	57417	2
2	5	4	1471	1476	57418	1
2	0	2	0	0	57419	2
2	0	2	0	0	57420	2
2	0	4	799	799	57421	2
2	0	2	4	4	57422	2
2	1	2	13	14	57423	1
2	0	2	0	0	57424	2
2	0	2	0	0	57425	2
2	0	4	5	5	57426	2
2	0	2	9	9	57427	2
2	0	2	0	0	57428	2
2	0	4	0	0	57429	2
2	0	2	0	0	57430	2
2	0	2	0	0	57431	2
2	0	4	0	0	57432	2
2	0	2	0	0	57433	2
2	0	2	0	0	57434	2
2	0	4	2	2	57435	2
2	0	2	8	8	57436	2
2	0	2	0	0	57437	2
2	0	2	0	0	57438	2
2	0	2	1	1	57439	2
2	0	2	0	0	57440	2
2	0	2	0	0	57441	2
2	0	2	0	0	57442	2
2	0	2	0	0	57443	2
2	0	2	0	0	57444	2
2	0	4	10	10	57445	2
2	0	2	0	0	57446	2
2	0	2	0	0	57447	2
2	0	4	0	0	57448	2
2	0	2	0	0	57449	2
2	0	2	0	0	57450	2
2	0	2	0	0	57451	2
2	0	2	0	0	57452	2
2	0	4	0	0	57453	2
2	0	2	0	0	57454	2
2	8	2	0	8	57455	0
2	0	2	0	0	57456	2
2	0	2	0	0	57457	2
2	0	2	0	0	57458	2
2	0	2	0	0	57459	2
2	0	2	0	0	57460	2
2	0	2	0	0	57461	2
2	20	2	66	86	57462	1
2	0	2	11	11	57463	2
2	0	2	0	0	57464	2
2	1	2	4	5	57465	1
2	3	2	14	17	57466	0
2	0	2	0	0	57467	2
2	0	2	0	0	57468	2
2	0	2	0	0	57469	2
2	0	2	0	0	57470	2
2	0	2	0	0	57471	2
2	0	2	0	0	57472	2
2	0	2	0	0	57473	2
2	0	2	0	0	57474	2
2	0	2	0	0	57475	2
2	0	2	0	0	57476	2
2	0	2	0	0	57477	2
2	0	2	0	0	57478	2
2	34	4	49	83	57479	0
2	0	2	116	116	57480	2
2	0	2	0	0	57481	2
2	1	4	217	218	57482	1
2	0	2	0	0	57483	2
2	0	2	0	0	57484	2
2	0	4	13	13	57485	2
2	0	2	0	0	57486	2
2	0	2	0	0	57487	2
2	0	2	0	0	57488	2
2	0	2	0	0	57489	2
2	0	2	0	0	57490	2
2	0	2	0	0	57491	2
2	0	2	0	0	57492	2
2	0	2	0	0	57493	2
2	1	2	0	1	57494	0
2	0	2	5	5	57495	2
2	0	2	0	0	57496	2
2	0	2	0	0	57497	2
2	0	2	0	0	57498	2
2	0	2	0	0	57499	2
2	0	2	0	0	57500	2
2	0	2	0	0	57501	2
2	0	2	1	1	57502	2
2	0	2	0	0	57503	2
2	0	2	1	1	57504	2
2	0	2	0	0	57505	2
2	0	2	1	1	57506	2
2	0	2	0	0	57507	2
2	0	2	0	0	57508	2
2	0	2	0	0	57509	2
2	0	2	0	0	57510	2
2	0	2	0	0	57511	2
2	0	2	0	0	57512	2
2	0	2	0	0	57513	2
2	0	2	0	0	57514	2
2	1278	2	20	1298	57515	0
2	0	2	0	0	57516	2
2	0	2	0	0	57517	2
2	0	2	0	0	57518	2
2	0	2	0	0	57519	2
2	0	2	0	0	57520	2
2	0	2	0	0	57521	2
2	0	2	0	0	57522	2
2	0	2	0	0	57523	2
2	0	2	0	0	57524	2
2	0	2	0	0	57525	2
2	0	2	0	0	57526	2
2	0	2	0	0	57527	2
2	0	2	0	0	57528	2
2	0	2	0	0	57529	2
2	0	2	0	0	57530	2
2	0	2	0	0	57531	2
2	0	2	0	0	57532	2
2	0	2	0	0	57533	2
2	1027	4	4963	5990	57534	1
2	2	2	701	703	57535	1
2	0	2	33	33	57536	2
0	0	2	480	480	57537	2
0	0	2	17	17	57538	2
2	0	4	1	1	57539	2
0	2	4	204	206	57540	0
2	478	4	204	682	57541	0
2	0	2	2292	2292	57542	2
2	0	2	0	0	57543	2
2	0	2	0	0	57544	2
2	0	2	0	0	57545	2
2	0	2	0	0	57546	2
2	0	2	0	0	57547	2
2	0	2	0	0	57548	2
2	1	2	0	1	57549	0
2	0	2	3	3	57550	2
2	0	2	0	0	57551	2
2	0	2	0	0	57552	2
2	0	2	0	0	57553	2
2	0	2	2	2	57554	2
2	0	4	4	4	57555	2
2	0	2	0	0	57556	2
2	0	2	0	0	57557	2
2	0	2	0	0	57558	2
2	0	2	0	0	57559	2
2	0	2	0	0	57560	2
2	0	2	0	0	57561	2
2	0	2	0	0	57562	2
2	0	2	0	0	57563	2
0	0	4	167	167	57564	2
0	0	4	0	0	57565	2
0	0	4	0	0	57566	2
0	0	4	7	7	57567	2
2	0	4	10	10	57568	2
2	0	2	2	2	57569	2
2	0	2	0	0	57570	2
2	0	4	1333	1333	57571	2
2	0	2	8	8	57572	2
2	0	2	0	0	57573	2
2	0	2	0	0	57574	2
2	0	2	0	0	57575	2
2	0	2	0	0	57576	2
2	0	2	0	0	57577	2
2	0	2	0	0	57578	2
2	4	2	0	4	57579	0
2	0	4	1521	1521	57580	2
2	0	2	1	1	57581	2
2	0	2	1	1	57582	2
2	4	4	421	425	57583	0
2	0	2	11	11	57584	2
2	0	2	0	0	57585	2
2	1	2	14	15	57586	1
2	0	2	0	0	57587	2
2	0	2	0	0	57588	2
4	0	2	0	0	57589	2
4	0	4	297	297	57590	2
2	0	2	0	0	57591	2
2	24	0	95	119	57592	0
2	0	2	0	0	57593	2
2	0	2	0	0	57594	2
0	0	0	12	12	57595	2
2	0	2	0	0	57596	2
2	0	2	0	0	57597	2
2	0	2	0	0	57598	2
2	0	2	0	0	57599	2
2	0	2	0	0	57600	2
2	0	2	0	0	57601	2
2	0	2	0	0	57602	2
2	0	2	0	0	57603	2
2	0	2	0	0	57604	2
2	0	2	0	0	57605	2
2	0	2	0	0	57606	2
2	0	2	0	0	57607	2
2	0	0	3	3	57608	2
2	0	2	0	0	57609	2
2	0	2	0	0	57610	2
2	1	2	0	1	57611	0
2	0	4	13	13	57612	2
2	0	2	0	0	57613	2
2	0	2	0	0	57614	2
2	0	4	0	0	57615	2
2	0	2	0	0	57616	2
2	0	2	0	0	57617	2
2	0	2	0	0	57618	2
2	0	2	0	0	57619	2
0	0	4	28	28	57620	2
2	0	2	0	0	57621	2
2	0	2	8	8	57622	2
2	0	2	0	0	57623	2
2	0	2	0	0	57624	2
2	0	2	0	0	57625	2
2	0	2	0	0	57626	2
2	0	2	0	0	57627	2
2	0	2	0	0	57628	2
2	0	2	0	0	57629	2
2	0	2	0	0	57630	2
2	0	2	0	0	57631	2
2	0	2	0	0	57632	2
2	0	2	0	0	57633	2
2	0	0	252	252	57634	2
2	0	2	0	0	57635	2
2	0	2	0	0	57636	2
2	0	0	151	151	57637	2
2	0	2	0	0	57638	2
2	0	2	0	0	57639	2
2	0	2	0	0	57640	2
2	0	2	0	0	57641	2
2	0	2	0	0	57642	2
2	0	2	0	0	57643	2
2	0	2	0	0	57644	2
2	0	2	0	0	57645	2
2	1	2	0	1	57646	1
2	0	2	0	0	57647	2
2	0	2	0	0	57648	2
2	0	2	0	0	57649	2
2	0	2	0	0	57650	2
2	0	2	0	0	57651	2
2	0	2	0	0	57652	2
2	0	2	0	0	57653	2
2	0	2	0	0	57654	2
2	0	2	0	0	57655	2
2	0	2	0	0	57656	2
2	0	2	0	0	57657	2
2	0	2	0	0	57658	2
2	0	2	0	0	57659	2
2	0	2	0	0	57660	2
2	0	2	0	0	57661	2
2	0	2	0	0	57662	2
2	626	2	4	630	57663	0
2	0	2	0	0	57664	2
2	0	2	0	0	57665	2
2	0	2	0	0	57666	2
2	0	2	0	0	57667	2
2	0	2	0	0	57668	2
2	0	2	0	0	57669	2
2	64	2	35829	35893	57670	1
2	0	2	305	305	57671	2
2	0	2	1	1	57672	2
2	460	2	362	822	57673	0
2	0	2	2001	2001	57674	2
2	4	4	291	295	57675	1
2	0	0	55	55	57676	2
2	0	2	2	2	57677	2
2	0	2	2	2	57678	2
2	0	2	0	0	57679	2
2	0	2	0	0	57680	2
2	0	2	0	0	57681	2
2	0	2	0	0	57682	2
2	0	2	0	0	57683	2
2	0	2	0	0	57684	2
2	0	2	0	0	57685	2
2	0	2	0	0	57686	2
2	0	2	0	0	57687	2
2	0	2	0	0	57688	2
2	0	2	0	0	57689	2
2	0	2	0	0	57690	2
2	0	2	0	0	57691	2
2	0	4	28	28	57692	2
2	0	2	0	0	57693	2
2	0	2	0	0	57694	2
2	0	2	0	0	57695	2
2	0	2	0	0	57696	2
2	0	2	0	0	57697	2
2	0	2	0	0	57698	2
2	0	2	0	0	57699	2
2	0	2	0	0	57700	2
2	2	4	5	7	57701	1
2	0	2	4	4	57702	2
2	1	2	0	1	57703	0
2	0	2	0	0	57704	2
2	0	4	0	0	57705	2
2	0	2	0	0	57706	2
2	0	2	0	0	57707	2
2	0	4	0	0	57708	2
2	0	2	0	0	57709	2
2	0	2	0	0	57710	2
2	0	4	0	0	57711	2
2	0	2	0	0	57712	2
2	0	2	0	0	57713	2
2	1	4	0	1	57714	0
2	0	2	0	0	57715	2
2	0	2	0	0	57716	2
2	0	2	0	0	57717	2
2	0	2	0	0	57718	2
2	0	2	0	0	57719	2
2	0	2	0	0	57720	2
2	0	2	0	0	57721	2
2	0	2	0	0	57722	2
2	0	2	0	0	57723	2
2	0	2	0	0	57724	2
2	0	2	0	0	57725	2
2	0	2	0	0	57726	2
2	0	2	0	0	57727	2
2	0	2	0	0	57728	2
2	0	2	0	0	57729	2
2	0	2	0	0	57730	2
2	0	2	0	0	57731	2
2	0	2	0	0	57732	2
2	0	2	0	0	57733	2
2	16	2	5	21	57734	0
2	35	2	9	44	57735	0
2	0	2	0	0	57736	2
2	0	2	3	3	57737	2
2	0	2	0	0	57738	2
2	0	2	0	0	57739	2
4	1	4	0	1	57740	1
2	0	2	0	0	57741	2
2	9	2	0	9	57742	1
2	0	2	0	0	57743	2
2	0	2	0	0	57744	2
2	5	2	0	5	57745	1
2	0	2	0	0	57746	2
2	0	2	0	0	57747	2
2	0	2	0	0	57748	2
2	0	2	80	80	57749	2
2	0	2	0	0	57750	2
2	0	2	3	3	57751	2
2	18	2	0	18	57752	0
2	0	2	48	48	57753	2
2	0	2	5	5	57754	2
2	0	2	0	0	57755	2
2	8	2	0	8	57756	0
2	0	2	27	27	57757	2
2	0	2	0	0	57758	2
2	0	2	0	0	57759	2
2	0	2	0	0	57760	2
2	1	2	2	3	57761	1
2	0	2	0	0	57762	2
2	0	2	0	0	57763	2
2	0	2	0	0	57764	2
2	0	2	0	0	57765	2
2	0	2	0	0	57766	2
2	0	2	0	0	57767	2
2	0	2	0	0	57768	2
2	0	2	0	0	57769	2
2	0	2	0	0	57770	2
2	0	2	0	0	57771	2
2	0	2	0	0	57772	2
2	0	2	0	0	57773	2
2	0	2	0	0	57774	2
2	0	2	0	0	57775	2
2	0	2	0	0	57776	2
2	0	2	0	0	57777	2
2	0	2	0	0	57778	2
2	0	2	0	0	57779	2
2	0	2	0	0	57780	2
2	0	2	2	2	57781	2
2	0	4	667	667	57782	2
2	0	2	0	0	57783	2
2	0	2	0	0	57784	2
2	70	4	102	172	57785	0
2	3	4	102	105	57786	1
2	0	2	0	0	57787	2
2	0	2	0	0	57788	2
2	0	2	0	0	57789	2
2	0	2	0	0	57790	2
2	0	2	0	0	57791	2
2	0	2	0	0	57792	2
2	0	2	0	0	57793	2
2	13	2	0	13	57794	0
2	0	2	122	122	57795	2
2	0	2	2	2	57796	2
2	0	2	0	0	57797	2
2	5	2	0	5	57798	0
2	0	2	49	49	57799	2
2	0	2	0	0	57800	2
2	0	2	0	0	57801	2
2	0	2	0	0	57802	2
2	0	2	0	0	57803	2
2	0	2	0	0	57804	2
2	0	2	1	1	57805	2
2	0	2	0	0	57806	2
2	0	2	0	0	57807	2
2	0	2	0	0	57808	2
2	0	2	0	0	57809	2
2	0	2	0	0	57810	2
2	0	2	0	0	57811	2
2	2	2	0	2	57812	0
2	0	2	0	0	57813	2
2	0	2	0	0	57814	2
2	0	2	0	0	57815	2
2	0	2	21	21	57816	2
2	0	2	0	0	57817	2
2	0	2	0	0	57818	2
2	0	2	0	0	57819	2
2	0	2	0	0	57820	2
2	0	2	0	0	57821	2
2	0	2	4	4	57822	2
2	0	2	88	88	57823	2
2	0	2	0	0	57824	2
2	0	2	0	0	57825	2
2	0	2	0	0	57826	2
2	0	2	0	0	57827	2
2	0	2	0	0	57828	2
2	0	2	0	0	57829	2
2	43	2	0	43	57830	0
2	0	2	5	5	57831	2
2	0	2	2	2	57832	2
2	0	2	0	0	57833	2
2	0	2	1	1	57834	2
2	0	2	0	0	57835	2
2	0	2	0	0	57836	2
2	0	2	0	0	57837	2
2	0	2	0	0	57838	2
2	0	2	0	0	57839	2
2	0	2	0	0	57840	2
2	0	2	0	0	57841	2
2	0	2	0	0	57842	2
2	0	2	0	0	57843	2
2	0	2	0	0	57844	2
2	0	2	1	1	57845	2
2	0	2	0	0	57846	2
2	0	2	0	0	57847	2
2	66	2	0	66	57848	0
2	59	2	560	619	57849	1
2	1	2	5	6	57850	1
2	0	2	0	0	57851	2
2	23	2	2	25	57852	0
2	0	2	118	118	57853	2
2	0	2	0	0	57854	2
2	0	2	0	0	57855	2
2	0	2	0	0	57856	2
2	0	2	0	0	57857	2
2	0	2	0	0	57858	2
2	0	2	0	0	57859	2
2	0	2	0	0	57860	2
2	0	2	0	0	57861	2
2	0	2	0	0	57862	2
2	3	2	0	3	57863	0
2	0	2	4	4	57864	2
2	0	2	0	0	57865	2
2	0	2	0	0	57866	2
2	0	2	0	0	57867	2
2	0	2	0	0	57868	2
2	0	2	0	0	57869	2
2	0	2	0	0	57870	2
2	0	2	0	0	57871	2
2	0	2	0	0	57872	2
2	1	2	0	1	57873	0
2	1	2	33	34	57874	1
2	0	2	0	0	57875	2
2	0	2	0	0	57876	2
0	0	2	1	1	57877	2
0	0	2	0	0	57878	2
2	0	2	0	0	57879	2
2	0	2	7	7	57880	2
2	0	2	0	0	57881	2
2	0	2	0	0	57882	2
2	0	2	0	0	57883	2
2	0	2	0	0	57884	2
2	0	2	0	0	57885	2
2	0	2	0	0	57886	2
2	0	2	0	0	57887	2
2	0	2	6	6	57888	2
2	0	2	0	0	57889	2
2	0	2	0	0	57890	2
2	0	2	0	0	57891	2
2	0	2	0	0	57892	2
2	285	2	2726	3011	57893	0
2	69	2	0	69	57894	0
2	0	2	420	420	57895	2
2	0	2	0	0	57896	2
2	0	2	0	0	57897	2
2	0	2	0	0	57898	2
2	0	2	0	0	57899	2
2	1	2	0	1	57900	1
2	0	2	0	0	57901	2
2	0	2	0	0	57902	2
2	0	2	1	1	57903	2
2	0	2	0	0	57904	2
2	0	2	0	0	57905	2
2	0	2	0	0	57906	2
2	0	2	1	1	57907	2
2	0	2	0	0	57908	2
2	0	2	4	4	57909	2
2	0	2	0	0	57910	2
2	0	2	0	0	57911	2
2	0	2	1	1	57912	2
2	0	2	5	5	57913	2
2	0	2	0	0	57914	2
2	0	2	4	4	57915	2
2	0	2	0	0	57916	2
2	0	2	0	0	57917	2
2	1	2	0	1	57918	1
2	0	2	0	0	57919	2
2	15	2	0	15	57920	0
2	7	2	270	277	57921	1
2	0	2	2	2	57922	2
2	0	2	0	0	57923	2
2	6	2	9	15	57924	0
2	0	2	36	36	57925	2
2	14	2	0	14	57926	0
2	0	2	86	86	57927	2
2	0	2	1	1	57928	2
2	0	2	0	0	57929	2
2	2	2	0	2	57930	0
2	0	2	52	52	57931	2
4	4	2	0	4	57932	0
2	0	2	0	0	57933	2
2	0	2	0	0	57934	2
2	0	2	0	0	57935	2
2	0	2	0	0	57936	2
2	0	2	0	0	57937	2
2	0	2	0	0	57938	2
2	0	2	0	0	57939	2
2	0	2	0	0	57940	2
2	0	2	0	0	57941	2
2	0	2	0	0	57942	2
2	0	2	0	0	57943	2
2	0	2	0	0	57944	2
2	0	2	0	0	57945	2
2	0	2	1	1	57946	2
2	0	2	0	0	57947	2
2	0	2	0	0	57948	2
2	0	2	0	0	57949	2
2	0	2	1	1	57950	2
2	0	2	0	0	57951	2
2	0	2	0	0	57952	2
2	0	2	0	0	57953	2
2	0	2	0	0	57954	2
2	0	2	0	0	57955	2
2	0	2	0	0	57956	2
2	0	2	0	0	57957	2
2	0	2	0	0	57958	2
2	0	2	0	0	57959	2
2	0	2	0	0	57960	2
2	0	2	0	0	57961	2
2	0	2	0	0	57962	2
2	0	2	0	0	57963	2
2	0	2	0	0	57964	2
2	0	2	0	0	57965	2
2	0	2	0	0	57966	2
2	0	2	0	0	57967	2
2	0	2	0	0	57968	2
2	0	2	0	0	57969	2
2	0	2	0	0	57970	2
2	0	2	0	0	57971	2
2	0	2	0	0	57972	2
2	0	2	0	0	57973	2
4	1	4	3	4	57974	1
4	2	4	0	2	57975	1
2	0	2	0	0	57976	2
2	0	2	0	0	57977	2
2	0	2	0	0	57978	2
2	0	2	0	0	57979	2
2	0	2	0	0	57980	2
2	0	2	0	0	57981	2
2	0	2	0	0	57982	2
2	0	2	3	3	57983	2
2	0	2	0	0	57984	2
2	0	2	0	0	57985	2
2	0	2	0	0	57986	2
2	0	2	1	1	57987	2
2	0	2	0	0	57988	2
2	0	2	0	0	57989	2
2	0	2	0	0	57990	2
2	0	2	0	0	57991	2
2	0	2	0	0	57992	2
2	0	2	0	0	57993	2
2	0	2	0	0	57994	2
2	0	2	0	0	57995	2
2	0	2	0	0	57996	2
2	0	2	0	0	57997	2
2	0	2	0	0	57998	2
2	0	2	0	0	57999	2
2	0	2	0	0	58000	2
2	0	2	0	0	58001	2
2	0	2	0	0	58002	2
2	0	2	0	0	58003	2
2	0	2	0	0	58004	2
2	0	2	0	0	58005	2
2	69	2	3	72	58006	0
2	392	2	284	676	58007	1
2	1	2	11	12	58008	1
2	0	2	1	1	58009	2
2	85	2	35	120	58010	0
2	0	2	118	118	58011	2
2	0	2	0	0	58012	2
2	0	2	0	0	58013	2
2	0	2	0	0	58014	2
2	0	2	0	0	58015	2
2	0	2	0	0	58016	2
2	0	2	0	0	58017	2
2	0	2	0	0	58018	2
2	0	2	0	0	58019	2
2	0	2	0	0	58020	2
2	0	2	0	0	58021	2
2	0	2	0	0	58022	2
2	0	2	0	0	58023	2
2	0	2	0	0	58024	2
2	0	2	0	0	58025	2
2	0	2	0	0	58026	2
2	0	2	0	0	58027	2
2	0	2	0	0	58028	2
2	0	2	0	0	58029	2
2	0	2	0	0	58030	2
2	0	2	0	0	58031	2
2	7	2	0	7	58032	0
2	4	2	83	87	58033	1
2	0	2	0	0	58034	2
2	0	2	0	0	58035	2
2	6	2	1	7	58036	0
2	0	2	14	14	58037	2
2	0	2	0	0	58038	2
2	0	2	0	0	58039	2
2	0	2	0	0	58040	2
2	0	2	0	0	58041	2
2	0	2	0	0	58042	2
2	0	2	0	0	58043	2
2	0	2	0	0	58044	2
2	0	2	4	4	58045	2
2	0	2	0	0	58046	2
2	0	2	0	0	58047	2
2	0	2	0	0	58048	2
2	0	2	0	0	58049	2
2	0	2	0	0	58050	2
2	0	2	0	0	58051	2
2	0	2	0	0	58052	2
2	0	2	0	0	58053	2
2	0	2	3	3	58054	2
2	0	2	0	0	58055	2
2	0	2	0	0	58056	2
2	0	2	0	0	58057	2
2	0	2	0	0	58058	2
2	0	2	0	0	58059	2
2	0	2	0	0	58060	2
2	0	2	0	0	58061	2
2	0	2	0	0	58062	2
2	0	2	0	0	58063	2
2	0	2	0	0	58064	2
2	0	2	0	0	58065	2
2	0	2	0	0	58066	2
2	0	2	0	0	58067	2
2	0	2	0	0	58068	2
2	0	2	0	0	58069	2
2	0	2	0	0	58070	2
2	0	2	0	0	58071	2
2	0	2	14	14	58072	2
2	0	2	0	0	58073	2
2	0	2	0	0	58074	2
2	0	2	0	0	58075	2
2	0	2	0	0	58076	2
2	0	2	0	0	58077	2
2	0	2	0	0	58078	2
2	0	2	0	0	58079	2
2	0	2	0	0	58080	2
2	0	2	0	0	58081	2
4	0	2	0	0	58082	2
2	0	2	0	0	58083	2
2	0	2	1	1	58084	2
2	0	2	0	0	58085	2
2	0	2	0	0	58086	2
2	0	2	0	0	58087	2
2	0	2	0	0	58088	2
2	3	2	0	3	58089	0
2	1	2	8	9	58090	1
2	0	2	0	0	58091	2
2	0	2	0	0	58092	2
2	1	2	0	1	58093	1
2	0	2	0	0	58094	2
2	1	2	0	1	58095	0
2	1	2	10	11	58096	1
2	0	2	0	0	58097	2
2	0	2	0	0	58098	2
2	0	2	0	0	58099	2
2	0	2	4	4	58100	2
2	0	2	0	0	58101	2
2	0	2	0	0	58102	2
2	0	2	0	0	58103	2
2	0	2	0	0	58104	2
2	0	2	0	0	58105	2
2	0	2	0	0	58106	2
2	0	2	0	0	58107	2
2	0	2	0	0	58108	2
2	0	2	0	0	58109	2
2	0	2	0	0	58110	2
2	0	2	0	0	58111	2
2	0	2	0	0	58112	2
2	0	2	0	0	58113	2
2	0	2	0	0	58114	2
2	0	2	0	0	58115	2
2	0	2	0	0	58116	2
2	0	2	0	0	58117	2
2	1	2	3	4	58118	1
2	0	2	0	0	58119	2
2	0	2	0	0	58120	2
2	0	2	0	0	58121	2
2	0	2	1	1	58122	2
2	0	2	0	0	58123	2
2	0	2	0	0	58124	2
2	68	2	92	160	58125	0
2	0	2	0	0	58126	2
2	0	2	0	0	58127	2
2	0	2	0	0	58128	2
2	0	2	0	0	58129	2
2	0	2	0	0	58130	2
2	0	2	0	0	58131	2
2	0	2	0	0	58132	2
2	23	2	5	28	58133	0
2	65	4	1138	1203	58134	1
2	0	2	4	4	58135	2
2	0	2	1	1	58136	2
2	13	2	22	35	58137	0
2	0	2	45	45	58138	2
0	0	4	0	0	58139	2
0	2	0	7	9	58140	1
0	0	0	2	2	58141	2
2	3	4	49	52	58142	1
2	0	2	0	0	58143	2
2	0	2	0	0	58144	2
2	15	4	590	605	58145	0
2	30727	4	590	31317	58146	0
2	0	2	129	129	58147	2
2	0	2	5	5	58148	2
2	0	2	2	2	58149	2
4	0	2	0	0	58150	2
2	7	2	0	7	58151	0
2	8	4	630	638	58152	1
2	0	2	2	2	58153	2
2	0	2	0	0	58154	2
0	0	4	231	231	58155	2
2	0	2	101	101	58156	2
2	0	2	60	60	58157	2
2	0	2	4	4	58158	2
2	0	2	5	5	58159	2
2	0	2	0	0	58160	2
2	0	2	0	0	58161	2
2	0	2	0	0	58162	2
2	0	2	0	0	58163	2
2	0	2	0	0	58164	2
2	0	2	0	0	58165	2
2	284	2	5	289	58166	0
2	0	2	0	0	58167	2
2	0	2	0	0	58168	2
2	0	2	0	0	58169	2
2	0	2	0	0	58170	2
2	0	2	0	0	58171	2
2	0	2	0	0	58172	2
2	0	2	0	0	58173	2
2	0	2	0	0	58174	2
2	0	2	0	0	58175	2
2	0	2	0	0	58176	2
2	0	2	0	0	58177	2
2	0	2	0	0	58178	2
2	0	2	0	0	58179	2
2	0	2	0	0	58180	2
2	0	2	0	0	58181	2
2	0	2	0	0	58182	2
2	0	2	0	0	58183	2
2	0	2	0	0	58184	2
2	647	2	2584	3231	58185	1
2	0	2	305	305	58186	2
2	0	2	4	4	58187	2
2	93	2	121	214	58188	1
2	0	2	459	459	58189	2
2	0	2	0	0	58190	2
2	0	2	0	0	58191	2
2	0	2	0	0	58192	2
2	0	2	0	0	58193	2
2	0	2	0	0	58194	2
2	0	2	0	0	58195	2
2	0	2	0	0	58196	2
2	0	2	0	0	58197	2
2	0	2	0	0	58198	2
2	1	2	1	2	58199	0
2	0	2	0	0	58200	2
2	0	2	0	0	58201	2
2	0	2	0	0	58202	2
2	0	2	0	0	58203	2
2	0	2	0	0	58204	2
2	0	2	0	0	58205	2
2	0	2	27	27	58206	2
2	0	2	0	0	58207	2
2	0	2	0	0	58208	2
2	2	2	5	7	58209	1
2	0	2	8	8	58210	2
4	0	2	15	15	58211	2
2	0	2	0	0	58212	2
2	0	4	0	0	58213	2
2	0	2	0	0	58214	2
2	0	2	0	0	58215	2
2	1	4	1	2	58216	0
2	0	2	0	0	58217	2
4	0	2	0	0	58218	2
2	0	4	1	1	58219	2
2	0	2	0	0	58220	2
2	0	2	0	0	58221	2
2	0	2	3	3	58222	2
2	0	2	0	0	58223	2
2	0	2	0	0	58224	2
2	0	4	0	0	58225	2
2	0	2	0	0	58226	2
2	0	2	0	0	58227	2
2	0	2	0	0	58228	2
2	5	2	0	5	58229	0
2	0	2	0	0	58230	2
2	43	2	2	45	58231	0
2	74	4	458	532	58232	1
2	0	2	7	7	58233	2
2	0	2	1	1	58234	2
2	40	4	16	56	58235	0
2	0	2	110	110	58236	2
0	1	3	49	50	58237	1
0	0	3	49	49	58238	2
2	0	2	0	0	58239	2
2	0	2	0	0	58240	2
2	0	2	0	0	58241	2
2	0	2	0	0	58242	2
2	0	2	0	0	58243	2
2	0	2	0	0	58244	2
2	0	4	21	21	58245	2
2	0	2	0	0	58246	2
2	0	2	0	0	58247	2
2	0	4	24	24	58248	2
2	0	2	1	1	58249	2
2	0	2	0	0	58250	2
2	0	2	0	0	58251	2
2	0	2	0	0	58252	2
2	0	2	0	0	58253	2
2	0	2	0	0	58254	2
2	0	2	0	0	58255	2
2	0	2	0	0	58256	2
2	0	2	0	0	58257	2
2	0	2	0	0	58258	2
2	0	2	0	0	58259	2
2	0	2	0	0	58260	2
2	0	2	0	0	58261	2
2	0	2	0	0	58262	2
2	0	2	0	0	58263	2
2	0	2	0	0	58264	2
2	0	2	0	0	58265	2
2	0	2	0	0	58266	2
2	0	2	0	0	58267	2
2	0	2	0	0	58268	2
2	5	2	2	7	58269	1
2	0	2	9	9	58270	2
2	3	2	0	3	58271	0
2	1	2	41	42	58272	1
2	0	2	1	1	58273	2
2	0	2	0	0	58274	2
2	0	2	0	0	58275	2
2	0	2	0	0	58276	2
2	0	2	0	0	58277	2
2	0	2	0	0	58278	2
2	0	2	0	0	58279	2
2	0	2	0	0	58280	2
2	0	4	5	5	58281	2
2	0	2	0	0	58282	2
2	0	2	0	0	58283	2
2	0	4	0	0	58284	2
2	0	2	0	0	58285	2
4	0	2	0	0	58286	2
2	0	2	0	0	58287	2
2	0	2	0	0	58288	2
2	0	2	0	0	58289	2
2	0	2	0	0	58290	2
2	0	2	0	0	58291	2
2	0	2	0	0	58292	2
2	0	2	0	0	58293	2
2	0	2	0	0	58294	2
2	1	4	2	3	58295	1
2	0	2	0	0	58296	2
2	0	2	0	0	58297	2
2	0	2	0	0	58298	2
2	0	2	0	0	58299	2
2	0	2	0	0	58300	2
2	0	2	0	0	58301	2
2	0	2	0	0	58302	2
2	0	2	0	0	58303	2
2	0	2	0	0	58304	2
2	0	2	0	0	58305	2
2	0	2	0	0	58306	2
2	0	2	0	0	58307	2
2	0	2	0	0	58308	2
2	0	2	0	0	58309	2
2	0	2	0	0	58310	2
2	0	2	0	0	58311	2
2	0	2	0	0	58312	2
2	0	2	0	0	58313	2
2	0	2	0	0	58314	2
2	0	2	0	0	58315	2
2	0	4	0	0	58316	2
2	0	2	0	0	58317	2
2	0	2	0	0	58318	2
2	0	2	0	0	58319	2
2	0	2	0	0	58320	2
2	0	2	0	0	58321	2
2	0	2	0	0	58322	2
2	0	2	0	0	58323	2
2	0	2	0	0	58324	2
2	0	2	0	0	58325	2
2	0	2	0	0	58326	2
2	0	2	0	0	58327	2
2	0	2	0	0	58328	2
2	0	2	0	0	58329	2
2	0	2	0	0	58330	2
2	0	2	0	0	58331	2
2	0	2	0	0	58332	2
0	0	2	0	0	58333	2
0	0	2	0	0	58334	2
2	0	2	0	0	58335	2
2	0	2	0	0	58336	2
0	63	3	1104	1167	58337	0
0	1	3	1104	1105	58338	0
2	0	2	0	0	58339	2
2	0	2	0	0	58340	2
2	0	2	0	0	58341	2
2	0	2	0	0	58342	2
2	0	2	0	0	58343	2
2	0	2	0	0	58344	2
2	0	2	0	0	58345	2
2	0	2	4	4	58346	2
2	0	2	0	0	58347	2
2	0	2	0	0	58348	2
2	0	2	0	0	58349	2
2	0	2	25	25	58350	2
2	0	2	0	0	58351	2
2	0	2	0	0	58352	2
2	0	2	0	0	58353	2
2	0	2	0	0	58354	2
2	0	2	0	0	58355	2
2	0	2	0	0	58356	2
2	69	2	0	69	58357	0
2	0	2	0	0	58358	2
2	0	4	0	0	58359	2
2	0	2	0	0	58360	2
2	0	2	0	0	58361	2
2	0	4	0	0	58362	2
2	0	2	0	0	58363	2
2	0	2	0	0	58364	2
2	0	2	0	0	58365	2
2	0	2	0	0	58366	2
2	0	2	0	0	58367	2
2	0	2	0	0	58368	2
2	0	2	0	0	58369	2
2	1	2	0	1	58370	1
2	0	2	4	4	58371	2
2	0	2	0	0	58372	2
2	0	2	0	0	58373	2
0	208	2	3	211	58374	0
0	123	2	0	123	58375	0
2	0	2	0	0	58376	2
2	0	2	2	2	58377	2
4	61	4	2934	2995	58378	1
2	0	2	0	0	58379	2
2	0	2	0	0	58380	2
2	0	2	0	0	58381	2
2	0	2	0	0	58382	2
2	0	2	0	0	58383	2
2	0	2	0	0	58384	2
2	0	2	0	0	58385	2
2	0	2	0	0	58386	2
2	0	2	0	0	58387	2
2	0	2	0	0	58388	2
2	0	2	0	0	58389	2
2	0	2	0	0	58390	2
2	0	2	0	0	58391	2
2	0	2	0	0	58392	2
2	0	2	0	0	58393	2
2	0	2	0	0	58394	2
2	0	2	0	0	58395	2
2	0	2	0	0	58396	2
2	242	2	0	242	58397	0
2	15	4	10	25	58398	0
2	0	2	97	97	58399	2
2	22	4	342	364	58400	1
2	0	2	48	48	58401	2
2	0	2	7	7	58402	2
2	0	2	0	0	58403	2
2	0	2	0	0	58404	2
2	0	2	0	0	58405	2
2	0	4	0	0	58406	2
2	0	2	0	0	58407	2
2	0	2	0	0	58408	2
2	0	2	0	0	58409	2
2	0	2	0	0	58410	2
2	0	2	0	0	58411	2
2	0	2	0	0	58412	2
2	0	2	0	0	58413	2
2	0	2	0	0	58414	2
2	0	2	0	0	58415	2
2	0	4	11	11	58416	2
2	0	2	0	0	58417	2
2	0	2	0	0	58418	2
4	0	2	0	0	58419	2
2	0	4	0	0	58420	2
2	0	2	0	0	58421	2
2	0	2	0	0	58422	2
2	0	4	3	3	58423	2
2	0	2	1	1	58424	2
2	0	2	1	1	58425	2
2	0	4	0	0	58426	2
2	0	2	0	0	58427	2
2	0	0	19	19	58428	2
2	0	2	0	0	58429	2
2	0	2	0	0	58430	2
2	0	0	0	0	58431	2
2	0	2	1	1	58432	2
2	19	2	0	19	58433	0
2	4	2	37	41	58434	1
2	0	2	9	9	58435	2
2	0	2	1	1	58436	2
2	10	2	0	10	58437	1
2	0	2	52	52	58438	2
2	0	2	0	0	58439	2
2	0	2	0	0	58440	2
2	0	2	0	0	58441	2
2	4	2	0	4	58442	0
2	2	2	12	14	58443	1
2	0	2	0	0	58444	2
2	0	2	0	0	58445	2
2	0	2	0	0	58446	2
2	0	2	3	3	58447	2
4	2	0	1	3	58448	0
2	0	2	0	0	58449	2
2	0	2	0	0	58450	2
2	0	2	0	0	58451	2
2	0	2	0	0	58452	2
2	0	2	0	0	58453	2
2	0	2	0	0	58454	2
2	0	2	0	0	58455	2
2	0	2	0	0	58456	2
2	0	2	0	0	58457	2
2	0	2	0	0	58458	2
2	0	2	0	0	58459	2
2	0	2	1	1	58460	2
2	0	2	0	0	58461	2
2	0	2	0	0	58462	2
2	0	2	0	0	58463	2
2	0	2	0	0	58464	2
4	0	4	0	0	58465	2
4	0	4	0	0	58466	2
2	0	2	0	0	58467	2
2	0	2	0	0	58468	2
4	0	4	0	0	58469	2
4	0	4	0	0	58470	2
2	0	2	0	0	58471	2
2	0	2	0	0	58472	2
2	0	2	0	0	58473	2
2	0	2	0	0	58474	2
2	0	2	1	1	58475	2
2	0	2	0	0	58476	2
2	0	2	0	0	58477	2
2	0	2	0	0	58478	2
2	0	2	0	0	58479	2
2	0	2	0	0	58480	2
2	0	2	0	0	58481	2
2	0	2	0	0	58482	2
2	1	2	0	1	58483	0
2	1	2	7	8	58484	1
2	0	2	0	0	58485	2
2	0	2	0	0	58486	2
2	0	2	1	1	58487	2
2	0	2	0	0	58488	2
2	0	2	0	0	58489	2
2	0	2	6	6	58490	2
2	0	2	0	0	58491	2
2	0	2	0	0	58492	2
2	1	2	0	1	58493	0
2	0	2	6	6	58494	2
2	25	4	1339	1364	58495	1
2	0	2	20	20	58496	2
2	1	2	3	4	58497	1
2	36	4	50	86	58498	0
2	0	2	0	0	58499	2
2	584	2	7	591	58500	0
2	409	4	21966	22375	58501	1
2	5	2	636	641	58502	1
2	0	2	579	579	58503	2
2	210	4	341	551	58504	0
2	2	2	1354	1356	58505	1
2	0	2	0	0	58506	2
2	0	2	0	0	58507	2
2	0	2	0	0	58508	2
2	0	2	0	0	58509	2
2	0	2	0	0	58510	2
2	0	2	0	0	58511	2
0	75	4	307	382	58512	0
2	0	2	0	0	58513	2
2	0	2	0	0	58514	2
2	0	2	0	0	58515	2
2	0	2	0	0	58516	2
2	0	2	0	0	58517	2
2	0	2	0	0	58518	2
2	0	2	0	0	58519	2
2	0	2	0	0	58520	2
2	0	2	0	0	58521	2
2	0	2	0	0	58522	2
2	0	2	0	0	58523	2
2	0	2	0	0	58524	2
2	0	2	0	0	58525	2
2	0	2	0	0	58526	2
2	0	2	0	0	58527	2
2	0	2	0	0	58528	2
2	0	2	0	0	58529	2
2	0	2	0	0	58530	2
2	0	2	0	0	58531	2
2	0	2	0	0	58532	2
2	0	2	0	0	58533	2
2	0	2	0	0	58534	2
2	0	2	0	0	58535	2
2	0	2	0	0	58536	2
2	0	2	0	0	58537	2
2	0	0	157	157	58538	2
2	0	2	0	0	58539	2
2	0	2	0	0	58540	2
2	0	2	0	0	58541	2
2	0	2	0	0	58542	2
2	0	0	82	82	58543	2
2	0	2	0	0	58544	2
2	0	2	0	0	58545	2
2	0	2	0	0	58546	2
2	0	4	0	0	58547	2
2	0	2	0	0	58548	2
2	0	2	0	0	58549	2
2	0	4	0	0	58550	2
2	0	2	0	0	58551	2
2	2	2	0	2	58552	0
2	0	2	0	0	58553	2
2	0	2	0	0	58554	2
2	0	2	0	0	58555	2
2	0	2	0	0	58556	2
2	0	2	0	0	58557	2
2	0	2	0	0	58558	2
2	1	2	17	18	58559	1
2	0	2	0	0	58560	2
2	0	2	0	0	58561	2
2	3	2	0	3	58562	0
2	0	2	4	4	58563	2
2	1	4	73	74	58564	1
2	0	2	0	0	58565	2
2	0	2	0	0	58566	2
2	0	4	1	1	58567	2
2	0	2	1	1	58568	2
4	0	4	195	195	58569	2
2	0	2	0	0	58570	2
2	0	2	0	0	58571	2
2	0	2	0	0	58572	2
2	0	2	0	0	58573	2
2	0	2	5	5	58574	2
2	0	2	0	0	58575	2
2	0	2	0	0	58576	2
2	0	2	0	0	58577	2
2	0	2	0	0	58578	2
2	0	2	0	0	58579	2
2	0	2	0	0	58580	2
2	0	2	0	0	58581	2
2	0	2	0	0	58582	2
2	0	4	2	2	58583	2
2	0	2	0	0	58584	2
2	0	2	0	0	58585	2
2	0	4	0	0	58586	2
2	0	2	0	0	58587	2
2	0	2	0	0	58588	2
2	0	2	2	2	58589	2
2	0	2	0	0	58590	2
2	0	2	0	0	58591	2
2	0	2	0	0	58592	2
2	0	2	0	0	58593	2
4	0	2	0	0	58594	2
2	0	2	0	0	58595	2
2	0	2	0	0	58596	2
2	0	2	0	0	58597	2
2	0	2	0	0	58598	2
2	0	2	0	0	58599	2
2	0	2	0	0	58600	2
2	21	2	0	21	58601	0
2	0	2	0	0	58602	2
2	0	2	0	0	58603	2
2	0	2	0	0	58604	2
2	0	2	0	0	58605	2
2	0	2	0	0	58606	2
2	0	2	0	0	58607	2
2	14	4	386	400	58608	1
2	0	2	16	16	58609	2
2	0	2	2	2	58610	2
2	0	2	0	0	58611	2
2	0	2	0	0	58612	2
2	0	2	0	0	58613	2
2	0	2	0	0	58614	2
2	0	2	0	0	58615	2
2	0	2	0	0	58616	2
2	0	2	0	0	58617	2
2	0	4	1	1	58618	2
2	0	2	0	0	58619	2
2	0	2	0	0	58620	2
2	0	4	4	4	58621	2
2	0	2	0	0	58622	2
2	0	2	0	0	58623	2
2	0	4	0	0	58624	2
2	0	2	0	0	58625	2
2	0	2	0	0	58626	2
2	0	2	0	0	58627	2
2	0	2	7	7	58628	2
2	0	2	0	0	58629	2
2	0	4	2	2	58630	2
2	0	2	0	0	58631	2
2	0	2	0	0	58632	2
2	0	4	4	4	58633	2
2	0	2	0	0	58634	2
2	4	2	0	4	58635	0
2	2	2	30	32	58636	1
2	0	2	1	1	58637	2
2	0	2	0	0	58638	2
2	0	2	0	0	58639	2
2	0	2	0	0	58640	2
2	14	4	41	55	58641	1
2	0	2	87	87	58642	2
4	4666	2	3	4669	58643	0
4	346	2	0	346	58644	0
4	7109	2	77	7186	58645	1
4	91	2	1	92	58646	0
0	10	2	0	10	58647	0
4	44	2	15	59	58648	0
4	1	2	15	16	58649	0
4	87	4	677	764	58650	1
4	35	4	249	284	58651	1
4	0	4	0	0	58652	2
4	0	4	0	0	58653	2
0	0	2	0	0	58654	2
4	0	2	12	12	58655	2
4	0	2	0	0	58656	2
4	0	4	17	17	58657	2
2	0	2	0	0	58658	2
2	0	2	0	0	58659	2
2	0	2	0	0	58660	2
2	0	2	0	0	58661	2
2	0	2	0	0	58662	2
2	0	2	0	0	58663	2
2	0	2	0	0	58664	2
2	0	2	1	1	58665	2
2	0	2	0	0	58666	2
2	0	2	0	0	58667	2
2	0	2	0	0	58668	2
2	0	2	0	0	58669	2
2	0	2	0	0	58670	2
2	0	2	0	0	58671	2
2	0	2	0	0	58672	2
2	0	2	0	0	58673	2
2	0	2	0	0	58674	2
2	0	2	0	0	58675	2
2	0	2	0	0	58676	2
2	0	2	0	0	58677	2
2	0	2	0	0	58678	2
2	0	2	0	0	58679	2
2	0	2	0	0	58680	2
2	0	2	0	0	58681	2
2	0	2	0	0	58682	2
2	0	2	4	4	58683	2
2	0	2	0	0	58684	2
2	0	2	0	0	58685	2
2	0	2	0	0	58686	2
2	0	2	0	0	58687	2
2	0	2	0	0	58688	2
2	0	2	0	0	58689	2
2	0	2	0	0	58690	2
2	0	2	0	0	58691	2
2	0	2	0	0	58692	2
2	0	2	0	0	58693	2
2	0	2	0	0	58694	2
2	0	2	0	0	58695	2
2	0	2	0	0	58696	2
2	0	2	0	0	58697	2
2	0	2	0	0	58698	2
2	0	2	0	0	58699	2
2	0	2	0	0	58700	2
2	0	2	0	0	58701	2
2	0	2	0	0	58702	2
2	0	2	0	0	58703	2
2	0	2	0	0	58704	2
2	0	2	0	0	58705	2
2	0	2	0	0	58706	2
2	0	2	1	1	58707	2
2	0	2	0	0	58708	2
2	0	2	0	0	58709	2
4	3	2	0	3	58710	0
4	1	2	0	1	58711	0
4	0	2	0	0	58712	2
2	1	2	0	1	58713	1
2	11	2	5	16	58714	0
4	2	2	0	2	58715	0
2	0	2	0	0	58716	2
2	0	4	140	140	58717	2
2	0	2	0	0	58718	2
2	0	2	0	0	58719	2
2	0	4	125	125	58720	2
2	0	2	0	0	58721	2
2	2	2	0	2	58722	0
2	0	2	17	17	58723	2
2	0	2	1	1	58724	2
2	0	2	0	0	58725	2
2	0	2	2	2	58726	2
2	0	2	2	2	58727	2
0	14	0	829	843	58728	0
0	0	0	829	829	58729	2
2	0	2	0	0	58730	2
2	0	2	0	0	58731	2
2	0	2	0	0	58732	2
2	0	2	0	0	58733	2
2	0	2	2	2	58734	2
2	4	2	3	7	58735	1
2	0	2	0	0	58736	2
2	0	4	1	1	58737	2
2	0	2	0	0	58738	2
2	0	2	0	0	58739	2
2	0	4	0	0	58740	2
2	0	2	0	0	58741	2
2	0	2	0	0	58742	2
2	0	2	0	0	58743	2
2	0	2	0	0	58744	2
2	0	2	0	0	58745	2
2	0	2	0	0	58746	2
2	0	2	0	0	58747	2
2	0	2	0	0	58748	2
2	0	4	364	364	58749	2
2	0	2	0	0	58750	2
2	0	2	0	0	58751	2
2	0	4	7	7	58752	2
2	0	2	0	0	58753	2
2	0	2	0	0	58754	2
2	0	2	1	1	58755	2
2	0	2	0	0	58756	2
2	0	2	0	0	58757	2
2	0	2	0	0	58758	2
2	0	2	0	0	58759	2
0	1	0	55	56	58760	1
0	0	0	53	53	58761	2
4	3	4	3564	3567	58762	1
4	0	4	25	25	58763	2
4	19	2	3	22	58764	0
4	2	0	1	3	58765	1
4	6	0	0	6	58766	1
4	0	4	49	49	58767	2
4	0	2	0	0	58768	2
4	0	2	0	0	58769	2
4	0	0	5	5	58770	2
4	2	0	1	3	58771	1
4	8	0	0	8	58772	1
4	1	0	1	2	58773	1
4	129	4	22	151	58774	1
4	5	4	13	18	58775	1
4	0	4	1	1	58776	2
4	26	2	17942	17968	58777	0
4	8	2	346	354	58778	0
4	0	4	4	4	58779	2
4	0	4	8	8	58780	2
2	80441	4	2807	83248	58781	0
4	0	2	17942	17942	58782	2
4	0	2	346	346	58783	2
4	0	4	7	7	58784	2
4	0	4	6	6	58785	2
4	2	4	136	138	58786	1
4	0	3	128469	128469	58787	2
4	0	3	123910	123910	58788	2
4	0	4	2	2	58789	2
4	0	4	0	0	58790	2
4	1170	2	20	1190	58791	0
0	0	4	718	718	58792	2
2	11	2	0	11	58793	0
2	7	2	149	156	58794	1
2	0	2	0	0	58795	2
2	0	2	0	0	58796	2
2	2	2	0	2	58797	0
2	0	2	2	2	58798	2
2	0	2	0	0	58799	2
2	0	2	40	40	58800	2
2	0	2	0	0	58801	2
2	0	2	0	0	58802	2
2	0	2	0	0	58803	2
2	0	2	1	1	58804	2
2	0	2	0	0	58805	2
2	0	2	0	0	58806	2
2	0	2	0	0	58807	2
2	0	2	0	0	58808	2
2	0	2	0	0	58809	2
2	0	2	0	0	58810	2
2	0	2	1	1	58811	2
2	0	2	0	0	58812	2
2	0	2	1	1	58813	2
2	0	2	0	0	58814	2
2	0	2	0	0	58815	2
2	0	4	3	3	58816	2
2	0	2	0	0	58817	2
2	0	2	0	0	58818	2
2	0	4	0	0	58819	2
2	0	2	0	0	58820	2
0	11	4	19	30	58821	0
2	0	2	0	0	58822	2
2	0	2	1	1	58823	2
2	0	2	0	0	58824	2
2	0	2	2	2	58825	2
2	0	2	0	0	58826	2
2	0	2	0	0	58827	2
2	1	2	0	1	58828	0
2	0	2	0	0	58829	2
2	0	2	0	0	58830	2
2	0	2	0	0	58831	2
2	0	2	0	0	58832	2
2	0	2	0	0	58833	2
2	0	2	0	0	58834	2
2	0	2	0	0	58835	2
2	0	2	0	0	58836	2
2	0	2	0	0	58837	2
2	0	2	0	0	58838	2
2	0	2	0	0	58839	2
2	0	2	0	0	58840	2
2	0	2	2	2	58841	2
2	8	2	0	8	58842	0
2	0	2	100	100	58843	2
2	0	2	2	2	58844	2
2	0	2	0	0	58845	2
2	2	2	11	13	58846	0
2	0	2	13	13	58847	2
2	0	2	0	0	58848	2
2	0	2	1	1	58849	2
2	0	2	0	0	58850	2
2	0	2	0	0	58851	2
2	0	2	0	0	58852	2
2	0	2	0	0	58853	2
0	10	4	21	31	58854	0
0	0	4	0	0	58855	2
2	0	2	0	0	58856	2
2	1	2	17	18	58857	1
2	0	2	0	0	58858	2
2	0	2	0	0	58859	2
2	0	2	0	0	58860	2
2	0	2	1	1	58861	2
2	0	2	0	0	58862	2
2	0	4	10	10	58863	2
2	0	2	0	0	58864	2
2	0	2	0	0	58865	2
2	0	2	1	1	58866	2
2	0	2	0	0	58867	2
2	0	2	0	0	58868	2
2	0	0	164	164	58869	2
2	0	2	0	0	58870	2
2	0	2	0	0	58871	2
2	0	0	24	24	58872	2
2	0	2	0	0	58873	2
2	0	2	0	0	58874	2
2	0	2	0	0	58875	2
2	0	2	0	0	58876	2
2	0	2	0	0	58877	2
2	0	2	0	0	58878	2
2	0	2	0	0	58879	2
2	0	2	0	0	58880	2
2	0	2	0	0	58881	2
2	0	2	0	0	58882	2
2	0	2	0	0	58883	2
2	0	2	0	0	58884	2
2	0	2	0	0	58885	2
2	0	2	0	0	58886	2
2	0	2	0	0	58887	2
2	0	2	0	0	58888	2
2	0	2	0	0	58889	2
2	0	2	0	0	58890	2
2	0	2	0	0	58891	2
2	0	2	0	0	58892	2
2	0	2	0	0	58893	2
2	0	4	35	35	58894	2
2	0	2	0	0	58895	2
2	0	2	0	0	58896	2
2	0	4	212	212	58897	2
2	0	2	0	0	58898	2
2	0	2	0	0	58899	2
2	0	2	0	0	58900	2
2	9	2	0	9	58901	0
2	11	2	59	70	58902	1
2	0	2	1	1	58903	2
2	0	2	0	0	58904	2
2	5	2	0	5	58905	1
2	0	2	25	25	58906	2
2	0	2	0	0	58907	2
2	1	2	0	1	58908	0
2	0	2	3	3	58909	2
2	0	2	0	0	58910	2
2	0	2	0	0	58911	2
2	0	2	0	0	58912	2
2	0	2	0	0	58913	2
2	0	2	2	2	58914	2
2	0	2	0	0	58915	2
2	0	2	0	0	58916	2
2	0	2	871	871	58917	2
2	0	2	1	1	58918	2
2	113	2	2	115	58919	0
2	0	2	0	0	58920	2
2	0	2	0	0	58921	2
2	0	2	0	0	58922	2
2	0	2	0	0	58923	2
2	1	2	0	1	58924	0
2	0	2	0	0	58925	2
2	0	2	0	0	58926	2
2	0	2	11	11	58927	2
2	0	2	0	0	58928	2
2	0	2	0	0	58929	2
2	0	2	0	0	58930	2
2	0	2	0	0	58931	2
4	0	2	3	3	58932	2
0	0	4	66	66	58933	2
0	0	4	66	66	58934	2
2	0	2	17	17	58935	2
2	0	2	6	6	58936	2
2	0	2	0	0	58937	2
2	0	2	0	0	58938	2
2	0	2	0	0	58939	2
2	0	2	0	0	58940	2
2	0	2	0	0	58941	2
2	0	2	0	0	58942	2
2	0	2	0	0	58943	2
2	0	2	0	0	58944	2
2	0	2	0	0	58945	2
2	0	2	2	2	58946	2
2	0	2	0	0	58947	2
2	0	2	0	0	58948	2
2	0	2	0	0	58949	2
2	0	2	0	0	58950	2
2	0	2	0	0	58951	2
2	0	2	0	0	58952	2
2	0	2	0	0	58953	2
2	0	2	0	0	58954	2
2	0	2	0	0	58955	2
2	0	2	0	0	58956	2
2	0	2	0	0	58957	2
2	0	2	0	0	58958	2
2	0	2	0	0	58959	2
2	0	2	0	0	58960	2
2	0	2	0	0	58961	2
2	0	4	65	65	58962	2
2	0	2	0	0	58963	2
2	0	2	0	0	58964	2
2	0	4	157	157	58965	2
2	0	2	0	0	58966	2
2	0	2	0	0	58967	2
2	0	2	0	0	58968	2
2	0	2	0	0	58969	2
4	0	4	0	0	58970	2
4	0	4	0	0	58971	2
2	441	2	3	444	58972	0
2	0	2	0	0	58973	2
2	0	2	0	0	58974	2
2	0	2	0	0	58975	2
2	0	2	0	0	58976	2
2	0	2	0	0	58977	2
2	0	2	0	0	58978	2
2	0	2	0	0	58979	2
2	0	2	0	0	58980	2
2	0	2	0	0	58981	2
2	0	2	0	0	58982	2
2	0	2	0	0	58983	2
2	0	2	0	0	58984	2
2	0	2	0	0	58985	2
0	1	2	0	1	58986	0
0	0	2	0	0	58987	2
2	0	2	0	0	58988	2
2	0	2	1	1	58989	2
2	6	2	8	14	58990	1
2	0	2	1	1	58991	2
2	0	2	0	0	58992	2
2	2	2	1	3	58993	1
2	0	2	7	7	58994	2
2	81	2	4250	4331	58995	1
2	0	2	31	31	58996	2
2	0	2	10	10	58997	2
2	42	2	24	66	58998	0
2	0	2	327	327	58999	2
2	1460	2	2	1462	59000	0
2	236	2	12582	12818	59001	1
2	0	2	200	200	59002	2
2	0	2	45	45	59003	2
2	177	2	94	271	59004	0
2	0	2	1334	1334	59005	2
2	0	2	0	0	59006	2
2	0	2	0	0	59007	2
2	0	2	0	0	59008	2
2	0	2	0	0	59009	2
2	0	2	0	0	59010	2
2	0	2	0	0	59011	2
2	0	2	0	0	59012	2
2	0	2	0	0	59013	2
2	0	2	2	2	59014	2
2	0	2	0	0	59015	2
2	0	2	0	0	59016	2
2	0	2	2	2	59017	2
2	0	2	0	0	59018	2
2	9	2	0	9	59019	0
2	4	2	35	39	59020	1
2	0	2	7	7	59021	2
2	0	2	0	0	59022	2
2	2	2	0	2	59023	1
2	0	2	7	7	59024	2
2	1	2	0	1	59025	0
2	0	4	419	419	59026	2
2	0	2	1	1	59027	2
2	0	2	0	0	59028	2
2	1	4	664	665	59029	0
2	0	2	3	3	59030	2
2	0	4	432	432	59031	2
2	0	2	0	0	59032	2
2	0	2	0	0	59033	2
4	0	2	0	0	59034	2
4	0	2	0	0	59035	2
2	0	2	0	0	59036	2
2	0	2	1	1	59037	2
2	0	2	0	0	59038	2
2	0	2	0	0	59039	2
2	0	2	0	0	59040	2
2	0	2	0	0	59041	2
2	0	2	0	0	59042	2
2	0	2	0	0	59043	2
2	0	2	0	0	59044	2
2	0	2	1	1	59045	2
2	0	2	0	0	59046	2
2	0	2	0	0	59047	2
2	0	2	0	0	59048	2
2	0	2	0	0	59049	2
2	0	2	0	0	59050	2
2	0	2	0	0	59051	2
2	0	2	0	0	59052	2
2	0	2	0	0	59053	2
2	0	2	0	0	59054	2
2	0	2	0	0	59055	2
2	0	2	0	0	59056	2
2	0	2	0	0	59057	2
2	0	2	0	0	59058	2
2	0	2	0	0	59059	2
2	0	2	0	0	59060	2
2	0	4	549	549	59061	2
2	0	2	2	2	59062	2
2	1	4	1710	1711	59063	1
2	0	2	0	0	59064	2
2	0	2	0	0	59065	2
4	139	2	2	141	59066	0
2	0	2	0	0	59067	2
2	0	2	0	0	59068	2
2	0	2	0	0	59069	2
2	0	2	0	0	59070	2
2	0	2	0	0	59071	2
2	0	2	0	0	59072	2
2	0	2	46	46	59073	2
2	0	2	0	0	59074	2
2	0	2	0	0	59075	2
2	0	2	0	0	59076	2
2	0	2	0	0	59077	2
2	0	2	0	0	59078	2
2	0	2	0	0	59079	2
2	0	2	0	0	59080	2
2	0	2	0	0	59081	2
2	0	2	0	0	59082	2
2	0	2	0	0	59083	2
2	0	2	0	0	59084	2
2	0	2	0	0	59085	2
0	0	4	1	1	59086	2
2	11	2	0	11	59087	0
2	0	2	188	188	59088	2
2	7	2	0	7	59089	0
2	0	2	114	114	59090	2
2	0	2	1	1	59091	2
2	0	2	1	1	59092	2
2	2	2	0	2	59093	1
2	0	2	14	14	59094	2
2	0	2	0	0	59095	2
2	0	2	0	0	59096	2
2	0	2	0	0	59097	2
2	0	2	0	0	59098	2
2	0	2	0	0	59099	2
2	0	2	0	0	59100	2
0	0	4	3	3	59101	2
0	0	4	0	0	59102	2
0	0	4	4	4	59103	2
0	0	4	4	4	59104	2
2	74	2	1	75	59105	0
2	0	2	0	0	59106	2
2	0	2	1	1	59107	2
2	0	2	0	0	59108	2
2	0	2	0	0	59109	2
2	0	2	0	0	59110	2
2	0	2	0	0	59111	2
2	9	2	419	428	59112	1
2	0	2	14	14	59113	2
2	0	2	0	0	59114	2
2	20	2	12	32	59115	1
2	0	2	98	98	59116	2
2	0	2	0	0	59117	2
2	0	2	0	0	59118	2
2	0	2	0	0	59119	2
2	0	2	0	0	59120	2
2	0	2	7	7	59121	2
2	0	2	0	0	59122	2
2	0	2	0	0	59123	2
2	0	2	1	1	59124	2
2	0	2	0	0	59125	2
2	0	2	0	0	59126	2
2	0	2	0	0	59127	2
2	0	2	0	0	59128	2
2	0	2	0	0	59129	2
2	0	2	0	0	59130	2
2	0	2	0	0	59131	2
2	0	2	0	0	59132	2
2	0	2	0	0	59133	2
2	0	2	0	0	59134	2
2	0	2	0	0	59135	2
2	0	2	5	5	59136	2
2	0	2	0	0	59137	2
2	0	2	0	0	59138	2
2	0	2	0	0	59139	2
2	0	2	0	0	59140	2
4	2	2	5	7	59141	0
4	0	2	0	0	59142	2
2	0	2	0	0	59143	2
2	0	2	0	0	59144	2
2	0	2	0	0	59145	2
2	0	2	0	0	59146	2
2	0	2	0	0	59147	2
2	0	2	0	0	59148	2
2	0	2	0	0	59149	2
2	0	2	0	0	59150	2
2	1	2	4	5	59151	1
2	0	2	0	0	59152	2
2	0	2	0	0	59153	2
2	0	2	0	0	59154	2
2	0	2	0	0	59155	2
2	0	0	80	80	59156	2
2	0	2	0	0	59157	2
2	0	2	0	0	59158	2
2	0	0	55	55	59159	2
2	0	2	0	0	59160	2
2	0	2	0	0	59161	2
2	0	2	0	0	59162	2
2	0	2	12	12	59163	2
2	0	2	0	0	59164	2
2	0	2	0	0	59165	2
2	0	2	0	0	59166	2
2	0	2	1	1	59167	2
2	0	2	0	0	59168	2
2	0	2	0	0	59169	2
2	0	2	0	0	59170	2
2	0	2	0	0	59171	2
2	0	2	0	0	59172	2
2	0	4	836	836	59173	2
2	0	2	0	0	59174	2
2	0	2	0	0	59175	2
2	0	2	0	0	59176	2
2	0	2	0	0	59177	2
2	0	2	0	0	59178	2
2	0	2	0	0	59179	2
2	0	2	0	0	59180	2
2	0	2	0	0	59181	2
2	59	2	0	59	59182	0
2	0	2	0	0	59183	2
2	0	2	0	0	59184	2
2	0	2	0	0	59185	2
2	0	2	0	0	59186	2
2	0	2	0	0	59187	2
2	0	2	0	0	59188	2
2	0	2	0	0	59189	2
2	0	4	6	6	59190	2
2	0	2	0	0	59191	2
2	0	2	0	0	59192	2
2	0	4	0	0	59193	2
2	0	2	0	0	59194	2
2	11	2	1327	1338	59195	1
2	0	2	0	0	59196	2
2	0	2	0	0	59197	2
2	2	2	59	61	59198	0
2	1	2	0	1	59199	0
2	10	0	143	153	59200	0
2	0	2	0	0	59201	2
2	0	2	0	0	59202	2
2	0	2	186	186	59203	2
2	0	2	4	4	59204	2
2	0	2	0	0	59205	2
2	0	2	0	0	59206	2
2	0	2	0	0	59207	2
2	0	2	0	0	59208	2
2	0	2	0	0	59209	2
2	0	2	0	0	59210	2
2	0	2	0	0	59211	2
2	0	2	0	0	59212	2
2	0	2	0	0	59213	2
2	0	2	0	0	59214	2
2	0	2	0	0	59215	2
2	0	2	0	0	59216	2
2	0	2	0	0	59217	2
2	0	2	2	2	59218	2
2	0	2	0	0	59219	2
2	0	2	0	0	59220	2
2	0	2	0	0	59221	2
2	0	2	1	1	59222	2
2	0	2	0	0	59223	2
2	0	2	7	7	59224	2
2	0	2	0	0	59225	2
2	0	2	0	0	59226	2
2	0	2	0	0	59227	2
2	0	2	0	0	59228	2
2	0	2	0	0	59229	2
2	0	2	0	0	59230	2
2	0	4	206	206	59231	2
2	0	2	0	0	59232	2
2	0	2	0	0	59233	2
2	0	4	52	52	59234	2
2	0	2	0	0	59235	2
2	0	4	72	72	59236	2
2	0	2	0	0	59237	2
2	0	2	0	0	59238	2
2	0	4	37	37	59239	2
2	0	2	1	1	59240	2
0	72	2	0	72	59241	0
2	0	2	0	0	59242	2
2	0	2	34	34	59243	2
2	0	2	0	0	59244	2
2	0	2	0	0	59245	2
2	0	2	0	0	59246	2
2	0	2	0	0	59247	2
0	14	4	209	223	59248	1
2	0	2	0	0	59249	2
2	0	2	3	3	59250	2
2	0	2	0	0	59251	2
2	0	2	0	0	59252	2
2	0	2	0	0	59253	2
2	0	2	0	0	59254	2
2	304	2	24	328	59255	0
2	0	2	0	0	59256	2
2	0	2	0	0	59257	2
2	0	2	0	0	59258	2
2	0	2	0	0	59259	2
2	0	2	0	0	59260	2
2	0	2	0	0	59261	2
2	0	2	1	1	59262	2
2	0	2	0	0	59263	2
2	0	2	0	0	59264	2
2	0	2	0	0	59265	2
2	0	2	0	0	59266	2
2	0	2	0	0	59267	2
2	0	2	0	0	59268	2
2	0	2	0	0	59269	2
2	0	2	0	0	59270	2
2	0	2	0	0	59271	2
2	0	2	0	0	59272	2
2	0	2	0	0	59273	2
2	0	2	0	0	59274	2
2	0	2	0	0	59275	2
2	0	2	0	0	59276	2
2	0	2	0	0	59277	2
2	0	2	0	0	59278	2
2	0	2	0	0	59279	2
2	0	2	0	0	59280	2
2	0	2	0	0	59281	2
2	0	2	0	0	59282	2
2	0	2	0	0	59283	2
2	0	2	0	0	59284	2
2	0	2	0	0	59285	2
2	0	2	0	0	59286	2
2	0	2	0	0	59287	2
2	0	2	0	0	59288	2
2	0	2	0	0	59289	2
2	0	2	0	0	59290	2
2	0	2	0	0	59291	2
2	0	2	0	0	59292	2
2	0	4	415	415	59293	2
2	0	2	0	0	59294	2
2	0	2	0	0	59295	2
2	0	4	159	159	59296	2
2	0	2	2	2	59297	2
2	26	2	0	26	59298	0
2	0	2	0	0	59299	2
2	0	2	0	0	59300	2
2	0	2	0	0	59301	2
2	0	2	0	0	59302	2
2	0	4	0	0	59303	2
2	0	2	0	0	59304	2
4	0	2	0	0	59305	2
2	0	2	20	20	59306	2
2	0	2	0	0	59307	2
2	8	2	0	8	59308	0
2	0	2	54	54	59309	2
2	13	2	3434	3447	59310	0
2	0	2	0	0	59311	2
2	1	4	103	104	59312	1
2	0	2	0	0	59313	2
2	0	2	0	0	59314	2
2	2	4	2	4	59315	0
2	0	2	5	5	59316	2
2	31	2	1	32	59317	0
2	0	2	60	60	59318	2
4	0	2	5	5	59319	2
2	2	4	0	2	59320	0
2	0	2	65	65	59321	2
2	5	2	1	6	59322	0
2	2	4	34	36	59323	1
2	0	2	5	5	59324	2
2	0	2	0	0	59325	2
2	0	2	0	0	59326	2
2	0	4	1	1	59327	2
2	0	2	0	0	59328	2
2	0	2	0	0	59329	2
2	0	4	1	1	59330	2
2	0	2	0	0	59331	2
2	1	2	0	1	59332	0
2	0	2	0	0	59333	2
2	0	2	0	0	59334	2
2	0	2	0	0	59335	2
2	0	2	1	1	59336	2
2	0	2	0	0	59337	2
2	0	2	0	0	59338	2
2	0	2	0	0	59339	2
2	0	2	4	4	59340	2
2	0	2	0	0	59341	2
2	0	2	0	0	59342	2
2	0	2	1	1	59343	2
2	0	2	4	4	59344	2
2	0	2	0	0	59345	2
2	0	2	0	0	59346	2
2	0	2	0	0	59347	2
2	0	2	0	0	59348	2
2	0	2	0	0	59349	2
2	0	2	0	0	59350	2
2	0	2	0	0	59351	2
2	0	2	0	0	59352	2
2	0	2	0	0	59353	2
2	0	2	0	0	59354	2
2	0	2	0	0	59355	2
2	0	2	0	0	59356	2
2	0	2	75	75	59357	2
2	0	2	1	1	59358	2
2	0	2	0	0	59359	2
2	0	2	33	33	59360	2
2	0	2	1	1	59361	2
4	0	2	0	0	59362	2
2	0	2	0	0	59363	2
2	0	2	0	0	59364	2
2	0	2	0	0	59365	2
2	0	2	0	0	59366	2
2	0	2	0	0	59367	2
2	0	2	0	0	59368	2
2	0	2	0	0	59369	2
2	0	2	0	0	59370	2
2	0	2	0	0	59371	2
2	0	2	0	0	59372	2
2	0	2	0	0	59373	2
2	0	2	0	0	59374	2
2	0	2	0	0	59375	2
2	0	2	0	0	59376	2
2	0	2	0	0	59377	2
2	0	2	0	0	59378	2
2	0	2	0	0	59379	2
2	0	2	0	0	59380	2
2	0	2	0	0	59381	2
2	0	2	0	0	59382	2
2	0	2	0	0	59383	2
2	0	2	0	0	59384	2
2	0	2	0	0	59385	2
2	0	2	0	0	59386	2
2	0	2	0	0	59387	2
2	0	2	0	0	59388	2
2	0	2	0	0	59389	2
2	0	2	0	0	59390	2
2	0	2	0	0	59391	2
2	0	2	0	0	59392	2
2	0	2	0	0	59393	2
2	0	2	0	0	59394	2
2	0	2	0	0	59395	2
2	0	2	1	1	59396	2
2	0	2	0	0	59397	2
2	0	2	0	0	59398	2
2	0	2	0	0	59399	2
2	1	4	37	38	59400	1
2	0	2	0	0	59401	2
2	0	2	0	0	59402	2
2	0	4	4	4	59403	2
2	0	2	1	1	59404	2
2	0	2	0	0	59405	2
2	0	2	0	0	59406	2
2	0	2	0	0	59407	2
2	0	2	0	0	59408	2
2	0	2	0	0	59409	2
2	0	2	0	0	59410	2
2	0	2	0	0	59411	2
2	0	2	0	0	59412	2
2	0	2	0	0	59413	2
2	0	4	12	12	59414	2
2	0	2	0	0	59415	2
2	0	2	0	0	59416	2
2	0	2	0	0	59417	2
2	0	2	0	0	59418	2
2	0	2	0	0	59419	2
2	0	2	0	0	59420	2
2	0	2	0	0	59421	2
2	61	2	0	61	59422	0
2	3	2	394	397	59423	1
2	0	2	39	39	59424	2
2	0	2	0	0	59425	2
2	14	2	0	14	59426	0
2	0	2	74	74	59427	2
2	0	2	0	0	59428	2
2	0	2	1	1	59429	2
2	0	2	0	0	59430	2
2	0	2	0	0	59431	2
2	0	2	0	0	59432	2
2	0	2	0	0	59433	2
2	0	2	0	0	59434	2
2	0	2	0	0	59435	2
2	0	2	0	0	59436	2
2	0	2	0	0	59437	2
2	0	2	0	0	59438	2
2	0	2	0	0	59439	2
2	0	2	0	0	59440	2
2	0	2	0	0	59441	2
2	0	2	0	0	59442	2
2	0	2	0	0	59443	2
2	0	2	0	0	59444	2
2	0	2	0	0	59445	2
2	0	2	0	0	59446	2
2	0	4	216	216	59447	2
2	0	2	0	0	59448	2
2	0	2	0	0	59449	2
2	0	4	2	2	59450	2
2	0	4	1	1	59451	2
0	1	4	211	212	59452	0
0	0	4	211	211	59453	2
2	26	2	0	26	59454	0
2	0	2	0	0	59455	2
2	0	2	0	0	59456	2
2	0	2	0	0	59457	2
2	0	2	0	0	59458	2
2	0	2	0	0	59459	2
2	0	2	0	0	59460	2
2	0	2	0	0	59461	2
2	0	2	0	0	59462	2
2	0	2	0	0	59463	2
2	0	2	0	0	59464	2
2	0	2	0	0	59465	2
2	0	2	0	0	59466	2
2	0	2	0	0	59467	2
2	2	2	1	3	59468	1
2	0	2	0	0	59469	2
2	0	2	0	0	59470	2
2	1	2	6	7	59471	1
2	0	2	0	0	59472	2
2	0	2	314	314	59473	2
2	0	2	0	0	59474	2
2	0	2	0	0	59475	2
2	4	2	2	6	59476	1
2	0	2	29	29	59477	2
2	0	2	0	0	59478	2
2	1	2	4	5	59479	1
2	0	2	0	0	59480	2
2	0	2	0	0	59481	2
2	1	2	3	4	59482	0
2	0	2	0	0	59483	2
2	0	2	0	0	59484	2
2	0	2	0	0	59485	2
2	0	2	0	0	59486	2
2	0	2	0	0	59487	2
2	0	2	0	0	59488	2
2	0	2	0	0	59489	2
4	0	4	1	1	59490	2
4	1	4	0	1	59491	0
4	409	4	5	414	59492	0
2	0	2	0	0	59493	2
0	0	4	1	1	59494	2
2	0	2	0	0	59495	2
2	0	2	0	0	59496	2
2	0	2	0	0	59497	2
2	0	2	2	2	59498	2
2	0	2	0	0	59499	2
2	0	2	0	0	59500	2
2	1	2	0	1	59501	0
2	1	4	28	29	59502	1
2	0	2	2	2	59503	2
2	0	2	0	0	59504	2
2	4	2	3	7	59505	0
2	1	2	8	9	59506	1
2	2	2	0	2	59507	0
2	0	2	1	1	59508	2
2	0	2	0	0	59509	2
2	0	2	10	10	59510	2
2	0	2	0	0	59511	2
2	0	2	0	0	59512	2
2	0	2	1	1	59513	2
2	0	2	1	1	59514	2
2	1	2	0	1	59515	0
0	309	4	2	311	59516	0
2	1	2	0	1	59517	0
2	107	2	0	107	59518	0
2	2	4	39	41	59519	1
2	0	2	67	67	59520	2
2	0	2	0	0	59521	2
2	16	4	4	20	59522	1
2	0	2	133	133	59523	2
2	0	4	6	6	59524	2
2	0	2	0	0	59525	2
2	0	2	0	0	59526	2
2	0	4	0	0	59527	2
2	0	2	0	0	59528	2
2	2	4	63	65	59529	1
2	0	2	0	0	59530	2
2	0	2	0	0	59531	2
2	4	4	40	44	59532	0
2	0	2	5	5	59533	2
4	0	2	830	830	59534	2
2	179	2	37693	37872	59535	0
2	0	2	0	0	59536	2
2	0	2	1	1	59537	2
2	0	2	0	0	59538	2
2	0	2	0	0	59539	2
2	0	2	0	0	59540	2
2	0	2	1	1	59541	2
2	0	2	0	0	59542	2
2	31	4	2392	2423	59543	0
2	0	2	52	52	59544	2
2	0	2	0	0	59545	2
2	0	2	0	0	59546	2
2	0	2	0	0	59547	2
2	0	2	0	0	59548	2
2	0	2	0	0	59549	2
2	0	2	0	0	59550	2
2	68	2	0	68	59551	0
2	238	2	461	699	59552	1
2	1	2	11	12	59553	1
2	0	2	0	0	59554	2
2	1	2	0	1	59555	0
2	0	4	22	22	59556	2
2	0	2	0	0	59557	2
2	0	2	0	0	59558	2
2	1	4	0	1	59559	0
2	0	2	4	4	59560	2
4	0	4	0	0	59561	2
4	0	4	0	0	59562	2
4	1	4	0	1	59563	1
4	0	4	0	0	59564	2
2	0	2	0	0	59565	2
2	0	2	4	4	59566	2
2	0	2	0	0	59567	2
2	0	2	0	0	59568	2
2	0	2	0	0	59569	2
2	0	2	0	0	59570	2
2	0	2	0	0	59571	2
2	0	2	0	0	59572	2
2	0	2	0	0	59573	2
2	0	2	0	0	59574	2
2	0	2	0	0	59575	2
2	0	2	1	1	59576	2
2	0	2	0	0	59577	2
2	0	2	0	0	59578	2
2	0	2	0	0	59579	2
2	0	2	0	0	59580	2
2	0	2	0	0	59581	2
2	0	2	0	0	59582	2
0	3	4	11	14	59583	0
0	0	4	1	1	59584	2
2	0	2	0	0	59585	2
2	0	2	0	0	59586	2
2	0	2	0	0	59587	2
2	0	2	0	0	59588	2
2	0	2	0	0	59589	2
2	0	2	0	0	59590	2
2	0	2	0	0	59591	2
2	0	2	0	0	59592	2
2	0	2	0	0	59593	2
2	0	2	196	196	59594	2
2	0	2	1	1	59595	2
2	75	2	0	75	59596	0
2	3	2	298	301	59597	1
2	0	2	78	78	59598	2
2	0	2	5	5	59599	2
2	28	2	9	37	59600	1
2	0	2	153	153	59601	2
2	1	2	0	1	59602	0
2	0	2	0	0	59603	2
2	0	2	1	1	59604	2
2	0	2	0	0	59605	2
2	0	2	0	0	59606	2
2	0	2	0	0	59607	2
2	0	2	0	0	59608	2
2	0	2	0	0	59609	2
2	0	2	0	0	59610	2
4	0	4	6	6	59611	2
0	18	4	2	20	59612	0
0	0	4	2	2	59613	2
0	0	4	11	11	59614	2
2	0	2	0	0	59615	2
2	0	2	2	2	59616	2
2	0	2	0	0	59617	2
2	0	2	0	0	59618	2
2	0	2	0	0	59619	2
2	0	2	0	0	59620	2
2	0	2	0	0	59621	2
2	0	2	0	0	59622	2
2	0	2	0	0	59623	2
2	0	2	0	0	59624	2
4	3	4	196	199	59625	1
0	38	4	2100	2138	59626	0
2	0	2	0	0	59627	2
2	0	2	0	0	59628	2
2	0	2	0	0	59629	2
2	0	2	0	0	59630	2
2	0	2	1581	1581	59631	2
2	0	2	0	0	59632	2
2	22	2	0	22	59633	0
2	5	2	236	241	59634	1
2	0	2	4	4	59635	2
2	0	2	0	0	59636	2
2	9	2	0	9	59637	0
2	0	2	91	91	59638	2
2	0	2	0	0	59639	2
2	0	2	0	0	59640	2
2	0	2	0	0	59641	2
2	0	2	0	0	59642	2
2	0	2	0	0	59643	2
2	0	2	0	0	59644	2
2	91	2	102	193	59645	1
2	144	2	6	150	59646	0
2	0	2	691	691	59647	2
2	0	2	0	0	59648	2
2	0	2	1	1	59649	2
2	0	2	0	0	59650	2
2	0	2	0	0	59651	2
2	0	2	0	0	59652	2
2	0	2	0	0	59653	2
0	12	3	282	294	59654	0
0	1	3	282	283	59655	0
2	0	2	0	0	59656	2
2	0	2	0	0	59657	2
2	0	2	0	0	59658	2
2	0	2	0	0	59659	2
2	0	2	0	0	59660	2
2	0	2	0	0	59661	2
2	0	2	0	0	59662	2
2	0	2	0	0	59663	2
2	0	2	0	0	59664	2
2	0	2	0	0	59665	2
2	0	2	0	0	59666	2
2	0	2	0	0	59667	2
2	0	2	0	0	59668	2
2	0	4	62	62	59669	2
2	0	2	0	0	59670	2
2	0	2	0	0	59671	2
2	0	4	62	62	59672	2
2	0	2	0	0	59673	2
2	12	2	0	12	59674	0
2	0	2	0	0	59675	2
2	0	0	736	736	59676	2
2	0	2	0	0	59677	2
2	0	2	0	0	59678	2
2	0	0	418	418	59679	2
2	0	2	2	2	59680	2
2	5	4	851	856	59681	1
2	0	2	2	2	59682	2
2	0	2	1	1	59683	2
2	11	4	44	55	59684	1
2	777	2	73	850	59685	0
4	3	2	0	3	59686	0
2	0	2	0	0	59687	2
2	0	2	0	0	59688	2
2	0	2	0	0	59689	2
2	0	2	0	0	59690	2
2	0	2	0	0	59691	2
2	0	2	0	0	59692	2
2	0	2	0	0	59693	2
2	0	2	0	0	59694	2
2	0	2	0	0	59695	2
2	0	2	0	0	59696	2
2	0	2	0	0	59697	2
2	0	2	0	0	59698	2
2	0	2	0	0	59699	2
2	0	2	0	0	59700	2
2	0	2	0	0	59701	2
2	0	2	0	0	59702	2
2	0	2	0	0	59703	2
2	0	2	0	0	59704	2
2	0	2	0	0	59705	2
2	0	2	0	0	59706	2
2	0	2	3	3	59707	2
2	0	2	0	0	59708	2
2	0	2	0	0	59709	2
2	0	2	0	0	59710	2
2	0	2	0	0	59711	2
2	0	2	0	0	59712	2
2	0	2	0	0	59713	2
2	0	2	0	0	59714	2
2	0	2	0	0	59715	2
2	0	2	1	1	59716	2
2	0	2	0	0	59717	2
2	0	2	0	0	59718	2
2	0	2	0	0	59719	2
2	0	4	0	0	59720	2
2	0	2	6	6	59721	2
0	1	2	2	3	59722	0
2	0	2	0	0	59723	2
0	41	4	1	42	59724	0
2	0	2	0	0	59725	2
2	1	2	4	5	59726	1
2	0	2	0	0	59727	2
2	0	2	0	0	59728	2
2	0	2	0	0	59729	2
2	0	2	0	0	59730	2
2	0	2	0	0	59731	2
2	1	2	0	1	59732	1
2	0	2	0	0	59733	2
2	0	2	0	0	59734	2
0	41	2	0	41	59735	0
0	16	2	1	17	59736	0
2	0	2	0	0	59737	2
2	0	2	2	2	59738	2
2	71	2	2	73	59739	0
2	175	4	3803	3978	59740	1
2	0	2	14	14	59741	2
2	0	2	0	0	59742	2
2	50	4	1353	1403	59743	0
2	0	2	118	118	59744	2
2	48	4	2	50	59745	0
2	0	2	171	171	59746	2
0	0	4	4	4	59747	2
0	20	2	257	277	59748	0
2	41	2	0	41	59749	0
2	1	2	1395	1396	59750	1
2	0	2	0	0	59751	2
2	0	2	21	21	59752	2
2	3	2	0	3	59753	0
2	0	2	21	21	59754	2
2	0	2	0	0	59755	2
2	0	4	0	0	59756	2
2	0	2	0	0	59757	2
2	0	2	0	0	59758	2
2	0	4	0	0	59759	2
2	0	2	0	0	59760	2
2	0	2	0	0	59761	2
2	0	2	0	0	59762	2
2	0	2	4	4	59763	2
2	0	2	6	6	59764	2
4	11	2	11	22	59765	0
2	0	2	0	0	59766	2
2	0	2	0	0	59767	2
2	0	2	0	0	59768	2
2	0	2	0	0	59769	2
2	0	2	0	0	59770	2
2	0	2	0	0	59771	2
0	7	4	26	33	59772	0
2	0	2	0	0	59773	2
2	0	2	0	0	59774	2
2	0	2	0	0	59775	2
2	0	2	0	0	59776	2
2	0	2	0	0	59777	2
2	0	2	0	0	59778	2
2	0	2	0	0	59779	2
2	0	2	0	0	59780	2
2	0	2	0	0	59781	2
2	0	2	0	0	59782	2
2	0	2	0	0	59783	2
2	0	2	0	0	59784	2
2	32	4	7172	7204	59785	1
2	0	2	0	0	59786	2
2	0	2	0	0	59787	2
2	0	2	0	0	59788	2
2	0	2	0	0	59789	2
2	0	2	0	0	59790	2
2	0	2	0	0	59791	2
2	0	2	0	0	59792	2
2	0	2	2	2	59793	2
2	0	2	0	0	59794	2
2	0	2	0	0	59795	2
2	0	2	0	0	59796	2
2	0	2	0	0	59797	2
4	16	2	0	16	59798	0
4	38	2	0	38	59799	0
0	0	2	0	0	59800	2
0	0	2	2	2	59801	2
0	0	2	0	0	59802	2
2	0	2	0	0	59803	2
2	0	2	0	0	59804	2
0	940	2	2	942	59805	0
0	107	2	0	107	59806	0
4	6	2	0	6	59807	0
2	0	4	4972	4972	59808	2
2	0	2	1593	1593	59809	2
4	4	2	1	5	59810	0
2	0	2	0	0	59811	2
2	0	2	2	2	59812	2
2	0	2	0	0	59813	2
2	0	2	0	0	59814	2
2	0	2	0	0	59815	2
2	0	2	0	0	59816	2
2	0	2	0	0	59817	2
2	0	2	2	2	59818	2
2	0	2	0	0	59819	2
2	0	2	0	0	59820	2
2	0	2	0	0	59821	2
2	0	2	0	0	59822	2
2	0	2	0	0	59823	2
2	0	2	0	0	59824	2
2	0	4	0	0	59825	2
2	0	2	1	1	59826	2
2	0	4	29	29	59827	2
2	0	2	0	0	59828	2
2	0	2	0	0	59829	2
2	0	4	0	0	59830	2
2	0	2	0	0	59831	2
2	0	2	0	0	59832	2
2	0	4	1	1	59833	2
2	17	2	0	17	59834	0
2	0	2	0	0	59835	2
2	0	2	2	2	59836	2
2	0	2	0	0	59837	2
2	0	2	0	0	59838	2
2	0	2	0	0	59839	2
2	0	2	0	0	59840	2
4	648	0	2	650	59841	0
2	0	2	0	0	59842	2
2	0	2	1	1	59843	2
2	0	2	0	0	59844	2
2	0	2	0	0	59845	2
2	0	2	0	0	59846	2
2	0	2	0	0	59847	2
2	0	2	0	0	59848	2
2	0	2	0	0	59849	2
2	0	2	2	2	59850	2
2	0	2	0	0	59851	2
2	0	2	0	0	59852	2
2	0	2	1	1	59853	2
2	1	2	0	1	59854	0
2	0	2	0	0	59855	2
2	0	2	0	0	59856	2
2	0	2	0	0	59857	2
2	1	2	16	17	59858	1
2	0	2	0	0	59859	2
2	0	2	0	0	59860	2
2	0	4	2204	2204	59861	2
2	0	2	0	0	59862	2
2	0	2	0	0	59863	2
2	0	4	621	621	59864	2
2	0	2	3	3	59865	2
2	57	4	215	272	59866	1
2	0	2	8	8	59867	2
2	0	2	1	1	59868	2
2	18	2	8	26	59869	1
2	1	2	24	25	59870	1
2	1	2	0	1	59871	0
2	0	2	0	0	59872	2
2	0	2	0	0	59873	2
2	0	2	0	0	59874	2
2	0	2	0	0	59875	2
2	0	2	0	0	59876	2
2	0	2	0	0	59877	2
2	0	2	7	7	59878	2
2	0	2	0	0	59879	2
2	0	2	0	0	59880	2
2	1	2	2	3	59881	1
2	0	2	2	2	59882	2
2	0	2	0	0	59883	2
2	0	2	0	0	59884	2
2	1	2	0	1	59885	0
2	1	2	63	64	59886	1
2	0	2	2	2	59887	2
2	0	2	0	0	59888	2
2	0	2	0	0	59889	2
2	0	2	0	0	59890	2
2	0	2	0	0	59891	2
2	0	2	0	0	59892	2
2	0	2	0	0	59893	2
2	0	2	0	0	59894	2
2	0	2	0	0	59895	2
2	0	4	0	0	59896	2
2	0	2	0	0	59897	2
2	0	2	0	0	59898	2
2	0	4	1	1	59899	2
2	0	2	0	0	59900	2
2	4	4	4917	4921	59901	0
2	0	2	39	39	59902	2
2	922	2	0	922	59903	0
2	36	2	389	425	59904	1
2	0	2	1888	1888	59905	2
2	0	2	4	4	59906	2
2	180	2	14	194	59907	1
2	0	2	700	700	59908	2
0	1	3	16	17	59909	1
0	0	3	16	16	59910	2
2	0	2	0	0	59911	2
2	0	2	0	0	59912	2
2	0	2	0	0	59913	2
2	0	2	0	0	59914	2
2	0	2	0	0	59915	2
2	0	2	0	0	59916	2
2	0	2	0	0	59917	2
2	0	2	0	0	59918	2
2	0	2	0	0	59919	2
2	0	2	0	0	59920	2
2	0	2	0	0	59921	2
2	0	2	0	0	59922	2
2	0	2	0	0	59923	2
2	0	2	0	0	59924	2
2	0	2	0	0	59925	2
2	0	2	0	0	59926	2
2	0	2	0	0	59927	2
2	0	2	0	0	59928	2
2	3	2	0	3	59929	0
2	0	2	112	112	59930	2
2	0	2	0	0	59931	2
2	0	2	0	0	59932	2
0	0	2	6	6	59933	2
0	0	2	0	0	59934	2
2	1	2	0	1	59935	1
2	0	2	23	23	59936	2
4	0	2	0	0	59937	2
4	0	2	0	0	59938	2
0	4313	2	13	4326	59939	0
0	2749	2	114	2863	59940	0
0	794	2	0	794	59941	0
2	242	2	54	296	59942	0
2	171	2	34	205	59943	0
0	6	2	1327	1333	59944	0
0	178	2	59	237	59945	0
2	66	2	3386	3452	59946	1
2	3	2	540	543	59947	1
4	19	2	703	722	59948	0
4	0	2	14	14	59949	2
4	60	2	4	64	59950	0
4	194	2	3	197	59951	0
2	0	2	3386	3386	59952	2
2	0	2	540	540	59953	2
4	0	4	0	0	59954	2
4	0	4	0	0	59955	2
2	1	2	28	29	59956	0
4	0	4	3552	3552	59957	2
4	1	4	2341	2342	59958	1
2	1495	2	852	2347	59959	0
2	0	2	60	60	59960	2
2	0	2	71	71	59961	2
2	0	2	5	5	59962	2
2	107	2	117	224	59963	1
2	1	2	1	2	59964	0
2	1766	2	441	2207	59965	0
2	3	4	12172	12175	59966	1
0	0	2	5	5	59967	2
4	8	2	1	9	59968	0
4	33	2	1	34	59969	0
5	870	4	173	1043	59970	0
2	0	2	0	0	59971	2
2	0	2	0	0	59972	2
2	0	2	0	0	59973	2
2	0	2	0	0	59974	2
4	1	2	0	1	59975	0
2	0	2	0	0	59976	2
2	0	2	1	1	59977	2
2	0	2	0	0	59978	2
2	0	2	1	1	59979	2
2	0	2	0	0	59980	2
2	0	2	0	0	59981	2
2	0	2	0	0	59982	2
2	0	2	0	0	59983	2
2	0	2	0	0	59984	2
2	0	2	0	0	59985	2
2	0	2	0	0	59986	2
2	0	2	0	0	59987	2
2	0	2	0	0	59988	2
2	0	2	0	0	59989	2
2	0	2	0	0	59990	2
2	0	2	0	0	59991	2
2	0	2	0	0	59992	2
2	0	2	0	0	59993	2
2	0	2	0	0	59994	2
2	0	2	2	2	59995	2
2	0	2	0	0	59996	2
2	0	2	0	0	59997	2
2	0	4	1	1	59998	2
2	0	2	0	0	59999	2
4	0	2	0	0	60000	2
2	0	2	0	0	60001	2
2	0	2	0	0	60002	2
2	0	2	0	0	60003	2
2	0	2	0	0	60004	2
2	0	2	0	0	60005	2
2	0	2	0	0	60006	2
2	0	2	0	0	60007	2
2	0	4	0	0	60008	2
2	0	2	0	0	60009	2
2	0	2	0	0	60010	2
2	0	4	0	0	60011	2
2	0	2	0	0	60012	2
2	0	2	0	0	60013	2
2	0	4	0	0	60014	2
2	0	2	0	0	60015	2
2	0	2	0	0	60016	2
2	0	4	0	0	60017	2
2	0	2	0	0	60018	2
2	0	2	0	0	60019	2
2	0	2	0	0	60020	2
2	0	2	0	0	60021	2
2	0	2	0	0	60022	2
2	0	2	0	0	60023	2
2	0	2	0	0	60024	2
2	0	4	1	1	60025	2
2	0	2	0	0	60026	2
2	0	2	0	0	60027	2
2	0	4	0	0	60028	2
2	0	2	0	0	60029	2
2	0	2	0	0	60030	2
2	0	2	0	0	60031	2
2	0	2	0	0	60032	2
2	0	2	0	0	60033	2
2	0	2	0	0	60034	2
2	0	2	0	0	60035	2
2	0	2	0	0	60036	2
2	0	2	0	0	60037	2
2	0	2	0	0	60038	2
2	0	2	0	0	60039	2
2	0	2	0	0	60040	2
2	0	2	0	0	60041	2
2	0	2	0	0	60042	2
2	0	2	0	0	60043	2
2	0	2	0	0	60044	2
2	0	2	0	0	60045	2
2	0	2	0	0	60046	2
2	0	2	0	0	60047	2
2	0	2	0	0	60048	2
2	0	2	0	0	60049	2
2	0	2	0	0	60050	2
2	0	2	0	0	60051	2
2	0	2	0	0	60052	2
2	0	2	0	0	60053	2
2	0	2	0	0	60054	2
2	4	2	0	4	60055	1
2	0	2	0	0	60056	2
2	0	2	0	0	60057	2
2	0	2	0	0	60058	2
2	0	2	0	0	60059	2
2	0	2	0	0	60060	2
2	0	2	0	0	60061	2
2	0	2	0	0	60062	2
2	0	2	0	0	60063	2
2	0	2	0	0	60064	2
2	0	2	0	0	60065	2
2	0	2	0	0	60066	2
2	0	2	0	0	60067	2
2	0	2	0	0	60068	2
2	0	2	0	0	60069	2
2	0	2	0	0	60070	2
2	0	2	0	0	60071	2
2	0	2	0	0	60072	2
2	0	2	0	0	60073	2
2	0	2	0	0	60074	2
2	0	2	0	0	60075	2
2	0	2	0	0	60076	2
2	0	2	0	0	60077	2
2	0	2	0	0	60078	2
2	0	2	0	0	60079	2
2	0	2	0	0	60080	2
2	0	2	0	0	60081	2
2	0	2	0	0	60082	2
2	0	2	0	0	60083	2
2	0	2	0	0	60084	2
2	0	2	0	0	60085	2
2	0	2	0	0	60086	2
2	0	2	0	0	60087	2
2	0	2	0	0	60088	2
2	0	2	0	0	60089	2
2	0	2	0	0	60090	2
2	0	4	40	40	60091	2
2	0	2	0	0	60092	2
2	0	2	0	0	60093	2
2	0	4	19	19	60094	2
4	0	2	1	1	60095	2
4	0	4	0	0	60096	2
2	0	2	0	0	60097	2
2	0	2	0	0	60098	2
2	0	2	0	0	60099	2
2	0	2	0	0	60100	2
2	0	2	0	0	60101	2
2	0	2	0	0	60102	2
2	0	2	0	0	60103	2
2	0	2	0	0	60104	2
2	0	2	0	0	60105	2
2	0	2	0	0	60106	2
2	0	2	0	0	60107	2
2	0	2	0	0	60108	2
2	0	2	0	0	60109	2
2	0	2	0	0	60110	2
2	0	2	0	0	60111	2
2	0	2	0	0	60112	2
2	0	2	0	0	60113	2
2	0	2	0	0	60114	2
2	0	2	0	0	60115	2
2	0	2	0	0	60116	2
2	0	2	0	0	60117	2
2	0	2	0	0	60118	2
2	0	2	0	0	60119	2
2	0	2	0	0	60120	2
2	0	2	0	0	60121	2
2	0	2	0	0	60122	2
2	0	2	0	0	60123	2
2	0	2	0	0	60124	2
2	0	2	0	0	60125	2
2	0	2	0	0	60126	2
2	0	2	0	0	60127	2
2	0	2	0	0	60128	2
2	0	2	0	0	60129	2
2	0	4	0	0	60130	2
2	0	2	0	0	60131	2
2	0	2	0	0	60132	2
2	0	4	0	0	60133	2
2	0	2	0	0	60134	2
4	0	2	2	2	60135	2
2	0	2	0	0	60136	2
2	0	2	0	0	60137	2
2	0	2	0	0	60138	2
2	0	2	0	0	60139	2
2	0	2	0	0	60140	2
2	0	2	0	0	60141	2
2	0	2	0	0	60142	2
2	0	2	0	0	60143	2
2	0	2	0	0	60144	2
2	0	2	0	0	60145	2
2	0	2	0	0	60146	2
2	0	2	0	0	60147	2
2	0	2	0	0	60148	2
2	0	2	0	0	60149	2
2	0	2	0	0	60150	2
2	0	2	0	0	60151	2
2	0	2	0	0	60152	2
2	0	2	0	0	60153	2
2	0	2	5	5	60154	2
2	0	2	0	0	60155	2
2	0	2	0	0	60156	2
2	0	2	0	0	60157	2
2	0	2	0	0	60158	2
2	0	2	0	0	60159	2
2	0	2	0	0	60160	2
2	0	2	0	0	60161	2
2	0	2	0	0	60162	2
2	0	2	0	0	60163	2
2	0	2	0	0	60164	2
2	0	2	0	0	60165	2
2	0	2	0	0	60166	2
2	0	2	4	4	60167	2
2	0	2	0	0	60168	2
2	0	2	0	0	60169	2
2	0	2	0	0	60170	2
2	0	2	0	0	60171	2
2	0	2	0	0	60172	2
2	0	0	1	1	60173	2
2	0	2	0	0	60174	2
2	0	0	0	0	60175	2
2	0	2	0	0	60176	2
2	0	2	0	0	60177	2
0	1	4	11	12	60178	0
2	0	2	0	0	60179	2
2	0	2	0	0	60180	2
2	0	2	0	0	60181	2
2	0	2	12	12	60182	2
2	0	2	0	0	60183	2
2	0	2	1	1	60184	2
2	0	2	0	0	60185	2
2	0	2	0	0	60186	2
2	0	2	0	0	60187	2
2	0	2	0	0	60188	2
2	0	2	0	0	60189	2
2	0	2	0	0	60190	2
4	1	0	6	7	60191	1
2	0	2	0	0	60192	2
2	0	2	0	0	60193	2
2	0	2	0	0	60194	2
2	0	2	0	0	60195	2
2	0	2	0	0	60196	2
2	0	2	0	0	60197	2
2	0	2	0	0	60198	2
2	0	2	0	0	60199	2
2	0	2	0	0	60200	2
2	0	2	0	0	60201	2
2	0	2	0	0	60202	2
2	0	2	0	0	60203	2
2	0	2	0	0	60204	2
2	0	2	0	0	60205	2
2	0	2	0	0	60206	2
2	0	2	0	0	60207	2
2	0	2	0	0	60208	2
2	0	2	0	0	60209	2
2	0	4	156	156	60210	2
0	0	4	3	3	60211	2
2	0	2	0	0	60212	2
2	0	2	0	0	60213	2
2	0	2	0	0	60214	2
2	0	2	0	0	60215	2
2	0	2	0	0	60216	2
2	0	2	0	0	60217	2
0	1	4	4	5	60218	0
2	0	2	0	0	60219	2
2	0	2	0	0	60220	2
2	0	2	0	0	60221	2
2	0	2	0	0	60222	2
2	0	2	0	0	60223	2
2	0	4	77	77	60224	2
2	0	2	0	0	60225	2
2	0	4	64	64	60226	2
2	0	2	0	0	60227	2
2	0	2	0	0	60228	2
2	0	2	0	0	60229	2
2	0	2	0	0	60230	2
2	0	2	0	0	60231	2
2	0	2	0	0	60232	2
2	0	2	0	0	60233	2
2	0	2	0	0	60234	2
2	0	2	0	0	60235	2
2	0	2	0	0	60236	2
4	0	2	0	0	60237	2
4	1	2	0	1	60238	0
2	0	2	0	0	60239	2
2	0	4	2	2	60240	2
2	0	2	0	0	60241	2
2	0	2	0	0	60242	2
2	0	4	0	0	60243	2
2	0	2	0	0	60244	2
2	0	2	0	0	60245	2
2	0	2	0	0	60246	2
2	0	2	0	0	60247	2
2	0	2	0	0	60248	2
2	0	2	0	0	60249	2
2	0	2	0	0	60250	2
2	0	2	0	0	60251	2
2	0	2	0	0	60252	2
2	0	2	0	0	60253	2
2	0	2	0	0	60254	2
2	0	2	0	0	60255	2
2	0	2	0	0	60256	2
2	2	2	0	2	60257	0
2	0	2	0	0	60258	2
2	0	2	1	1	60259	2
2	0	2	0	0	60260	2
2	0	2	0	0	60261	2
2	0	2	0	0	60262	2
2	0	2	0	0	60263	2
2	0	2	0	0	60264	2
2	0	2	0	0	60265	2
2	0	2	0	0	60266	2
2	0	2	0	0	60267	2
2	0	2	0	0	60268	2
2	0	2	0	0	60269	2
2	0	4	8	8	60270	2
2	0	2	4	4	60271	2
2	0	2	0	0	60272	2
2	0	4	2	2	60273	2
2	0	4	2	2	60274	2
0	2	4	6	8	60275	1
4	31	4	0	31	60276	0
4	0	4	0	0	60277	2
2	1	2	0	1	60278	0
2	2	4	2891	2893	60279	1
2	0	2	1	1	60280	2
2	0	2	0	0	60281	2
2	1	4	4226	4227	60282	1
2	0	2	6	6	60283	2
2	0	2	0	0	60284	2
2	0	4	31	31	60285	2
2	0	2	0	0	60286	2
2	0	2	0	0	60287	2
2	0	4	45	45	60288	2
2	0	2	0	0	60289	2
0	154	4	1217	1371	60290	0
0	0	4	1217	1217	60291	2
4	41	4	0	41	60292	1
4	6	4	0	6	60293	1
2	0	2	0	0	60294	2
2	0	2	0	0	60295	2
2	0	2	0	0	60296	2
2	0	2	0	0	60297	2
2	0	2	0	0	60298	2
2	0	2	0	0	60299	2
2	0	2	0	0	60300	2
2	0	2	0	0	60301	2
2	0	2	0	0	60302	2
2	0	2	0	0	60303	2
2	0	2	0	0	60304	2
2	0	2	0	0	60305	2
2	0	2	0	0	60306	2
2	0	4	13517	13517	60307	2
2	0	2	0	0	60308	2
2	0	2	0	0	60309	2
0	2939	4	8	2947	60310	1
4	0	2	6	6	60311	2
2	41	4	8	49	60312	0
2	0	2	0	0	60313	2
2	0	2	0	0	60314	2
2	0	2	0	0	60315	2
2	0	2	0	0	60316	2
2	0	2	0	0	60317	2
2	0	2	5	5	60318	2
2	0	2	0	0	60319	2
2	0	2	0	0	60320	2
2	0	2	1	1	60321	2
2	0	2	0	0	60322	2
2	0	2	0	0	60323	2
2	0	2	0	0	60324	2
2	0	2	0	0	60325	2
2	0	2	0	0	60326	2
2	0	2	0	0	60327	2
2	0	2	0	0	60328	2
2	0	2	0	0	60329	2
2	0	2	0	0	60330	2
2	0	2	0	0	60331	2
2	0	2	0	0	60332	2
2	0	2	0	0	60333	2
2	0	2	0	0	60334	2
2	0	2	0	0	60335	2
2	0	2	0	0	60336	2
2	0	2	0	0	60337	2
2	0	2	0	0	60338	2
2	0	2	0	0	60339	2
2	0	2	0	0	60340	2
2	0	2	0	0	60341	2
2	0	2	0	0	60342	2
2	0	2	0	0	60343	2
0	0	4	7	7	60344	2
2	0	2	0	0	60345	2
2	0	2	9	9	60346	2
2	0	2	0	0	60347	2
2	0	2	0	0	60348	2
2	0	2	13	13	60349	2
2	0	2	1	1	60350	2
0	0	2	1	1	60351	2
2	0	2	0	0	60352	2
2	0	2	0	0	60353	2
2	0	2	0	0	60354	2
2	0	2	0	0	60355	2
2	0	2	0	0	60356	2
2	0	2	0	0	60357	2
2	0	2	0	0	60358	2
2	0	2	1	1	60359	2
2	0	2	0	0	60360	2
2	0	2	0	0	60361	2
2	0	2	0	0	60362	2
2	0	2	0	0	60363	2
2	0	2	0	0	60364	2
2	0	2	12	12	60365	2
2	0	2	0	0	60366	2
2	0	2	0	0	60367	2
2	1	2	0	1	60368	1
2	0	2	2	2	60369	2
2	0	2	0	0	60370	2
2	0	2	1	1	60371	2
2	0	2	1	1	60372	2
2	1	2	0	1	60373	0
2	0	2	10	10	60374	2
2	0	2	0	0	60375	2
2	0	2	0	0	60376	2
2	0	2	1	1	60377	2
2	0	2	0	0	60378	2
2	0	2	0	0	60379	2
2	0	2	0	0	60380	2
2	0	2	0	0	60381	2
2	0	2	0	0	60382	2
2	0	2	0	0	60383	2
2	0	2	2	2	60384	2
2	0	2	0	0	60385	2
2	0	2	0	0	60386	2
2	0	2	0	0	60387	2
2	0	2	0	0	60388	2
2	0	4	96	96	60389	2
2	0	2	0	0	60390	2
2	0	2	0	0	60391	2
2	0	2	1	1	60392	2
2	0	2	0	0	60393	2
2	8	2	1	9	60394	0
2	7	2	185	192	60395	1
2	0	2	3	3	60396	2
2	0	2	0	0	60397	2
2	0	2	0	0	60398	2
2	0	0	6	6	60399	2
2	0	2	0	0	60400	2
2	0	2	0	0	60401	2
2	0	0	0	0	60402	2
2	0	2	0	0	60403	2
2	0	2	0	0	60404	2
2	0	2	0	0	60405	2
2	0	2	0	0	60406	2
2	0	2	0	0	60407	2
2	0	2	0	0	60408	2
2	0	2	0	0	60409	2
2	0	2	0	0	60410	2
2	0	0	15	15	60411	2
2	0	2	0	0	60412	2
2	0	2	0	0	60413	2
2	0	0	2	2	60414	2
2	0	2	0	0	60415	2
2	6	2	0	6	60416	1
2	0	2	8	8	60417	2
2	0	2	0	0	60418	2
2	0	2	0	0	60419	2
2	0	2	0	0	60420	2
2	0	2	0	0	60421	2
2	0	2	0	0	60422	2
2	0	2	0	0	60423	2
2	0	2	0	0	60424	2
2	0	4	0	0	60425	2
2	0	2	0	0	60426	2
2	0	2	0	0	60427	2
2	0	4	0	0	60428	2
2	0	2	0	0	60429	2
2	1	2	0	1	60430	0
2	0	4	13	13	60431	2
2	0	2	1	1	60432	2
2	0	2	0	0	60433	2
2	2	4	1	3	60434	1
2	0	2	1	1	60435	2
2	0	2	0	0	60436	2
2	0	2	0	0	60437	2
2	0	2	0	0	60438	2
2	0	2	0	0	60439	2
2	0	2	0	0	60440	2
2	0	2	0	0	60441	2
0	0	4	2	2	60442	2
2	0	2	0	0	60443	2
2	1	2	2	3	60444	1
2	0	2	0	0	60445	2
2	0	2	0	0	60446	2
2	0	2	0	0	60447	2
2	2	2	2	4	60448	1
2	0	2	0	0	60449	2
2	3	2	0	3	60450	1
2	0	2	0	0	60451	2
2	0	2	0	0	60452	2
2	0	2	0	0	60453	2
2	0	2	0	0	60454	2
4	1	2	0	1	60455	1
2	0	2	0	0	60456	2
2	0	4	0	0	60457	2
2	0	2	0	0	60458	2
2	0	2	0	0	60459	2
2	0	4	0	0	60460	2
2	0	2	0	0	60461	2
2	0	2	0	0	60462	2
2	0	2	0	0	60463	2
2	0	2	0	0	60464	2
2	0	2	0	0	60465	2
2	0	2	0	0	60466	2
2	0	2	0	0	60467	2
2	0	2	0	0	60468	2
2	0	4	23	23	60469	2
2	0	2	0	0	60470	2
2	0	2	0	0	60471	2
2	0	4	1	1	60472	2
2	0	2	3	3	60473	2
0	1	4	3	4	60474	0
0	3	4	0	3	60475	0
4	430	4	31	461	60476	1
4	10	4	1	11	60477	1
0	0	2	0	0	60478	2
4	8	4	94	102	60479	1
4	0	4	3	3	60480	2
4	0	4	1	1	60481	2
4	0	4	21	21	60482	2
0	36	4	0	36	60483	0
0	0	4	0	0	60484	2
0	0	4	76	76	60485	2
2	0	2	0	0	60486	2
2	0	2	0	0	60487	2
2	0	2	0	0	60488	2
2	0	2	0	0	60489	2
2	0	2	0	0	60490	2
2	0	2	0	0	60491	2
2	0	2	0	0	60492	2
2	0	2	0	0	60493	2
2	0	2	0	0	60494	2
2	0	2	0	0	60495	2
2	0	2	0	0	60496	2
2	0	2	1	1	60497	2
2	0	2	0	0	60498	2
2	0	2	0	0	60499	2
2	0	2	0	0	60500	2
2	0	2	0	0	60501	2
2	0	2	0	0	60502	2
2	0	2	0	0	60503	2
2	0	2	0	0	60504	2
2	0	2	0	0	60505	2
2	0	2	0	0	60506	2
2	0	2	2	2	60507	2
2	0	2	0	0	60508	2
2	0	2	0	0	60509	2
2	0	2	0	0	60510	2
2	0	2	0	0	60511	2
2	0	2	0	0	60512	2
2	0	2	0	0	60513	2
2	0	2	0	0	60514	2
2	0	2	0	0	60515	2
2	0	2	0	0	60516	2
2	0	2	0	0	60517	2
2	0	2	0	0	60518	2
2	0	2	0	0	60519	2
2	0	2	0	0	60520	2
2	0	2	0	0	60521	2
0	9	0	141	150	60522	1
0	8	0	53	61	60523	1
2	0	2	0	0	60524	2
2	0	2	0	0	60525	2
2	0	2	0	0	60526	2
2	0	2	0	0	60527	2
2	0	2	0	0	60528	2
2	0	2	0	0	60529	2
4	3	2	0	3	60530	0
4	10717	2	182	10899	60531	0
4	0	2	0	0	60532	2
4	34	2	15	49	60533	0
4	0	4	761	761	60534	2
4	0	4	10	10	60535	2
4	0	0	13	13	60536	2
4	13	2	1200	1213	60537	0
4	268	2	15	283	60538	0
4	4	4	32	36	60539	1
4	0	4	3223	3223	60540	2
4	41	4	64	105	60541	1
4	5	4	100	105	60542	1
4	57	2	9	66	60543	0
4	0	4	258	258	60544	2
4	3	4	41	44	60545	1
4	0	4	69	69	60546	2
4	6	4	868	874	60547	1
4	30	2	1	31	60548	1
4	4	4	0	4	60549	1
4	0	2	0	0	60550	2
4	22	4	102	124	60551	1
4	0	2	9	9	60552	2
4	10	4	14	24	60553	1
4	48	4	669	717	60554	0
4	2	4	49	51	60555	1
4	0	4	10	10	60556	2
4	7	4	1	8	60557	1
4	10	2	4	14	60558	0
0	2024	2	57	2081	60559	0
0	128	2	0	128	60560	0
0	48	2	0	48	60561	0
0	0	2	12	12	60562	2
0	0	2	3	3	60563	2
0	0	2	0	0	60564	2
0	0	4	4	4	60565	2
0	0	4	1	1	60566	2
4	2	4	0	2	60567	0
4	0	4	0	0	60568	2
0	0	4	0	0	60569	2
0	2	4	3	5	60570	0
4	0	4	33	33	60571	2
4	2	4	259	261	60572	0
0	0	4	193	193	60573	2
4	19	2	99	118	60574	0
4	2	0	257	259	60575	1
4	720	2	9	729	60576	0
0	0	2	10	10	60577	2
0	0	2	2	2	60578	2
0	0	2	0	0	60579	2
0	7117	2	935	8052	60580	0
0	1279	2	6	1285	60581	0
4	298	2	99	397	60582	0
4	79	2	3	82	60583	0
4	1	2	0	1	60584	1
4	0	2	0	0	60585	2
4	0	4	9	9	60586	2
4	0	4	1	1	60587	2
4	4	4	5	9	60588	0
4	7	4	1	8	60589	0
4	1378	2	3	1381	60590	0
4	1061	2	605	1666	60591	0
4	0	0	0	0	60592	2
4	0	0	0	0	60593	2
4	130	2	2	132	60594	0
4	40	2	0	40	60595	0
4	1	2	0	1	60596	0
4	0	2	0	0	60597	2
4	0	2	4	4	60598	2
4	388	2	10	398	60599	0
4	93	2	0	93	60600	0
4	1	4	85	86	60601	0
0	130	4	0	130	60602	0
0	1194	2	8	1202	60603	0
4	0	4	0	0	60604	2
4	0	2	0	0	60605	2
4	0	2	7	7	60606	2
4	2	4	8	10	60607	1
4	0	4	0	0	60608	2
0	1	0	8	9	60609	1
0	2	0	1	3	60610	1
7	0	4	707	707	60611	2
4	0	4	6654	6654	60612	2
4	0	4	5130	5130	60613	2
0	0	2	0	0	60614	2
0	0	2	6	6	60615	2
0	0	2	0	0	60616	2
4	12	2	4	16	60617	0
0	0	4	0	0	60618	2
0	0	4	0	0	60619	2
0	0	4	1	1	60620	2
0	22	0	35	57	60621	1
0	1	0	17	18	60622	1
0	0	0	1	1	60623	2
0	59	0	21	80	60624	1
4	645	2	34	679	60625	0
0	68	2	7	75	60626	0
0	25	2	3	28	60627	0
0	6	2	0	6	60628	0
4	65	2	0	65	60629	0
4	9	4	22	31	60630	1
4	0	4	1	1	60631	2
4	0	4	0	0	60632	2
4	14	2	0	14	60633	0
4	0	2	0	0	60634	2
4	0	2	44	44	60635	2
4	0	2	0	0	60636	2
4	0	2	0	0	60637	2
4	55	4	43	98	60638	0
4	64	4	1	65	60639	0
4	0	2	8	8	60640	2
4	0	2	0	0	60641	2
2	720021	4	627928	1347949	60642	0
2	2457	4	77	2534	60643	0
4	4185	4	4	4189	60644	0
4	1	2	0	1	60645	1
4	5	2	0	5	60646	0
4	3	2	0	3	60647	0
4	3548	2	182	3730	60648	0
0	554	2	2	556	60649	0
0	12	2	5636	5648	60650	0
0	4	2	1	5	60651	0
4	5	4	11	16	60652	0
0	179	2	385	564	60653	0
0	139	2	0	139	60654	0
0	33	2	0	33	60655	0
0	193	2	0	193	60656	0
0	132	4	2	134	60657	0
0	67	4	5	72	60658	0
0	0	2	0	0	60659	2
0	0	2	52	52	60660	2
0	0	2	0	0	60661	2
0	446	2	17	463	60662	0
0	216	2	4	220	60663	0
4	13	4	14	27	60664	0
4	7	4	0	7	60665	0
4	3251	2	1618	4869	60666	0
4	641	2	3	644	60667	0
0	456	2	0	456	60668	0
0	629	2	4	633	60669	0
0	174	2	2	176	60670	0
4	2227	2	161	2388	60671	0
4	552	2	1	553	60672	0
0	1	2	0	1	60673	0
4	89	2	0	89	60674	0
4	3	4	1037	1040	60675	0
4	416	2	1	417	60676	0
4	641	4	1363	2004	60677	1
4	40	4	13	53	60678	0
4	0	4	0	0	60679	2
4	265	4	1075	1340	60680	1
4	47	2	0	47	60681	0
4	68	2	0	68	60682	0
0	13970	2	8	13978	60683	0
0	13513	2	100	13613	60684	0
0	4260	2	11	4271	60685	0
4	0	2	0	0	60686	2
4	0	2	0	0	60687	2
2	30279	5	18670	48949	60688	0
